,Row_ID,Game_ID,Team,Player_ID,Number,Name,Min,FGM,FGA,FG%,2ptsM,2ptsA,2pts%,3ptsM,3ptsA,3pts%,FTM,FTA,FT%,ORebs,DRebs,Rebs,As,PF,To,Stl,Blks,Pts,y
0,13,01_04_01,ANGOLA,0,TOTALS,ANGOLA,200,26,63,41.3,11,34,32.4,15,29,51.7,6,12,50.0,4,17,21,12,37,11,5,3,73,0
1,26,01_04_01,LITHUANIA,0,TOTALS,LITHUANIA,200,20,50,40.0,14,30,46.7,6,20,30.0,32,50,64.0,18,29,47,12,20,16,5,3,78,1
2,39,01_04_02,ITALY,0,TOTALS,ITALY,200,25,64,39.1,15,33,45.5,10,31,32.3,11,19,57.9,6,25,31,14,24,10,5,0,71,1
3,52,01_04_02,NEW ZEALAND,0,TOTALS,NEW ZEALAND,200,23,63,36.5,14,34,41.2,9,29,31.0,14,19,73.7,7,32,39,15,21,14,2,2,69,0
4,65,01_04_03,CHINA,0,TOTALS,CHINA,200,20,62,32.3,11,36,30.6,9,26,34.6,9,12,75.0,13,23,36,5,23,16,3,0,58,0
5,78,01_04_03,SPAIN,0,TOTALS,SPAIN,200,31,66,47.0,26,41,63.4,5,25,20.0,16,24,66.7,15,26,41,10,16,10,5,1,83,1
6,91,01_04_04,ARGENTINA,0,TOTALS,ARGENTINA,200,30,54,55.6,22,37,59.5,8,17,47.1,15,20,75.0,4,21,25,10,25,14,5,2,83,1
7,104,01_04_04,SERBIA & MONTENEGRO,0,TOTALS,SERBIA & MONTENEGRO,200,28,51,54.9,20,33,60.6,8,18,44.4,18,27,66.7,4,20,24,3,24,11,5,0,82,0
8,117,01_04_05,PUERTO RICO,0,TOTALS,PUERTO RICO,200,31,55,56.4,23,39,59.0,8,16,50.0,22,33,66.7,3,24,27,11,25,18,7,0,92,1
9,130,01_04_05,USA,0,TOTALS,USA,200,26,76,34.2,23,52,44.2,3,24,12.5,18,29,62.1,25,21,46,11,28,22,12,3,73,0
10,143,01_04_06,GREECE,0,TOTALS,GREECE,200,28,54,51.9,24,40,60.0,4,14,28.6,16,25,64.0,9,23,32,9,22,9,9,2,76,1
11,156,01_04_06,AUSTRALIA,0,TOTALS,AUSTRALIA,200,18,47,38.3,14,34,41.2,4,13,30.8,14,16,87.5,5,20,25,2,26,15,4,1,54,0
12,169,01_04_07,NEW ZEALAND,0,TOTALS,NEW ZEALAND,200,23,66,34.8,13,29,44.8,10,37,27.0,6,10,60.0,13,26,39,6,27,19,8,1,62,0
13,182,01_04_07,CHINA,0,TOTALS,CHINA,200,25,60,41.7,24,49,49.0,1,11,9.1,18,29,62.1,9,26,35,11,17,17,4,1,69,1
14,195,01_04_08,AUSTRALIA,0,TOTALS,AUSTRALIA,200,29,59,49.2,22,41,53.7,7,18,38.9,18,30,60.0,9,35,44,8,19,16,5,5,83,1
15,208,01_04_08,ANGOLA,0,TOTALS,ANGOLA,200,19,71,26.8,10,41,24.4,9,30,30.0,12,19,63.2,15,21,36,4,24,11,7,1,59,0
16,221,01_04_09,LITHUANIA,0,TOTALS,LITHUANIA,200,30,56,53.6,14,26,53.8,16,30,53.3,22,35,62.9,8,28,36,16,34,19,12,5,98,1
17,233,01_04_09,PUERTO RICO,0,TOTALS,PUERTO RICO,200,25,64,39.1,13,38,34.2,12,26,46.2,28,38,73.7,11,19,30,7,30,17,14,1,90,0
18,246,01_04_10,SERBIA & MONTENEGRO,0,TOTALS,SERBIA & MONTENEGRO,200,25,53,47.2,15,34,44.1,10,19,52.6,14,23,60.9,10,20,30,13,20,16,3,2,74,1
19,259,01_04_10,ITALY,0,TOTALS,ITALY,200,28,59,47.5,20,41,48.8,8,18,44.4,8,9,88.9,7,17,24,4,27,16,9,1,72,0
20,272,01_04_11,SPAIN,0,TOTALS,SPAIN,200,26,50,52.0,19,35,54.3,7,15,46.7,28,38,73.7,7,17,24,11,20,17,8,6,87,1
21,285,01_04_11,ARGENTINA,0,TOTALS,ARGENTINA,200,30,70,42.9,26,50,52.0,4,20,20.0,12,17,70.6,15,14,29,17,30,19,10,3,76,0
22,298,01_04_12,USA,0,TOTALS,USA,200,27,67,40.3,23,46,50.0,4,21,19.0,19,32,59.4,16,26,42,14,22,19,11,4,77,1
23,311,01_04_12,GREECE,0,TOTALS,GREECE,200,27,61,44.3,19,42,45.2,8,19,42.1,9,15,60.0,4,24,28,15,25,21,11,2,71,0
24,324,01_04_13,SERBIA & MONTENEGRO,0,TOTALS,SERBIA & MONTENEGRO,200,32,58,55.2,24,35,68.6,8,23,34.8,15,20,75.0,6,21,27,8,29,21,5,1,87,0
25,337,01_04_13,NEW ZEALAND,0,TOTALS,NEW ZEALAND,200,33,62,53.2,22,38,57.9,11,24,45.8,13,26,50.0,6,16,22,14,25,12,10,1,90,1
26,350,01_04_14,ITALY,0,TOTALS,ITALY,200,24,68,35.3,12,33,36.4,12,35,34.3,3,3,100.0,16,18,34,8,28,18,12,2,63,0
27,363,01_04_14,SPAIN,0,TOTALS,SPAIN,200,23,51,45.1,21,40,52.5,2,11,18.2,23,33,69.7,10,23,33,6,12,15,9,3,71,1
28,376,01_04_15,USA,0,TOTALS,USA,200,39,68,57.4,36,51,70.6,3,17,17.6,8,15,53.3,8,26,34,23,18,7,7,2,89,1
29,389,01_04_15,AUSTRALIA,0,TOTALS,AUSTRALIA,200,30,60,50.0,18,34,52.9,12,26,46.2,7,13,53.8,4,24,28,15,17,13,1,2,79,0
30,401,01_04_16,PUERTO RICO,0,TOTALS,PUERTO RICO,192,28,60,46.7,22,47,46.8,6,13,46.2,21,28,75.0,11,26,37,12,16,12,8,2,83,1
31,414,01_04_16,ANGOLA,0,TOTALS,ANGOLA,200,30,68,44.1,15,27,55.6,15,41,36.6,5,8,62.5,7,18,25,15,25,12,8,3,80,0
32,427,01_04_17,ARGENTINA,0,TOTALS,ARGENTINA,200,33,70,47.1,27,41,65.9,6,29,20.7,10,16,62.5,14,27,41,17,19,14,9,1,82,1
33,440,01_04_17,CHINA,0,TOTALS,CHINA,200,21,57,36.8,16,33,48.5,5,24,20.8,10,17,58.8,10,20,30,8,20,23,2,1,57,0
34,453,01_04_18,GREECE,0,TOTALS,GREECE,200,26,51,51.0,21,35,60.0,5,16,31.2,19,31,61.3,10,16,26,10,28,16,6,2,76,0
35,466,01_04_18,LITHUANIA,0,TOTALS,LITHUANIA,200,33,55,60.0,20,31,64.5,13,24,54.2,19,26,73.1,10,18,28,17,32,15,9,4,98,1
36,479,01_04_19,AUSTRALIA,0,TOTALS,AUSTRALIA,200,31,65,47.7,22,41,53.7,9,24,37.5,11,18,61.1,9,31,40,14,25,14,2,3,82,0
37,492,01_04_19,PUERTO RICO,0,TOTALS,PUERTO RICO,200,32,66,48.5,27,42,64.3,5,24,20.8,18,26,69.2,6,20,26,11,23,5,7,1,87,1
38,505,01_04_20,SPAIN,0,TOTALS,SPAIN,200,23,53,43.4,22,39,56.4,1,14,7.1,29,37,78.4,6,21,27,8,21,10,8,2,76,1
39,518,01_04_20,SERBIA & MONTENEGRO,0,TOTALS,SERBIA & MONTENEGRO,200,25,57,43.9,18,36,50.0,7,21,33.3,11,14,78.6,8,22,30,10,31,14,5,2,68,0
40,531,01_04_21,NEW ZEALAND,0,TOTALS,NEW ZEALAND,200,31,62,50.0,17,32,53.1,14,30,46.7,18,26,69.2,8,16,24,11,30,12,3,2,94,0
41,544,01_04_21,ARGENTINA,0,TOTALS,ARGENTINA,200,36,60,60.0,30,44,68.2,6,16,37.5,20,33,60.6,8,18,26,20,26,11,4,2,98,1
42,557,01_04_22,CHINA,0,TOTALS,CHINA,200,14,53,26.4,8,40,20.0,6,13,46.2,18,26,69.2,10,22,32,5,18,21,1,1,52,0
43,570,01_04_22,ITALY,0,TOTALS,ITALY,200,35,66,53.0,22,35,62.9,13,31,41.9,6,8,75.0,4,27,31,26,22,9,10,7,89,1
44,583,01_04_23,LITHUANIA,0,TOTALS,LITHUANIA,200,28,54,51.9,15,27,55.6,13,27,48.1,25,31,80.6,9,23,32,7,27,21,4,2,94,1
45,596,01_04_23,USA,0,TOTALS,USA,200,30,67,44.8,22,46,47.8,8,21,38.1,22,33,66.7,15,16,31,11,24,12,13,6,90,0
46,609,01_04_24,ANGOLA,0,TOTALS,ANGOLA,200,19,55,34.5,13,31,41.9,6,24,25.0,12,21,57.1,7,13,20,5,17,15,8,3,56,0
47,622,01_04_24,GREECE,0,TOTALS,GREECE,200,33,64,51.6,24,48,50.0,9,16,56.2,13,16,81.2,13,29,42,10,23,15,10,2,88,1
48,635,01_04_25,SPAIN,0,TOTALS,SPAIN,200,30,59,50.8,16,33,48.5,14,26,53.8,14,21,66.7,4,25,29,10,15,18,7,2,88,1
49,648,01_04_25,NEW ZEALAND,0,TOTALS,NEW ZEALAND,200,31,75,41.3,22,40,55.0,9,35,25.7,13,15,86.7,15,25,40,9,21,13,12,1,84,0
50,661,01_04_26,LITHUANIA,0,TOTALS,LITHUANIA,200,37,68,54.4,27,40,67.5,10,28,35.7,16,21,76.2,9,22,31,13,14,9,8,3,100,0
51,674,01_04_26,AUSTRALIA,0,TOTALS,AUSTRALIA,200,32,71,45.1,21,43,48.8,11,28,39.3,10,15,66.7,12,17,29,8,19,10,4,0,85,1
52,687,01_04_27,USA,0,TOTALS,USA,200,33,60,55.0,30,54,55.6,3,6,50.0,20,26,76.9,16,36,52,16,20,17,9,7,89,1
53,700,01_04_27,ANGOLA,0,TOTALS,ANGOLA,200,19,61,31.1,13,36,36.1,6,25,24.0,9,18,50.0,5,12,17,7,19,12,5,4,53,0
54,713,01_04_28,SERBIA & MONTENEGRO,0,TOTALS,SERBIA & MONTENEGRO,200,25,64,39.1,16,40,40.0,9,24,37.5,7,11,63.6,13,18,31,15,19,9,8,6,66,0
55,726,01_04_28,CHINA,0,TOTALS,CHINA,200,22,54,40.7,17,35,48.6,5,19,26.3,18,20,90.0,8,25,33,8,16,11,5,2,67,1
56,739,01_04_29,ITALY,0,TOTALS,ITALY,200,28,50,56.0,21,35,60.0,7,15,46.7,13,20,65.0,2,30,32,10,15,19,7,3,76,1
57,752,01_04_29,ARGENTINA,0,TOTALS,ARGENTINA,200,31,71,43.7,25,51,49.0,6,20,30.0,7,8,87.5,8,19,27,10,19,13,10,2,75,0
58,765,01_04_30,SERBIA & MONTENEGRO,0,TOTALS,SERBIA & MONTENEGRO,200,30,53,56.6,22,35,62.9,8,18,44.4,17,22,77.3,4,31,35,15,21,12,7,0,85,1
59,778,01_04_30,ANGOLA,0,TOTALS,ANGOLA,200,20,56,35.7,9,27,33.3,11,29,37.9,11,16,68.8,4,17,21,6,19,11,5,2,62,0
60,791,01_04_31,NEW ZEALAND,0,TOTALS,NEW ZEALAND,200,30,66,45.5,21,36,58.3,9,30,30.0,11,18,61.1,6,24,30,11,21,18,7,0,80,0
61,804,01_04_31,AUSTRALIA,0,TOTALS,AUSTRALIA,200,34,69,49.3,18,33,54.5,16,36,44.4,14,18,77.8,10,26,36,15,21,14,11,1,98,1
62,817,01_04_32,SPAIN,0,TOTALS,SPAIN,200,34,70,48.6,27,47,57.4,7,23,30.4,19,23,82.6,10,26,36,3,18,10,4,3,94,1
63,830,01_04_32,USA,0,TOTALS,USA,200,36,71,50.7,24,49,49.0,12,22,54.5,18,25,72.0,11,19,30,16,27,9,8,4,102,0
64,843,01_04_33,LITHUANIA,0,TOTALS,LITHUANIA,200,36,71,50.7,25,51,49.0,11,20,55.0,12,14,85.7,8,27,35,13,20,9,11,4,95,1
65,856,01_04_33,CHINA,0,TOTALS,CHINA,200,24,67,35.8,13,33,39.4,11,34,32.4,16,20,80.0,12,24,36,15,21,15,5,1,75,0
66,869,01_04_34,ITALY,0,TOTALS,ITALY,200,26,57,45.6,21,40,52.5,5,17,29.4,26,31,83.9,9,27,36,12,24,14,6,1,83,1
67,882,01_04_34,PUERTO RICO,0,TOTALS,PUERTO RICO,200,23,61,37.7,16,36,44.4,7,25,28.0,17,25,68.0,11,20,31,6,24,15,9,1,70,0
68,895,01_04_35,GREECE,0,TOTALS,GREECE,200,23,64,35.9,17,34,50.0,6,30,20.0,12,21,57.1,15,23,38,10,29,12,7,2,64,0
69,908,01_04_35,ARGENTINA,0,TOTALS,ARGENTINA,200,23,54,42.6,18,36,50.0,5,18,27.8,18,28,64.3,6,22,28,5,22,7,3,2,69,1
70,921,01_04_36,ITALY,0,TOTALS,ITALY,200,29,61,47.5,11,33,33.3,18,28,64.3,24,28,85.7,9,31,40,12,23,13,6,5,100,0
71,934,01_04_36,LITHUANIA,0,TOTALS,LITHUANIA,200,28,72,38.9,13,37,35.1,15,35,42.9,20,25,80.0,12,18,30,19,27,10,7,1,91,1
72,947,01_04_37,ARGENTINA,0,TOTALS,ARGENTINA,200,32,59,54.2,21,37,56.8,11,22,50.0,14,21,66.7,6,26,32,18,24,20,9,4,89,1
73,960,01_04_37,USA,0,TOTALS,USA,200,32,77,41.6,29,66,43.9,3,11,27.3,14,20,70.0,17,20,37,11,21,14,13,3,81,0
74,973,01_04_38,CHINA,0,TOTALS,CHINA,200,28,58,48.3,16,31,51.6,12,27,44.4,8,10,80.0,4,18,22,10,25,17,2,2,76,0
75,986,01_04_38,SPAIN,0,TOTALS,SPAIN,200,33,65,50.8,28,42,66.7,5,23,21.7,21,26,80.8,12,22,34,18,19,9,7,2,92,1
76,998,01_04_39,PUERTO RICO,0,TOTALS,PUERTO RICO,200,27,57,47.4,19,39,48.7,8,18,44.4,13,16,81.2,8,16,24,11,25,16,6,3,75,0
77,1011,01_04_39,GREECE,0,TOTALS,GREECE,200,31,54,57.4,27,37,73.0,4,17,23.5,19,26,73.1,7,21,28,15,16,12,11,4,85,1
78,1024,01_04_40,LITHUANIA,0,TOTALS,LITHUANIA,200,32,63,50.8,11,26,42.3,21,37,56.8,11,17,64.7,7,18,25,13,27,19,4,2,96,1
79,1037,01_04_40,USA,0,TOTALS,USA,200,36,79,45.6,28,61,45.9,8,18,44.4,24,34,70.6,20,20,40,19,22,12,13,4,104,0
80,1050,01_04_41,ITALY,0,TOTALS,ITALY,200,22,58,37.9,11,27,40.7,11,31,35.5,14,23,60.9,6,20,26,4,29,9,6,3,69,0
81,1063,01_04_41,ARGENTINA,0,TOTALS,ARGENTINA,200,29,56,51.8,26,42,61.9,3,14,21.4,23,34,67.6,9,29,38,13,25,12,3,3,84,1
82,2165,03_04_01,ARGENTINA,0,TOTALS,ARGENTINA,200,27,62,43.5,22,35,62.9,5,27,18.5,8,17,47.1,9,25,34,15,22,12,11,0,67,1
83,2178,03_04_01,ANGOLA,0,TOTALS,ANGOLA,200,21,55,38.2,14,36,38.9,7,19,36.8,14,20,70.0,8,21,29,7,21,15,8,0,63,0
84,2191,03_04_02,SERBIA & MONTENEGRO,0,TOTALS,SERBIA & MONTENEGRO,200,34,75,45.3,28,60,46.7,6,15,40.0,18,25,72.0,14,14,28,20,21,14,20,4,92,1
85,2204,03_04_02,CHINA,0,TOTALS,CHINA,200,27,58,46.6,21,41,51.2,6,17,35.3,18,21,85.7,5,19,24,15,22,21,10,10,78,0
86,2217,03_04_03,ANGOLA,0,TOTALS,ANGOLA,200,23,65,35.4,13,38,34.2,10,27,37.0,12,18,66.7,15,16,31,13,22,16,11,2,68,0
87,2230,03_04_03,LITHUANIA,0,TOTALS,LITHUANIA,200,31,60,51.7,21,33,63.6,10,27,37.0,12,19,63.2,10,15,25,18,20,17,12,5,84,1
88,2243,03_04_04,CHINA,0,TOTALS,CHINA,200,23,53,43.4,15,39,38.5,8,14,57.1,30,42,71.4,6,22,28,9,20,18,13,2,84,1
89,2256,03_04_04,AUSTRALIA,0,TOTALS,AUSTRALIA,200,30,72,41.7,18,34,52.9,12,38,31.6,10,15,66.7,4,17,21,21,32,17,16,3,82,0
90,2269,03_04_05,LITHUANIA,0,TOTALS,LITHUANIA,200,29,54,53.7,24,36,66.7,5,18,27.8,27,38,71.1,6,25,31,13,22,17,7,2,90,1
91,2282,03_04_05,ARGENTINA,0,TOTALS,ARGENTINA,200,28,63,44.4,21,40,52.5,7,23,30.4,16,20,80.0,4,20,24,13,32,13,9,0,79,0
92,2295,03_04_06,AUSTRALIA,0,TOTALS,AUSTRALIA,200,25,65,38.5,16,37,43.2,9,28,32.1,2,7,28.6,9,13,22,16,17,12,9,3,61,0
93,2308,03_04_06,SERBIA & MONTENEGRO,0,TOTALS,SERBIA & MONTENEGRO,200,33,54,61.1,27,38,71.1,6,16,37.5,7,15,46.7,6,20,26,12,17,13,12,2,79,1
94,2321,03_04_07,ANGOLA,0,TOTALS,ANGOLA,200,24,67,35.8,17,37,45.9,7,30,23.3,9,13,69.2,7,14,21,8,23,6,14,2,64,0
95,2334,03_04_07,AUSTRALIA,0,TOTALS,AUSTRALIA,200,23,54,42.6,17,35,48.6,6,19,31.6,18,22,81.8,8,24,32,9,20,19,6,0,70,1
96,2347,03_04_08,ARGENTINA,0,TOTALS,ARGENTINA,200,30,70,42.9,25,48,52.1,5,22,22.7,19,33,57.6,9,18,27,18,25,15,15,0,84,1
97,2360,03_04_08,CHINA,0,TOTALS,CHINA,200,24,51,47.1,19,29,65.5,5,22,22.7,21,26,80.8,4,23,27,6,27,36,7,2,74,0
98,2373,03_04_09,LITHUANIA,0,TOTALS,LITHUANIA,200,27,61,44.3,21,41,51.2,6,20,30.0,20,25,80.0,7,19,26,15,25,15,7,4,80,0
99,2386,03_04_09,SERBIA & MONTENEGRO,0,TOTALS,SERBIA & MONTENEGRO,200,32,66,48.5,25,46,54.3,7,20,35.0,22,31,71.0,11,22,33,13,26,10,14,6,93,1
100,2633,07_04_01,URUGUAY,0,TOTALS,URUGUAY,200,25,59,42.4,17,36,47.2,8,23,34.8,19,28,67.9,6,22,28,15,26,16,7,1,77,0
101,2646,07_04_01,VENEZUELA,0,TOTALS,VENEZUELA,200,35,67,52.2,27,49,55.1,8,18,44.4,19,30,63.3,10,26,36,22,27,16,11,2,97,1
102,2659,07_04_02,CHILE,0,TOTALS,CHILE,200,28,51,54.9,21,33,63.6,7,18,38.9,21,24,87.5,7,19,26,15,29,18,8,1,84,0
103,2669,07_04_02,BRAZIL,0,TOTALS,BRAZIL,200,30,67,44.8,20,40,50.0,10,27,37.0,22,26,84.6,13,13,26,17,26,15,8,2,92,1
104,2682,07_04_03,VENEZUELA,0,TOTALS,VENEZUELA,200,39,71,54.9,27,47,57.4,12,24,50.0,18,22,81.8,7,28,35,19,27,12,3,3,108,0
105,2695,07_04_03,CHILE,0,TOTALS,CHILE,200,26,62,41.9,18,40,45.0,8,22,36.4,17,28,60.7,4,21,25,8,21,12,12,0,77,1
106,2708,07_04_04,PARAGUAY,0,TOTALS,PARAGUAY,200,25,58,43.1,21,37,56.8,4,21,19.0,22,39,56.4,0,23,23,10,19,17,4,4,76,0
107,2721,07_04_04,URUGUAY,0,TOTALS,URUGUAY,200,31,67,46.3,22,44,50.0,9,23,39.1,18,21,85.7,7,22,29,19,29,17,4,2,89,1
108,2734,07_04_05,BRAZIL,0,TOTALS,BRAZIL,200,36,63,57.1,30,45,66.7,6,18,33.3,20,28,71.4,9,23,32,28,32,14,7,0,98,1
109,2747,07_04_05,ARGENTINA,0,TOTALS,ARGENTINA,200,27,64,42.2,17,28,60.7,10,36,27.8,28,34,82.4,12,14,26,18,26,13,5,1,92,0
110,2760,07_04_06,PARAGUAY,0,TOTALS,PARAGUAY,200,25,63,39.7,14,38,36.8,11,25,44.0,16,27,59.3,8,12,20,11,28,17,6,1,77,1
111,2773,07_04_06,VENEZUELA,0,TOTALS,VENEZUELA,200,39,67,58.2,30,49,61.2,9,18,50.0,27,33,81.8,10,27,37,16,23,10,9,6,114,0
112,2786,07_04_07,ARGENTINA,0,TOTALS,ARGENTINA,200,39,69,56.5,25,41,61.0,14,28,50.0,16,21,76.2,4,17,21,23,23,12,14,2,108,0
113,2799,07_04_07,CHILE,0,TOTALS,CHILE,200,27,54,50.0,22,37,59.5,5,17,29.4,10,16,62.5,8,21,29,16,21,24,4,1,69,1
114,2812,07_04_08,URUGUAY,0,TOTALS,URUGUAY,200,33,61,54.1,17,35,48.6,16,26,61.5,21,28,75.0,4,27,31,22,30,13,6,0,103,0
115,2825,07_04_08,BRAZIL,0,TOTALS,BRAZIL,200,29,71,40.8,24,47,51.1,5,24,20.8,23,31,74.2,13,22,35,17,27,10,9,3,86,1
116,2838,07_04_09,ARGENTINA,0,TOTALS,ARGENTINA,200,35,61,57.4,20,35,57.1,15,26,57.7,33,39,84.6,8,20,28,25,30,11,14,1,118,0
117,2851,07_04_09,URUGUAY,0,TOTALS,URUGUAY,200,25,52,48.1,16,27,59.3,9,25,36.0,30,37,81.1,5,16,21,10,33,19,6,1,89,1
118,2864,07_04_10,BRAZIL,0,TOTALS,BRAZIL,200,39,69,56.5,28,48,58.3,11,21,52.4,9,17,52.9,4,25,29,20,22,15,12,1,98,1
119,2877,07_04_10,VENEZUELA,0,TOTALS,VENEZUELA,200,35,66,53.0,26,34,76.5,9,32,28.1,15,25,60.0,7,23,30,20,20,16,4,2,94,0
120,2890,07_04_11,BRAZIL,0,TOTALS,BRAZIL,200,30,60,50.0,26,47,55.3,4,13,30.8,21,24,87.5,7,26,33,22,17,16,10,7,85,1
121,2903,07_04_11,PARAGUAY,0,TOTALS,PARAGUAY,200,25,54,46.3,18,39,46.2,7,15,46.7,11,15,73.3,2,21,23,15,20,19,8,4,68,0
122,2916,07_04_12,VENEZUELA,0,TOTALS,VENEZUELA,200,35,55,63.6,28,39,71.8,7,16,43.8,23,32,71.9,5,20,25,15,21,17,4,4,100,0
123,2929,07_04_12,ARGENTINA,0,TOTALS,ARGENTINA,200,42,76,55.3,31,47,66.0,11,29,37.9,18,22,81.8,13,14,27,22,27,10,10,1,113,1
124,2942,07_04_13,BRAZIL,0,TOTALS,BRAZIL,200,28,64,43.8,19,36,52.8,9,28,32.1,13,16,81.2,8,16,24,14,20,13,4,3,78,0
125,2955,07_04_13,ARGENTINA,0,TOTALS,ARGENTINA,200,38,73,52.1,28,43,65.1,10,30,33.3,9,18,50.0,14,25,39,14,15,12,6,0,95,1
126,2966,08_04_01,MEXICO,0,TOTALS,MEXICO,200,24,51,47.1,18,33,54.5,6,18,33.3,40,48,83.3,12,23,35,10,24,21,9,4,94,1
127,2978,08_04_01,BARBADOS,0,TOTALS,BARBADOS,200,33,87,37.9,25,54,46.3,8,33,24.2,9,20,45.0,23,15,38,15,33,19,4,2,83,0
128,2990,08_04_02,CUBA,0,TOTALS,CUBA,200,27,71,38.0,24,56,42.9,3,15,20.0,9,15,60.0,12,24,36,11,25,19,12,0,66,0
129,3000,08_04_02,PANAMA,0,TOTALS,PANAMA,200,25,69,36.2,20,49,40.8,5,20,25.0,17,24,70.8,19,28,47,13,17,20,9,5,72,1
130,3013,08_04_03,PUERTO RICO,0,TOTALS,PUERTO RICO,200,45,79,57.0,36,54,66.7,9,25,36.0,23,31,74.2,8,36,44,34,13,7,17,4,122,0
131,3025,08_04_03,ANTIGUA,0,TOTALS,ANTIGUA,200,32,80,40.0,25,59,42.4,7,21,33.3,6,12,50.0,9,28,37,13,21,20,3,2,77,1
132,3037,08_04_04,DOMINICAN REPUBLIC,0,TOTALS,DOMINICAN REPUBLIC,200,30,68,44.1,23,48,47.9,7,20,35.0,8,10,80.0,15,26,41,10,16,21,13,4,75,1
133,3047,08_04_04,GUATEMALA,0,TOTALS,GUATEMALA,200,25,59,42.4,12,30,40.0,13,29,44.8,8,14,57.1,7,19,26,13,15,18,9,3,71,0
134,3059,08_04_05,GUATEMALA,0,TOTALS,GUATEMALA,200,24,67,35.8,10,33,30.3,14,34,41.2,10,16,62.5,9,13,22,18,23,18,8,1,72,0
135,3071,08_04_05,MEXICO,0,TOTALS,MEXICO,200,31,57,54.4,25,37,67.6,6,20,30.0,16,20,80.0,7,27,34,22,19,19,7,2,84,1
136,3083,08_04_06,PANAMA,0,TOTALS,PANAMA,200,37,76,48.7,25,40,62.5,12,36,33.3,18,25,72.0,14,26,40,23,23,18,9,4,104,0
137,3095,08_04_06,ANTIGUA,0,TOTALS,ANTIGUA,200,22,63,34.9,19,51,37.3,3,12,25.0,20,26,76.9,13,24,37,9,23,24,11,1,67,1
138,3107,08_04_07,CUBA,0,TOTALS,CUBA,200,21,63,33.3,18,48,37.5,3,15,20.0,16,27,59.3,13,12,25,8,23,19,9,2,61,0
139,3119,08_04_07,PUERTO RICO,0,TOTALS,PUERTO RICO,200,35,54,64.8,29,42,69.0,6,12,50.0,17,22,77.3,4,25,29,23,23,20,7,2,93,1
140,3130,08_04_08,BARBADOS,0,TOTALS,BARBADOS,200,22,71,31.0,18,45,40.0,4,26,15.4,7,19,36.8,17,28,45,10,16,16,6,1,55,0
141,3143,08_04_08,DOMINICAN REPUBLIC,0,TOTALS,DOMINICAN REPUBLIC,200,31,69,44.9,23,46,50.0,8,23,34.8,12,18,66.7,10,29,39,21,18,14,11,1,82,1
142,3155,08_04_09,GUATEMALA,0,TOTALS,GUATEMALA,200,23,55,41.8,16,34,47.1,7,21,33.3,18,26,69.2,10,18,28,6,28,23,4,1,71,0
143,3168,08_04_09,BARBADOS,0,TOTALS,BARBADOS,200,30,66,45.5,21,42,50.0,9,24,37.5,27,40,67.5,19,21,40,16,26,14,12,4,96,1
144,3181,08_04_10,ANTIGUA,0,TOTALS,ANTIGUA,200,25,62,40.3,24,49,49.0,1,13,7.7,9,16,56.2,11,17,28,8,26,35,6,2,60,1
145,3194,08_04_10,CUBA,0,TOTALS,CUBA,200,45,87,51.7,31,64,48.4,14,23,60.9,24,38,63.2,23,25,48,26,19,15,25,2,128,0
146,3207,08_04_11,PUERTO RICO,0,TOTALS,PUERTO RICO,200,38,70,54.3,29,46,63.0,9,24,37.5,17,22,77.3,9,23,32,21,14,15,10,6,102,0
147,3216,08_04_11,PANAMA,0,TOTALS,PANAMA,200,28,70,40.0,17,41,41.5,11,29,37.9,13,18,72.2,10,22,32,8,17,16,10,1,80,1
148,3228,08_04_12,DOMINICAN REPUBLIC,0,TOTALS,DOMINICAN REPUBLIC,200,27,72,37.5,22,45,48.9,5,27,18.5,11,15,73.3,12,22,34,17,19,8,12,1,70,1
149,3240,08_04_12,MEXICO,0,TOTALS,MEXICO,200,29,61,47.5,26,45,57.8,3,16,18.8,7,12,58.3,7,31,38,8,11,17,2,3,68,0
150,3253,08_04_13,BARBADOS,0,TOTALS,BARBADOS,200,31,74,41.9,27,54,50.0,4,20,20.0,22,37,59.5,16,28,44,15,21,25,9,6,88,1
151,3264,08_04_13,ANTIGUA,0,TOTALS,ANTIGUA,200,34,77,44.2,32,59,54.2,2,18,11.1,7,21,33.3,15,25,40,11,29,22,17,1,77,0
152,3276,08_04_14,CUBA,0,TOTALS,CUBA,200,34,76,44.7,28,58,48.3,6,18,33.3,10,16,62.5,20,29,49,14,20,15,11,3,84,1
153,3288,08_04_14,GUATEMALA,0,TOTALS,GUATEMALA,200,17,51,33.3,8,30,26.7,9,21,42.9,6,14,42.9,6,22,28,9,16,24,8,2,49,0
154,3300,08_04_15,PUERTO RICO,0,TOTALS,PUERTO RICO,200,33,68,48.5,26,48,54.2,7,20,35.0,16,20,80.0,7,28,35,16,18,9,4,1,89,1
155,3312,08_04_15,MEXICO,0,TOTALS,MEXICO,200,29,71,40.8,21,48,43.8,8,23,34.8,14,18,77.8,12,22,34,11,21,13,4,2,80,0
156,3325,08_04_16,DOMINICAN REPUBLIC,0,TOTALS,DOMINICAN REPUBLIC,200,31,79,39.2,26,55,47.3,5,24,20.8,14,20,70.0,19,23,42,12,16,9,10,3,81,1
157,3335,08_04_16,PANAMA,0,TOTALS,PANAMA,200,31,77,40.3,28,61,45.9,3,16,18.8,12,18,66.7,18,27,45,13,19,13,6,1,77,0
158,3348,08_04_17,ANTIGUA,0,TOTALS,ANTIGUA,200,32,64,50.0,31,54,57.4,1,10,10.0,12,20,60.0,13,29,42,14,31,22,7,0,77,1
159,3359,08_04_17,GUATEMALA,0,TOTALS,GUATEMALA,200,20,57,35.1,13,21,61.9,7,36,19.4,20,33,60.6,9,18,27,12,20,17,10,3,67,0
160,3369,08_04_18,BARBADOS,0,TOTALS,BARBADOS,225,31,61,50.8,25,46,54.3,6,15,40.0,13,23,56.5,13,24,37,14,22,25,7,5,81,0
161,3381,08_04_18,CUBA,0,TOTALS,CUBA,225,32,85,37.6,23,59,39.0,9,26,34.6,10,18,55.6,25,20,45,9,27,19,10,2,83,1
162,3393,08_04_19,MEXICO,0,TOTALS,MEXICO,200,31,60,51.7,25,42,59.5,6,18,33.3,21,26,80.8,14,16,30,12,22,23,10,0,89,0
163,3404,08_04_19,PANAMA,0,TOTALS,PANAMA,200,33,69,47.8,21,41,51.2,12,28,42.9,20,25,80.0,16,18,34,19,24,17,12,0,98,1
164,3415,08_04_20,PUERTO RICO,0,TOTALS,PUERTO RICO,200,29,64,45.3,23,40,57.5,6,24,25.0,10,16,62.5,7,24,31,14,13,8,5,2,74,0
165,3427,08_04_20,DOMINICAN REPUBLIC,0,TOTALS,DOMINICAN REPUBLIC,200,30,72,41.7,25,54,46.3,5,18,27.8,10,13,76.9,15,26,41,10,18,10,5,1,75,1
166,3438,14_04_01,ARGENTINA,0,TOTALS,ARGENTINA,200,29,58,50.0,24,40,60.0,5,18,27.8,20,27,74.1,10,23,33,18,15,19,7,1,83,1
167,3451,14_04_01,DOMINICAN REPUBLIC,0,TOTALS,DOMINICAN REPUBLIC,200,22,63,34.9,19,47,40.4,3,16,18.8,10,15,66.7,11,16,27,8,24,21,13,2,57,0
168,3464,14_04_02,PUERTO RICO,0,TOTALS,PUERTO RICO,225,37,75,49.3,24,49,49.0,13,26,50.0,14,24,58.3,12,33,45,27,18,17,13,6,101,0
169,3473,14_04_02,BRAZIL,0,TOTALS,BRAZIL,225,34,87,39.1,17,49,34.7,17,38,44.7,11,16,68.8,15,23,38,24,21,20,10,3,96,1
170,3486,14_04_03,CANADA,0,TOTALS,CANADA,200,31,64,48.4,25,52,48.1,6,12,50.0,16,28,57.1,18,31,49,18,21,32,14,3,84,1
171,3499,14_04_03,BAHAMAS,0,TOTALS,BAHAMAS,200,24,83,28.9,17,55,30.9,7,28,25.0,11,21,52.4,19,20,39,6,23,21,17,5,66,0
172,3512,14_04_04,BAHAMAS,0,TOTALS,BAHAMAS,200,25,66,37.9,21,53,39.6,4,13,30.8,16,22,72.7,10,15,25,12,24,22,16,2,70,1
173,3525,14_04_04,ARGENTINA,0,TOTALS,ARGENTINA,200,34,57,59.6,23,34,67.6,11,23,47.8,27,33,81.8,6,26,32,26,21,28,9,5,106,0
174,3537,14_04_05,VENEZUELA,0,TOTALS,VENEZUELA,200,26,55,47.3,17,35,48.6,9,20,45.0,19,26,73.1,5,21,26,17,31,19,5,4,80,0
175,3550,14_04_05,PUERTO RICO,0,TOTALS,PUERTO RICO,200,27,72,37.5,18,48,37.5,9,24,37.5,30,35,85.7,19,20,39,11,23,13,12,3,93,1
176,3560,14_04_06,BRAZIL,0,TOTALS,BRAZIL,200,21,62,33.9,16,42,38.1,5,20,25.0,17,23,73.9,13,22,35,8,15,25,12,4,64,0
177,3573,14_04_06,USA,0,TOTALS,USA,200,33,67,49.3,29,51,56.9,4,16,25.0,17,21,81.0,12,26,38,14,22,17,17,4,87,1
178,3586,14_04_07,DOMINICAN REPUBLIC,0,TOTALS,DOMINICAN REPUBLIC,200,23,64,35.9,18,42,42.9,5,22,22.7,23,35,65.7,10,17,27,5,24,14,17,1,74,0
179,3599,14_04_07,CANADA,0,TOTALS,CANADA,200,33,61,54.1,26,41,63.4,7,20,35.0,21,28,75.0,11,32,43,15,22,27,5,3,94,1
180,3610,14_04_08,BRAZIL,0,TOTALS,BRAZIL,200,29,64,45.3,19,38,50.0,10,26,38.5,8,13,61.5,9,28,37,10,22,13,7,0,76,1
181,3620,14_04_08,VENEZUELA,0,TOTALS,VENEZUELA,200,23,63,36.5,16,40,40.0,7,23,30.4,15,24,62.5,9,25,34,16,15,11,6,2,68,0
182,3632,14_04_09,DOMINICAN REPUBLIC,0,TOTALS,DOMINICAN REPUBLIC,200,28,75,37.3,24,56,42.9,4,19,21.1,19,26,73.1,21,17,38,13,19,17,15,0,79,0
183,3644,14_04_09,BAHAMAS,0,TOTALS,BAHAMAS,200,28,62,45.2,20,44,45.5,8,18,44.4,18,23,78.3,21,24,45,16,23,24,11,6,82,1
184,3657,14_04_10,USA,0,TOTALS,USA,200,33,75,44.0,27,58,46.6,6,17,35.3,20,31,64.5,12,29,41,19,24,7,8,6,92,1
185,3670,14_04_10,PUERTO RICO,0,TOTALS,PUERTO RICO,200,28,71,39.4,24,53,45.3,4,18,22.2,19,26,73.1,8,29,37,8,21,14,2,1,79,0
186,3682,14_04_11,CANADA,0,TOTALS,CANADA,200,22,41,53.7,21,33,63.6,1,8,12.5,25,31,80.6,6,25,31,10,25,27,7,4,70,0
187,3693,14_04_11,ARGENTINA,0,TOTALS,ARGENTINA,200,28,65,43.1,20,41,48.8,8,24,33.3,15,25,60.0,11,14,25,9,26,16,15,1,79,1
188,3705,14_04_12,BAHAMAS,0,TOTALS,BAHAMAS,200,26,65,40.0,17,41,41.5,9,24,37.5,15,21,71.4,11,27,38,15,29,18,5,4,76,0
189,3717,14_04_12,VENEZUELA,0,TOTALS,VENEZUELA,200,25,64,39.1,18,37,48.6,7,27,25.9,25,41,61.0,13,22,35,19,21,11,9,4,82,1
190,3728,14_04_13,BRAZIL,0,TOTALS,BRAZIL,200,28,70,40.0,17,41,41.5,11,29,37.9,21,27,77.8,21,25,46,11,18,23,10,0,88,1
191,3738,14_04_13,DOMINICAN REPUBLIC,0,TOTALS,DOMINICAN REPUBLIC,200,30,73,41.1,26,49,53.1,4,24,16.7,14,18,77.8,15,14,29,10,22,18,8,2,78,0
192,3749,14_04_14,ARGENTINA,0,TOTALS,ARGENTINA,200,28,67,41.8,22,46,47.8,6,21,28.6,5,12,41.7,12,18,30,17,20,13,6,1,67,0
193,3761,14_04_14,PUERTO RICO,0,TOTALS,PUERTO RICO,200,32,62,51.6,29,52,55.8,3,10,30.0,6,12,50.0,10,22,32,17,17,13,8,3,73,1
194,3774,14_04_15,USA,0,TOTALS,USA,200,30,61,49.2,20,41,48.8,10,20,50.0,16,22,72.7,10,26,36,14,29,16,9,3,86,1
195,3787,14_04_15,CANADA,0,TOTALS,CANADA,200,19,57,33.3,18,39,46.2,1,18,5.6,24,34,70.6,10,18,28,7,19,13,6,2,63,0
196,3799,14_04_16,BAHAMAS,0,TOTALS,BAHAMAS,225,34,83,41.0,24,57,42.1,10,26,38.5,24,36,66.7,22,29,51,23,21,19,14,3,102,0
197,3810,14_04_16,DOMINICAN REPUBLIC,0,TOTALS,DOMINICAN REPUBLIC,225,33,75,44.0,23,52,44.2,10,23,43.5,15,24,62.5,11,24,35,16,25,23,14,1,91,1
198,3822,14_04_17,VENEZUELA,0,TOTALS,VENEZUELA,200,28,61,45.9,20,37,54.1,8,24,33.3,23,28,82.1,10,23,33,17,15,15,6,2,87,1
199,3832,14_04_17,BRAZIL,0,TOTALS,BRAZIL,200,27,69,39.1,24,44,54.5,3,25,12.0,16,20,80.0,17,17,34,7,24,11,9,2,73,0
200,3843,14_04_18,ARGENTINA,0,TOTALS,ARGENTINA,200,27,58,46.6,21,40,52.5,6,18,33.3,18,28,64.3,9,14,23,8,30,15,13,0,78,1
201,3856,14_04_18,CANADA,0,TOTALS,CANADA,200,19,37,51.4,17,33,51.5,2,4,50.0,30,44,68.2,7,23,30,7,22,22,5,3,70,0
202,3869,14_04_19,PUERTO RICO,0,TOTALS,PUERTO RICO,200,31,67,46.3,27,53,50.9,4,14,28.6,20,24,83.3,9,16,25,9,19,13,6,6,86,0
203,3880,14_04_19,USA,0,TOTALS,USA,200,37,73,50.7,32,52,61.5,5,21,23.8,18,23,78.3,13,27,40,20,17,13,9,2,97,1
204,4377,20_04_01,VIRGIN ISLANDS,0,TOTALS,VIRGIN ISLANDS,200,18,69,26.1,15,54,27.8,3,15,20.0,13,34,38.2,20,16,36,6,19,22,12,5,52,0
205,4390,20_04_01,BAHAMAS,0,TOTALS,BAHAMAS,200,35,80,43.8,28,54,51.9,7,26,26.9,19,27,70.4,30,32,62,18,21,21,12,10,96,1
206,4403,20_04_02,PUERTO RICO,0,TOTALS,PUERTO RICO,200,38,75,50.7,33,55,60.0,5,20,25.0,18,25,72.0,21,30,51,23,8,17,19,7,99,1
207,4416,20_04_02,BARBADOS,0,TOTALS,BARBADOS,200,18,67,26.9,15,48,31.2,3,19,15.8,5,12,41.7,12,20,32,7,19,28,5,2,44,0
208,4429,20_04_03,BAHAMAS,0,TOTALS,BAHAMAS,225,29,79,36.7,24,53,45.3,5,26,19.2,12,20,60.0,20,30,50,12,26,23,10,7,75,1
209,4442,20_04_03,DOMINICAN REPUBLIC,0,TOTALS,DOMINICAN REPUBLIC,225,23,73,31.5,21,56,37.5,2,17,11.8,25,35,71.4,19,30,49,15,20,25,18,2,73,0
210,4453,20_04_04,MEXICO,0,TOTALS,MEXICO,200,28,58,48.3,26,53,49.1,2,5,40.0,20,31,64.5,18,30,48,19,18,21,5,4,78,1
211,4465,20_04_04,BARBADOS,0,TOTALS,BARBADOS,200,29,70,41.4,16,41,39.0,13,29,44.8,5,7,71.4,9,18,27,22,25,14,4,2,76,0
212,4478,20_04_05,DOMINICAN REPUBLIC,0,TOTALS,DOMINICAN REPUBLIC,200,33,57,57.9,28,47,59.6,5,10,50.0,19,33,57.6,8,27,35,16,25,25,18,2,90,1
213,4491,20_04_05,VIRGIN ISLANDS,0,TOTALS,VIRGIN ISLANDS,200,22,67,32.8,18,47,38.3,4,20,20.0,19,34,55.9,18,14,32,5,26,27,12,2,67,0
214,4504,20_04_06,PUERTO RICO,0,TOTALS,PUERTO RICO,200,39,83,47.0,24,53,45.3,15,30,50.0,5,10,50.0,16,33,49,25,18,9,17,7,98,1
215,4516,20_04_06,MEXICO,0,TOTALS,MEXICO,200,15,66,22.7,15,51,29.4,0,15,0.0,16,22,72.7,14,30,44,3,12,24,3,3,46,0
216,4527,20_04_07,BARBADOS,0,TOTALS,BARBADOS,200,16,65,24.6,13,41,31.7,3,24,12.5,11,20,55.0,19,14,33,7,21,25,6,2,46,0
217,4539,20_04_07,VIRGIN ISLANDS,0,TOTALS,VIRGIN ISLANDS,200,33,70,47.1,30,55,54.5,3,15,20.0,15,24,62.5,21,27,48,16,20,15,13,6,84,1
218,4552,20_04_08,BAHAMAS,0,TOTALS,BAHAMAS,200,30,76,39.5,23,49,46.9,7,27,25.9,23,27,85.2,15,27,42,19,22,12,9,11,90,1
219,4563,20_04_08,MEXICO,0,TOTALS,MEXICO,200,23,69,33.3,20,57,35.1,3,12,25.0,26,33,78.8,17,27,44,8,22,19,5,6,75,0
220,4576,20_04_09,PUERTO RICO,0,TOTALS,PUERTO RICO,200,41,77,53.2,36,61,59.0,5,16,31.2,15,21,71.4,23,22,45,25,22,16,14,6,102,0
221,4589,20_04_09,DOMINICAN REPUBLIC,0,TOTALS,DOMINICAN REPUBLIC,200,25,61,41.0,21,45,46.7,4,16,25.0,20,29,69.0,13,17,30,7,18,24,9,0,74,1
222,4600,20_04_10,MEXICO,0,TOTALS,MEXICO,200,25,52,48.1,21,42,50.0,4,10,40.0,13,19,68.4,8,31,39,15,24,31,4,1,67,0
223,4611,20_04_10,DOMINICAN REPUBLIC,0,TOTALS,DOMINICAN REPUBLIC,200,22,69,31.9,16,45,35.6,6,24,25.0,21,30,70.0,15,15,30,7,18,13,14,2,71,1
224,4622,20_04_11,BAHAMAS,0,TOTALS,BAHAMAS,200,29,66,43.9,22,47,46.8,7,19,36.8,11,18,61.1,10,30,40,14,25,21,4,3,76,0
225,4635,20_04_11,PUERTO RICO,0,TOTALS,PUERTO RICO,200,33,73,45.2,27,52,51.9,6,21,28.6,18,30,60.0,10,25,35,15,17,8,9,4,90,1
226,4648,21_04_01,COSTA RICA,0,TOTALS,COSTA RICA,200,35,94,37.2,26,67,38.8,9,27,33.3,14,30,46.7,16,21,37,13,19,14,20,0,93,1
227,4660,21_04_01,EL SALVADOR,0,TOTALS,EL SALVADOR,200,20,57,35.1,13,38,34.2,7,19,36.8,10,13,76.9,7,22,29,5,19,29,8,0,57,0
228,4672,21_04_02,HONDURAS,0,TOTALS,HONDURAS,200,20,69,29.0,17,49,34.7,3,20,15.0,4,8,50.0,7,22,29,6,11,19,11,0,47,0
229,4685,21_04_02,GUATEMALA,0,TOTALS,GUATEMALA,200,36,67,53.7,24,47,51.1,12,20,60.0,13,19,68.4,6,31,37,19,10,23,22,0,97,1
230,4697,21_04_03,MEXICO,0,TOTALS,MEXICO,200,25,61,41.0,22,51,43.1,3,10,30.0,12,14,85.7,8,23,31,6,17,21,8,0,65,1
231,4710,21_04_03,COSTA RICA,0,TOTALS,COSTA RICA,200,23,81,28.4,21,65,32.3,2,16,12.5,10,19,52.6,14,15,29,16,10,14,8,0,58,0
232,4722,21_04_04,NICARAGUA,0,TOTALS,NICARAGUA,200,26,80,32.5,24,69,34.8,2,11,18.2,21,27,77.8,19,31,50,10,12,11,11,0,75,1
233,4734,21_04_04,HONDURAS,0,TOTALS,HONDURAS,200,25,64,39.1,16,39,41.0,9,25,36.0,5,14,35.7,3,14,17,2,19,9,7,0,64,0
234,4746,21_04_05,EL SALVADOR,0,TOTALS,EL SALVADOR,200,22,72,30.6,15,50,30.0,7,22,31.8,10,14,71.4,11,13,24,5,16,5,1,0,61,0
235,4758,21_04_05,MEXICO,0,TOTALS,MEXICO,200,25,65,38.5,19,46,41.3,6,19,31.6,13,14,92.9,10,30,40,16,9,7,2,0,69,1
236,4771,21_04_06,GUATEMALA,0,TOTALS,GUATEMALA,200,20,86,23.3,16,55,29.1,4,31,12.9,17,25,68.0,10,24,34,2,19,8,7,0,61,0
237,4783,21_04_06,NICARAGUA,0,TOTALS,NICARAGUA,200,23,65,35.4,19,53,35.8,4,12,33.3,13,18,72.2,6,27,33,18,21,10,9,0,63,1
238,4795,21_04_07,HONDURAS,0,TOTALS,HONDURAS,200,23,70,32.9,19,47,40.4,4,23,17.4,7,15,46.7,10,16,26,10,10,11,10,0,57,0
239,4807,21_04_07,EL SALVADOR,0,TOTALS,EL SALVADOR,200,26,65,40.0,14,36,38.9,12,29,41.4,9,13,69.2,11,25,36,13,15,15,2,0,73,1
240,4819,21_04_08,MEXICO,0,TOTALS,MEXICO,200,26,60,43.3,24,52,46.2,2,8,25.0,26,44,59.1,19,39,58,15,16,5,7,0,80,1
241,4832,21_04_08,GUATEMALA,0,TOTALS,GUATEMALA,200,24,78,30.8,15,50,30.0,9,28,32.1,11,16,68.8,7,12,19,1,31,11,2,0,68,0
242,4844,21_04_09,NICARAGUA,0,TOTALS,NICARAGUA,200,25,59,42.4,21,44,47.7,4,15,26.7,10,17,58.8,2,29,31,22,10,11,3,0,64,0
243,4857,21_04_09,COSTA RICA,0,TOTALS,COSTA RICA,200,28,90,31.1,20,63,31.7,8,27,29.6,13,26,50.0,17,24,41,5,18,10,13,0,77,1
244,4870,21_04_10,GUATEMALA,0,TOTALS,GUATEMALA,200,25,73,34.2,18,46,39.1,7,27,25.9,20,26,76.9,11,20,31,16,12,10,8,0,77,1
245,4882,21_04_10,NICARAGUA,0,TOTALS,NICARAGUA,200,28,81,34.6,21,64,32.8,7,17,41.2,11,20,55.0,14,25,39,14,21,14,5,0,74,0
246,4894,21_04_11,MEXICO,0,TOTALS,MEXICO,200,20,59,33.9,16,49,32.7,4,10,40.0,19,31,61.3,6,26,32,9,13,12,2,0,63,0
247,4907,21_04_11,COSTA RICA,0,TOTALS,COSTA RICA,200,32,84,38.1,28,65,43.1,4,19,21.1,17,23,73.9,10,23,33,13,20,9,7,0,85,1
248,5022,23_04_01,LUXEMBOURG,0,TOTALS,LUXEMBOURG,200,33,72,45.8,24,55,43.6,9,17,52.9,15,21,71.4,11,35,46,10,23,25,22,2,90,1
249,5033,23_04_01,WALES,0,TOTALS,WALES,200,21,63,33.3,19,48,39.6,2,15,13.3,15,38,39.5,10,21,31,3,18,27,13,0,59,0
250,5044,23_04_02,MALTA,0,TOTALS,MALTA,200,21,70,30.0,14,54,25.9,7,16,43.8,13,24,54.2,11,20,31,6,25,12,13,0,62,0
251,5057,23_04_02,SCOTLAND,0,TOTALS,SCOTLAND,200,31,67,46.3,22,47,46.8,9,20,45.0,15,26,57.7,17,34,51,12,24,22,12,3,86,1
252,5070,23_04_03,SAN MARINO,0,TOTALS,SAN MARINO,200,29,69,42.0,23,39,59.0,6,30,20.0,18,20,90.0,14,15,29,5,22,17,13,3,82,0
253,5083,23_04_03,ANDORRA,0,TOTALS,ANDORRA,200,28,61,45.9,19,33,57.6,9,28,32.1,21,34,61.8,16,21,37,12,18,16,20,4,86,1
254,5094,23_04_04,WALES,0,TOTALS,WALES,200,38,65,58.5,36,56,64.3,2,9,22.2,15,24,62.5,7,31,38,14,21,8,11,0,93,1
255,5105,23_04_04,MALTA,0,TOTALS,MALTA,200,26,71,36.6,23,54,42.6,3,17,17.6,14,21,66.7,12,24,36,6,25,14,3,3,69,0
256,5118,23_04_05,GIBRALTAR,0,TOTALS,GIBRALTAR,200,20,53,37.7,15,35,42.9,5,18,27.8,19,26,73.1,10,21,31,7,19,17,11,1,64,0
257,5129,23_04_05,AZERBAIJAN,0,TOTALS,AZERBAIJAN,200,36,76,47.4,28,49,57.1,8,27,29.6,7,13,53.8,14,23,37,18,24,18,15,17,87,1
258,5142,23_04_06,ALBANIA,0,TOTALS,ALBANIA,200,27,54,50.0,24,42,57.1,3,12,25.0,14,20,70.0,6,27,33,7,22,24,9,1,71,0
259,5155,23_04_06,LUXEMBOURG,0,TOTALS,LUXEMBOURG,200,29,66,43.9,24,46,52.2,5,20,25.0,14,21,66.7,6,21,27,8,25,11,15,1,77,1
260,5166,23_04_07,MALTA,0,TOTALS,MALTA,200,26,61,42.6,18,38,47.4,8,23,34.8,16,30,53.3,8,23,31,13,23,15,11,4,76,0
261,5179,23_04_07,ALBANIA,0,TOTALS,ALBANIA,200,33,74,44.6,30,59,50.8,3,15,20.0,17,33,51.5,25,31,56,12,25,19,10,2,86,1
262,5190,23_04_08,AZERBAIJAN,0,TOTALS,AZERBAIJAN,200,26,61,42.6,8,25,32.0,18,36,50.0,11,17,64.7,13,21,34,15,20,21,15,3,81,1
263,5203,23_04_08,SAN MARINO,0,TOTALS,SAN MARINO,200,22,53,41.5,16,32,50.0,6,21,28.6,9,11,81.8,9,21,30,8,19,24,10,0,59,0
264,5216,23_04_09,SCOTLAND,0,TOTALS,SCOTLAND,200,30,73,41.1,20,47,42.6,10,26,38.5,22,27,81.5,22,31,53,13,22,18,8,3,92,1
265,5227,23_04_09,WALES,0,TOTALS,WALES,200,27,66,40.9,20,42,47.6,7,24,29.2,10,12,83.3,9,21,30,11,21,16,10,2,71,0
266,5240,23_04_10,GIBRALTAR,0,TOTALS,GIBRALTAR,200,32,57,56.1,25,36,69.4,7,21,33.3,11,17,64.7,13,22,35,13,28,33,7,2,82,1
267,5253,23_04_10,ANDORRA,0,TOTALS,ANDORRA,200,41,76,53.9,38,61,62.3,3,15,20.0,20,27,74.1,14,15,29,14,18,14,29,3,105,0
268,5266,23_04_11,LUXEMBOURG,0,TOTALS,LUXEMBOURG,200,34,66,51.5,28,52,53.8,6,14,42.9,18,24,75.0,14,33,47,12,18,17,11,1,92,1
269,5277,23_04_11,MALTA,0,TOTALS,MALTA,200,24,58,41.4,20,45,44.4,4,13,30.8,9,18,50.0,5,21,26,8,22,20,9,0,61,0
270,5290,23_04_12,SAN MARINO,0,TOTALS,SAN MARINO,200,28,59,47.5,20,39,51.3,8,20,40.0,10,11,90.9,8,27,35,12,22,19,11,0,74,1
271,5303,23_04_12,GIBRALTAR,0,TOTALS,GIBRALTAR,200,17,51,33.3,14,34,41.2,3,17,17.6,17,26,65.4,8,20,28,3,14,19,11,1,54,0
272,5316,23_04_13,ALBANIA,0,TOTALS,ALBANIA,200,27,74,36.5,20,51,39.2,7,23,30.4,11,17,64.7,15,17,32,8,24,15,11,2,72,0
273,5329,23_04_13,SCOTLAND,0,TOTALS,SCOTLAND,200,26,60,43.3,16,37,43.2,10,23,43.5,19,27,70.4,16,24,40,11,17,18,8,0,81,1
274,5340,23_04_14,WALES,0,TOTALS,WALES,200,24,70,34.3,17,52,32.7,7,18,38.9,11,21,52.4,10,19,29,11,14,16,12,2,66,0
275,5353,23_04_14,ALBANIA,0,TOTALS,ALBANIA,200,38,67,56.7,33,51,64.7,5,16,31.2,9,17,52.9,14,36,50,17,16,23,10,7,90,1
276,5366,23_04_15,SCOTLAND,0,TOTALS,SCOTLAND,200,29,66,43.9,24,44,54.5,5,22,22.7,8,19,42.1,9,18,27,11,21,13,8,2,71,0
277,5379,23_04_15,LUXEMBOURG,0,TOTALS,LUXEMBOURG,200,31,61,50.8,26,47,55.3,5,14,35.7,13,23,56.5,10,24,34,12,13,15,8,2,80,1
278,5392,23_04_16,ANDORRA,0,TOTALS,ANDORRA,200,32,67,47.8,22,35,62.9,10,32,31.2,25,44,56.8,12,24,36,14,31,20,21,1,99,1
279,5403,23_04_16,AZERBAIJAN,0,TOTALS,AZERBAIJAN,200,27,61,44.3,19,37,51.4,8,24,33.3,22,35,62.9,12,26,38,7,32,31,18,3,84,0
280,5416,23_04_17,GIBRALTAR,0,TOTALS,GIBRALTAR,200,24,59,40.7,18,40,45.0,6,19,31.6,16,22,72.7,8,14,22,11,21,19,16,0,70,1
281,5427,23_04_17,WALES,0,TOTALS,WALES,200,26,61,42.6,24,51,47.1,2,10,20.0,15,22,68.2,13,26,39,7,23,28,11,4,69,0
282,5440,23_04_18,SAN MARINO,0,TOTALS,SAN MARINO,200,29,70,41.4,22,49,44.9,7,21,33.3,5,7,71.4,7,19,26,5,18,12,7,1,70,0
283,5453,23_04_18,ALBANIA,0,TOTALS,ALBANIA,200,33,64,51.6,27,46,58.7,6,18,33.3,12,16,75.0,12,30,42,17,15,16,9,5,84,1
284,5464,23_04_19,AZERBAIJAN,0,TOTALS,AZERBAIJAN,200,29,71,40.8,20,33,60.6,9,38,23.7,11,16,68.8,5,31,36,12,22,13,11,1,78,1
285,5477,23_04_19,SCOTLAND,0,TOTALS,SCOTLAND,200,38,77,49.4,29,57,50.9,9,20,45.0,16,29,55.2,15,30,45,15,15,12,12,1,101,0
286,5490,23_04_20,ANDORRA,0,TOTALS,ANDORRA,200,35,63,55.6,29,47,61.7,6,16,37.5,19,24,79.2,7,25,32,13,18,16,12,2,95,1
287,5503,23_04_20,LUXEMBOURG,0,TOTALS,LUXEMBOURG,200,32,69,46.4,26,49,53.1,6,20,30.0,13,18,72.2,12,20,32,7,24,17,10,4,83,0
288,6131,25_04_01,LITHUANIA,0,TOTALS,LITHUANIA,200,32,67,47.8,28,54,51.9,4,13,30.8,13,25,52.0,10,36,46,18,22,21,13,5,81,1
289,6144,25_04_01,BELARUS,0,TOTALS,BELARUS,200,16,65,24.6,13,53,24.5,3,12,25.0,12,24,50.0,13,15,28,4,22,19,23,3,47,0
290,6157,25_04_02,LATVIA,0,TOTALS,LATVIA,200,23,55,41.8,16,33,48.5,7,22,31.8,15,27,55.6,9,20,29,6,22,12,12,3,68,0
291,6170,25_04_02,ISRAEL,0,TOTALS,ISRAEL,200,25,55,45.5,22,48,45.8,3,7,42.9,20,23,87.0,4,17,21,9,28,11,13,2,73,1
292,6183,25_04_03,UKRAINE,0,TOTALS,UKRAINE,200,24,63,38.1,22,43,51.2,2,20,10.0,12,28,42.9,12,15,27,10,23,23,13,2,62,0
293,6196,25_04_03,SERBIA & MONTENEGRO,0,TOTALS,SERBIA & MONTENEGRO,200,36,66,54.5,31,50,62.0,5,16,31.2,13,23,56.5,13,22,35,15,25,18,19,3,90,1
294,6209,25_04_04,GREECE,0,TOTALS,GREECE,200,37,68,54.4,31,50,62.0,6,18,33.3,11,20,55.0,16,23,39,20,24,17,11,3,91,1
295,6222,25_04_04,SLOVENIA,0,TOTALS,SLOVENIA,200,30,61,49.2,21,41,51.2,9,20,45.0,15,19,78.9,7,19,26,12,21,14,13,5,84,0
296,6235,25_04_05,RUSSIA,0,TOTALS,RUSSIA,200,26,50,52.0,19,35,54.3,7,15,46.7,30,38,78.9,5,25,30,15,17,15,14,6,89,1
297,6248,25_04_05,CZECH REPUBLIC,0,TOTALS,CZECH REPUBLIC,200,28,69,40.6,21,44,47.7,7,25,28.0,9,15,60.0,15,21,36,16,34,17,11,2,72,0
298,6261,25_04_06,SPAIN,0,TOTALS,SPAIN,200,28,60,46.7,22,45,48.9,6,15,40.0,20,32,62.5,12,28,40,7,19,14,18,5,82,1
299,6274,25_04_06,CROATIA,0,TOTALS,CROATIA,200,27,64,42.2,20,43,46.5,7,21,33.3,14,18,77.8,6,26,32,16,30,17,14,2,75,0
300,6287,25_04_07,SLOVENIA,0,TOTALS,SLOVENIA,200,40,66,60.6,32,44,72.7,8,22,36.4,12,20,60.0,8,19,27,28,19,11,16,1,100,0
301,6300,25_04_07,UKRAINE,0,TOTALS,UKRAINE,200,27,56,48.2,14,30,46.7,13,26,50.0,15,17,88.2,4,11,15,11,22,16,5,3,82,1
302,6313,25_04_08,BELARUS,0,TOTALS,BELARUS,200,17,50,34.0,14,35,40.0,3,15,20.0,23,33,69.7,9,24,33,6,21,20,8,3,60,0
303,6326,25_04_08,GREECE,0,TOTALS,GREECE,200,29,59,49.2,22,37,59.5,7,22,31.8,16,18,88.9,2,22,24,12,28,17,20,1,81,1
304,6339,25_04_09,ISRAEL,0,TOTALS,ISRAEL,200,24,53,45.3,18,39,46.2,6,14,42.9,29,37,78.4,8,16,24,7,31,15,9,1,83,0
305,6352,25_04_09,RUSSIA,0,TOTALS,RUSSIA,200,28,55,50.9,23,40,57.5,5,15,33.3,29,40,72.5,10,20,30,6,27,17,15,2,90,1
306,6365,25_04_10,CROATIA,0,TOTALS,CROATIA,200,22,56,39.3,12,29,41.4,10,27,37.0,15,22,68.2,10,18,28,11,26,14,8,2,69,0
307,6378,25_04_10,LATVIA,0,TOTALS,LATVIA,200,27,56,48.2,25,45,55.6,2,11,18.2,20,29,69.0,11,24,35,13,22,12,14,3,76,1
308,6391,25_04_11,CZECH REPUBLIC,0,TOTALS,CZECH REPUBLIC,200,27,64,42.2,19,38,50.0,8,26,30.8,7,15,46.7,8,35,43,8,30,13,10,6,69,1
309,6404,25_04_11,SPAIN,0,TOTALS,SPAIN,200,18,63,28.6,13,40,32.5,5,23,21.7,24,34,70.6,12,30,42,7,15,11,12,4,65,0
310,6417,25_04_12,SERBIA & MONTENEGRO,0,TOTALS,SERBIA & MONTENEGRO,200,28,62,45.2,19,44,43.2,9,18,50.0,15,20,75.0,10,23,33,17,23,8,15,0,80,1
311,6430,25_04_12,LITHUANIA,0,TOTALS,LITHUANIA,200,24,64,37.5,19,47,40.4,5,17,29.4,19,31,61.3,15,25,40,11,22,14,4,2,72,0
312,6443,25_04_13,BELARUS,0,TOTALS,BELARUS,200,16,52,30.8,12,39,30.8,4,13,30.8,19,24,79.2,8,16,24,6,22,16,9,1,55,0
313,6456,25_04_13,SLOVENIA,0,TOTALS,SLOVENIA,200,29,64,45.3,22,52,42.3,7,12,58.3,19,24,79.2,14,21,35,15,20,12,14,4,84,1
314,6469,25_04_14,RUSSIA,0,TOTALS,RUSSIA,200,26,59,44.1,22,42,52.4,4,17,23.5,22,28,78.6,8,12,20,6,25,11,15,2,78,1
315,6482,25_04_14,LATVIA,0,TOTALS,LATVIA,200,22,52,42.3,14,33,42.4,8,19,42.1,21,28,75.0,10,15,25,12,22,10,11,3,73,0
316,6495,25_04_15,LITHUANIA,0,TOTALS,LITHUANIA,200,26,57,45.6,20,42,47.6,6,15,40.0,35,40,87.5,3,31,34,17,21,14,9,3,93,1
317,6508,25_04_15,UKRAINE,0,TOTALS,UKRAINE,200,29,80,36.2,17,44,38.6,12,36,33.3,8,16,50.0,9,19,28,13,32,7,7,0,78,0
318,6521,25_04_16,SPAIN,0,TOTALS,SPAIN,200,28,67,41.8,18,33,54.5,10,34,29.4,11,17,64.7,10,26,36,15,34,17,11,4,77,0
319,6534,25_04_16,ISRAEL,0,TOTALS,ISRAEL,200,20,54,37.0,15,38,39.5,5,16,31.2,41,49,83.7,7,23,30,7,20,10,14,1,86,1
320,6547,25_04_17,CZECH REPUBLIC,0,TOTALS,CZECH REPUBLIC,200,26,66,39.4,24,41,58.5,2,25,8.0,10,20,50.0,15,25,40,11,19,13,10,2,64,0
321,6560,25_04_17,CROATIA,0,TOTALS,CROATIA,200,29,62,46.8,21,37,56.8,8,25,32.0,16,19,84.2,6,29,35,13,19,9,12,3,82,1
322,6573,25_04_18,GREECE,0,TOTALS,GREECE,200,28,63,44.4,21,46,45.7,7,17,41.2,9,14,64.3,9,31,40,11,21,15,14,5,72,1
323,6586,25_04_18,SERBIA & MONTENEGRO,0,TOTALS,SERBIA & MONTENEGRO,200,21,59,35.6,15,38,39.5,6,21,28.6,11,14,78.6,6,21,27,7,15,14,13,4,59,0
324,6599,25_04_19,CROATIA,0,TOTALS,CROATIA,200,18,55,32.7,16,34,47.1,2,21,9.5,16,20,80.0,9,17,26,9,17,17,12,0,54,0
325,6612,25_04_19,RUSSIA,0,TOTALS,RUSSIA,200,33,63,52.4,22,41,53.7,11,22,50.0,9,16,56.2,15,24,39,15,21,14,18,5,86,1
326,6625,25_04_20,SERBIA & MONTENEGRO,0,TOTALS,SERBIA & MONTENEGRO,200,27,65,41.5,22,45,48.9,5,20,25.0,17,20,85.0,11,19,30,18,19,15,22,3,76,1
327,6638,25_04_20,BELARUS,0,TOTALS,BELARUS,200,23,64,35.9,21,46,45.7,2,18,11.1,14,23,60.9,22,26,48,12,20,25,14,7,62,0
328,6651,25_04_21,LATVIA,0,TOTALS,LATVIA,200,23,59,39.0,8,25,32.0,15,34,44.1,18,26,69.2,9,22,31,15,24,14,15,0,79,1
329,6664,25_04_21,SPAIN,0,TOTALS,SPAIN,200,22,61,36.1,17,38,44.7,5,23,21.7,23,28,82.1,17,27,44,10,24,15,15,6,72,0
330,6677,25_04_22,SLOVENIA,0,TOTALS,SLOVENIA,200,28,67,41.8,25,49,51.0,3,18,16.7,6,7,85.7,7,12,19,9,21,5,17,2,65,0
331,6690,25_04_22,LITHUANIA,0,TOTALS,LITHUANIA,200,25,51,49.0,22,39,56.4,3,12,25.0,16,23,69.6,14,25,39,11,18,17,10,2,69,1
332,6703,25_04_23,ISRAEL,0,TOTALS,ISRAEL,200,27,65,41.5,23,55,41.8,4,10,40.0,20,27,74.1,6,21,27,9,20,8,19,2,78,1
333,6716,25_04_23,CZECH REPUBLIC,0,TOTALS,CZECH REPUBLIC,200,26,61,42.6,20,32,62.5,6,29,20.7,10,14,71.4,8,29,37,14,27,20,6,2,68,0
334,6729,25_04_24,UKRAINE,0,TOTALS,UKRAINE,200,28,61,45.9,13,32,40.6,15,29,51.7,11,14,78.6,9,14,23,13,26,14,11,1,82,0
335,6742,25_04_24,GREECE,0,TOTALS,GREECE,200,30,53,56.6,24,37,64.9,6,16,37.5,25,30,83.3,6,21,27,15,17,15,9,0,91,1
336,6755,25_04_25,SPAIN,0,TOTALS,SPAIN,200,31,61,50.8,23,44,52.3,8,17,47.1,22,30,73.3,14,32,46,22,19,19,11,2,92,1
337,6768,25_04_25,RUSSIA,0,TOTALS,RUSSIA,200,25,68,36.8,19,46,41.3,6,22,27.3,13,19,68.4,4,12,16,10,26,12,18,1,69,0
338,6781,25_04_26,SERBIA & MONTENEGRO,0,TOTALS,SERBIA & MONTENEGRO,200,30,53,56.6,22,37,59.5,8,16,50.0,8,13,61.5,7,26,33,6,14,13,7,5,76,1
339,6794,25_04_26,SLOVENIA,0,TOTALS,SLOVENIA,200,20,60,33.3,18,46,39.1,2,14,14.3,5,7,71.4,11,14,25,4,14,10,8,2,47,0
340,6807,25_04_27,GREECE,0,TOTALS,GREECE,200,21,58,36.2,15,36,41.7,6,22,27.3,19,24,79.2,8,12,20,9,23,10,10,1,67,0
341,6820,25_04_27,LITHUANIA,0,TOTALS,LITHUANIA,200,25,61,41.0,19,44,43.2,6,17,35.3,17,21,81.0,17,25,42,12,21,17,9,3,73,1
342,6833,25_04_28,BELARUS,0,TOTALS,BELARUS,200,23,71,32.4,20,51,39.2,3,20,15.0,18,30,60.0,13,28,41,8,15,18,18,5,67,0
343,6846,25_04_28,UKRAINE,0,TOTALS,UKRAINE,200,25,68,36.8,13,33,39.4,12,35,34.3,11,13,84.6,11,34,45,12,22,24,18,2,73,1
344,6859,25_04_29,CZECH REPUBLIC,0,TOTALS,CZECH REPUBLIC,200,32,66,48.5,23,42,54.8,9,24,37.5,7,11,63.6,14,28,42,19,23,10,7,1,80,1
345,6872,25_04_29,LATVIA,0,TOTALS,LATVIA,200,22,63,34.9,15,30,50.0,7,33,21.2,14,21,66.7,13,19,32,10,12,8,8,4,65,0
346,6885,25_04_30,ISRAEL,0,TOTALS,ISRAEL,200,32,60,53.3,29,50,58.0,3,10,30.0,17,24,70.8,9,20,29,15,22,17,12,1,84,1
347,6898,25_04_30,CROATIA,0,TOTALS,CROATIA,200,33,55,60.0,20,33,60.6,13,22,59.1,25,32,78.1,5,17,22,17,25,15,15,5,104,0
348,6911,25_04_31,SPAIN,0,TOTALS,SPAIN,200,23,66,34.8,15,41,36.6,8,25,32.0,5,8,62.5,14,20,34,10,10,22,9,1,59,0
349,6924,25_04_31,BELARUS,0,TOTALS,BELARUS,200,36,68,52.9,29,54,53.7,7,14,50.0,5,6,83.3,6,23,29,16,11,13,21,3,84,1
350,6937,25_04_32,UKRAINE,0,TOTALS,UKRAINE,200,25,54,46.3,20,32,62.5,5,22,22.7,12,19,63.2,7,20,27,10,14,9,10,5,67,1
351,6950,25_04_32,CROATIA,0,TOTALS,CROATIA,200,24,59,40.7,14,30,46.7,10,29,34.5,7,9,77.8,11,19,30,12,19,14,8,1,65,0
352,6963,25_04_33,RUSSIA,0,TOTALS,RUSSIA,200,25,56,44.6,19,37,51.4,6,19,31.6,11,15,73.3,7,16,23,7,33,18,13,1,67,0
353,6976,25_04_33,SLOVENIA,0,TOTALS,SLOVENIA,200,24,50,48.0,19,33,57.6,5,17,29.4,21,30,70.0,9,17,26,11,19,21,17,3,74,1
354,6989,25_04_34,ISRAEL,0,TOTALS,ISRAEL,200,28,55,50.9,19,38,50.0,9,17,52.9,18,27,66.7,11,18,29,13,21,14,13,5,83,1
355,7002,25_04_34,SERBIA & MONTENEGRO,0,TOTALS,SERBIA & MONTENEGRO,200,28,56,50.0,17,32,53.1,11,24,45.8,15,19,78.9,9,18,27,17,21,13,15,4,82,0
356,7015,25_04_35,LITHUANIA,0,TOTALS,LITHUANIA,200,29,63,46.0,23,50,46.0,6,13,46.2,35,53,66.0,12,29,41,11,14,15,20,10,99,1
357,7028,25_04_35,CZECH REPUBLIC,0,TOTALS,CZECH REPUBLIC,200,30,70,42.9,22,50,44.0,8,20,40.0,4,12,33.3,11,22,33,14,35,21,15,6,72,0
358,7041,25_04_36,GREECE,0,TOTALS,GREECE,200,29,61,47.5,19,38,50.0,10,23,43.5,19,25,76.0,7,28,35,17,24,14,18,6,87,1
359,7054,25_04_36,LATVIA,0,TOTALS,LATVIA,200,22,49,44.9,13,23,56.5,9,26,34.6,13,24,54.2,6,26,32,13,23,19,13,1,66,0
360,7067,25_04_37,SPAIN,0,TOTALS,SPAIN,200,28,56,50.0,22,41,53.7,6,15,40.0,16,22,72.7,6,22,28,8,20,13,11,3,78,1
361,7080,25_04_37,CROATIA,0,TOTALS,CROATIA,200,27,55,49.1,20,34,58.8,7,21,33.3,10,12,83.3,6,15,21,8,20,13,13,1,71,0
362,7093,25_04_38,BELARUS,0,TOTALS,BELARUS,200,30,72,41.7,24,54,44.4,6,18,33.3,14,25,56.0,13,29,42,14,20,12,8,3,80,1
363,7106,25_04_38,UKRAINE,0,TOTALS,UKRAINE,200,26,71,36.6,14,38,36.8,12,33,36.4,12,18,66.7,9,28,37,15,26,16,8,1,76,0
364,7119,25_04_39,CZECH REPUBLIC,0,TOTALS,CZECH REPUBLIC,200,24,63,38.1,17,43,39.5,7,20,35.0,7,13,53.8,10,16,26,15,30,30,10,4,62,0
365,7132,25_04_39,RUSSIA,0,TOTALS,RUSSIA,200,32,66,48.5,23,50,46.0,9,16,56.2,22,35,62.9,16,24,40,15,17,17,24,6,95,1
366,7145,25_04_40,SERBIA & MONTENEGRO,0,TOTALS,SERBIA & MONTENEGRO,200,28,53,52.8,20,34,58.8,8,19,42.1,10,19,52.6,5,31,36,13,21,20,12,5,74,1
367,7158,25_04_40,LATVIA,0,TOTALS,LATVIA,200,27,72,37.5,19,44,43.2,8,28,28.6,9,13,69.2,13,22,35,14,20,12,16,3,71,0
368,7171,25_04_41,LITHUANIA,0,TOTALS,LITHUANIA,200,17,47,36.2,14,29,48.3,3,18,16.7,20,26,76.9,5,20,25,4,27,17,9,4,57,0
369,7184,25_04_41,SLOVENIA,0,TOTALS,SLOVENIA,200,39,66,59.1,31,47,66.0,8,19,42.1,11,17,64.7,8,20,28,12,21,8,17,3,97,1
370,7197,25_04_42,ISRAEL,0,TOTALS,ISRAEL,200,27,54,50.0,17,41,41.5,10,13,76.9,24,32,75.0,7,20,27,8,27,15,11,1,88,1
371,7210,25_04_42,GREECE,0,TOTALS,GREECE,200,25,57,43.9,20,38,52.6,5,19,26.3,27,38,71.1,13,18,31,14,26,15,15,6,82,0
372,7223,25_04_43,CZECH REPUBLIC,0,TOTALS,CZECH REPUBLIC,200,27,72,37.5,18,47,38.3,9,25,36.0,16,18,88.9,15,18,33,11,22,13,12,1,79,1
373,7236,25_04_43,LATVIA,0,TOTALS,LATVIA,200,36,67,53.7,24,39,61.5,12,28,42.9,16,23,69.6,15,22,37,17,20,17,13,1,100,0
374,7249,25_04_44,RUSSIA,0,TOTALS,RUSSIA,200,32,73,43.8,24,52,46.2,8,21,38.1,14,19,73.7,13,19,32,7,32,16,22,2,86,1
375,7262,25_04_44,SERBIA & MONTENEGRO,0,TOTALS,SERBIA & MONTENEGRO,200,29,53,54.7,21,30,70.0,8,23,34.8,35,46,76.1,11,29,40,9,19,22,16,5,101,0
376,7275,25_04_45,LITHUANIA,0,TOTALS,LITHUANIA,200,35,73,47.9,24,52,46.2,11,21,52.4,11,15,73.3,16,30,46,12,19,12,17,3,92,1
377,7288,25_04_45,GREECE,0,TOTALS,GREECE,200,22,58,37.9,15,38,39.5,7,20,35.0,12,19,63.2,8,22,30,7,17,17,9,3,63,0
378,7301,25_04_46,SLOVENIA,0,TOTALS,SLOVENIA,200,21,56,37.5,14,32,43.8,7,24,29.2,17,24,70.8,14,17,31,10,22,15,8,5,66,1
379,7314,25_04_46,ISRAEL,0,TOTALS,ISRAEL,200,22,57,38.6,19,48,39.6,3,9,33.3,14,20,70.0,10,15,25,6,26,10,8,1,61,0
380,7327,26_03_01,HUNGARY,0,TOTALS,HUNGARY,200,25,63,39.7,14,29,48.3,11,34,32.4,12,21,57.1,11,24,35,1,23,16,12,2,73,0
381,7340,26_03_01,TURKEY,0,TOTALS,TURKEY,200,29,61,47.5,18,37,48.6,11,24,45.8,11,19,57.9,5,19,24,8,19,9,13,3,80,1
382,7353,26_03_02,RUSSIA,0,TOTALS,RUSSIA,200,34,62,54.8,23,41,56.1,11,21,52.4,28,36,77.8,14,22,36,14,25,22,21,6,107,0
383,7366,26_03_02,SLOVAK REPUBLIC,0,TOTALS,SLOVAK REPUBLIC,200,23,62,37.1,19,50,38.0,4,12,33.3,22,27,81.5,11,13,24,11,29,28,10,2,72,1
384,7379,26_03_03,PORTUGAL,0,TOTALS,PORTUGAL,200,16,40,40.0,14,31,45.2,2,9,22.2,24,32,75.0,3,14,17,3,28,29,14,1,58,1
385,7392,26_03_03,UKRAINE,0,TOTALS,UKRAINE,200,34,61,55.7,24,40,60.0,10,21,47.6,22,33,66.7,9,22,31,4,28,23,16,2,100,0
386,7405,26_03_04,SWEDEN,0,TOTALS,SWEDEN,200,23,64,35.9,20,52,38.5,3,12,25.0,17,23,73.9,6,27,33,14,20,10,6,1,66,0
387,7417,26_03_04,GERMANY,0,TOTALS,GERMANY,200,27,69,39.1,23,48,47.9,4,21,19.0,14,22,63.6,17,34,51,10,21,14,7,2,72,1
388,7430,26_03_05,BELARUS,0,TOTALS,BELARUS,200,25,61,41.0,18,42,42.9,7,19,36.8,9,16,56.2,12,15,27,4,18,24,17,3,66,1
389,7443,26_03_05,GREECE,0,TOTALS,GREECE,200,41,76,53.9,32,53,60.4,9,23,39.1,12,16,75.0,14,20,34,11,18,15,25,3,103,0
390,7456,26_03_06,POLAND,0,TOTALS,POLAND,200,27,64,42.2,20,37,54.1,7,27,25.9,15,18,83.3,10,31,41,14,24,19,6,2,76,1
391,7469,26_03_06,ESTONIA,0,TOTALS,ESTONIA,200,23,59,39.0,18,40,45.0,5,19,26.3,17,28,60.7,6,21,27,10,19,9,14,2,68,0
392,7482,26_03_07,LATVIA,0,TOTALS,LATVIA,200,25,73,34.2,22,55,40.0,3,18,16.7,17,24,70.8,15,26,41,12,31,10,6,9,70,0
393,7495,26_03_07,LITHUANIA,0,TOTALS,LITHUANIA,200,23,59,39.0,20,46,43.5,3,13,23.1,30,39,76.9,11,36,47,11,24,11,9,4,79,1
394,7508,26_03_08,BULGARIA,0,TOTALS,BULGARIA,200,33,62,53.2,28,45,62.2,5,17,29.4,8,12,66.7,17,20,37,5,18,11,5,0,79,1
395,7520,26_03_08,CROATIA,0,TOTALS,CROATIA,200,44,75,58.7,37,57,64.9,7,18,38.9,15,20,75.0,6,28,34,4,16,9,8,1,110,0
396,7533,26_03_09,SLOVENIA,0,TOTALS,SLOVENIA,200,21,53,39.6,17,40,42.5,4,13,30.8,18,28,64.3,6,17,23,7,14,16,23,3,64,1
397,7546,26_03_09,SWITZERLAND,0,TOTALS,SWITZERLAND,200,19,54,35.2,16,38,42.1,3,16,18.8,4,10,40.0,10,26,36,5,25,29,12,3,45,0
398,7559,26_03_10,GREECE,0,TOTALS,GREECE,200,41,71,57.7,35,52,67.3,6,19,31.6,10,14,71.4,11,19,30,12,25,15,27,1,98,1
399,7572,26_03_10,HUNGARY,0,TOTALS,HUNGARY,200,18,44,40.9,12,25,48.0,6,19,31.6,24,31,77.4,9,9,18,8,20,28,15,2,66,0
400,7585,26_03_11,ESTONIA,0,TOTALS,ESTONIA,200,21,55,38.2,13,32,40.6,8,23,34.8,11,19,57.9,4,18,22,13,25,17,14,1,61,0
401,7598,26_03_11,RUSSIA,0,TOTALS,RUSSIA,200,28,57,49.1,20,35,57.1,8,22,36.4,24,30,80.0,13,33,46,16,21,16,14,6,88,1
402,7610,26_03_12,GERMANY,0,TOTALS,GERMANY,200,30,55,54.5,23,43,53.5,7,12,58.3,16,26,61.5,12,19,31,14,33,28,10,3,83,0
403,7623,26_03_12,LITHUANIA,0,TOTALS,LITHUANIA,200,31,69,44.9,25,49,51.0,6,20,30.0,29,39,74.4,18,16,34,19,20,17,14,1,97,1
404,7636,26_03_13,ITALY,0,TOTALS,ITALY,200,31,69,44.9,25,42,59.5,6,27,22.2,15,21,71.4,10,14,24,5,26,9,16,3,83,1
405,7649,26_03_13,BULGARIA,0,TOTALS,BULGARIA,194,18,37,48.6,15,23,65.2,3,14,21.4,22,27,81.5,5,19,24,4,24,17,6,2,61,0
406,7662,26_03_14,SWITZERLAND,0,TOTALS,SWITZERLAND,200,18,68,26.5,18,56,32.1,0,12,0.0,17,22,77.3,14,21,35,3,25,19,17,2,53,0
407,7675,26_03_14,TURKEY,0,TOTALS,TURKEY,200,25,56,44.6,18,35,51.4,7,21,33.3,21,29,72.4,7,25,32,10,19,15,16,2,78,1
408,7687,26_03_15,LUXEMBOURG,0,TOTALS,LUXEMBOURG,200,29,65,44.6,20,27,74.1,9,38,23.7,4,8,50.0,10,11,21,13,28,18,10,3,71,1
409,7699,26_03_15,FRANCE,0,TOTALS,FRANCE,200,32,75,42.7,24,54,44.4,8,21,38.1,29,34,85.3,25,24,49,12,13,19,13,4,101,0
410,7712,26_03_16,SERBIA & MONTENEGRO,0,TOTALS,SERBIA & MONTENEGRO,200,24,59,40.7,17,33,51.5,7,26,26.9,13,18,72.2,7,27,34,11,18,11,9,4,68,1
411,7725,26_03_16,POLAND,0,TOTALS,POLAND,200,20,62,32.3,13,40,32.5,7,22,31.8,14,17,82.4,9,24,33,11,22,10,5,2,61,0
412,7738,26_03_17,FINLAND,0,TOTALS,FINLAND,200,24,57,42.1,13,36,36.1,11,21,52.4,9,12,75.0,9,25,34,14,15,20,6,2,68,0
413,7751,26_03_17,LATVIA,0,TOTALS,LATVIA,200,30,76,39.5,20,50,40.0,10,26,38.5,10,12,83.3,17,21,38,20,11,13,15,6,80,1
414,7763,26_03_18,SPAIN,0,TOTALS,SPAIN,200,28,62,45.2,24,45,53.3,4,17,23.5,25,33,75.8,19,22,41,11,25,23,9,3,85,1
415,7775,26_03_18,ISRAEL,0,TOTALS,ISRAEL,200,22,52,42.3,20,42,47.6,2,10,20.0,23,31,74.2,4,8,12,9,30,17,10,8,69,0
416,7787,26_03_19,CROATIA,0,TOTALS,CROATIA,200,42,65,64.6,31,40,77.5,11,25,44.0,29,36,80.6,12,12,24,9,22,15,13,4,124,1
417,7800,26_03_19,PORTUGAL,0,TOTALS,PORTUGAL,200,36,60,60.0,30,51,58.8,6,9,66.7,24,32,75.0,8,13,21,3,32,23,10,0,102,0
418,7813,26_03_20,SLOVENIA,0,TOTALS,SLOVENIA,200,23,59,39.0,19,43,44.2,4,16,25.0,20,25,80.0,9,19,28,7,27,19,21,4,70,1
419,7826,26_03_20,BELARUS,0,TOTALS,BELARUS,200,18,58,31.0,13,43,30.2,5,15,33.3,13,27,48.1,14,21,35,5,23,25,22,3,54,0
420,7839,26_03_21,TURKEY,0,TOTALS,TURKEY,200,20,59,33.9,11,33,33.3,9,26,34.6,24,29,82.8,6,9,15,5,20,14,18,0,73,0
421,7852,26_03_21,GREECE,0,TOTALS,GREECE,200,31,52,59.6,26,34,76.5,5,18,27.8,16,22,72.7,8,20,28,10,27,29,17,0,83,1
422,7865,26_03_22,RUSSIA,0,TOTALS,RUSSIA,200,30,71,42.3,25,53,47.2,5,18,27.8,12,15,80.0,14,22,36,14,24,14,16,4,77,1
423,7878,26_03_22,SERBIA & MONTENEGRO,0,TOTALS,SERBIA & MONTENEGRO,200,22,51,43.1,18,39,46.2,4,12,33.3,16,26,61.5,9,20,29,13,20,20,9,0,64,0
424,7891,26_03_23,LITHUANIA,0,TOTALS,LITHUANIA,200,34,75,45.3,27,53,50.9,7,22,31.8,30,39,76.9,14,27,41,24,20,5,12,4,105,0
425,7904,26_03_23,SWEDEN,0,TOTALS,SWEDEN,200,27,65,41.5,15,37,40.5,12,28,42.9,17,23,73.9,10,29,39,12,29,20,2,0,83,1
426,7917,26_03_24,UKRAINE,0,TOTALS,UKRAINE,200,29,65,44.6,24,44,54.5,5,21,23.8,12,24,50.0,14,18,32,10,20,18,9,1,75,0
427,7929,26_03_24,CROATIA,0,TOTALS,CROATIA,200,36,64,56.2,29,42,69.0,7,22,31.8,13,19,68.4,10,24,34,10,23,16,11,3,92,1
428,7942,26_03_25,BELARUS,0,TOTALS,BELARUS,200,26,75,34.7,20,51,39.2,6,24,25.0,15,24,62.5,15,19,34,5,18,17,29,0,73,1
429,7955,26_03_25,SWITZERLAND,0,TOTALS,SWITZERLAND,200,23,61,37.7,21,51,41.2,2,10,20.0,9,18,50.0,8,25,33,4,22,26,20,0,57,0
430,7967,26_03_26,FRANCE,0,TOTALS,FRANCE,225,34,78,43.6,28,55,50.9,6,23,26.1,23,30,76.7,20,15,35,6,31,20,10,7,97,0
431,7979,26_03_26,ISRAEL,0,TOTALS,ISRAEL,225,34,63,54.0,27,51,52.9,7,12,58.3,23,31,74.2,11,13,24,7,27,16,16,10,98,1
432,7992,26_03_27,SLOVAK REPUBLIC,0,TOTALS,SLOVAK REPUBLIC,200,32,68,47.1,23,45,51.1,9,23,39.1,14,20,70.0,9,20,29,19,29,11,13,1,87,1
433,8005,26_03_27,ESTONIA,0,TOTALS,ESTONIA,200,27,59,45.8,21,42,50.0,6,17,35.3,26,32,81.2,10,23,33,9,22,15,9,6,86,0
434,8017,26_03_28,GERMANY,0,TOTALS,GERMANY,200,36,66,54.5,29,51,56.9,7,15,46.7,6,14,42.9,9,32,41,21,22,16,6,0,85,1
435,8030,26_03_28,FINLAND,0,TOTALS,FINLAND,200,25,78,32.1,15,43,34.9,10,35,28.6,13,18,72.2,16,21,37,10,21,9,11,3,73,0
436,8042,26_03_29,LUXEMBOURG,0,TOTALS,LUXEMBOURG,200,17,62,27.4,9,32,28.1,8,30,26.7,4,7,57.1,7,8,15,4,26,23,6,0,46,1
437,8054,26_03_29,SPAIN,0,TOTALS,SPAIN,200,47,78,60.3,40,63,63.5,7,15,46.7,22,35,62.9,24,33,57,24,8,13,15,3,123,0
438,8067,26_03_30,PORTUGAL,0,TOTALS,PORTUGAL,200,20,46,43.5,17,38,44.7,3,8,37.5,26,33,78.8,6,14,20,6,38,28,9,0,69,1
439,8079,26_03_30,ITALY,0,TOTALS,ITALY,200,28,53,52.8,23,37,62.2,5,16,31.2,45,58,77.6,14,21,35,4,31,21,17,4,106,0
440,8092,26_03_31,HUNGARY,0,TOTALS,HUNGARY,200,21,55,38.2,12,32,37.5,9,23,39.1,9,12,75.0,11,22,33,1,21,25,9,0,60,0
441,8105,26_03_31,SLOVENIA,0,TOTALS,SLOVENIA,200,29,65,44.6,23,42,54.8,6,23,26.1,6,10,60.0,7,17,24,5,20,13,20,0,70,1
442,8118,26_03_32,SWITZERLAND,0,TOTALS,SWITZERLAND,200,21,54,38.9,18,41,43.9,3,13,23.1,10,24,41.7,5,24,29,6,24,21,13,0,55,0
443,8131,26_03_32,GREECE,0,TOTALS,GREECE,200,27,57,47.4,23,44,52.3,4,13,30.8,20,27,74.1,3,24,27,13,21,16,21,0,78,1
444,8144,26_03_33,SERBIA & MONTENEGRO,0,TOTALS,SERBIA & MONTENEGRO,200,37,59,62.7,27,41,65.9,10,18,55.6,29,33,87.9,3,27,30,23,20,18,15,7,113,0
445,8157,26_03_33,SLOVAK REPUBLIC,0,TOTALS,SLOVAK REPUBLIC,200,26,65,40.0,21,47,44.7,5,18,27.8,11,18,61.1,9,19,28,14,19,24,8,2,68,1
446,8170,26_03_34,FINLAND,0,TOTALS,FINLAND,200,20,59,33.9,11,31,35.5,9,28,32.1,9,14,64.3,17,11,28,11,19,12,7,0,58,0
447,8183,26_03_34,SWEDEN,0,TOTALS,SWEDEN,200,29,59,49.2,27,50,54.0,2,9,22.2,11,15,73.3,13,19,32,20,14,17,4,1,71,1
448,8196,26_03_35,BULGARIA,0,TOTALS,BULGARIA,200,26,47,55.3,21,35,60.0,5,12,41.7,19,56,33.9,8,23,31,13,21,24,10,1,76,1
449,8209,26_03_35,PORTUGAL,0,TOTALS,PORTUGAL,200,21,61,34.4,20,55,36.4,1,6,16.7,12,61,19.7,12,17,29,7,28,18,11,1,55,0
450,8222,26_03_36,BELARUS,0,TOTALS,BELARUS,200,30,60,50.0,22,38,57.9,8,22,36.4,11,16,68.8,7,16,23,4,18,14,16,0,79,0
451,8235,26_03_36,HUNGARY,0,TOTALS,HUNGARY,200,30,53,56.6,17,28,60.7,13,25,52.0,11,17,64.7,3,19,22,9,17,18,21,0,84,1
452,8247,26_03_37,ISRAEL,0,TOTALS,ISRAEL,200,36,67,53.7,27,47,57.4,9,20,45.0,19,25,76.0,9,17,26,21,17,13,23,7,100,0
453,8259,26_03_37,LUXEMBOURG,0,TOTALS,LUXEMBOURG,200,22,56,39.3,15,38,39.5,7,18,38.9,7,12,58.3,9,20,29,9,23,26,8,1,58,1
454,8272,26_03_38,POLAND,0,TOTALS,POLAND,200,26,63,41.3,24,44,54.5,2,19,10.5,14,17,82.4,6,28,34,9,21,14,10,3,68,0
455,8285,26_03_38,RUSSIA,0,TOTALS,RUSSIA,200,25,63,39.7,15,42,35.7,10,21,47.6,15,22,68.2,10,27,37,15,16,13,9,5,75,1
456,8298,26_03_39,LATVIA,0,TOTALS,LATVIA,200,36,78,46.2,27,59,45.8,9,19,47.4,13,23,56.5,19,23,42,20,22,16,18,5,94,1
457,8311,26_03_39,GERMANY,0,TOTALS,GERMANY,200,18,57,31.6,13,41,31.7,5,16,31.2,22,31,71.0,11,26,37,7,19,24,4,1,63,0
458,8323,26_03_40,SPAIN,0,TOTALS,SPAIN,200,30,82,36.6,25,62,40.3,5,20,25.0,23,37,62.2,18,26,44,9,31,11,14,8,88,1
459,8335,26_03_40,FRANCE,0,TOTALS,FRANCE,200,22,61,36.1,17,45,37.8,5,16,31.2,24,35,68.6,11,23,34,5,31,18,5,11,73,0
460,8348,26_03_41,ITALY,0,TOTALS,ITALY,200,25,67,37.3,18,39,46.2,7,28,25.0,21,26,80.8,12,25,37,6,29,17,8,3,78,0
461,8361,26_03_41,UKRAINE,0,TOTALS,UKRAINE,200,30,74,40.5,22,44,50.0,8,30,26.7,25,36,69.4,19,31,50,2,24,17,8,1,93,1
462,8374,26_03_42,SLOVENIA,0,TOTALS,SLOVENIA,200,24,60,40.0,13,39,33.3,11,21,52.4,10,16,62.5,3,22,25,6,27,13,14,0,69,1
463,8387,26_03_42,TURKEY,0,TOTALS,TURKEY,200,21,51,41.2,17,31,54.8,4,20,20.0,20,34,58.8,11,20,31,5,20,18,20,0,66,0
464,8400,26_03_43,FINLAND,0,TOTALS,FINLAND,200,27,72,37.5,17,38,44.7,10,34,29.4,2,4,50.0,12,19,31,15,20,23,12,1,66,1
465,8413,26_03_43,LITHUANIA,0,TOTALS,LITHUANIA,200,49,78,62.8,37,57,64.9,12,21,57.1,10,15,66.7,12,31,43,33,13,17,16,2,120,0
466,8426,26_03_44,ESTONIA,0,TOTALS,ESTONIA,200,23,58,39.7,13,36,36.1,10,22,45.5,21,32,65.6,13,30,43,9,16,22,14,3,77,1
467,8439,26_03_44,SERBIA & MONTENEGRO,0,TOTALS,SERBIA & MONTENEGRO,200,29,74,39.2,22,49,44.9,7,25,28.0,9,14,64.3,14,24,38,13,22,14,16,4,74,0
468,8452,26_03_45,SWEDEN,0,TOTALS,SWEDEN,200,22,51,43.1,14,34,41.2,8,17,47.1,10,15,66.7,6,24,30,11,14,31,4,2,62,0
469,8465,26_03_45,LATVIA,0,TOTALS,LATVIA,200,37,76,48.7,30,58,51.7,7,18,38.9,14,19,73.7,15,25,40,25,10,10,24,4,95,1
470,8478,26_03_46,SLOVAK REPUBLIC,0,TOTALS,SLOVAK REPUBLIC,200,31,63,49.2,23,39,59.0,8,24,33.3,14,16,87.5,7,13,20,16,23,16,14,0,84,0
471,8491,26_03_46,POLAND,0,TOTALS,POLAND,200,35,60,58.3,28,42,66.7,7,18,38.9,19,27,70.4,9,24,33,18,21,21,8,5,96,1
472,8504,26_03_47,TURKEY,0,TOTALS,TURKEY,200,26,72,36.1,20,48,41.7,6,24,25.0,18,25,72.0,14,21,35,11,18,15,13,5,76,0
473,8517,26_03_47,BELARUS,0,TOTALS,BELARUS,200,32,71,45.1,26,49,53.1,6,22,27.3,17,26,65.4,10,16,26,5,20,9,20,0,87,1
474,8529,26_03_48,CROATIA,0,TOTALS,CROATIA,200,30,67,44.8,26,51,51.0,4,16,25.0,23,67,34.3,10,30,40,3,24,11,6,2,87,1
475,8541,26_03_48,ITALY,0,TOTALS,ITALY,200,29,74,39.2,21,45,46.7,8,29,27.6,15,77,19.5,17,26,43,6,23,8,6,4,81,0
476,8554,26_03_49,HUNGARY,0,TOTALS,HUNGARY,200,24,60,40.0,15,40,37.5,9,20,45.0,15,27,55.6,14,24,38,7,17,17,10,0,72,0
477,8567,26_03_49,SWITZERLAND,0,TOTALS,SWITZERLAND,200,31,65,47.7,25,47,53.2,6,18,33.3,5,7,71.4,6,24,30,8,23,16,4,0,73,1
478,8580,26_03_50,UKRAINE,0,TOTALS,UKRAINE,200,32,66,48.5,27,42,64.3,5,24,20.8,11,18,61.1,17,34,51,5,13,15,13,3,80,1
479,8593,26_03_50,BULGARIA,0,TOTALS,BULGARIA,200,20,59,33.9,13,38,34.2,7,21,33.3,6,8,75.0,7,29,36,2,19,21,7,0,53,0
480,8606,26_03_51,GREECE,0,TOTALS,GREECE,200,25,52,48.1,18,36,50.0,7,16,43.8,23,31,74.2,7,15,22,4,18,14,17,0,80,1
481,8619,26_03_51,SLOVENIA,0,TOTALS,SLOVENIA,200,27,58,46.6,20,37,54.1,7,21,33.3,11,15,73.3,7,19,26,10,27,17,14,0,72,0
482,11254,29_04_01,BELARUS,0,TOTALS,BELARUS,200,22,60,36.7,17,33,51.5,5,27,18.5,10,22,45.5,8,15,23,10,22,21,21,3,59,0
483,11267,29_04_01,SLOVENIA,0,TOTALS,SLOVENIA,200,30,57,52.6,29,48,60.4,1,9,11.1,9,17,52.9,17,26,43,15,19,32,12,5,70,1
484,11280,29_04_02,BULGARIA,0,TOTALS,BULGARIA,200,30,61,49.2,26,46,56.5,4,15,26.7,13,25,52.0,19,24,43,13,13,16,6,5,77,1
485,11293,29_04_02,ISRAEL,0,TOTALS,ISRAEL,200,27,60,45.0,22,46,47.8,5,14,35.7,8,12,66.7,8,15,23,13,26,14,10,1,67,0
486,11306,29_04_03,GEORGIA,0,TOTALS,GEORGIA,200,30,58,51.7,29,49,59.2,1,9,11.1,26,40,65.0,13,17,30,13,21,19,14,3,87,1
487,11319,29_04_03,ITALY,0,TOTALS,ITALY,200,35,71,49.3,25,45,55.6,10,26,38.5,21,27,77.8,8,8,16,19,29,15,19,1,101,0
488,11332,29_04_04,SERBIA & MONTENEGRO,0,TOTALS,SERBIA & MONTENEGRO,200,34,72,47.2,29,55,52.7,5,17,29.4,8,10,80.0,10,24,34,14,21,13,10,6,81,1
489,11345,29_04_04,LITHUANIA,0,TOTALS,LITHUANIA,200,25,65,38.5,16,45,35.6,9,20,45.0,14,21,66.7,11,23,34,12,15,18,9,4,73,0
490,11358,29_04_05,GREECE,0,TOTALS,GREECE,200,34,56,60.7,26,31,83.9,8,25,32.0,18,22,81.8,6,28,34,12,20,18,9,3,94,1
491,11371,29_04_05,PORTUGAL,0,TOTALS,PORTUGAL,200,19,70,27.1,16,48,33.3,3,22,13.6,7,12,58.3,19,16,35,8,24,22,6,0,48,0
492,11384,29_04_06,FRANCE,0,TOTALS,FRANCE,200,24,72,33.3,20,54,37.0,4,18,22.2,5,9,55.6,11,19,30,12,27,20,31,1,57,0
493,11397,29_04_06,LATVIA,0,TOTALS,LATVIA,200,23,49,46.9,20,41,48.8,3,8,37.5,12,26,46.2,14,19,33,10,17,27,28,6,61,1
494,11410,29_04_07,POLAND,0,TOTALS,POLAND,200,25,67,37.3,16,43,37.2,9,24,37.5,16,25,64.0,11,23,34,12,22,9,3,3,75,0
495,11423,29_04_07,TURKEY,0,TOTALS,TURKEY,200,28,72,38.9,20,48,41.7,8,24,33.3,13,16,81.2,10,37,47,16,23,8,6,4,77,1
496,11436,29_04_08,RUSSIA,0,TOTALS,RUSSIA,200,31,68,45.6,25,53,47.2,6,15,40.0,27,43,62.8,19,37,56,9,20,18,7,7,95,1
497,11449,29_04_08,ESTONIA,0,TOTALS,ESTONIA,200,24,72,33.3,19,57,33.3,5,15,33.3,8,20,40.0,9,20,29,8,29,10,12,6,61,0
498,11462,29_04_09,FINLAND,0,TOTALS,FINLAND,200,17,65,26.2,10,40,25.0,7,25,28.0,10,20,50.0,10,20,30,9,20,14,9,3,51,0
499,11475,29_04_09,CROATIA,0,TOTALS,CROATIA,200,32,72,44.4,30,63,47.6,2,9,22.2,13,18,72.2,16,27,43,13,18,9,17,8,79,1
500,11488,29_04_10,SLOVENIA,0,TOTALS,SLOVENIA,200,19,56,33.9,16,40,40.0,3,16,18.8,8,14,57.1,6,15,21,8,39,23,2,3,49,1
501,11501,29_04_10,SERBIA & MONTENEGRO,0,TOTALS,SERBIA & MONTENEGRO,200,32,55,58.2,27,42,64.3,5,13,38.5,40,53,75.5,11,27,38,17,16,14,18,3,109,0
502,11514,29_04_11,PORTUGAL,0,TOTALS,PORTUGAL,200,24,63,38.1,21,45,46.7,3,18,16.7,11,18,61.1,9,19,28,9,23,12,8,3,62,0
503,11527,29_04_11,BULGARIA,0,TOTALS,BULGARIA,200,32,68,47.1,28,54,51.9,4,14,28.6,17,26,65.4,24,37,61,16,22,17,4,0,85,1
504,11540,29_04_12,ITALY,0,TOTALS,ITALY,200,21,72,29.2,14,38,36.8,7,34,20.6,12,18,66.7,17,17,34,9,15,15,19,3,61,0
505,11553,29_04_12,FRANCE,0,TOTALS,FRANCE,200,30,63,47.6,22,45,48.9,8,18,44.4,11,16,68.8,8,27,35,22,18,19,25,2,79,1
506,11566,29_04_13,TURKEY,0,TOTALS,TURKEY,200,27,66,40.9,19,46,41.3,8,20,40.0,13,22,59.1,9,20,29,15,20,16,11,1,75,1
507,11579,29_04_13,LITHUANIA,0,TOTALS,LITHUANIA,200,24,56,42.9,13,30,43.3,11,26,42.3,12,16,75.0,4,29,33,17,23,26,7,3,71,0
508,11592,29_04_14,ESTONIA,0,TOTALS,ESTONIA,200,22,58,37.9,16,42,38.1,6,16,37.5,10,17,58.8,9,24,33,7,33,26,4,0,60,1
509,11605,29_04_14,GREECE,0,TOTALS,GREECE,200,38,69,55.1,30,40,75.0,8,29,27.6,27,36,75.0,14,31,45,13,19,11,19,1,111,0
510,11618,29_04_15,LATVIA,0,TOTALS,LATVIA,200,24,65,36.9,15,41,36.6,9,24,37.5,19,32,59.4,15,23,38,10,18,21,13,6,76,1
511,11631,29_04_15,FINLAND,0,TOTALS,FINLAND,200,25,71,35.2,20,46,43.5,5,25,20.0,9,12,75.0,6,20,26,11,26,15,15,3,64,0
512,11644,29_04_16,POLAND,0,TOTALS,POLAND,200,26,58,44.8,21,45,46.7,5,13,38.5,16,22,72.7,10,18,28,12,23,16,6,1,73,1
513,11657,29_04_16,BELARUS,0,TOTALS,BELARUS,200,26,70,37.1,17,38,44.7,9,32,28.1,10,17,58.8,18,19,37,15,21,13,7,2,71,0
514,11670,29_04_17,ISRAEL,0,TOTALS,ISRAEL,200,17,61,27.9,17,47,36.2,0,14,0.0,13,29,44.8,10,19,29,0,26,15,5,0,47,0
515,11683,29_04_17,RUSSIA,0,TOTALS,RUSSIA,200,23,55,41.8,19,36,52.8,4,19,21.1,19,29,65.5,19,39,58,7,24,23,10,4,69,1
516,11696,29_04_18,CROATIA,0,TOTALS,CROATIA,200,29,61,47.5,24,46,52.2,5,15,33.3,12,23,52.2,9,16,25,15,21,16,13,4,75,0
517,11709,29_04_18,GEORGIA,0,TOTALS,GEORGIA,200,31,65,47.7,27,49,55.1,4,16,25.0,13,19,68.4,11,20,31,12,16,18,21,5,79,1
518,11722,29_04_19,LITHUANIA,0,TOTALS,LITHUANIA,200,23,60,38.3,18,38,47.4,5,22,22.7,22,31,71.0,12,25,37,17,16,22,12,8,73,1
519,11735,29_04_19,SLOVENIA,0,TOTALS,SLOVENIA,200,24,69,34.8,17,47,36.2,7,22,31.8,6,9,66.7,11,26,37,12,26,22,14,2,61,0
520,11748,29_04_20,ESTONIA,0,TOTALS,ESTONIA,200,22,55,40.0,16,34,47.1,6,21,28.6,16,26,61.5,12,26,38,7,19,14,8,1,66,0
521,11761,29_04_20,PORTUGAL,0,TOTALS,PORTUGAL,200,32,65,49.2,28,50,56.0,4,15,26.7,6,11,54.5,8,24,32,7,20,10,6,5,74,1
522,11774,29_04_21,ITALY,0,TOTALS,ITALY,250,33,89,37.1,23,49,46.9,10,40,25.0,22,26,84.6,10,24,34,14,22,14,30,10,98,1
523,11787,29_04_21,LATVIA,0,TOTALS,LATVIA,250,32,81,39.5,27,56,48.2,5,25,20.0,17,31,54.8,19,37,56,11,27,23,9,4,86,0
524,11800,29_04_22,BELARUS,0,TOTALS,BELARUS,200,19,61,31.1,14,38,36.8,5,23,21.7,10,16,62.5,10,15,25,9,18,21,6,0,53,1
525,11813,29_04_22,TURKEY,0,TOTALS,TURKEY,200,41,65,63.1,34,50,68.0,7,15,46.7,15,20,75.0,11,27,38,27,14,17,13,1,104,0
526,11826,29_04_23,RUSSIA,0,TOTALS,RUSSIA,200,32,53,60.4,27,43,62.8,5,10,50.0,10,16,62.5,5,21,26,5,20,11,9,1,79,1
527,11839,29_04_23,BULGARIA,0,TOTALS,BULGARIA,200,28,69,40.6,23,46,50.0,5,23,21.7,12,23,52.2,25,18,43,10,19,15,6,1,73,0
528,11852,29_04_24,GEORGIA,0,TOTALS,GEORGIA,200,26,77,33.8,13,33,39.4,13,44,29.5,7,13,53.8,18,23,41,15,23,16,20,6,72,1
529,11865,29_04_24,FINLAND,0,TOTALS,FINLAND,200,22,56,39.3,16,41,39.0,6,15,40.0,19,29,65.5,10,33,43,12,15,20,11,2,69,0
530,11878,29_04_25,SERBIA & MONTENEGRO,0,TOTALS,SERBIA & MONTENEGRO,200,31,66,47.0,26,49,53.1,5,17,29.4,12,18,66.7,13,27,40,20,20,13,8,6,79,1
531,11891,29_04_25,POLAND,0,TOTALS,POLAND,200,22,59,37.3,19,46,41.3,3,13,23.1,8,13,61.5,8,23,31,4,21,18,6,5,55,0
532,11904,29_04_26,GREECE,0,TOTALS,GREECE,200,33,62,53.2,17,28,60.7,16,34,47.1,24,31,77.4,15,24,39,15,22,9,7,6,106,0
533,11917,29_04_26,ISRAEL,0,TOTALS,ISRAEL,200,29,56,51.8,23,39,59.0,6,17,35.3,12,18,66.7,7,15,22,8,30,15,4,2,76,1
534,11930,29_04_27,SLOVENIA,0,TOTALS,SLOVENIA,200,25,62,40.3,17,39,43.6,8,23,34.8,11,15,73.3,10,25,35,10,26,22,11,3,69,0
535,11943,29_04_27,TURKEY,0,TOTALS,TURKEY,200,32,62,51.6,26,43,60.5,6,19,31.6,19,30,63.3,9,25,34,13,16,18,13,24,89,1
536,11956,29_04_28,PORTUGAL,0,TOTALS,PORTUGAL,200,21,62,33.9,18,42,42.9,3,20,15.0,13,24,54.2,13,12,25,6,15,14,10,1,58,0
537,11969,29_04_28,RUSSIA,0,TOTALS,RUSSIA,200,31,53,58.5,24,38,63.2,7,15,46.7,12,16,75.0,8,30,38,8,15,22,9,4,81,1
538,11982,29_04_29,LATVIA,0,TOTALS,LATVIA,200,23,54,42.6,17,37,45.9,6,17,35.3,13,30,43.3,12,20,32,19,20,16,20,9,65,0
539,11995,29_04_29,GEORGIA,0,TOTALS,GEORGIA,200,25,73,34.2,16,42,38.1,9,31,29.0,8,12,66.7,18,16,34,11,19,12,31,7,67,1
540,12008,29_04_30,BELARUS,0,TOTALS,BELARUS,200,19,59,32.2,14,44,31.8,5,15,33.3,7,13,53.8,7,14,21,8,16,11,10,1,50,0
541,12021,29_04_30,SERBIA & MONTENEGRO,0,TOTALS,SERBIA & MONTENEGRO,200,33,56,58.9,29,45,64.4,4,11,36.4,17,20,85.0,8,31,39,20,17,16,6,0,87,1
542,12034,29_04_31,ISRAEL,0,TOTALS,ISRAEL,200,34,66,51.5,29,54,53.7,5,12,41.7,20,33,60.6,16,26,42,14,25,14,16,3,93,1
543,12047,29_04_31,ESTONIA,0,TOTALS,ESTONIA,200,22,54,40.7,17,38,44.7,5,16,31.2,11,19,57.9,9,22,31,7,23,21,5,3,60,0
544,12060,29_04_32,FINLAND,0,TOTALS,FINLAND,200,17,47,36.2,13,29,44.8,4,18,22.2,13,16,81.2,9,19,28,12,14,29,21,3,51,0
545,12073,29_04_32,FRANCE,0,TOTALS,FRANCE,200,28,76,36.8,16,41,39.0,12,35,34.3,12,21,57.1,27,16,43,18,17,13,22,4,80,1
546,12086,29_04_33,POLAND,0,TOTALS,POLAND,200,28,67,41.8,15,39,38.5,13,28,46.4,7,9,77.8,5,24,29,16,17,18,8,1,76,0
547,12099,29_04_33,LITHUANIA,0,TOTALS,LITHUANIA,200,29,72,40.3,23,47,48.9,6,25,24.0,15,22,68.2,16,28,44,18,12,10,12,3,79,1
548,12112,29_04_34,BULGARIA,0,TOTALS,BULGARIA,225,37,72,51.4,32,50,64.0,5,22,22.7,9,16,56.2,12,33,45,17,23,21,3,2,88,0
549,12125,29_04_34,GREECE,0,TOTALS,GREECE,225,33,72,45.8,23,44,52.3,10,28,35.7,15,19,78.9,11,26,37,10,20,10,12,0,91,1
550,12138,29_04_35,CROATIA,0,TOTALS,CROATIA,225,35,77,45.5,31,63,49.2,4,14,28.6,22,38,57.9,16,34,50,13,22,15,10,0,96,1
551,12151,29_04_35,ITALY,0,TOTALS,ITALY,225,36,85,42.4,22,39,56.4,14,46,30.4,9,15,60.0,11,24,35,19,28,9,17,3,95,0
552,12164,29_04_36,SERBIA & MONTENEGRO,0,TOTALS,SERBIA & MONTENEGRO,200,28,54,51.9,22,39,56.4,6,15,40.0,18,27,66.7,12,21,33,14,15,14,10,2,80,1
553,12177,29_04_36,TURKEY,0,TOTALS,TURKEY,200,26,59,44.1,18,35,51.4,8,24,33.3,6,11,54.5,11,15,26,13,24,17,10,4,66,0
554,12190,29_04_37,ESTONIA,0,TOTALS,ESTONIA,200,20,63,31.7,15,43,34.9,5,20,25.0,9,19,47.4,9,27,36,8,25,15,6,1,54,0
555,12203,29_04_37,BULGARIA,0,TOTALS,BULGARIA,200,30,68,44.1,25,49,51.0,5,19,26.3,23,37,62.2,11,39,50,12,21,12,9,2,88,1
556,12216,29_04_38,FRANCE,0,TOTALS,FRANCE,200,28,61,45.9,24,43,55.8,4,18,22.2,12,14,85.7,11,28,39,15,6,17,13,3,72,1
557,12229,29_04_38,GEORGIA,0,TOTALS,GEORGIA,200,23,68,33.8,14,35,40.0,9,33,27.3,0,0,0.0,13,19,32,12,11,15,13,1,55,0
558,12242,29_04_39,LITHUANIA,0,TOTALS,LITHUANIA,200,23,58,39.7,21,37,56.8,2,21,9.5,9,13,69.2,13,30,43,11,21,20,7,4,57,0
559,12255,29_04_39,BELARUS,0,TOTALS,BELARUS,200,23,66,34.8,17,39,43.6,6,27,22.2,10,16,62.5,7,19,26,11,17,8,15,3,62,1
560,12268,29_04_40,ISRAEL,0,TOTALS,ISRAEL,200,28,61,45.9,23,44,52.3,5,17,29.4,19,27,70.4,10,24,34,13,23,8,12,1,80,1
561,12281,29_04_40,PORTUGAL,0,TOTALS,PORTUGAL,200,25,57,43.9,18,41,43.9,7,16,43.8,13,23,56.5,10,21,31,11,24,22,3,1,70,0
562,12294,29_04_41,ITALY,0,TOTALS,ITALY,200,30,71,42.3,21,44,47.7,9,27,33.3,15,28,53.6,9,30,39,16,22,18,17,2,84,1
563,12307,29_04_41,FINLAND,0,TOTALS,FINLAND,200,18,63,28.6,12,39,30.8,6,24,25.0,10,19,52.6,10,25,35,10,23,25,18,2,52,0
564,12320,29_04_42,SLOVENIA,0,TOTALS,SLOVENIA,225,36,80,45.0,32,64,50.0,4,16,25.0,23,33,69.7,19,34,53,16,32,15,6,3,99,1
565,12333,29_04_42,POLAND,0,TOTALS,POLAND,225,29,71,40.8,22,52,42.3,7,19,36.8,28,39,71.8,8,22,30,9,27,10,10,8,93,0
566,12346,29_04_43,GREECE,0,TOTALS,GREECE,200,28,60,46.7,20,38,52.6,8,22,36.4,16,22,72.7,13,18,31,13,23,17,10,4,80,1
567,12359,29_04_43,RUSSIA,0,TOTALS,RUSSIA,200,27,66,40.9,21,43,48.8,6,23,26.1,13,20,65.0,16,21,37,7,26,21,8,4,73,0
568,12372,29_04_44,CROATIA,0,TOTALS,CROATIA,200,30,71,42.3,29,58,50.0,1,13,7.7,6,8,75.0,15,18,33,12,25,8,10,1,67,0
569,12385,29_04_44,LATVIA,0,TOTALS,LATVIA,200,24,59,40.7,14,26,53.8,10,33,30.3,17,35,48.6,19,18,37,16,12,13,16,3,75,1
570,12398,30_04_01,BULGARIA,0,TOTALS,BULGARIA,200,25,62,40.3,21,40,52.5,4,22,18.2,15,27,55.6,12,26,38,12,20,19,8,2,69,0
571,12411,30_04_01,GREECE,0,TOTALS,GREECE,200,29,73,39.7,18,43,41.9,11,30,36.7,10,14,71.4,13,20,33,17,26,10,11,4,79,1
572,12424,30_04_02,TURKEY,0,TOTALS,TURKEY,200,17,56,30.4,9,26,34.6,8,30,26.7,16,28,57.1,13,27,40,14,24,15,7,8,58,0
573,12437,30_04_02,ISRAEL,0,TOTALS,ISRAEL,200,23,65,35.4,18,50,36.0,5,15,33.3,18,28,64.3,13,25,38,8,26,9,11,1,69,1
574,12450,30_04_03,ITALY,0,TOTALS,ITALY,200,33,66,50.0,22,39,56.4,11,27,40.7,24,26,92.3,6,18,24,14,35,10,13,2,101,0
575,12463,30_04_03,SERBIA & MONTENEGRO,0,TOTALS,SERBIA & MONTENEGRO,200,26,51,51.0,21,34,61.8,5,17,29.4,33,43,76.7,5,22,27,15,25,15,9,0,90,1
576,12476,30_04_04,FRANCE,0,TOTALS,FRANCE,200,35,60,58.3,24,39,61.5,11,21,52.4,26,33,78.8,9,28,37,10,14,19,16,1,107,0
577,12489,30_04_04,GEORGIA,0,TOTALS,GEORGIA,200,24,64,37.5,17,42,40.5,7,22,31.8,9,9,100.0,5,19,24,10,25,25,14,2,64,1
578,12502,30_04_05,RUSSIA,0,TOTALS,RUSSIA,200,35,64,54.7,27,44,61.4,8,20,40.0,16,26,61.5,9,24,33,22,19,13,10,6,94,0
579,12515,30_04_05,LATVIA,0,TOTALS,LATVIA,200,34,68,50.0,18,41,43.9,16,27,59.3,11,19,57.9,13,17,30,14,20,16,7,4,95,1
580,12528,30_04_06,SPAIN,0,TOTALS,SPAIN,200,36,72,50.0,27,57,47.4,9,15,60.0,20,27,74.1,11,29,40,21,15,10,10,2,101,0
581,12541,30_04_06,LITHUANIA,0,TOTALS,LITHUANIA,200,30,75,40.0,16,43,37.2,14,32,43.8,8,10,80.0,10,19,29,11,26,16,8,5,82,1
582,12554,30_04_07,LATVIA,0,TOTALS,LATVIA,200,23,67,34.3,14,39,35.9,9,28,32.1,6,10,60.0,15,24,39,14,26,23,8,5,61,0
583,12567,30_04_07,FRANCE,0,TOTALS,FRANCE,200,22,60,36.7,14,35,40.0,8,25,32.0,20,31,64.5,18,27,45,16,20,17,13,4,72,1
584,12580,30_04_08,GEORGIA,0,TOTALS,GEORGIA,200,32,78,41.0,20,43,46.5,12,35,34.3,7,9,77.8,14,16,30,16,18,11,10,2,83,0
585,12593,30_04_08,ITALY,0,TOTALS,ITALY,200,33,63,52.4,22,33,66.7,11,30,36.7,13,17,76.5,10,27,37,24,16,12,9,6,90,1
586,12606,30_04_09,SERBIA & MONTENEGRO,0,TOTALS,SERBIA & MONTENEGRO,200,34,69,49.3,27,53,50.9,7,16,43.8,15,21,71.4,6,19,25,18,21,14,13,1,90,1
587,12619,30_04_09,RUSSIA,0,TOTALS,RUSSIA,200,33,63,52.4,27,47,57.4,6,16,37.5,12,17,70.6,5,28,33,14,24,20,15,3,84,0
588,12632,30_04_10,LITHUANIA,0,TOTALS,LITHUANIA,200,31,86,36.0,21,46,45.7,10,40,25.0,16,26,61.5,23,19,42,16,33,18,13,3,88,0
589,12645,30_04_10,BULGARIA,0,TOTALS,BULGARIA,200,30,74,40.5,23,52,44.2,7,22,31.8,26,35,74.3,18,32,50,19,26,18,17,3,93,1
590,12658,30_04_11,GREECE,0,TOTALS,GREECE,200,19,51,37.3,10,19,52.6,9,32,28.1,10,18,55.6,7,23,30,7,20,18,7,3,57,0
591,12671,30_04_11,TURKEY,0,TOTALS,TURKEY,200,25,63,39.7,19,40,47.5,6,23,26.1,17,25,68.0,17,22,39,14,21,10,13,1,73,1
592,12684,30_04_12,ISRAEL,0,TOTALS,ISRAEL,200,32,70,45.7,27,56,48.2,5,14,35.7,14,21,66.7,13,12,25,14,29,12,15,1,83,0
593,12697,30_04_12,SPAIN,0,TOTALS,SPAIN,200,29,48,60.4,23,33,69.7,6,15,40.0,25,36,69.4,7,23,30,17,22,24,11,4,89,1
594,12710,30_04_13,RUSSIA,0,TOTALS,RUSSIA,200,29,72,40.3,26,58,44.8,3,14,21.4,34,47,72.3,19,30,49,16,29,15,15,4,95,1
595,12723,30_04_13,ITALY,0,TOTALS,ITALY,200,23,59,39.0,15,31,48.4,8,28,28.6,26,34,76.5,5,22,27,10,34,19,14,3,80,0
596,12736,30_04_14,LATVIA,0,TOTALS,LATVIA,200,25,62,40.3,15,32,46.9,10,30,33.3,15,17,88.2,19,18,37,8,19,19,9,2,75,0
597,12749,30_04_14,GEORGIA,0,TOTALS,GEORGIA,200,29,72,40.3,18,35,51.4,11,37,29.7,8,14,57.1,11,21,32,15,16,13,17,5,77,1
598,12762,30_04_15,ISRAEL,0,TOTALS,ISRAEL,200,28,73,38.4,21,55,38.2,7,18,38.9,24,35,68.6,12,20,32,13,31,17,25,0,87,0
599,12775,30_04_15,LITHUANIA,0,TOTALS,LITHUANIA,200,31,59,52.5,23,36,63.9,8,23,34.8,24,38,63.2,9,32,41,21,34,28,13,11,94,1
600,12788,30_04_16,TURKEY,0,TOTALS,TURKEY,200,32,68,47.1,25,48,52.1,7,20,35.0,12,20,60.0,11,17,28,23,29,19,19,4,83,1
601,12801,30_04_16,BULGARIA,0,TOTALS,BULGARIA,200,24,52,46.2,19,36,52.8,5,16,31.2,21,36,58.3,12,23,35,12,24,27,15,4,74,0
602,12814,30_04_17,FRANCE,0,TOTALS,FRANCE,200,28,60,46.7,22,43,51.2,6,17,35.3,10,16,62.5,11,12,23,13,22,15,19,6,72,1
603,12827,30_04_17,SERBIA & MONTENEGRO,0,TOTALS,SERBIA & MONTENEGRO,200,23,60,38.3,16,41,39.0,7,19,36.8,18,21,85.7,10,17,27,12,20,24,15,2,71,0
604,12840,30_04_18,SPAIN,0,TOTALS,SPAIN,200,31,69,44.9,25,58,43.1,6,11,54.5,17,27,63.0,19,33,52,13,21,16,10,4,85,1
605,12853,30_04_18,GREECE,0,TOTALS,GREECE,200,22,67,32.8,14,37,37.8,8,30,26.7,19,26,73.1,9,20,29,10,18,14,8,9,71,0
606,12866,30_04_19,LITHUANIA,0,TOTALS,LITHUANIA,200,24,59,40.7,16,33,48.5,8,26,30.8,16,21,76.2,10,26,36,10,21,15,9,3,72,1
607,12879,30_04_19,TURKEY,0,TOTALS,TURKEY,200,25,67,37.3,23,52,44.2,2,15,13.3,14,16,87.5,13,24,37,7,22,14,12,2,66,0
608,12892,30_04_20,GEORGIA,0,TOTALS,GEORGIA,200,26,74,35.1,23,49,46.9,3,25,12.0,10,17,58.8,10,23,33,14,22,16,11,2,65,0
609,12905,30_04_20,RUSSIA,0,TOTALS,RUSSIA,200,35,75,46.7,32,66,48.5,3,9,33.3,21,28,75.0,18,35,53,14,15,18,11,7,94,1
610,12918,30_04_21,GREECE,0,TOTALS,GREECE,200,26,55,47.3,17,29,58.6,9,26,34.6,21,32,65.6,10,22,32,12,24,21,7,1,82,0
611,12931,30_04_21,ISRAEL,0,TOTALS,ISRAEL,200,30,62,48.4,26,48,54.2,4,14,28.6,24,34,70.6,11,22,33,7,31,13,14,1,88,1
612,12944,30_04_22,SERBIA & MONTENEGRO,0,TOTALS,SERBIA & MONTENEGRO,200,28,59,47.5,22,40,55.0,6,19,31.6,19,24,79.2,14,23,37,12,17,14,10,4,81,1
613,12957,30_04_22,LATVIA,0,TOTALS,LATVIA,200,26,59,44.1,18,42,42.9,8,17,47.1,10,12,83.3,6,15,21,14,23,15,15,0,70,0
614,12970,30_04_23,ITALY,0,TOTALS,ITALY,200,31,69,44.9,19,38,50.0,12,31,38.7,9,10,90.0,12,17,29,20,17,6,11,3,83,1
615,12983,30_04_23,FRANCE,0,TOTALS,FRANCE,200,26,67,38.8,21,45,46.7,5,22,22.7,12,19,63.2,19,27,46,11,16,15,6,2,69,0
616,12996,30_04_24,BULGARIA,0,TOTALS,BULGARIA,200,31,76,40.8,24,47,51.1,7,29,24.1,6,12,50.0,14,20,34,10,20,11,12,5,75,1
617,13009,30_04_24,SPAIN,0,TOTALS,SPAIN,200,24,65,36.9,18,52,34.6,6,13,46.2,20,28,71.4,16,28,44,17,16,17,9,5,74,0
618,13022,30_04_25,SERBIA & MONTENEGRO,0,TOTALS,SERBIA & MONTENEGRO,200,37,62,59.7,28,39,71.8,9,23,39.1,18,24,75.0,11,19,30,23,12,13,11,3,101,0
619,13035,30_04_25,GEORGIA,0,TOTALS,GEORGIA,200,27,65,41.5,24,46,52.2,3,19,15.8,7,10,70.0,18,9,27,8,18,16,10,3,64,1
620,13048,30_04_26,GREECE,0,TOTALS,GREECE,250,31,75,41.3,16,34,47.1,15,41,36.6,23,31,74.2,13,27,40,17,32,17,13,5,100,0
621,13061,30_04_26,LITHUANIA,0,TOTALS,LITHUANIA,250,32,90,35.6,26,58,44.8,6,32,18.8,23,40,57.5,23,29,52,7,30,18,14,4,93,1
622,13074,30_04_27,FRANCE,0,TOTALS,FRANCE,225,33,75,44.0,24,55,43.6,9,20,45.0,25,32,78.1,14,26,40,18,35,19,13,3,100,0
623,13087,30_04_27,RUSSIA,0,TOTALS,RUSSIA,225,30,70,42.9,20,44,45.5,10,26,38.5,36,50,72.0,18,28,46,21,24,16,14,6,106,1
624,13100,30_04_28,ISRAEL,0,TOTALS,ISRAEL,225,33,75,44.0,24,52,46.2,9,23,39.1,14,26,53.8,14,18,32,18,25,12,16,0,89,1
625,13113,30_04_28,BULGARIA,0,TOTALS,BULGARIA,225,26,64,40.6,15,30,50.0,11,34,32.4,18,30,60.0,19,28,47,17,24,28,11,2,81,0
626,13126,30_04_29,LATVIA,0,TOTALS,LATVIA,200,22,67,32.8,14,41,34.1,8,26,30.8,16,27,59.3,14,26,40,12,19,17,8,1,68,0
627,13139,30_04_29,ITALY,0,TOTALS,ITALY,200,32,75,42.7,24,49,49.0,8,26,30.8,12,16,75.0,12,25,37,17,25,12,14,0,84,1
628,13152,30_04_30,SPAIN,0,TOTALS,SPAIN,200,25,61,41.0,21,43,48.8,4,18,22.2,21,31,67.7,11,22,33,7,17,20,10,8,75,0
629,13165,30_04_30,TURKEY,0,TOTALS,TURKEY,200,28,66,42.4,16,44,36.4,12,22,54.5,10,13,76.9,13,23,36,16,27,21,11,3,78,1
630,13178,30_04_31,GEORGIA,0,TOTALS,GEORGIA,200,25,73,34.2,19,46,41.3,6,27,22.2,5,7,71.4,14,17,31,10,26,12,11,2,61,0
631,13191,30_04_31,LITHUANIA,0,TOTALS,LITHUANIA,200,33,69,47.8,26,46,56.5,7,23,30.4,23,32,71.9,15,32,47,12,11,9,6,2,96,1
632,13204,30_04_32,BULGARIA,0,TOTALS,BULGARIA,225,31,66,47.0,25,46,54.3,6,20,30.0,37,51,72.5,12,39,51,15,15,23,13,2,105,0
633,13217,30_04_32,LATVIA,0,TOTALS,LATVIA,225,37,104,35.6,21,46,45.7,16,58,27.6,6,11,54.5,22,27,49,19,38,16,17,0,96,1
634,13230,30_04_33,ISRAEL,0,TOTALS,ISRAEL,200,20,55,36.4,13,35,37.1,7,20,35.0,9,16,56.2,6,13,19,11,23,17,7,2,56,0
635,13243,30_04_33,FRANCE,0,TOTALS,FRANCE,200,30,56,53.6,21,31,67.7,9,25,36.0,10,17,58.8,8,24,32,16,19,15,13,4,79,1
636,13256,30_04_34,ITALY,0,TOTALS,ITALY,225,25,62,40.3,16,36,44.4,9,26,34.6,16,23,69.6,10,27,37,16,23,13,6,5,75,1
637,13269,30_04_34,GREECE,0,TOTALS,GREECE,225,26,68,38.2,18,41,43.9,8,27,29.6,14,21,66.7,9,25,34,11,20,12,10,5,74,0
638,13282,30_04_35,SERBIA & MONTENEGRO,0,TOTALS,SERBIA & MONTENEGRO,200,20,48,41.7,16,32,50.0,4,16,25.0,12,19,63.2,7,19,26,12,27,19,7,2,56,0
639,13295,30_04_35,TURKEY,0,TOTALS,TURKEY,200,26,59,44.1,20,39,51.3,6,20,30.0,18,27,66.7,12,22,34,17,19,16,16,4,76,1
640,13308,30_04_36,SPAIN,0,TOTALS,SPAIN,200,34,72,47.2,30,56,53.6,4,16,25.0,29,41,70.7,17,32,49,15,24,20,11,8,101,0
641,13321,30_04_36,RUSSIA,0,TOTALS,RUSSIA,200,25,69,36.2,14,42,33.3,11,27,40.7,20,28,71.4,10,20,30,16,31,15,14,7,81,1
642,13334,30_04_37,GEORGIA,0,TOTALS,GEORGIA,200,26,60,43.3,15,32,46.9,11,28,39.3,17,21,81.0,8,21,29,19,17,16,18,4,80,1
643,13347,30_04_37,LATVIA,0,TOTALS,LATVIA,200,27,67,40.3,22,43,51.2,5,24,20.8,12,19,63.2,14,27,41,10,16,21,8,1,71,0
644,13360,30_04_38,LITHUANIA,0,TOTALS,LITHUANIA,200,35,70,50.0,24,45,53.3,11,25,44.0,15,22,68.2,16,24,40,12,26,20,12,5,96,1
645,13373,30_04_38,BULGARIA,0,TOTALS,BULGARIA,200,33,73,45.2,27,50,54.0,6,23,26.1,16,20,80.0,12,15,27,15,22,16,14,1,88,0
646,13386,30_04_39,RUSSIA,0,TOTALS,RUSSIA,200,26,53,49.1,23,39,59.0,3,14,21.4,25,38,65.8,15,27,42,16,17,20,11,5,80,1
647,13399,30_04_39,GREECE,0,TOTALS,GREECE,200,27,71,38.0,20,42,47.6,7,29,24.1,15,18,83.3,15,10,25,14,26,15,14,1,76,0
648,13412,30_04_40,SERBIA & MONTENEGRO,0,TOTALS,SERBIA & MONTENEGRO,200,28,54,51.9,23,37,62.2,5,17,29.4,27,38,71.1,10,20,30,12,21,14,12,7,88,1
649,13425,30_04_40,ISRAEL,0,TOTALS,ISRAEL,200,26,62,41.9,25,52,48.1,1,10,10.0,9,20,45.0,15,14,29,6,29,19,6,1,62,0
650,13438,30_04_41,TURKEY,0,TOTALS,TURKEY,200,20,63,31.7,16,43,37.2,4,20,20.0,13,13,100.0,14,16,30,12,18,18,14,1,57,1
651,13451,30_04_41,FRANCE,0,TOTALS,FRANCE,200,20,48,41.7,17,27,63.0,3,21,14.3,12,15,80.0,6,26,32,10,16,23,9,3,55,0
652,13464,30_04_42,SPAIN,0,TOTALS,SPAIN,200,36,69,52.2,27,52,51.9,9,17,52.9,14,25,56.0,19,31,50,14,23,20,7,3,95,1
653,13477,30_04_42,ITALY,0,TOTALS,ITALY,200,26,69,37.7,20,45,44.4,6,24,25.0,20,25,80.0,14,15,29,14,19,14,12,3,78,0
654,13490,30_04_43,GREECE,0,TOTALS,GREECE,200,27,58,46.6,12,23,52.2,15,35,42.9,20,28,71.4,6,26,32,18,16,18,8,4,89,1
655,13503,30_04_43,ISRAEL,0,TOTALS,ISRAEL,200,32,66,48.5,27,50,54.0,5,16,31.2,13,20,65.0,5,28,33,21,24,14,15,0,82,0
656,13516,30_04_44,RUSSIA,0,TOTALS,RUSSIA,200,35,64,54.7,34,57,59.6,1,7,14.3,10,14,71.4,10,21,31,10,22,17,9,1,81,0
657,13529,30_04_44,SERBIA & MONTENEGRO,0,TOTALS,SERBIA & MONTENEGRO,200,32,66,48.5,29,49,59.2,3,17,17.6,18,22,81.8,10,15,25,17,17,12,11,1,85,1
658,13542,30_04_45,ITALY,0,TOTALS,ITALY,200,24,73,32.9,16,40,40.0,8,33,24.2,12,14,85.7,12,17,29,8,18,8,12,3,68,0
659,13555,30_04_45,FRANCE,0,TOTALS,FRANCE,200,30,63,47.6,24,42,57.1,6,21,28.6,8,13,61.5,12,34,46,17,23,17,7,5,74,1
660,13568,30_04_46,SPAIN,0,TOTALS,SPAIN,200,31,66,47.0,22,48,45.8,9,18,50.0,18,23,78.3,15,30,45,19,14,13,6,3,89,1
661,13581,30_04_46,TURKEY,0,TOTALS,TURKEY,200,28,67,41.8,21,40,52.5,7,27,25.9,8,18,44.4,9,19,28,16,22,10,6,6,71,0
662,13594,31_03_01,IRELAND,0,TOTALS,IRELAND,200,31,61,50.8,24,36,66.7,7,25,28.0,6,16,37.5,5,18,23,8,19,17,12,2,75,0
663,13607,31_03_01,BELARUS,0,TOTALS,BELARUS,200,34,75,45.3,26,46,56.5,8,29,27.6,12,20,60.0,12,20,32,2,18,10,18,2,88,1
664,13620,31_03_02,CZECH REPUBLIC,0,TOTALS,CZECH REPUBLIC,200,22,65,33.8,18,44,40.9,4,21,19.0,13,23,56.5,2,14,16,4,30,15,16,3,61,1
665,13633,31_03_02,LITHUANIA,0,TOTALS,LITHUANIA,200,36,67,53.7,33,49,67.3,3,18,16.7,25,40,62.5,8,26,34,9,19,10,21,7,100,0
666,13646,31_03_03,CROATIA,0,TOTALS,CROATIA,200,37,70,52.9,27,47,57.4,10,23,43.5,8,11,72.7,8,24,32,8,22,15,10,1,92,0
667,13659,31_03_03,IRELAND,0,TOTALS,IRELAND,200,36,70,51.4,26,44,59.1,10,26,38.5,11,21,52.4,9,16,25,8,14,14,14,2,93,1
668,13672,31_03_04,BELARUS,0,TOTALS,BELARUS,200,38,64,59.4,33,47,70.2,5,17,29.4,25,43,58.1,12,14,26,7,16,13,26,0,106,0
669,13685,31_03_04,CZECH REPUBLIC,0,TOTALS,CZECH REPUBLIC,200,25,64,39.1,21,45,46.7,4,19,21.1,14,17,82.4,5,15,20,2,32,24,14,1,68,1
670,13698,31_03_05,LITHUANIA,0,TOTALS,LITHUANIA,200,33,72,45.8,24,45,53.3,9,27,33.3,24,35,68.6,21,17,38,4,16,13,16,5,99,1
671,13711,31_03_05,CROATIA,0,TOTALS,CROATIA,200,25,52,48.1,19,33,57.6,6,19,31.6,7,10,70.0,3,10,13,5,30,15,18,3,63,0
672,13724,31_03_06,CZECH REPUBLIC,0,TOTALS,CZECH REPUBLIC,200,29,57,50.9,24,36,66.7,5,21,23.8,25,40,62.5,6,21,27,9,25,16,14,1,88,0
673,13737,31_03_06,IRELAND,0,TOTALS,IRELAND,200,31,61,50.8,24,34,70.6,7,27,25.9,22,27,81.5,6,17,23,4,33,14,12,1,91,1
674,13750,31_03_07,CROATIA,0,TOTALS,CROATIA,200,28,61,45.9,24,49,49.0,4,12,33.3,13,20,65.0,13,11,24,3,24,14,16,1,73,1
675,13763,31_03_07,BELARUS,0,TOTALS,BELARUS,200,24,50,48.0,20,32,62.5,4,18,22.2,15,21,71.4,9,20,29,6,20,15,10,1,67,0
676,13776,31_03_08,IRELAND,0,TOTALS,IRELAND,200,19,55,34.5,12,26,46.2,7,29,24.1,16,24,66.7,4,12,16,4,22,16,7,0,61,1
677,13789,31_03_08,LITHUANIA,0,TOTALS,LITHUANIA,200,52,87,59.8,43,61,70.5,9,26,34.6,13,17,76.5,14,24,38,15,22,10,26,6,126,0
678,13802,31_03_09,LITHUANIA,0,TOTALS,LITHUANIA,200,35,78,44.9,28,51,54.9,7,27,25.9,9,17,52.9,19,13,32,4,16,18,17,6,86,1
679,13815,31_03_09,BELARUS,0,TOTALS,BELARUS,200,32,61,52.5,25,39,64.1,7,22,31.8,8,12,66.7,10,14,24,10,17,23,14,2,79,0
680,13828,31_03_10,CZECH REPUBLIC,0,TOTALS,CZECH REPUBLIC,200,29,64,45.3,21,39,53.8,8,25,32.0,11,18,61.1,6,13,19,3,26,21,11,6,77,1
681,13841,31_03_10,CROATIA,0,TOTALS,CROATIA,200,35,65,53.8,32,52,61.5,3,13,23.1,28,35,80.0,9,16,25,4,18,12,19,3,101,0
682,13854,31_03_11,GEORGIA,0,TOTALS,GEORGIA,200,29,66,43.9,21,44,47.7,8,22,36.4,7,12,58.3,2,19,21,14,20,14,17,2,73,0
683,13867,31_03_11,FRANCE,0,TOTALS,FRANCE,200,29,68,42.6,23,54,42.6,6,14,42.9,11,24,45.8,16,25,41,13,14,16,14,5,75,1
684,13880,31_03_12,LATVIA,0,TOTALS,LATVIA,200,16,66,24.2,5,33,15.2,11,33,33.3,15,28,53.6,18,27,45,10,20,11,6,3,58,0
685,13893,31_03_12,FINLAND,0,TOTALS,FINLAND,200,22,51,43.1,15,35,42.9,7,16,43.8,18,21,85.7,11,36,47,9,19,10,6,1,69,1
686,13906,31_03_13,ISRAEL,0,TOTALS,ISRAEL,200,28,63,44.4,26,52,50.0,2,11,18.2,15,33,45.5,11,35,46,9,26,17,9,0,73,1
687,13919,31_03_13,HUNGARY,0,TOTALS,HUNGARY,200,21,65,32.3,18,50,36.0,3,15,20.0,17,27,63.0,12,29,41,3,25,17,5,0,62,0
688,13932,31_03_14,NETHERLANDS,0,TOTALS,NETHERLANDS,200,34,77,44.2,24,52,46.2,10,25,40.0,6,16,37.5,21,23,44,18,20,17,14,2,84,1
689,13944,31_03_14,SCOTLAND,0,TOTALS,SCOTLAND,200,16,50,32.0,11,31,35.5,5,19,26.3,9,17,52.9,11,23,34,1,19,26,9,7,46,0
690,13957,31_03_15,SWEDEN,0,TOTALS,SWEDEN,200,27,81,33.3,24,62,38.7,3,19,15.8,8,16,50.0,22,21,43,22,22,21,14,5,65,0
691,13970,31_03_15,ENGLAND,0,TOTALS,ENGLAND,200,25,68,36.8,15,48,31.2,10,20,50.0,14,23,60.9,20,29,49,9,18,28,11,5,74,1
692,13983,31_03_16,LUXEMBOURG,0,TOTALS,LUXEMBOURG,200,29,66,43.9,22,46,47.8,7,20,35.0,6,16,37.5,6,21,27,14,26,20,16,0,71,0
693,13996,31_03_16,BELGIUM,0,TOTALS,BELGIUM,200,27,57,47.4,22,39,56.4,5,18,27.8,19,34,55.9,9,31,40,11,18,24,17,4,78,1
694,14009,31_03_17,RUSSIA,0,TOTALS,RUSSIA,200,28,60,46.7,22,45,48.9,6,15,40.0,14,21,66.7,14,36,50,8,23,32,10,0,76,1
695,14022,31_03_17,BULGARIA,0,TOTALS,BULGARIA,200,25,71,35.2,21,50,42.0,4,21,19.0,16,30,53.3,13,12,25,8,21,15,18,4,70,0
696,14035,31_03_18,SLOVENIA,0,TOTALS,SLOVENIA,200,24,69,34.8,20,49,40.8,4,20,20.0,10,13,76.9,13,19,32,4,26,18,16,1,62,0
697,14048,31_03_18,GREECE,0,TOTALS,GREECE,200,28,57,49.1,21,33,63.6,7,24,29.2,21,25,84.0,9,31,40,8,17,21,11,9,84,1
698,14061,31_03_19,ESTONIA,0,TOTALS,ESTONIA,200,18,56,32.1,16,49,32.7,2,7,28.6,14,28,50.0,11,22,33,19,23,29,14,2,52,0
699,14074,31_03_19,GERMANY,0,TOTALS,GERMANY,200,26,60,43.3,20,42,47.6,6,18,33.3,9,22,40.9,13,25,38,20,23,26,15,4,67,1
700,14087,31_03_20,SLOVAK REPUBLIC,0,TOTALS,SLOVAK REPUBLIC,200,20,73,27.4,18,59,30.5,2,14,14.3,6,12,50.0,13,20,33,6,28,24,14,4,48,0
701,14100,31_03_20,POLAND,0,TOTALS,POLAND,200,32,66,48.5,30,56,53.6,2,10,20.0,15,30,50.0,13,36,49,5,17,23,22,5,81,1
702,14113,31_03_21,ICELAND,0,TOTALS,ICELAND,200,32,69,46.4,28,53,52.8,4,16,25.0,12,16,75.0,10,27,37,20,23,27,9,3,80,1
703,14126,31_03_21,ITALY,0,TOTALS,ITALY,200,41,78,52.6,30,52,57.7,11,26,42.3,27,37,73.0,12,24,36,19,14,15,19,4,120,0
704,14139,31_03_22,FINLAND,0,TOTALS,FINLAND,200,32,71,45.1,24,45,53.3,8,26,30.8,8,13,61.5,15,27,42,14,22,15,8,3,80,1
705,14152,31_03_22,SWEDEN,0,TOTALS,SWEDEN,200,31,70,44.3,27,60,45.0,4,10,40.0,9,18,50.0,10,21,31,12,11,13,8,2,75,0
706,14165,31_03_23,GEORGIA,0,TOTALS,GEORGIA,200,41,72,56.9,36,58,62.1,5,14,35.7,17,33,51.5,15,23,38,24,17,21,32,12,104,0
707,14178,31_03_23,LUXEMBOURG,0,TOTALS,LUXEMBOURG,200,20,64,31.2,14,35,40.0,6,29,20.7,14,21,66.7,10,12,22,7,26,34,11,0,60,1
708,14191,31_03_24,CYPRUS,0,TOTALS,CYPRUS,200,19,57,33.3,18,42,42.9,1,15,6.7,17,26,65.4,13,30,43,1,32,29,19,4,56,0
709,14204,31_03_24,ISRAEL,0,TOTALS,ISRAEL,200,23,59,39.0,16,41,39.0,7,18,38.9,20,32,62.5,10,28,38,6,28,27,11,1,73,1
710,14217,31_03_25,GREECE,0,TOTALS,GREECE,200,46,89,51.7,30,53,56.6,16,36,44.4,11,17,64.7,10,29,39,15,22,18,23,1,119,0
711,14230,31_03_25,NETHERLANDS,0,TOTALS,NETHERLANDS,200,25,64,39.1,22,43,51.2,3,21,14.3,14,22,63.6,9,22,31,9,17,28,11,2,67,1
712,14243,31_03_26,GERMANY,0,TOTALS,GERMANY,200,20,66,30.3,16,48,33.3,4,18,22.2,11,20,55.0,12,33,45,17,22,18,9,2,55,0
713,14256,31_03_26,LATVIA,0,TOTALS,LATVIA,200,22,67,32.8,13,32,40.6,9,35,25.7,16,23,69.6,14,27,41,23,19,13,12,3,69,1
714,14269,31_03_27,FRANCE,0,TOTALS,FRANCE,200,36,79,45.6,29,61,47.5,7,18,38.9,6,12,50.0,13,28,41,17,13,8,19,4,85,1
715,14282,31_03_27,POLAND,0,TOTALS,POLAND,200,15,67,22.4,14,59,23.7,1,8,12.5,6,12,50.0,15,18,33,3,17,19,12,8,37,0
716,14295,31_03_28,HUNGARY,0,TOTALS,HUNGARY,200,21,53,39.6,19,45,42.2,2,8,25.0,20,30,66.7,16,18,34,3,21,28,5,1,64,0
717,14308,31_03_28,RUSSIA,0,TOTALS,RUSSIA,200,28,64,43.8,23,43,53.5,5,21,23.8,18,23,78.3,15,16,31,2,22,21,22,3,79,1
718,14321,31_03_29,ENGLAND,0,TOTALS,ENGLAND,200,22,60,36.7,12,33,36.4,10,27,37.0,13,24,54.2,8,23,31,18,23,13,6,1,67,0
719,14334,31_03_29,ESTONIA,0,TOTALS,ESTONIA,200,32,69,46.4,28,55,50.9,4,14,28.6,15,24,62.5,14,33,47,26,21,12,6,3,83,1
720,14346,31_03_30,SCOTLAND,0,TOTALS,SCOTLAND,200,22,65,33.8,19,51,37.3,3,14,21.4,12,21,57.1,13,21,34,6,20,33,8,6,59,0
721,14359,31_03_30,ICELAND,0,TOTALS,ICELAND,200,38,87,43.7,33,70,47.1,5,17,29.4,12,23,52.2,20,26,46,19,21,25,24,5,93,1
722,14372,31_03_31,BELGIUM,0,TOTALS,BELGIUM,200,26,67,38.8,20,52,38.5,6,15,40.0,8,15,53.3,7,23,30,14,24,17,14,1,66,0
723,14385,31_03_31,SLOVAK REPUBLIC,0,TOTALS,SLOVAK REPUBLIC,200,28,69,40.6,26,57,45.6,2,12,16.7,18,32,56.2,14,22,36,11,16,16,19,10,76,1
724,14398,31_03_32,ITALY,0,TOTALS,ITALY,200,24,64,37.5,16,39,41.0,8,25,32.0,18,30,60.0,15,25,40,10,25,29,13,6,74,1
725,14411,31_03_32,SLOVENIA,0,TOTALS,SLOVENIA,200,21,73,28.8,17,52,32.7,4,21,19.0,23,34,67.6,6,25,31,4,28,19,13,1,69,0
726,14424,31_03_33,GERMANY,0,TOTALS,GERMANY,200,23,71,32.4,22,59,37.3,1,12,8.3,9,16,56.2,12,21,33,27,15,15,12,3,56,0
727,14437,31_03_33,FINLAND,0,TOTALS,FINLAND,200,27,64,42.2,20,25,80.0,7,39,17.9,7,11,63.6,11,28,39,33,22,18,8,3,68,1
728,14450,31_03_34,LUXEMBOURG,0,TOTALS,LUXEMBOURG,200,17,74,23.0,9,43,20.9,8,31,25.8,3,4,75.0,6,12,18,10,19,17,17,0,45,1
729,14463,31_03_34,FRANCE,0,TOTALS,FRANCE,200,40,63,63.5,32,50,64.0,8,13,61.5,15,20,75.0,12,37,49,21,7,25,22,9,103,0
730,14476,31_03_35,RUSSIA,0,TOTALS,RUSSIA,200,30,64,46.9,26,47,55.3,4,17,23.5,22,33,66.7,16,30,46,13,20,25,15,6,86,1
731,14489,31_03_35,CYPRUS,0,TOTALS,CYPRUS,200,21,62,33.9,20,54,37.0,1,8,12.5,12,22,54.5,11,23,34,1,25,29,14,1,55,0
732,14502,31_03_36,ICELAND,0,TOTALS,ICELAND,200,22,64,34.4,20,47,42.6,2,17,11.8,20,23,87.0,9,25,34,9,22,30,11,5,66,1
733,14515,31_03_36,GREECE,0,TOTALS,GREECE,200,42,85,49.4,33,60,55.0,9,25,36.0,13,20,65.0,17,29,46,23,20,21,23,10,106,0
734,14528,31_03_37,LATVIA,0,TOTALS,LATVIA,200,33,67,49.3,22,37,59.5,11,30,36.7,14,26,53.8,10,21,31,20,0,19,19,0,91,1
735,14541,31_03_37,ENGLAND,0,TOTALS,ENGLAND,200,19,59,32.2,12,30,40.0,7,29,24.1,6,12,50.0,12,29,41,19,29,28,9,1,51,0
736,14554,31_03_38,POLAND,0,TOTALS,POLAND,200,24,77,31.2,22,64,34.4,2,13,15.4,23,37,62.2,20,23,43,6,18,13,26,3,73,1
737,14567,31_03_38,BELGIUM,0,TOTALS,BELGIUM,200,26,64,40.6,14,37,37.8,12,27,44.4,7,18,38.9,11,28,39,16,26,25,18,5,71,0
738,14580,31_03_39,BULGARIA,0,TOTALS,BULGARIA,200,29,69,42.0,21,47,44.7,8,22,36.4,20,29,69.0,27,24,51,8,19,23,16,2,86,1
739,14593,31_03_39,HUNGARY,0,TOTALS,HUNGARY,200,26,54,48.1,23,43,53.5,3,11,27.3,7,15,46.7,6,26,32,4,27,30,12,0,62,0
740,14606,31_03_40,ESTONIA,0,TOTALS,ESTONIA,200,32,80,40.0,25,64,39.1,7,16,43.8,11,20,55.0,17,24,41,13,21,0,13,5,82,1
741,14619,31_03_40,SWEDEN,0,TOTALS,SWEDEN,200,24,68,35.3,21,48,43.8,3,20,15.0,14,21,66.7,15,26,41,16,22,19,8,8,65,0
742,14632,31_03_41,NETHERLANDS,0,TOTALS,NETHERLANDS,200,24,68,35.3,19,47,40.4,5,21,23.8,17,23,73.9,16,26,42,9,26,25,23,4,70,0
743,14645,31_03_41,SLOVENIA,0,TOTALS,SLOVENIA,200,27,61,44.3,26,51,51.0,1,10,10.0,18,28,64.3,6,26,32,12,21,22,16,1,73,1
744,14658,31_03_42,SLOVAK REPUBLIC,0,TOTALS,SLOVAK REPUBLIC,200,20,76,26.3,18,56,32.1,2,20,10.0,8,12,66.7,22,17,39,4,28,19,14,1,50,0
745,14671,31_03_42,GEORGIA,0,TOTALS,GEORGIA,200,22,57,38.6,18,40,45.0,4,17,23.5,23,34,67.6,15,30,45,8,21,21,20,5,71,1
746,14682,31_03_43,SCOTLAND,0,TOTALS,SCOTLAND,200,18,59,30.5,15,43,34.9,3,16,18.8,10,16,62.5,6,15,21,0,17,26,3,1,49,1
747,14695,31_03_43,ITALY,0,TOTALS,ITALY,200,50,81,61.7,41,54,75.9,9,27,33.3,14,22,63.6,13,25,38,16,17,10,20,7,123,0
748,14708,31_03_44,ENGLAND,0,TOTALS,ENGLAND,225,29,74,39.2,20,43,46.5,9,31,29.0,22,33,66.7,14,27,41,23,30,17,10,10,89,1
749,14721,31_03_44,GERMANY,0,TOTALS,GERMANY,225,28,71,39.4,21,49,42.9,7,22,31.8,19,35,54.3,14,30,44,33,29,21,8,5,82,0
750,14734,31_03_45,FRANCE,0,TOTALS,FRANCE,200,28,68,41.2,25,53,47.2,3,15,20.0,18,25,72.0,16,20,36,10,14,19,23,2,77,1
751,14747,31_03_45,BELGIUM,0,TOTALS,BELGIUM,200,20,59,33.9,15,44,34.1,5,15,33.3,8,10,80.0,14,16,30,9,20,29,12,4,53,0
752,14760,31_03_46,ISRAEL,0,TOTALS,ISRAEL,200,26,65,40.0,22,53,41.5,4,12,33.3,9,17,52.9,11,17,28,6,27,27,16,0,65,0
753,14773,31_03_46,RUSSIA,0,TOTALS,RUSSIA,200,27,58,46.6,26,45,57.8,1,13,7.7,22,30,73.3,14,29,43,4,24,33,15,4,77,1
754,14786,31_03_47,SLOVENIA,0,TOTALS,SLOVENIA,200,31,68,45.6,23,49,46.9,8,19,42.1,13,17,76.5,12,21,33,11,30,23,11,4,83,1
755,14799,31_03_47,ICELAND,0,TOTALS,ICELAND,200,28,64,43.8,22,39,56.4,6,25,24.0,16,30,53.3,10,16,26,12,21,17,14,4,78,0
756,14812,31_03_48,SWEDEN,0,TOTALS,SWEDEN,200,30,73,41.1,22,49,44.9,8,24,33.3,6,6,100.0,14,29,43,30,24,26,8,4,74,0
757,14825,31_03_48,LATVIA,0,TOTALS,LATVIA,200,27,76,35.5,18,47,38.3,9,29,31.0,23,35,65.7,16,27,43,18,13,17,19,2,86,1
758,14838,31_03_49,GEORGIA,0,TOTALS,GEORGIA,200,32,80,40.0,22,50,44.0,10,30,33.3,11,15,73.3,21,22,43,14,18,17,22,7,85,1
759,14851,31_03_49,POLAND,0,TOTALS,POLAND,200,25,59,42.4,21,47,44.7,4,12,33.3,12,16,75.0,6,26,32,8,21,23,14,0,66,0
760,14864,31_03_50,CYPRUS,0,TOTALS,CYPRUS,200,17,59,28.8,15,44,34.1,2,15,13.3,8,12,66.7,11,14,25,0,20,24,5,0,44,0
761,14877,31_03_50,BULGARIA,0,TOTALS,BULGARIA,200,33,70,47.1,29,53,54.7,4,17,23.5,14,22,63.6,17,30,47,13,17,17,13,0,84,1
762,14890,31_03_51,FINLAND,0,TOTALS,FINLAND,200,24,59,40.7,20,40,50.0,4,19,21.1,22,33,66.7,15,27,42,21,21,19,9,6,74,1
763,14903,31_03_51,ESTONIA,0,TOTALS,ESTONIA,200,19,57,33.3,14,47,29.8,5,10,50.0,18,25,72.0,9,24,33,21,27,16,12,3,61,0
764,14916,31_03_52,GREECE,0,TOTALS,GREECE,200,56,88,63.6,48,70,68.6,8,18,44.4,8,16,50.0,17,41,58,26,13,16,18,11,128,0
765,14928,31_03_52,SCOTLAND,0,TOTALS,SCOTLAND,200,17,71,23.9,11,47,23.4,6,24,25.0,11,19,57.9,9,16,25,4,17,24,12,3,51,1
766,14941,31_03_53,LUXEMBOURG,0,TOTALS,LUXEMBOURG,200,29,76,38.2,25,53,47.2,4,23,17.4,10,19,52.6,8,18,26,16,20,14,16,3,72,0
767,14954,31_03_53,SLOVAK REPUBLIC,0,TOTALS,SLOVAK REPUBLIC,200,34,73,46.6,30,52,57.7,4,21,19.0,13,21,61.9,15,29,44,13,19,23,14,7,85,1
768,14967,31_03_54,ITALY,0,TOTALS,ITALY,200,34,63,54.0,22,38,57.9,12,25,48.0,23,31,74.2,7,25,32,23,17,12,17,3,103,0
769,14980,31_03_54,NETHERLANDS,0,TOTALS,NETHERLANDS,200,17,53,32.1,13,43,30.2,4,10,40.0,11,17,64.7,12,18,30,3,29,31,8,3,49,1
770,14993,31_03_55,GERMANY,0,TOTALS,GERMANY,200,39,73,53.4,32,54,59.3,7,19,36.8,6,10,60.0,14,27,41,31,17,22,16,9,91,1
771,15006,31_03_55,SWEDEN,0,TOTALS,SWEDEN,200,23,72,31.9,20,57,35.1,3,15,20.0,13,19,68.4,16,19,35,23,11,23,9,3,62,0
772,15019,31_03_56,ENGLAND,0,TOTALS,ENGLAND,200,25,65,38.5,18,43,41.9,7,22,31.8,12,24,50.0,8,28,36,22,19,14,6,3,69,0
773,15032,31_03_56,FINLAND,0,TOTALS,FINLAND,200,26,64,40.6,15,37,40.5,11,27,40.7,18,23,78.3,9,34,43,27,21,13,5,1,81,1
774,15045,31_03_57,LATVIA,0,TOTALS,LATVIA,200,21,67,31.3,13,34,38.2,8,33,24.2,5,9,55.6,9,32,41,14,18,19,10,3,55,0
775,15058,31_03_57,ESTONIA,0,TOTALS,ESTONIA,200,22,57,38.6,19,45,42.2,3,12,25.0,11,21,52.4,5,34,39,15,16,18,7,3,58,1
776,15071,31_03_58,BELGIUM,0,TOTALS,BELGIUM,200,23,69,33.3,15,51,29.4,8,18,44.4,12,19,63.2,14,22,36,11,13,22,13,0,66,0
777,15084,31_03_58,GEORGIA,0,TOTALS,GEORGIA,200,39,84,46.4,32,58,55.2,7,26,26.9,2,7,28.6,20,23,43,14,18,19,25,7,87,1
778,15097,31_03_59,POLAND,0,TOTALS,POLAND,200,37,67,55.2,35,56,62.5,2,11,18.2,11,19,57.9,14,27,41,19,17,26,21,10,87,1
779,15110,31_03_59,LUXEMBOURG,0,TOTALS,LUXEMBOURG,200,22,72,30.6,10,38,26.3,12,34,35.3,8,15,53.3,7,17,24,18,22,14,17,0,64,0
780,15123,31_03_60,HUNGARY,0,TOTALS,HUNGARY,200,27,61,44.3,19,46,41.3,8,15,53.3,8,12,66.7,11,19,30,6,24,24,4,0,70,0
781,15136,31_03_60,CYPRUS,0,TOTALS,CYPRUS,200,27,59,45.8,20,37,54.1,7,22,31.8,16,30,53.3,14,23,37,5,19,24,12,0,77,1
782,15148,31_03_61,SCOTLAND,0,TOTALS,SCOTLAND,200,15,46,32.6,11,33,33.3,4,13,30.8,22,37,59.5,10,20,30,2,26,44,12,10,56,1
783,15161,31_03_61,SLOVENIA,0,TOTALS,SLOVENIA,200,38,75,50.7,29,58,50.0,9,17,52.9,23,30,76.7,14,19,33,15,31,23,20,6,108,0
784,15174,31_03_62,BULGARIA,0,TOTALS,BULGARIA,200,25,56,44.6,24,47,51.1,1,9,11.1,21,35,60.0,15,30,45,12,16,26,11,1,72,1
785,15187,31_03_62,ISRAEL,0,TOTALS,ISRAEL,200,22,57,38.6,17,43,39.5,5,14,35.7,7,15,46.7,9,20,29,5,27,28,8,0,56,0
786,15200,31_03_63,SLOVAK REPUBLIC,0,TOTALS,SLOVAK REPUBLIC,200,25,69,36.2,18,50,36.0,7,19,36.8,2,2,100.0,11,16,27,6,19,14,14,5,59,0
787,15213,31_03_63,FRANCE,0,TOTALS,FRANCE,200,33,69,47.8,29,55,52.7,4,14,28.6,9,17,52.9,16,23,39,11,10,14,16,2,79,1
788,15226,31_03_64,ICELAND,0,TOTALS,ICELAND,200,27,71,38.0,13,43,30.2,14,28,50.0,21,35,60.0,22,21,43,6,30,14,13,4,89,1
789,15239,31_03_64,NETHERLANDS,0,TOTALS,NETHERLANDS,200,27,63,42.9,22,44,50.0,5,19,26.3,21,33,63.6,16,25,41,10,31,23,9,1,80,0
790,15252,31_03_65,GREECE,0,TOTALS,GREECE,200,35,61,57.4,19,37,51.4,16,24,66.7,19,24,79.2,4,27,31,6,23,15,16,0,105,0
791,15265,31_03_65,ITALY,0,TOTALS,ITALY,200,31,63,49.2,23,38,60.5,8,25,32.0,14,24,58.3,9,17,26,9,22,21,8,2,84,1
792,15278,31_03_66,UKRAINE,0,TOTALS,UKRAINE,200,21,69,30.4,20,50,40.0,1,19,5.3,15,23,65.2,19,25,44,6,22,20,8,3,58,0
793,15291,31_03_66,PORTUGAL,0,TOTALS,PORTUGAL,200,31,69,44.9,24,48,50.0,7,21,33.3,10,16,62.5,8,25,33,13,21,15,20,0,79,1
794,15304,31_03_67,SERBIA & MONTENEGRO,0,TOTALS,SERBIA & MONTENEGRO,200,35,68,51.5,29,47,61.7,6,21,28.6,31,42,73.8,17,27,44,14,17,13,16,5,107,0
795,15317,31_03_67,AUSTRIA,0,TOTALS,AUSTRIA,200,19,69,27.5,16,44,36.4,3,25,12.0,8,15,53.3,9,16,25,9,32,17,15,4,49,1
796,15330,31_03_68,TURKEY,0,TOTALS,TURKEY,200,56,91,61.5,49,66,74.2,7,25,28.0,13,19,68.4,13,22,35,18,10,11,32,7,132,0
797,15343,31_03_68,ROMANIA,0,TOTALS,ROMANIA,200,17,57,29.8,15,44,34.1,2,13,15.4,2,4,50.0,2,18,20,6,19,37,12,3,38,1
798,15356,31_03_69,AUSTRIA,0,TOTALS,AUSTRIA,200,17,73,23.3,13,53,24.5,4,20,20.0,12,15,80.0,13,12,25,4,20,16,17,0,50,0
799,15369,31_03_69,UKRAINE,0,TOTALS,UKRAINE,200,28,52,53.8,20,33,60.6,8,19,42.1,16,24,66.7,9,22,31,8,20,23,15,13,80,1
800,15382,31_03_70,PORTUGAL,0,TOTALS,PORTUGAL,200,26,68,38.2,19,43,44.2,7,25,28.0,9,12,75.0,7,25,32,8,19,17,14,3,68,0
801,15395,31_03_70,TURKEY,0,TOTALS,TURKEY,200,31,73,42.5,25,47,53.2,6,26,23.1,14,20,70.0,8,28,36,8,18,10,12,2,82,1
802,15408,31_03_71,ROMANIA,0,TOTALS,ROMANIA,200,9,48,18.8,9,39,23.1,0,9,0.0,3,8,37.5,6,14,20,5,28,39,6,0,21,1
803,15421,31_03_71,SERBIA & MONTENEGRO,0,TOTALS,SERBIA & MONTENEGRO,200,42,71,59.2,34,53,64.2,8,18,44.4,31,41,75.6,10,24,34,22,14,11,36,3,123,0
804,15434,31_03_72,TURKEY,0,TOTALS,TURKEY,200,38,62,61.3,24,39,61.5,14,23,60.9,22,32,68.8,5,20,25,17,20,7,23,4,112,0
805,15447,31_03_72,AUSTRIA,0,TOTALS,AUSTRIA,200,26,61,42.6,19,35,54.3,7,26,26.9,15,21,71.4,14,19,33,14,26,27,8,1,74,1
806,15460,31_03_73,ROMANIA,0,TOTALS,ROMANIA,200,14,55,25.5,11,38,28.9,3,17,17.6,1,3,33.3,7,18,25,3,17,28,14,2,32,0
807,15473,31_03_73,PORTUGAL,0,TOTALS,PORTUGAL,200,30,75,40.0,23,50,46.0,7,25,28.0,13,17,76.5,20,27,47,12,7,19,25,1,80,1
808,15486,31_03_74,SERBIA & MONTENEGRO,0,TOTALS,SERBIA & MONTENEGRO,200,31,68,45.6,24,45,53.3,7,23,30.4,15,20,75.0,8,17,25,11,28,13,20,2,84,1
809,15499,31_03_74,UKRAINE,0,TOTALS,UKRAINE,200,23,48,47.9,18,31,58.1,5,17,29.4,19,30,63.3,7,19,26,6,25,25,12,8,70,0
810,15512,31_03_75,AUSTRIA,0,TOTALS,AUSTRIA,200,35,63,55.6,25,41,61.0,10,22,45.5,11,21,52.4,10,23,33,19,22,16,17,6,91,1
811,15525,31_03_75,ROMANIA,0,TOTALS,ROMANIA,200,20,57,35.1,16,47,34.0,4,10,40.0,10,20,50.0,13,20,33,7,23,25,7,1,54,0
812,15538,31_03_76,UKRAINE,0,TOTALS,UKRAINE,200,18,57,31.6,13,31,41.9,5,26,19.2,26,39,66.7,6,24,30,3,26,18,13,5,67,0
813,15551,31_03_76,TURKEY,0,TOTALS,TURKEY,200,32,74,43.2,26,50,52.0,6,24,25.0,23,29,79.3,9,19,28,14,30,11,18,4,93,1
814,15564,31_03_77,PORTUGAL,0,TOTALS,PORTUGAL,200,26,56,46.4,20,41,48.8,6,15,40.0,10,14,71.4,6,13,19,7,26,20,14,2,68,0
815,15577,31_03_77,SERBIA & MONTENEGRO,0,TOTALS,SERBIA & MONTENEGRO,200,36,59,61.0,29,40,72.5,7,19,36.8,15,27,55.6,7,18,25,11,20,19,17,2,94,1
816,15590,31_03_78,ROMANIA,0,TOTALS,ROMANIA,200,14,55,25.5,11,39,28.2,3,16,18.8,12,18,66.7,6,19,25,4,21,36,15,2,43,1
817,15603,31_03_78,UKRAINE,0,TOTALS,UKRAINE,200,40,86,46.5,31,56,55.4,9,30,30.0,19,33,57.6,19,25,44,14,16,18,24,9,108,0
818,15616,31_03_79,SERBIA & MONTENEGRO,0,TOTALS,SERBIA & MONTENEGRO,200,26,59,44.1,18,34,52.9,8,25,32.0,13,23,56.5,10,22,32,12,20,18,18,3,73,1
819,15629,31_03_79,TURKEY,0,TOTALS,TURKEY,200,24,64,37.5,21,45,46.7,3,19,15.8,9,11,81.8,8,22,30,6,23,16,14,3,60,0
820,15642,31_03_80,PORTUGAL,0,TOTALS,PORTUGAL,200,30,64,46.9,21,36,58.3,9,28,32.1,11,15,73.3,17,25,42,8,9,14,6,1,80,1
821,15655,31_03_80,AUSTRIA,0,TOTALS,AUSTRIA,200,24,67,35.8,15,40,37.5,9,27,33.3,6,8,75.0,6,8,14,4,18,11,12,2,63,0
822,19709,35_04_01,POLAND,0,TOTALS,POLAND,200,23,64,35.9,22,49,44.9,1,15,6.7,18,39,46.2,11,25,36,11,26,25,14,9,65,1
823,19722,35_04_01,ISRAEL,0,TOTALS,ISRAEL,200,37,76,48.7,35,66,53.0,2,10,20.0,24,34,70.6,16,34,50,15,28,21,13,3,100,0
824,19735,35_04_02,LATVIA,0,TOTALS,LATVIA,200,23,67,34.3,21,41,51.2,2,26,7.7,7,16,43.8,15,27,42,14,20,13,11,7,55,0
825,19748,35_04_02,CROATIA,0,TOTALS,CROATIA,200,20,68,29.4,14,46,30.4,6,22,27.3,14,18,77.8,13,29,42,4,19,16,6,4,60,1
826,19761,35_04_03,RUSSIA,0,TOTALS,RUSSIA,200,29,72,40.3,24,59,40.7,5,13,38.5,7,14,50.0,19,31,50,6,17,18,6,5,70,0
827,19774,35_04_03,SLOVENIA,0,TOTALS,SLOVENIA,200,31,68,45.6,24,52,46.2,7,16,43.8,3,7,42.9,9,23,32,13,16,10,12,2,72,1
828,19787,35_04_04,TURKEY,0,TOTALS,TURKEY,200,24,62,38.7,19,39,48.7,5,23,21.7,0,5,0.0,7,21,28,10,20,20,14,4,53,1
829,19800,35_04_04,FRANCE,0,TOTALS,FRANCE,200,19,60,31.7,19,49,38.8,0,11,0.0,7,14,50.0,17,29,46,4,12,30,8,0,45,0
830,19813,35_04_05,GEORGIA,0,TOTALS,GEORGIA,200,26,80,32.5,21,60,35.0,5,20,25.0,6,18,33.3,15,21,36,11,21,10,13,2,63,0
831,19826,35_04_05,LITHUANIA,0,TOTALS,LITHUANIA,200,35,69,50.7,31,55,56.4,4,14,28.6,16,26,61.5,17,35,52,16,20,19,9,5,90,1
832,19839,35_04_06,SPAIN,0,TOTALS,SPAIN,200,28,71,39.4,26,52,50.0,2,19,10.5,15,30,50.0,18,33,51,16,15,17,14,4,73,1
833,19852,35_04_06,GREECE,0,TOTALS,GREECE,200,21,64,32.8,19,48,39.6,2,16,12.5,4,12,33.3,12,29,41,5,21,21,10,3,48,0
834,19865,35_04_07,SERBIA & MONTENEGRO,0,TOTALS,SERBIA & MONTENEGRO,200,22,60,36.7,18,39,46.2,4,21,19.0,12,25,48.0,12,25,37,8,27,19,5,3,60,0
835,19878,35_04_07,ITALY,0,TOTALS,ITALY,200,25,53,47.2,18,34,52.9,7,19,36.8,14,25,56.0,4,29,33,14,27,19,6,2,71,1
836,19891,35_04_08,BELGIUM,0,TOTALS,BELGIUM,200,30,69,43.5,22,45,48.9,8,24,33.3,5,11,45.5,14,18,32,13,26,20,16,4,73,1
837,19903,35_04_08,GERMANY,0,TOTALS,GERMANY,200,21,49,42.9,19,39,48.7,2,10,20.0,22,31,71.0,11,22,33,7,19,28,13,5,66,0
838,19916,35_04_09,SLOVENIA,0,TOTALS,SLOVENIA,200,31,72,43.1,27,50,54.0,4,22,18.2,9,15,60.0,10,21,31,15,14,22,17,1,75,1
839,19929,35_04_09,POLAND,0,TOTALS,POLAND,200,27,64,42.2,25,52,48.1,2,12,16.7,5,11,45.5,16,25,41,11,12,29,14,8,61,0
840,19942,35_04_10,FRANCE,0,TOTALS,FRANCE,200,31,67,46.3,27,54,50.0,4,13,30.8,22,33,66.7,19,28,47,12,9,16,9,8,88,1
841,19955,35_04_10,LATVIA,0,TOTALS,LATVIA,200,28,72,38.9,15,32,46.9,13,40,32.5,2,7,28.6,9,21,30,19,29,10,7,2,71,0
842,19968,35_04_11,ISRAEL,0,TOTALS,ISRAEL,200,27,69,39.1,25,60,41.7,2,9,22.2,10,15,66.7,12,19,31,11,24,22,13,3,66,0
843,19981,35_04_11,RUSSIA,0,TOTALS,RUSSIA,200,31,69,44.9,24,48,50.0,7,21,33.3,8,21,38.1,20,26,46,9,18,25,9,8,77,1
844,19994,35_04_12,CROATIA,0,TOTALS,CROATIA,200,28,64,43.8,23,44,52.3,5,20,25.0,5,10,50.0,9,28,37,11,23,17,6,4,66,0
845,20007,35_04_12,TURKEY,0,TOTALS,TURKEY,200,29,58,50.0,25,44,56.8,4,14,28.6,18,24,75.0,7,28,35,12,18,14,9,4,80,1
846,20020,35_04_13,ITALY,0,TOTALS,ITALY,200,25,63,39.7,20,43,46.5,5,20,25.0,16,24,66.7,12,30,42,11,19,22,9,2,71,1
847,20033,35_04_13,GEORGIA,0,TOTALS,GEORGIA,200,19,56,33.9,17,41,41.5,2,15,13.3,14,24,58.3,8,26,34,8,23,22,7,2,54,0
848,20046,35_04_14,GREECE,0,TOTALS,GREECE,200,25,57,43.9,20,44,45.5,5,13,38.5,19,32,59.4,15,29,44,14,13,17,9,2,74,1
849,20059,35_04_14,BELGIUM,0,TOTALS,BELGIUM,200,27,63,42.9,20,37,54.1,7,26,26.9,3,8,37.5,6,20,26,7,29,14,8,1,64,0
850,20072,35_04_15,LITHUANIA,0,TOTALS,LITHUANIA,200,30,63,47.6,25,48,52.1,5,15,33.3,11,23,47.8,12,21,33,18,29,14,6,6,76,1
851,20085,35_04_15,SERBIA & MONTENEGRO,0,TOTALS,SERBIA & MONTENEGRO,200,26,69,37.7,21,53,39.6,5,16,31.2,17,26,65.4,14,24,38,10,23,14,5,4,74,0
852,20097,35_04_16,GERMANY,0,TOTALS,GERMANY,200,17,63,27.0,14,51,27.5,3,12,25.0,13,20,65.0,17,23,40,8,23,28,7,0,50,0
853,20110,35_04_16,SPAIN,0,TOTALS,SPAIN,200,39,69,56.5,34,55,61.8,5,14,35.7,10,19,52.6,7,29,36,17,15,13,13,8,93,1
854,20123,35_04_17,SLOVENIA,0,TOTALS,SLOVENIA,200,28,66,42.4,22,55,40.0,6,11,54.5,14,29,48.3,18,31,49,13,15,13,3,6,76,1
855,20136,35_04_17,ISRAEL,0,TOTALS,ISRAEL,200,28,73,38.4,22,53,41.5,6,20,30.0,7,10,70.0,10,25,35,7,30,11,5,1,69,0
856,20149,35_04_18,LATVIA,0,TOTALS,LATVIA,200,17,59,28.8,14,44,31.8,3,15,20.0,15,30,50.0,19,23,42,8,32,27,10,3,52,0
857,20162,35_04_18,TURKEY,0,TOTALS,TURKEY,200,30,57,52.6,22,36,61.1,8,21,38.1,23,40,57.5,12,27,39,15,21,15,12,5,91,1
858,20175,35_04_19,POLAND,0,TOTALS,POLAND,200,31,83,37.3,28,70,40.0,3,13,23.1,10,17,58.8,25,15,40,11,19,29,20,3,75,1
859,20188,35_04_19,RUSSIA,0,TOTALS,RUSSIA,200,41,69,59.4,34,51,66.7,7,18,38.9,19,31,61.3,16,32,48,14,15,25,12,8,108,0
860,20201,35_04_20,FRANCE,0,TOTALS,FRANCE,200,23,61,37.7,21,51,41.2,2,10,20.0,13,23,56.5,12,24,36,11,15,18,15,3,61,1
861,20214,35_04_20,CROATIA,0,TOTALS,CROATIA,200,21,63,33.3,15,43,34.9,6,20,30.0,3,9,33.3,12,25,37,11,25,28,8,3,51,0
862,20227,35_04_21,GEORGIA,0,TOTALS,GEORGIA,200,26,50,52.0,23,38,60.5,3,12,25.0,13,23,56.5,18,19,37,3,18,31,6,4,68,0
863,20240,35_04_21,SERBIA & MONTENEGRO,0,TOTALS,SERBIA & MONTENEGRO,200,31,54,57.4,30,45,66.7,1,9,11.1,16,22,72.7,10,14,24,10,21,26,15,1,79,1
864,20253,35_04_22,GREECE,0,TOTALS,GREECE,200,28,65,43.1,26,48,54.2,2,17,11.8,15,23,65.2,10,28,38,14,20,18,14,4,73,1
865,20265,35_04_22,GERMANY,0,TOTALS,GERMANY,200,22,63,34.9,15,45,33.3,7,18,38.9,9,19,47.4,15,24,39,12,20,24,9,7,60,0
866,20278,35_04_23,ITALY,0,TOTALS,ITALY,200,24,73,32.9,19,54,35.2,5,19,26.3,6,12,50.0,23,26,49,8,20,13,4,6,59,1
867,20291,35_04_23,LITHUANIA,0,TOTALS,LITHUANIA,200,17,64,26.6,14,47,29.8,3,17,17.6,15,24,62.5,17,28,45,6,18,16,5,2,52,0
868,20304,35_04_24,BELGIUM,0,TOTALS,BELGIUM,200,18,62,29.0,14,45,31.1,4,17,23.5,2,2,100.0,15,10,25,7,22,21,11,3,42,0
869,20317,35_04_24,SPAIN,0,TOTALS,SPAIN,200,28,55,50.9,23,40,57.5,5,15,33.3,18,23,78.3,14,25,39,18,8,16,12,2,79,1
870,20330,35_04_25,LITHUANIA,0,TOTALS,LITHUANIA,200,26,64,40.6,23,47,48.9,3,17,17.6,12,19,63.2,10,18,28,6,13,21,5,6,67,0
871,20343,35_04_25,TURKEY,0,TOTALS,TURKEY,200,34,65,52.3,27,47,57.4,7,18,38.9,6,14,42.9,11,24,35,18,21,18,11,2,81,1
872,20356,35_04_26,ISRAEL,0,TOTALS,ISRAEL,200,36,74,48.6,33,61,54.1,3,13,23.1,24,36,66.7,23,18,41,9,28,22,12,2,99,1
873,20368,35_04_26,GERMANY,0,TOTALS,GERMANY,200,22,50,44.0,19,34,55.9,3,16,18.8,21,41,51.2,11,18,29,11,25,31,8,4,68,0
874,20381,35_04_27,RUSSIA,0,TOTALS,RUSSIA,200,26,66,39.4,17,38,44.7,9,28,32.1,16,22,72.7,17,28,45,15,23,28,6,2,77,1
875,20394,35_04_27,SPAIN,0,TOTALS,SPAIN,200,24,62,38.7,19,44,43.2,5,18,27.8,22,31,71.0,14,20,34,13,24,26,16,1,75,0
876,20407,35_04_28,GEORGIA,0,TOTALS,GEORGIA,200,20,58,34.5,14,42,33.3,6,16,37.5,9,17,52.9,4,18,22,5,21,22,12,6,55,0
877,20420,35_04_28,CROATIA,0,TOTALS,CROATIA,200,27,65,41.5,22,45,48.9,5,20,25.0,12,23,52.2,18,27,45,10,22,21,10,4,71,1
878,20433,35_04_29,SLOVENIA,0,TOTALS,SLOVENIA,200,20,50,40.0,12,33,36.4,8,17,47.1,12,21,57.1,8,16,24,10,17,22,13,2,60,1
879,20446,35_04_29,GREECE,0,TOTALS,GREECE,200,20,50,40.0,16,32,50.0,4,18,22.2,8,13,61.5,12,17,29,13,18,24,9,4,52,0
880,20459,35_04_30,POLAND,0,TOTALS,POLAND,200,34,69,49.3,32,58,55.2,2,11,18.2,8,21,38.1,21,18,39,14,12,25,14,2,78,0
881,20472,35_04_30,BELGIUM,0,TOTALS,BELGIUM,200,36,67,53.7,28,47,59.6,8,20,40.0,6,10,60.0,11,21,32,21,23,25,15,2,86,1
882,20485,35_04_31,ITALY,0,TOTALS,ITALY,200,18,51,35.3,16,39,41.0,2,12,16.7,18,33,54.5,8,14,22,7,23,10,6,2,56,0
883,20498,35_04_31,FRANCE,0,TOTALS,FRANCE,200,19,53,35.8,11,36,30.6,8,17,47.1,20,25,80.0,13,28,41,11,30,22,8,4,66,1
884,20511,35_04_32,SERBIA & MONTENEGRO,0,TOTALS,SERBIA & MONTENEGRO,200,23,65,35.4,19,45,42.2,4,20,20.0,4,13,30.8,19,28,47,12,21,21,8,2,54,0
885,20524,35_04_32,LATVIA,0,TOTALS,LATVIA,200,25,50,50.0,20,35,57.1,5,15,33.3,9,20,45.0,3,27,30,16,18,18,10,9,64,1
886,20537,35_04_33,TURKEY,0,TOTALS,TURKEY,200,29,57,50.9,26,44,59.1,3,13,23.1,6,13,46.2,16,27,43,12,15,20,11,8,67,1
887,20550,35_04_33,SLOVENIA,0,TOTALS,SLOVENIA,200,20,59,33.9,16,48,33.3,4,11,36.4,6,13,46.2,8,13,21,8,20,16,10,1,50,0
888,20563,35_04_34,CROATIA,0,TOTALS,CROATIA,200,25,62,40.3,16,30,53.3,9,32,28.1,16,23,69.6,7,29,36,17,28,21,11,0,75,1
889,20576,35_04_34,ISRAEL,0,TOTALS,ISRAEL,200,17,48,35.4,15,42,35.7,2,6,33.3,26,33,78.8,5,27,32,11,22,21,9,2,62,0
890,20589,35_04_35,FRANCE,0,TOTALS,FRANCE,200,31,65,47.7,24,47,51.1,7,18,38.9,8,15,53.3,15,26,41,11,25,21,15,2,77,0
891,20602,35_04_35,RUSSIA,0,TOTALS,RUSSIA,200,29,62,46.8,20,39,51.3,9,23,39.1,14,22,63.6,11,23,34,10,14,22,6,3,81,1
892,20614,35_04_36,GERMANY,0,TOTALS,GERMANY,225,26,67,38.8,23,51,45.1,3,16,18.8,19,27,70.4,16,28,44,11,26,26,10,6,74,0
893,20627,35_04_36,GEORGIA,0,TOTALS,GEORGIA,225,28,79,35.4,22,60,36.7,6,19,31.6,15,30,50.0,14,24,38,18,22,20,14,3,77,1
894,20640,35_04_37,GREECE,0,TOTALS,GREECE,200,25,57,43.9,22,44,50.0,3,13,23.1,15,21,71.4,8,27,35,13,26,20,7,6,68,0
895,20653,35_04_37,LITHUANIA,0,TOTALS,LITHUANIA,200,25,66,37.9,21,49,42.9,4,17,23.5,16,27,59.3,13,23,36,10,21,13,11,0,70,1
896,20666,35_04_38,LATVIA,0,TOTALS,LATVIA,200,22,73,30.1,16,45,35.6,6,28,21.4,14,24,58.3,21,20,41,12,18,22,10,4,64,0
897,20679,35_04_38,POLAND,0,TOTALS,POLAND,200,27,65,41.5,23,49,46.9,4,16,25.0,14,20,70.0,17,27,44,13,19,23,12,9,72,1
898,20692,35_04_39,SPAIN,0,TOTALS,SPAIN,200,24,59,40.7,19,41,46.3,5,18,27.8,15,25,60.0,17,22,39,15,24,26,11,1,68,0
899,20705,35_04_39,ITALY,0,TOTALS,ITALY,200,24,62,38.7,17,41,41.5,7,21,33.3,15,20,75.0,11,21,32,10,29,21,15,4,70,1
900,20718,35_04_40,BELGIUM,0,TOTALS,BELGIUM,200,24,48,50.0,18,33,54.5,6,15,40.0,12,16,75.0,7,20,27,10,34,28,6,3,66,0
901,20731,35_04_40,SERBIA & MONTENEGRO,0,TOTALS,SERBIA & MONTENEGRO,200,26,52,50.0,24,39,61.5,2,13,15.4,26,40,65.0,8,17,25,12,19,18,13,0,80,1
902,20744,35_04_41,SLOVENIA,0,TOTALS,SLOVENIA,200,24,75,32.0,22,59,37.3,2,16,12.5,11,22,50.0,12,19,31,10,18,13,11,5,61,0
903,20757,35_04_41,LITHUANIA,0,TOTALS,LITHUANIA,200,32,75,42.7,25,59,42.4,7,16,43.8,8,12,66.7,20,33,53,14,16,20,4,9,79,1
904,20770,35_04_42,ISRAEL,0,TOTALS,ISRAEL,200,31,61,50.8,30,55,54.5,1,6,16.7,17,22,77.3,11,30,41,12,30,24,9,4,80,1
905,20783,35_04_42,GEORGIA,0,TOTALS,GEORGIA,200,18,61,29.5,15,45,33.3,3,16,18.8,14,28,50.0,13,17,30,12,22,15,12,3,53,0
906,20796,35_04_43,RUSSIA,0,TOTALS,RUSSIA,200,25,53,47.2,17,36,47.2,8,17,47.1,36,57,63.2,12,34,46,7,24,22,8,9,94,1
907,20809,35_04_43,ITALY,0,TOTALS,ITALY,200,32,74,43.2,24,52,46.2,8,22,36.4,7,18,38.9,7,18,25,10,35,14,7,5,79,0
908,20822,35_04_44,CROATIA,0,TOTALS,CROATIA,200,29,70,41.4,21,45,46.7,8,25,32.0,15,19,78.9,14,24,38,17,21,26,13,1,81,1
909,20834,35_04_44,GERMANY,0,TOTALS,GERMANY,200,26,59,44.1,22,47,46.8,4,12,33.3,10,22,45.5,11,21,32,13,20,18,10,10,66,0
910,20847,35_04_45,TURKEY,0,TOTALS,TURKEY,200,23,57,40.4,13,37,35.1,10,20,50.0,13,23,56.5,13,29,42,16,18,19,10,4,69,1
911,20860,35_04_45,GREECE,0,TOTALS,GREECE,200,23,63,36.5,20,52,38.5,3,11,27.3,15,18,83.3,13,21,34,12,19,15,10,4,64,0
912,20873,35_04_46,POLAND,0,TOTALS,POLAND,200,27,61,44.3,25,49,51.0,2,12,16.7,13,15,86.7,9,17,26,11,20,32,9,2,69,1
913,20886,35_04_46,SERBIA & MONTENEGRO,0,TOTALS,SERBIA & MONTENEGRO,200,46,83,55.4,39,62,62.9,7,21,33.3,14,16,87.5,18,19,37,29,20,21,17,3,113,0
914,20899,35_04_47,FRANCE,0,TOTALS,FRANCE,200,25,57,43.9,24,42,57.1,1,15,6.7,14,22,63.6,19,28,47,10,29,28,5,5,65,0
915,20912,35_04_47,SPAIN,0,TOTALS,SPAIN,200,24,62,38.7,20,40,50.0,4,22,18.2,14,28,50.0,8,16,24,15,21,14,11,1,66,1
916,20925,35_04_48,LATVIA,0,TOTALS,LATVIA,200,25,59,42.4,19,38,50.0,6,21,28.6,9,20,45.0,12,19,31,16,22,28,13,3,65,0
917,20938,35_04_48,BELGIUM,0,TOTALS,BELGIUM,200,22,60,36.7,14,37,37.8,8,23,34.8,20,30,66.7,12,24,36,17,25,16,20,4,72,1
918,20951,35_04_49,GREECE,0,TOTALS,GREECE,200,28,58,48.3,23,43,53.5,5,15,33.3,15,26,57.7,11,24,35,20,13,19,7,6,76,1
919,20964,35_04_49,SPAIN,0,TOTALS,SPAIN,200,24,62,38.7,19,41,46.3,5,21,23.8,11,21,52.4,8,24,32,14,19,14,11,3,64,0
920,20977,35_04_50,CROATIA,0,TOTALS,CROATIA,200,31,64,48.4,24,47,51.1,7,17,41.2,10,18,55.6,13,21,34,14,23,21,16,1,79,1
921,20990,35_04_50,BELGIUM,0,TOTALS,BELGIUM,200,18,55,32.7,17,42,40.5,1,13,7.7,20,32,62.5,14,24,38,4,16,34,7,4,57,0
922,21003,35_04_51,SLOVENIA,0,TOTALS,SLOVENIA,200,23,59,39.0,20,49,40.8,3,10,30.0,5,8,62.5,4,16,20,11,14,14,9,0,54,0
923,21016,35_04_51,ITALY,0,TOTALS,ITALY,200,35,65,53.8,32,52,61.5,3,13,23.1,9,11,81.8,15,29,44,14,16,17,7,6,82,1
924,21029,35_04_52,ISRAEL,0,TOTALS,ISRAEL,200,22,57,38.6,20,51,39.2,2,6,33.3,14,17,82.4,9,19,28,8,30,36,11,1,60,0
925,21042,35_04_52,SERBIA & MONTENEGRO,0,TOTALS,SERBIA & MONTENEGRO,200,30,66,45.5,26,47,55.3,4,19,21.1,13,23,56.5,16,15,31,15,21,23,20,8,77,1
926,21055,35_04_53,TURKEY,0,TOTALS,TURKEY,200,23,63,36.5,11,24,45.8,12,39,30.8,3,9,33.3,9,22,31,13,19,14,7,3,61,0
927,21068,35_04_53,FRANCE,0,TOTALS,FRANCE,200,27,57,47.4,20,39,51.3,7,18,38.9,9,15,60.0,6,28,34,14,14,15,5,3,70,1
928,21081,35_04_54,GEORGIA,0,TOTALS,GEORGIA,200,30,75,40.0,21,54,38.9,9,21,42.9,10,21,47.6,10,19,29,12,23,17,16,3,79,0
929,21094,35_04_54,LATVIA,0,TOTALS,LATVIA,200,28,67,41.8,22,47,46.8,6,20,30.0,22,31,71.0,15,33,48,17,24,32,12,1,84,1
930,21107,35_04_55,LITHUANIA,0,TOTALS,LITHUANIA,200,31,84,36.9,21,57,36.8,10,27,37.0,1,6,16.7,16,25,41,15,20,16,2,7,73,0
931,21120,35_04_55,RUSSIA,0,TOTALS,RUSSIA,200,35,82,42.7,26,67,38.8,9,15,60.0,10,20,50.0,21,29,50,16,11,9,6,6,89,1
932,21132,35_04_56,GERMANY,0,TOTALS,GERMANY,200,31,74,41.9,24,59,40.7,7,15,46.7,5,10,50.0,6,27,33,13,15,19,12,3,74,0
933,21145,35_04_56,POLAND,0,TOTALS,POLAND,200,31,70,44.3,25,58,43.1,6,12,50.0,8,16,50.0,14,33,47,11,14,22,10,6,76,1
934,21158,35_04_57,GEORGIA,0,TOTALS,GEORGIA,200,31,64,48.4,26,47,55.3,5,17,29.4,13,20,65.0,8,18,26,9,22,13,11,2,80,1
935,21170,35_04_57,GERMANY,0,TOTALS,GERMANY,200,26,60,43.3,23,52,44.2,3,8,37.5,20,31,64.5,18,22,40,11,21,19,6,1,75,0
936,21183,35_04_58,LATVIA,0,TOTALS,LATVIA,200,27,61,44.3,24,49,49.0,3,12,25.0,13,30,43.3,9,27,36,13,22,16,12,8,70,1
937,21196,35_04_58,POLAND,0,TOTALS,POLAND,200,23,65,35.4,21,53,39.6,2,12,16.7,15,27,55.6,11,30,41,11,21,22,9,5,63,0
938,21209,35_04_59,BELGIUM,0,TOTALS,BELGIUM,200,29,63,46.0,25,44,56.8,4,19,21.1,12,15,80.0,8,22,30,8,28,21,6,10,74,0
939,21222,35_04_59,ISRAEL,0,TOTALS,ISRAEL,200,28,66,42.4,25,57,43.9,3,9,33.3,22,34,64.7,15,22,37,10,19,15,9,2,81,1
940,21235,35_04_60,SLOVENIA,0,TOTALS,SLOVENIA,200,22,59,37.3,20,46,43.5,2,13,15.4,9,13,69.2,10,13,23,11,17,21,14,3,55,0
941,21248,35_04_60,SPAIN,0,TOTALS,SPAIN,200,28,57,49.1,26,47,55.3,2,10,20.0,9,13,69.2,16,26,42,16,14,19,9,4,67,1
942,21261,35_04_61,CROATIA,0,TOTALS,CROATIA,200,28,59,47.5,24,38,63.2,4,21,19.0,3,7,42.9,7,25,32,15,17,24,6,2,63,0
943,21274,35_04_61,SERBIA & MONTENEGRO,0,TOTALS,SERBIA & MONTENEGRO,200,32,64,50.0,29,49,59.2,3,15,20.0,13,18,72.2,9,20,29,13,14,14,14,6,80,1
944,21287,35_04_62,ITALY,0,TOTALS,ITALY,200,22,62,35.5,17,46,37.0,5,16,31.2,13,18,72.2,6,25,31,14,21,17,20,3,62,0
945,21300,35_04_62,GREECE,0,TOTALS,GREECE,200,24,57,42.1,21,44,47.7,3,13,23.1,19,26,73.1,9,34,43,16,19,19,6,4,70,1
946,21313,35_04_63,TURKEY,0,TOTALS,TURKEY,225,30,65,46.2,27,45,60.0,3,20,15.0,12,21,57.1,7,30,37,13,19,17,12,2,75,1
947,21326,35_04_63,LITHUANIA,0,TOTALS,LITHUANIA,225,27,68,39.7,21,45,46.7,6,23,26.1,9,19,47.4,12,32,44,12,19,27,10,3,69,0
948,21339,35_04_64,FRANCE,0,TOTALS,FRANCE,200,26,80,32.5,22,58,37.9,4,22,18.2,9,22,40.9,18,32,50,13,20,13,7,8,65,1
949,21352,35_04_64,RUSSIA,0,TOTALS,RUSSIA,200,23,69,33.3,18,43,41.9,5,26,19.2,9,17,52.9,20,24,44,6,23,11,5,8,60,0
950,21365,36_04_01,SWEDEN,0,TOTALS,SWEDEN,200,21,65,32.3,16,44,36.4,5,21,23.8,11,17,64.7,11,28,39,12,18,16,5,3,58,0
951,21378,36_04_01,MKD,0,TOTALS,MKD,200,26,72,36.1,12,46,26.1,14,26,53.8,13,22,59.1,16,33,49,11,17,16,9,3,79,1
952,21391,36_04_02,ESTONIA,0,TOTALS,ESTONIA,200,26,65,40.0,23,51,45.1,3,14,21.4,8,16,50.0,17,17,34,6,24,28,18,2,63,0
953,21404,36_04_02,PORTUGAL,0,TOTALS,PORTUGAL,200,29,64,45.3,29,58,50.0,0,6,0.0,16,29,55.2,25,23,48,13,17,32,13,6,74,1
954,21417,36_04_03,HUNGARY,0,TOTALS,HUNGARY,200,20,66,30.3,16,52,30.8,4,14,28.6,10,20,50.0,13,31,44,6,28,28,11,2,54,0
955,21430,36_04_03,ICELAND,0,TOTALS,ICELAND,200,22,59,37.3,18,45,40.0,4,14,28.6,18,38,47.4,7,29,36,8,15,22,14,5,66,1
956,21443,36_04_04,UKRAINE,0,TOTALS,UKRAINE,200,48,98,49.0,45,75,60.0,3,23,13.0,27,36,75.0,23,32,55,12,12,16,28,4,126,0
957,21456,36_04_04,ALBANIA,0,TOTALS,ALBANIA,200,21,58,36.2,19,47,40.4,2,11,18.2,2,6,33.3,4,20,24,9,24,41,6,2,46,1
958,21469,36_04_05,CZECH REPUBLIC,0,TOTALS,CZECH REPUBLIC,225,27,71,38.0,22,51,43.1,5,20,25.0,8,14,57.1,11,33,44,11,22,30,11,5,67,1
959,21482,36_04_05,FINLAND,0,TOTALS,FINLAND,225,23,76,30.3,20,61,32.8,3,15,20.0,17,26,65.4,14,33,47,10,17,27,14,3,66,0
960,21495,36_04_06,IRELAND,0,TOTALS,IRELAND,200,11,80,13.8,7,53,13.2,4,27,14.8,10,13,76.9,20,26,46,7,31,21,14,1,36,0
961,21508,36_04_06,ENGLAND,0,TOTALS,ENGLAND,200,21,55,38.2,19,47,40.4,2,8,25.0,21,39,53.8,13,45,58,10,14,29,14,8,65,1
962,21521,36_04_07,BELARUS,0,TOTALS,BELARUS,200,19,67,28.4,18,57,31.6,1,10,10.0,7,17,41.2,13,26,39,9,21,34,12,3,46,0
963,21534,36_04_07,BULGARIA,0,TOTALS,BULGARIA,200,37,80,46.2,34,66,51.5,3,14,21.4,10,25,40.0,18,37,55,28,18,24,23,5,87,1
964,21547,36_04_08,NETHERLANDS,0,TOTALS,NETHERLANDS,200,29,60,48.3,26,46,56.5,3,14,21.4,11,17,64.7,10,30,40,18,21,20,9,1,72,1
965,21560,36_04_08,AUSTRIA,0,TOTALS,AUSTRIA,200,24,72,33.3,22,58,37.9,2,14,14.3,13,20,65.0,14,22,36,10,18,20,13,2,63,0
966,21573,36_04_09,BOSNIA AND HERZEGOVINA,0,TOTALS,BOSNIA AND HERZEGOVINA,200,38,72,52.8,33,61,54.1,5,11,45.5,12,18,66.7,15,21,36,19,22,21,18,1,93,1
967,21586,36_04_09,ROMANIA,0,TOTALS,ROMANIA,200,21,55,38.2,17,32,53.1,4,23,17.4,16,21,76.2,10,17,27,13,17,34,9,4,62,0
968,21599,36_04_10,SWEDEN,0,TOTALS,SWEDEN,200,27,66,40.9,19,41,46.3,8,25,32.0,10,15,66.7,5,35,40,14,17,17,8,0,72,1
969,21612,36_04_10,ICELAND,0,TOTALS,ICELAND,200,26,74,35.1,25,53,47.2,1,21,4.8,13,22,59.1,13,29,42,12,15,12,10,2,66,0
970,21625,36_04_11,MKD,0,TOTALS,MKD,200,23,67,34.3,17,39,43.6,6,28,21.4,10,17,58.8,10,23,33,6,17,16,14,1,62,1
971,21638,36_04_11,CZECH REPUBLIC,0,TOTALS,CZECH REPUBLIC,200,23,62,37.1,19,43,44.2,4,19,21.1,8,17,47.1,9,27,36,11,23,27,10,3,58,0
972,21651,36_04_12,CYPRUS,0,TOTALS,CYPRUS,200,22,62,35.5,15,36,41.7,7,26,26.9,14,23,60.9,11,20,31,16,25,13,13,1,65,0
973,21664,36_04_12,BELARUS,0,TOTALS,BELARUS,200,28,77,36.4,24,44,54.5,4,33,12.1,14,25,56.0,19,28,47,16,21,18,5,1,74,1
974,21677,36_04_13,AUSTRIA,0,TOTALS,AUSTRIA,200,21,50,42.0,18,37,48.6,3,13,23.1,16,29,55.2,15,25,40,10,29,31,12,5,61,1
975,21690,36_04_13,HUNGARY,0,TOTALS,HUNGARY,200,20,55,36.4,16,43,37.2,4,12,33.3,15,32,46.9,14,18,32,6,29,24,18,3,59,0
976,21703,36_04_14,ALBANIA,0,TOTALS,ALBANIA,200,21,63,33.3,20,56,35.7,1,7,14.3,19,32,59.4,9,24,33,6,24,28,12,3,62,1
977,21716,36_04_14,ESTONIA,0,TOTALS,ESTONIA,200,38,83,45.8,36,68,52.9,2,15,13.3,27,38,71.1,23,36,59,10,27,25,14,0,105,0
978,21729,36_04_15,FINLAND,0,TOTALS,FINLAND,200,20,78,25.6,13,45,28.9,7,33,21.2,3,6,50.0,15,26,41,13,13,20,10,2,50,0
979,21742,36_04_15,ENGLAND,0,TOTALS,ENGLAND,200,27,73,37.0,24,48,50.0,3,25,12.0,7,14,50.0,17,33,50,15,16,21,11,11,64,1
980,21755,36_04_16,BULGARIA,0,TOTALS,BULGARIA,200,32,67,47.8,25,46,54.3,7,21,33.3,13,26,50.0,13,25,38,19,23,24,6,5,84,1
981,21768,36_04_16,BOSNIA AND HERZEGOVINA,0,TOTALS,BOSNIA AND HERZEGOVINA,200,28,68,41.2,22,45,48.9,6,23,26.1,14,21,66.7,17,22,39,16,24,16,7,2,76,0
982,21781,36_04_17,NETHERLANDS,0,TOTALS,NETHERLANDS,200,19,65,29.2,17,43,39.5,2,22,9.1,10,19,52.6,11,25,36,10,21,18,14,1,50,0
983,21794,36_04_17,IRELAND,0,TOTALS,IRELAND,200,22,51,43.1,11,29,37.9,11,22,50.0,7,22,31.8,6,29,35,13,19,28,5,0,62,1
984,21807,36_04_18,ROMANIA,0,TOTALS,ROMANIA,200,20,49,40.8,14,32,43.8,6,17,35.3,11,27,40.7,9,23,32,7,17,27,7,5,57,0
985,21820,36_04_18,UKRAINE,0,TOTALS,UKRAINE,200,30,77,39.0,18,40,45.0,12,37,32.4,9,14,64.3,22,26,48,16,24,17,15,2,81,1
986,21833,36_04_19,AUSTRIA,0,TOTALS,AUSTRIA,200,21,71,29.6,18,54,33.3,3,17,17.6,7,10,70.0,22,22,44,6,18,27,16,4,52,0
987,21846,36_04_19,ICELAND,0,TOTALS,ICELAND,200,33,79,41.8,25,54,46.3,8,25,32.0,3,11,27.3,20,23,43,16,11,20,9,2,77,1
988,21859,36_04_20,SWEDEN,0,TOTALS,SWEDEN,200,14,46,30.4,10,30,33.3,4,16,25.0,11,18,61.1,5,23,28,8,20,23,10,2,43,0
989,21872,36_04_20,CZECH REPUBLIC,0,TOTALS,CZECH REPUBLIC,200,17,60,28.3,14,38,36.8,3,22,13.6,11,26,42.3,18,24,42,10,22,20,16,1,48,1
990,21885,36_04_21,BOSNIA AND HERZEGOVINA,0,TOTALS,BOSNIA AND HERZEGOVINA,200,31,72,43.1,26,56,46.4,5,16,31.2,17,31,54.8,20,37,57,13,18,22,7,6,84,1
991,21898,36_04_21,CYPRUS,0,TOTALS,CYPRUS,200,22,62,35.5,20,48,41.7,2,14,14.3,13,22,59.1,5,19,24,12,26,15,17,2,59,0
992,21911,36_04_22,ENGLAND,0,TOTALS,ENGLAND,200,17,73,23.3,12,49,24.5,5,24,20.8,4,12,33.3,19,24,43,8,8,14,5,4,43,0
993,21924,36_04_22,MKD,0,TOTALS,MKD,200,29,70,41.4,21,38,55.3,8,32,25.0,1,2,50.0,10,36,46,6,10,11,11,7,67,1
994,21937,36_04_23,ESTONIA,0,TOTALS,ESTONIA,200,22,66,33.3,13,41,31.7,9,25,36.0,14,24,58.3,14,22,36,8,24,19,10,1,67,0
995,21950,36_04_23,ROMANIA,0,TOTALS,ROMANIA,200,28,68,41.2,28,53,52.8,0,15,0.0,23,31,74.2,17,32,49,7,23,17,12,3,79,1
996,21963,36_04_24,HUNGARY,0,TOTALS,HUNGARY,200,31,69,44.9,26,53,49.1,5,16,31.2,15,21,71.4,10,38,48,12,25,29,20,4,82,1
997,21976,36_04_24,IRELAND,0,TOTALS,IRELAND,200,19,71,26.8,14,53,26.4,5,18,27.8,13,24,54.2,13,26,39,11,23,25,16,0,56,0
998,21989,36_04_25,UKRAINE,0,TOTALS,UKRAINE,200,19,62,30.6,14,42,33.3,5,20,25.0,20,26,76.9,16,27,43,11,15,23,15,9,63,1
999,22002,36_04_25,BULGARIA,0,TOTALS,BULGARIA,200,24,68,35.3,20,53,37.7,4,15,26.7,6,13,46.2,18,23,41,13,20,21,11,3,58,0
1000,22015,36_04_26,FINLAND,0,TOTALS,FINLAND,200,24,59,40.7,17,45,37.8,7,14,50.0,12,21,57.1,14,24,38,13,14,26,3,4,67,0
1001,22028,36_04_26,NETHERLANDS,0,TOTALS,NETHERLANDS,200,34,79,43.0,29,63,46.0,5,16,31.2,7,12,58.3,18,22,40,20,23,14,12,2,80,1
1002,22041,36_04_27,PORTUGAL,0,TOTALS,PORTUGAL,200,34,79,43.0,33,73,45.2,1,6,16.7,26,35,74.3,21,28,49,16,20,26,25,4,95,1
1003,22054,36_04_27,ALBANIA,0,TOTALS,ALBANIA,200,10,46,21.7,8,39,20.5,2,7,28.6,8,18,44.4,7,24,31,5,24,47,6,6,30,0
1004,22067,36_04_28,SWEDEN,0,TOTALS,SWEDEN,200,16,56,28.6,14,48,29.2,2,8,25.0,13,22,59.1,16,32,48,11,18,26,13,4,47,0
1005,22080,36_04_28,AUSTRIA,0,TOTALS,AUSTRIA,200,20,66,30.3,17,49,34.7,3,17,17.6,5,16,31.2,13,20,33,10,24,19,13,2,48,1
1006,22093,36_04_29,FINLAND,0,TOTALS,FINLAND,200,27,69,39.1,21,44,47.7,6,25,24.0,9,19,47.4,15,27,42,14,14,20,12,2,69,1
1007,22106,36_04_29,HUNGARY,0,TOTALS,HUNGARY,200,25,69,36.2,18,47,38.3,7,22,31.8,5,10,50.0,13,22,35,6,21,22,11,6,62,0
1008,22119,36_04_30,BELARUS,0,TOTALS,BELARUS,200,12,60,20.0,8,48,16.7,4,12,33.3,7,13,53.8,15,18,33,5,22,30,10,4,35,0
1009,22132,36_04_30,BOSNIA AND HERZEGOVINA,0,TOTALS,BOSNIA AND HERZEGOVINA,200,26,60,43.3,25,53,47.2,1,7,14.3,15,28,53.6,15,28,43,9,16,19,9,7,68,1
1010,22145,36_04_31,MKD,0,TOTALS,MKD,200,30,58,51.7,24,44,54.5,6,14,42.9,24,43,55.8,13,26,39,19,11,15,8,6,90,1
1011,22158,36_04_31,NETHERLANDS,0,TOTALS,NETHERLANDS,200,28,72,38.9,18,49,36.7,10,23,43.5,1,5,20.0,10,21,31,16,28,18,3,2,67,0
1012,22171,36_04_32,CYPRUS,0,TOTALS,CYPRUS,200,8,58,13.8,6,32,18.8,2,26,7.7,2,2,100.0,11,12,23,2,22,18,10,0,20,0
1013,22184,36_04_32,UKRAINE,0,TOTALS,UKRAINE,200,32,57,56.1,22,38,57.9,10,19,52.6,18,24,75.0,16,34,50,17,8,17,8,4,92,1
1014,22197,36_04_33,CZECH REPUBLIC,0,TOTALS,CZECH REPUBLIC,200,20,65,30.8,16,40,40.0,4,25,16.0,4,7,57.1,9,20,29,11,28,24,17,1,48,0
1015,22210,36_04_33,ENGLAND,0,TOTALS,ENGLAND,200,19,51,37.3,14,38,36.8,5,13,38.5,21,33,63.6,17,32,49,6,13,30,13,8,64,1
1016,22223,36_04_34,BULGARIA,0,TOTALS,BULGARIA,200,20,66,30.3,17,41,41.5,3,25,12.0,13,20,65.0,19,26,45,6,18,23,12,2,56,0
1017,22236,36_04_34,ESTONIA,0,TOTALS,ESTONIA,200,28,66,42.4,20,47,42.6,8,19,42.1,6,15,40.0,14,28,42,14,18,20,12,0,70,1
1018,22249,36_04_35,IRELAND,0,TOTALS,IRELAND,200,21,81,25.9,15,58,25.9,6,23,26.1,3,5,60.0,16,29,45,7,22,24,14,0,51,0
1019,22262,36_04_35,ICELAND,0,TOTALS,ICELAND,200,23,66,34.8,22,51,43.1,1,15,6.7,16,29,55.2,14,42,56,7,10,25,13,2,63,1
1020,22275,36_04_36,ROMANIA,0,TOTALS,ROMANIA,200,17,59,28.8,13,36,36.1,4,23,17.4,15,19,78.9,12,36,48,4,25,27,6,4,53,0
1021,22288,36_04_36,PORTUGAL,0,TOTALS,PORTUGAL,200,22,71,31.0,22,60,36.7,0,11,0.0,16,23,69.6,16,25,41,9,20,16,11,4,60,1
1022,22301,36_04_37,HUNGARY,0,TOTALS,HUNGARY,200,28,83,33.7,23,58,39.7,5,25,20.0,5,6,83.3,13,20,33,11,18,13,12,3,66,0
1023,22314,36_04_37,MKD,0,TOTALS,MKD,200,38,77,49.4,28,51,54.9,10,26,38.5,6,11,54.5,16,36,52,20,11,16,7,6,92,1
1024,22327,36_04_38,ICELAND,0,TOTALS,ICELAND,200,33,79,41.8,25,50,50.0,8,29,27.6,1,4,25.0,10,26,36,14,11,7,10,3,75,1
1025,22340,36_04_38,FINLAND,0,TOTALS,FINLAND,200,21,68,30.9,17,39,43.6,4,29,13.8,5,8,62.5,15,32,47,6,10,17,5,0,51,0
1026,22353,36_04_39,ESTONIA,0,TOTALS,ESTONIA,200,24,60,40.0,14,34,41.2,10,26,38.5,15,26,57.7,20,34,54,10,13,23,6,2,73,1
1027,22366,36_04_39,CYPRUS,0,TOTALS,CYPRUS,200,27,70,38.6,19,45,42.2,8,25,32.0,3,8,37.5,11,14,25,7,24,10,17,1,65,0
1028,22379,36_04_40,AUSTRIA,0,TOTALS,AUSTRIA,200,36,74,48.6,28,56,50.0,8,18,44.4,6,13,46.2,19,26,45,17,20,25,15,5,86,1
1029,22392,36_04_40,IRELAND,0,TOTALS,IRELAND,200,25,67,37.3,22,52,42.3,3,15,20.0,15,23,65.2,9,22,31,8,18,23,14,2,68,0
1030,22405,36_04_41,ALBANIA,0,TOTALS,ALBANIA,200,17,59,28.8,14,49,28.6,3,10,30.0,7,20,35.0,4,22,26,5,15,19,7,3,44,0
1031,22418,36_04_41,ROMANIA,0,TOTALS,ROMANIA,200,36,87,41.4,26,59,44.1,10,28,35.7,9,19,47.4,30,37,67,15,19,16,12,2,91,1
1032,22431,36_04_42,ENGLAND,0,TOTALS,ENGLAND,200,30,71,42.3,26,55,47.3,4,16,25.0,8,15,53.3,14,22,36,12,12,15,7,3,72,1
1033,22444,36_04_42,SWEDEN,0,TOTALS,SWEDEN,200,21,54,38.9,14,32,43.8,7,22,31.8,8,15,53.3,6,22,28,13,9,15,6,1,57,0
1034,22457,36_04_43,PORTUGAL,0,TOTALS,PORTUGAL,200,21,60,35.0,18,47,38.3,3,13,23.1,19,36,52.8,19,27,46,13,19,34,12,4,64,0
1035,22470,36_04_43,BULGARIA,0,TOTALS,BULGARIA,200,32,81,39.5,26,55,47.3,6,26,23.1,10,18,55.6,25,22,47,18,26,24,20,6,80,1
1036,22483,36_04_44,NETHERLANDS,0,TOTALS,NETHERLANDS,200,16,49,32.7,12,32,37.5,4,17,23.5,11,17,64.7,15,14,29,10,32,28,7,2,47,0
1037,22496,36_04_44,CZECH REPUBLIC,0,TOTALS,CZECH REPUBLIC,200,18,41,43.9,14,30,46.7,4,11,36.4,25,44,56.8,10,21,31,13,18,23,17,4,65,1
1038,22509,36_04_45,UKRAINE,0,TOTALS,UKRAINE,200,30,65,46.2,27,50,54.0,3,15,20.0,11,15,73.3,17,33,50,11,12,12,13,1,74,1
1039,22522,36_04_45,BELARUS,0,TOTALS,BELARUS,200,9,53,17.0,7,39,17.9,2,14,14.3,4,6,66.7,10,20,30,1,14,21,3,4,24,0
1040,22535,36_04_46,FINLAND,0,TOTALS,FINLAND,200,20,57,35.1,15,39,38.5,5,18,27.8,12,22,54.5,12,28,40,13,10,17,8,3,57,1
1041,22548,36_04_46,AUSTRIA,0,TOTALS,AUSTRIA,200,22,70,31.4,19,50,38.0,3,20,15.0,7,14,50.0,17,25,42,13,23,15,12,1,54,0
1042,22561,36_04_47,SWEDEN,0,TOTALS,SWEDEN,200,27,66,40.9,20,41,48.8,7,25,28.0,7,14,50.0,9,42,51,18,11,17,9,5,68,1
1043,22574,36_04_47,IRELAND,0,TOTALS,IRELAND,200,20,70,28.6,11,35,31.4,9,35,25.7,7,12,58.3,7,31,38,10,15,12,14,0,56,0
1044,22587,36_04_48,BOSNIA AND HERZEGOVINA,0,TOTALS,BOSNIA AND HERZEGOVINA,200,19,68,27.9,16,47,34.0,3,21,14.3,11,14,78.6,19,16,35,4,25,17,3,5,52,0
1045,22600,36_04_48,UKRAINE,0,TOTALS,UKRAINE,200,22,55,40.0,17,39,43.6,5,16,31.2,17,19,89.5,9,29,38,12,21,18,5,6,66,1
1046,22613,36_04_49,MKD,0,TOTALS,MKD,225,34,98,34.7,24,59,40.7,10,39,25.6,10,13,76.9,21,42,63,8,16,15,5,4,88,0
1047,22626,36_04_49,ICELAND,0,TOTALS,ICELAND,225,35,88,39.8,26,58,44.8,9,30,30.0,14,24,58.3,15,42,57,15,9,11,6,1,93,1
1048,22639,36_04_50,CYPRUS,0,TOTALS,CYPRUS,200,21,78,26.9,12,44,27.3,9,34,26.5,5,6,83.3,16,15,31,13,19,13,18,3,56,0
1049,22652,36_04_50,PORTUGAL,0,TOTALS,PORTUGAL,200,21,46,45.7,15,34,44.1,6,12,50.0,16,22,72.7,11,35,46,17,10,35,9,6,64,1
1050,22665,36_04_51,ENGLAND,0,TOTALS,ENGLAND,200,27,59,45.8,22,49,44.9,5,10,50.0,5,10,50.0,12,20,32,8,7,18,8,3,64,0
1051,22678,36_04_51,NETHERLANDS,0,TOTALS,NETHERLANDS,200,28,65,43.1,19,41,46.3,9,24,37.5,1,6,16.7,11,12,23,8,12,10,8,0,66,1
1052,22691,36_04_52,BULGARIA,0,TOTALS,BULGARIA,200,53,86,61.6,48,67,71.6,5,19,26.3,15,21,71.4,18,42,60,30,15,17,21,2,126,0
1053,22704,36_04_52,ALBANIA,0,TOTALS,ALBANIA,200,11,57,19.3,9,43,20.9,2,14,14.3,7,15,46.7,8,13,21,7,17,35,7,2,31,1
1054,22717,36_04_53,CZECH REPUBLIC,0,TOTALS,CZECH REPUBLIC,200,15,45,33.3,14,31,45.2,1,14,7.1,15,24,62.5,5,11,16,4,18,27,13,2,46,0
1055,22730,36_04_53,HUNGARY,0,TOTALS,HUNGARY,200,34,58,58.6,27,46,58.7,7,12,58.3,13,23,56.5,8,14,22,13,25,19,13,2,88,1
1056,22743,36_04_54,BELARUS,0,TOTALS,BELARUS,200,19,60,31.7,16,52,30.8,3,8,37.5,14,19,73.7,12,26,38,3,26,28,12,0,55,0
1057,22756,36_04_54,ESTONIA,0,TOTALS,ESTONIA,200,31,69,44.9,30,53,56.6,1,16,6.2,13,26,50.0,17,27,44,14,22,24,14,5,76,1
1058,22769,36_04_55,AUSTRIA,0,TOTALS,AUSTRIA,200,27,81,33.3,25,73,34.2,2,8,25.0,4,10,40.0,11,32,43,10,12,22,7,3,60,0
1059,22782,36_04_55,MKD,0,TOTALS,MKD,200,39,82,47.6,32,57,56.1,7,25,28.0,8,17,47.1,13,35,48,24,10,16,16,14,93,1
1060,22795,36_04_56,IRELAND,0,TOTALS,IRELAND,200,27,69,39.1,13,32,40.6,14,37,37.8,1,2,50.0,9,27,36,17,18,19,13,2,69,1
1061,22808,36_04_56,FINLAND,0,TOTALS,FINLAND,200,20,62,32.3,15,45,33.3,5,17,29.4,9,19,47.4,12,31,43,12,5,22,6,1,54,0
1062,22821,36_04_57,ALBANIA,0,TOTALS,ALBANIA,200,13,54,24.1,13,45,28.9,0,9,0.0,14,25,56.0,12,40,52,2,15,28,3,3,40,0
1063,22834,36_04_57,CYPRUS,0,TOTALS,CYPRUS,200,35,92,38.0,26,62,41.9,9,30,30.0,9,13,69.2,14,34,48,8,22,6,18,1,88,1
1064,22847,36_04_58,HUNGARY,0,TOTALS,HUNGARY,200,17,63,27.0,11,32,34.4,6,31,19.4,7,12,58.3,14,14,28,9,17,22,19,2,47,0
1065,22860,36_04_58,ENGLAND,0,TOTALS,ENGLAND,200,20,42,47.6,17,25,68.0,3,17,17.6,13,20,65.0,7,25,32,11,17,28,12,9,56,1
1066,22873,36_04_59,ESTONIA,0,TOTALS,ESTONIA,200,22,59,37.3,18,47,38.3,4,12,33.3,15,29,51.7,15,13,28,6,24,18,13,1,63,0
1067,22886,36_04_59,BOSNIA AND HERZEGOVINA,0,TOTALS,BOSNIA AND HERZEGOVINA,200,28,55,50.9,25,45,55.6,3,10,30.0,18,28,64.3,13,23,36,4,26,23,6,5,77,1
1068,22899,36_04_60,ICELAND,0,TOTALS,ICELAND,225,25,66,37.9,18,45,40.0,7,21,33.3,18,27,66.7,6,38,44,6,17,15,6,2,75,1
1069,22912,36_04_60,CZECH REPUBLIC,0,TOTALS,CZECH REPUBLIC,225,30,83,36.1,24,67,35.8,6,16,37.5,7,14,50.0,8,29,37,16,24,16,13,5,73,0
1070,22925,36_04_61,ROMANIA,0,TOTALS,ROMANIA,200,26,54,48.1,18,37,48.6,8,17,47.1,31,44,70.5,8,28,36,12,15,26,10,1,91,1
1071,22938,36_04_61,BULGARIA,0,TOTALS,BULGARIA,200,36,76,47.4,26,47,55.3,10,29,34.5,6,14,42.9,9,21,30,18,30,22,12,0,88,0
1072,22951,36_04_62,SWEDEN,0,TOTALS,SWEDEN,200,25,51,49.0,20,37,54.1,5,14,35.7,14,24,58.3,8,25,33,12,6,15,2,1,69,1
1073,22964,36_04_62,NETHERLANDS,0,TOTALS,NETHERLANDS,200,27,76,35.5,22,57,38.6,5,19,26.3,0,2,0.0,16,17,33,11,21,10,10,0,59,0
1074,22977,36_04_63,PORTUGAL,0,TOTALS,PORTUGAL,200,27,53,50.9,24,44,54.5,3,9,33.3,15,21,71.4,9,21,30,9,15,20,15,3,72,1
1075,22990,36_04_63,BELARUS,0,TOTALS,BELARUS,200,17,51,33.3,14,39,35.9,3,12,25.0,7,16,43.8,12,18,30,9,21,31,10,1,44,0
1076,23003,36_04_64,IRELAND,0,TOTALS,IRELAND,200,22,87,25.3,14,51,27.5,8,36,22.2,5,8,62.5,19,22,41,11,12,22,19,1,57,1
1077,23016,36_04_64,MKD,0,TOTALS,MKD,200,42,76,55.3,35,58,60.3,7,18,38.9,12,15,80.0,12,44,56,17,10,24,14,6,103,0
1078,23029,36_04_65,AUSTRIA,0,TOTALS,AUSTRIA,200,21,61,34.4,19,45,42.2,2,16,12.5,11,19,57.9,16,20,36,9,24,22,13,6,55,0
1079,23042,36_04_65,CZECH REPUBLIC,0,TOTALS,CZECH REPUBLIC,200,21,55,38.2,15,42,35.7,6,13,46.2,9,22,40.9,16,22,38,12,23,26,18,2,57,1
1080,23055,36_04_66,UKRAINE,0,TOTALS,UKRAINE,200,28,59,47.5,19,44,43.2,9,15,60.0,15,20,75.0,12,19,31,9,15,11,14,4,80,1
1081,23068,36_04_66,ESTONIA,0,TOTALS,ESTONIA,200,22,49,44.9,17,34,50.0,5,15,33.3,5,6,83.3,7,19,26,9,18,25,7,1,54,0
1082,23081,36_04_67,FINLAND,0,TOTALS,FINLAND,200,32,74,43.2,21,50,42.0,11,24,45.8,7,12,58.3,16,27,43,18,17,9,11,1,82,1
1083,23094,36_04_67,SWEDEN,0,TOTALS,SWEDEN,200,21,57,36.8,16,46,34.8,5,11,45.5,10,18,55.6,10,21,31,9,12,13,7,2,57,0
1084,23107,36_04_68,BOSNIA AND HERZEGOVINA,0,TOTALS,BOSNIA AND HERZEGOVINA,200,27,63,42.9,25,55,45.5,2,8,25.0,19,28,67.9,15,30,45,14,21,24,18,4,75,1
1085,23120,36_04_68,PORTUGAL,0,TOTALS,PORTUGAL,200,24,70,34.3,21,56,37.5,3,14,21.4,10,18,55.6,19,26,45,5,21,27,13,7,61,0
1086,23133,36_04_69,ENGLAND,0,TOTALS,ENGLAND,200,24,65,36.9,24,52,46.2,0,13,0.0,5,15,33.3,11,31,42,8,20,18,9,3,53,0
1087,23146,36_04_69,ICELAND,0,TOTALS,ICELAND,200,22,64,34.4,14,39,35.9,8,25,32.0,13,19,68.4,7,30,37,14,9,15,8,0,65,1
1088,23159,36_04_70,BELARUS,0,TOTALS,BELARUS,200,35,71,49.3,30,60,50.0,5,11,45.5,22,37,59.5,21,36,57,10,19,22,12,2,97,1
1089,23172,36_04_70,ALBANIA,0,TOTALS,ALBANIA,200,27,68,39.7,24,59,40.7,3,9,33.3,6,13,46.2,6,19,25,5,24,22,10,1,63,0
1090,23185,36_04_71,HUNGARY,0,TOTALS,HUNGARY,200,23,51,45.1,18,33,54.5,5,18,27.8,10,15,66.7,7,23,30,9,22,20,3,2,61,1
1091,23198,36_04_71,NETHERLANDS,0,TOTALS,NETHERLANDS,200,20,55,36.4,17,37,45.9,3,18,16.7,10,17,58.8,9,20,29,13,19,16,5,1,53,0
1092,23211,36_04_72,CYPRUS,0,TOTALS,CYPRUS,200,23,68,33.8,6,23,26.1,17,45,37.8,4,8,50.0,7,20,27,9,22,11,10,0,67,0
1093,23224,36_04_72,ROMANIA,0,TOTALS,ROMANIA,200,28,56,50.0,26,41,63.4,2,15,13.3,15,20,75.0,7,39,46,19,13,18,4,3,73,1
1094,23237,36_04_73,FINLAND,0,TOTALS,FINLAND,200,32,91,35.2,20,65,30.8,12,26,46.2,2,2,100.0,24,22,46,18,14,9,9,0,78,1
1095,23250,36_04_73,MKD,0,TOTALS,MKD,200,30,61,49.2,21,34,61.8,9,27,33.3,6,11,54.5,7,30,37,16,8,15,4,5,75,0
1096,23263,36_04_74,PORTUGAL,0,TOTALS,PORTUGAL,200,22,54,40.7,21,45,46.7,1,9,11.1,15,25,60.0,13,32,45,7,12,32,7,5,60,0
1097,23276,36_04_74,UKRAINE,0,TOTALS,UKRAINE,200,26,80,32.5,22,57,38.6,4,23,17.4,7,12,58.3,20,22,42,7,20,16,18,3,63,1
1098,23289,36_04_75,IRELAND,0,TOTALS,IRELAND,200,17,70,24.3,14,48,29.2,3,22,13.6,3,4,75.0,14,21,35,9,20,20,14,1,40,0
1099,23302,36_04_75,CZECH REPUBLIC,0,TOTALS,CZECH REPUBLIC,200,28,57,49.1,20,39,51.3,8,18,44.4,8,15,53.3,7,37,44,20,10,21,10,6,72,1
1100,23315,36_04_76,ROMANIA,0,TOTALS,ROMANIA,200,23,63,36.5,18,48,37.5,5,15,33.3,13,17,76.5,12,19,31,4,19,17,13,5,64,0
1101,23328,36_04_76,BELARUS,0,TOTALS,BELARUS,200,24,59,40.7,14,40,35.0,10,19,52.6,10,17,58.8,13,28,41,6,19,26,11,0,68,1
1102,23341,36_04_77,ICELAND,0,TOTALS,ICELAND,200,28,68,41.2,20,46,43.5,8,22,36.4,8,15,53.3,10,28,38,11,9,13,4,1,72,0
1103,23354,36_04_77,NETHERLANDS,0,TOTALS,NETHERLANDS,200,35,81,43.2,30,67,44.8,5,14,35.7,3,4,75.0,12,33,45,20,13,10,8,2,78,1
1104,23366,36_04_78,ALBANIA,0,TOTALS,ALBANIA,200,16,42,38.1,15,40,37.5,1,2,50.0,3,9,33.3,3,10,13,6,17,22,10,1,36,0
1105,23379,36_04_78,BOSNIA AND HERZEGOVINA,0,TOTALS,BOSNIA AND HERZEGOVINA,200,33,60,55.0,25,37,67.6,8,23,34.8,8,14,57.1,15,24,39,10,11,20,9,2,82,1
1106,23392,36_04_79,HUNGARY,0,TOTALS,HUNGARY,200,26,53,49.1,21,44,47.7,5,9,55.6,5,8,62.5,8,23,31,12,19,17,7,5,62,1
1107,23405,36_04_79,SWEDEN,0,TOTALS,SWEDEN,200,19,66,28.8,15,48,31.2,4,18,22.2,7,18,38.9,17,18,35,10,10,14,7,7,49,0
1108,23418,36_04_80,BULGARIA,0,TOTALS,BULGARIA,200,31,77,40.3,25,56,44.6,6,21,28.6,24,31,77.4,30,26,56,18,14,17,13,2,92,1
1109,23431,36_04_80,CYPRUS,0,TOTALS,CYPRUS,200,22,53,41.5,11,22,50.0,11,31,35.5,4,6,66.7,3,17,20,8,22,26,13,1,59,0
1110,23444,36_04_81,ENGLAND,0,TOTALS,ENGLAND,200,23,53,43.4,22,45,48.9,1,8,12.5,11,19,57.9,11,28,39,8,17,23,10,8,58,1
1111,23457,36_04_81,AUSTRIA,0,TOTALS,AUSTRIA,200,18,67,26.9,14,45,31.1,4,22,18.2,7,18,38.9,17,20,37,6,20,20,16,2,47,0
1112,23470,37_04_01,WALES,0,TOTALS,WALES,200,12,62,19.4,11,53,20.8,1,9,11.1,7,24,29.2,17,18,35,0,23,33,12,4,32,0
1113,23483,37_04_01,SCOTLAND,0,TOTALS,SCOTLAND,200,35,65,53.8,34,61,55.7,1,4,25.0,12,22,54.5,9,35,44,10,22,29,15,9,83,1
1114,23496,37_04_02,GIBRALTAR,0,TOTALS,GIBRALTAR,200,17,70,24.3,16,60,26.7,1,10,10.0,3,5,60.0,9,13,22,2,23,29,18,0,38,1
1115,23506,37_04_02,ANDORRA,0,TOTALS,ANDORRA,200,43,87,49.4,38,73,52.1,5,14,35.7,22,32,68.8,25,39,64,15,8,20,25,1,113,0
1116,23519,37_04_03,LUXEMBOURG,0,TOTALS,LUXEMBOURG,200,50,95,52.6,46,80,57.5,4,15,26.7,19,24,79.2,26,24,50,16,24,18,39,1,123,0
1117,23532,37_04_03,GIBRALTAR,0,TOTALS,GIBRALTAR,200,8,34,23.5,6,23,26.1,2,11,18.2,6,20,30.0,5,16,21,4,22,52,9,1,24,1
1118,23542,37_04_04,ANDORRA,0,TOTALS,ANDORRA,200,42,81,51.9,38,67,56.7,4,14,28.6,26,49,53.1,20,31,51,10,15,19,17,4,114,0
1119,23555,37_04_04,WALES,0,TOTALS,WALES,200,24,73,32.9,23,66,34.8,1,7,14.3,9,17,52.9,13,24,37,7,36,33,10,1,58,1
1120,23568,37_04_05,WALES,0,TOTALS,WALES,200,14,44,31.8,13,36,36.1,1,8,12.5,8,27,29.6,11,26,37,2,26,39,7,2,37,0
1121,23581,37_04_05,LUXEMBOURG,0,TOTALS,LUXEMBOURG,200,38,76,50.0,35,62,56.5,3,14,21.4,18,35,51.4,15,24,39,14,26,14,25,4,97,1
1122,23594,37_04_06,SCOTLAND,0,TOTALS,SCOTLAND,200,40,90,44.4,33,68,48.5,7,22,31.8,10,17,58.8,25,35,60,10,37,41,9,9,97,1
1123,23604,37_04_06,ANDORRA,0,TOTALS,ANDORRA,200,41,81,50.6,38,68,55.9,3,13,23.1,29,58,50.0,17,21,38,11,20,17,28,0,114,0
1124,23617,37_04_07,LUXEMBOURG,0,TOTALS,LUXEMBOURG,200,35,75,46.7,28,49,57.1,7,26,26.9,11,17,64.7,16,12,28,16,24,19,18,3,88,1
1125,23630,37_04_07,SCOTLAND,0,TOTALS,SCOTLAND,200,32,59,54.2,26,47,55.3,6,12,50.0,15,27,55.6,12,24,36,16,18,30,13,0,85,0
1126,23643,37_04_08,GIBRALTAR,0,TOTALS,GIBRALTAR,200,13,66,19.7,13,60,21.7,0,6,0.0,12,18,66.7,17,23,40,3,28,28,18,6,38,0
1127,23656,37_04_08,WALES,0,TOTALS,WALES,200,20,67,29.9,20,60,33.3,0,7,0.0,13,36,36.1,29,32,61,4,19,31,14,7,53,1
1128,23669,37_04_09,SCOTLAND,0,TOTALS,SCOTLAND,200,39,88,44.3,33,66,50.0,6,22,27.3,18,30,60.0,25,30,55,10,9,16,24,9,102,0
1129,23682,37_04_09,GIBRALTAR,0,TOTALS,GIBRALTAR,200,5,44,11.4,5,36,13.9,0,8,0.0,2,6,33.3,7,25,32,2,20,42,8,0,12,1
1130,23692,37_04_10,ANDORRA,0,TOTALS,ANDORRA,200,29,61,47.5,27,55,49.1,2,6,33.3,23,39,59.0,12,23,35,7,19,30,19,0,83,1
1131,23705,37_04_10,LUXEMBOURG,0,TOTALS,LUXEMBOURG,200,29,70,41.4,23,45,51.1,6,25,24.0,10,14,71.4,6,28,34,5,35,28,18,1,74,0
1132,27279,42_05_01,PUERTO RICO,0,TOTALS,PUERTO RICO,200,27,59,45.8,23,44,52.3,4,15,26.7,15,25,60.0,6,20,26,1,32,12,9,2,73,0
1133,27292,42_05_01,LITHUANIA,0,TOTALS,LITHUANIA,200,25,53,47.2,19,36,52.8,6,17,35.3,26,45,57.8,12,24,36,12,20,12,5,3,82,1
1134,27305,42_05_02,ARGENTINA,0,TOTALS,ARGENTINA,200,30,45,66.7,20,32,62.5,10,13,76.9,18,26,69.2,7,19,26,14,16,12,5,1,88,1
1135,27318,42_05_02,AUSTRALIA,0,TOTALS,AUSTRALIA,200,22,56,39.3,18,40,45.0,4,16,25.0,9,14,64.3,8,9,17,7,25,10,6,2,57,0
1136,27331,42_05_03,CHINA,0,TOTALS,CHINA,200,20,48,41.7,14,28,50.0,6,20,30.0,16,20,80.0,8,23,31,8,20,14,7,5,62,1
1137,27344,42_05_03,ANGOLA,0,TOTALS,ANGOLA,200,18,56,32.1,7,26,26.9,11,30,36.7,14,18,77.8,11,11,22,9,19,9,7,1,61,0
1138,27357,42_05_04,ARGENTINA,0,TOTALS,ARGENTINA,200,31,53,58.5,23,41,56.1,8,12,66.7,13,26,50.0,6,20,26,14,21,12,11,1,83,1
1139,27370,42_05_04,ANGOLA,0,TOTALS,ANGOLA,200,22,52,42.3,15,31,48.4,7,21,33.3,13,18,72.2,5,15,20,11,26,15,5,0,64,0
1140,27383,42_05_05,CHINA,0,TOTALS,CHINA,200,25,58,43.1,24,46,52.2,1,12,8.3,15,23,65.2,6,16,22,8,29,9,9,2,66,0
1141,27396,42_05_05,LITHUANIA,0,TOTALS,LITHUANIA,200,20,45,44.4,18,36,50.0,2,9,22.2,26,35,74.3,9,22,31,9,24,13,4,2,68,1
1142,27409,42_05_06,PUERTO RICO,0,TOTALS,PUERTO RICO,200,25,62,40.3,19,38,50.0,6,24,25.0,22,30,73.3,11,20,31,10,28,14,3,0,78,1
1143,27422,42_05_06,AUSTRALIA,0,TOTALS,AUSTRALIA,200,36,68,52.9,26,45,57.8,10,23,43.5,24,35,68.6,14,23,37,19,22,9,6,0,106,0
1144,27435,42_05_07,ARGENTINA,0,TOTALS,ARGENTINA,200,22,47,46.8,12,23,52.2,10,24,41.7,23,30,76.7,9,20,29,11,29,14,9,2,77,0
1145,27448,42_05_07,LITHUANIA,0,TOTALS,LITHUANIA,200,23,49,46.9,13,30,43.3,10,19,52.6,27,36,75.0,3,13,16,7,26,15,4,1,83,1
1146,27461,42_05_08,CHINA,0,TOTALS,CHINA,200,32,62,51.6,23,41,56.1,9,21,42.9,18,21,85.7,12,22,34,14,19,16,0,3,91,1
1147,27474,42_05_08,PUERTO RICO,0,TOTALS,PUERTO RICO,200,32,70,45.7,24,51,47.1,8,19,42.1,8,17,47.1,11,18,29,11,18,10,9,0,80,0
1148,27487,42_05_09,AUSTRALIA,0,TOTALS,AUSTRALIA,200,16,39,41.0,13,25,52.0,3,14,21.4,14,22,63.6,7,13,20,8,13,15,5,0,49,0
1149,27500,42_05_09,ANGOLA,0,TOTALS,ANGOLA,200,21,42,50.0,12,22,54.5,9,20,45.0,11,12,91.7,4,9,13,10,20,10,8,3,62,1
1150,27513,42_05_10,AUSTRALIA,0,TOTALS,AUSTRALIA,200,36,63,57.1,20,39,51.3,16,24,66.7,21,31,67.7,12,20,32,12,26,20,13,2,109,0
1151,27526,42_05_10,LITHUANIA,0,TOTALS,LITHUANIA,200,32,63,50.8,23,39,59.0,9,24,37.5,23,35,65.7,10,13,23,16,25,20,9,4,96,1
1152,27539,42_05_11,ANGOLA,0,TOTALS,ANGOLA,200,32,64,50.0,20,41,48.8,12,23,52.2,14,16,87.5,7,22,29,14,22,15,3,1,90,1
1153,27552,42_05_11,PUERTO RICO,0,TOTALS,PUERTO RICO,200,24,60,40.0,17,36,47.2,7,24,29.2,18,29,62.1,9,19,28,7,14,11,9,1,73,0
1154,27565,42_05_12,CHINA,0,TOTALS,CHINA,200,19,40,47.5,12,23,52.2,7,17,41.2,21,32,65.6,5,17,22,8,19,18,5,3,66,0
1155,27578,42_05_12,ARGENTINA,0,TOTALS,ARGENTINA,200,29,61,47.5,17,39,43.6,12,22,54.5,16,24,66.7,11,18,29,14,24,14,7,1,86,1
1156,27591,42_05_13,ANGOLA,0,TOTALS,ANGOLA,200,21,60,35.0,16,35,45.7,5,25,20.0,26,33,78.8,17,19,36,9,32,13,6,2,73,0
1157,27604,42_05_13,LITHUANIA,0,TOTALS,LITHUANIA,200,24,54,44.4,22,41,53.7,2,13,15.4,27,37,73.0,8,15,23,13,26,10,5,3,77,1
1158,27617,42_05_14,ARGENTINA,0,TOTALS,ARGENTINA,200,32,55,58.2,22,32,68.8,10,23,43.5,12,17,70.6,3,21,24,16,21,9,5,0,86,1
1159,27630,42_05_14,PUERTO RICO,0,TOTALS,PUERTO RICO,200,29,65,44.6,21,47,44.7,8,18,44.4,13,24,54.2,8,18,26,15,17,12,6,0,79,0
1160,27643,42_05_15,CHINA,0,TOTALS,CHINA,200,17,51,33.3,6,21,28.6,11,30,36.7,13,17,76.5,6,21,27,11,21,19,4,2,58,0
1161,27656,42_05_15,AUSTRALIA,0,TOTALS,AUSTRALIA,200,22,59,37.3,14,36,38.9,8,23,34.8,19,21,90.5,9,21,30,12,15,14,8,3,71,1
1162,27665,43_05_01,SLOVENIA,0,TOTALS,SLOVENIA,200,15,42,35.7,12,29,41.4,3,13,23.1,30,40,75.0,6,21,27,8,24,25,10,0,63,1
1163,27677,43_05_01,NIGERIA,0,TOTALS,NIGERIA,200,20,55,36.4,15,33,45.5,5,22,22.7,9,19,47.4,13,21,34,6,38,27,13,0,54,0
1164,27690,43_05_02,CHINA,0,TOTALS,CHINA,200,18,60,30.0,12,37,32.4,6,23,26.1,8,12,66.7,8,18,26,9,26,32,7,3,50,1
1165,27703,43_05_02,USA,0,TOTALS,USA,200,42,78,53.8,28,47,59.6,14,31,45.2,19,28,67.9,12,29,41,22,15,15,21,4,117,0
1166,27715,43_05_03,AUSTRALIA,0,TOTALS,AUSTRALIA,200,29,56,51.8,18,39,46.2,11,17,64.7,25,38,65.8,10,21,31,17,27,20,12,4,94,1
1167,27728,43_05_03,GREECE,0,TOTALS,GREECE,200,27,57,47.4,23,47,48.9,4,10,40.0,23,31,74.2,9,19,28,11,26,21,8,8,81,0
1168,27741,43_05_04,LITHUANIA,0,TOTALS,LITHUANIA,200,30,71,42.3,27,49,55.1,3,22,13.6,34,48,70.8,16,32,48,15,31,17,6,0,97,1
1169,27754,43_05_04,PUERTO RICO,0,TOTALS,PUERTO RICO,200,26,72,36.1,19,49,38.8,7,23,30.4,22,34,64.7,12,21,33,7,38,15,9,6,81,0
1170,27766,43_05_05,ISRAEL,0,TOTALS,ISRAEL,200,20,49,40.8,15,33,45.5,5,16,31.2,13,22,59.1,6,19,25,12,20,18,5,2,58,0
1171,27779,43_05_05,ARGENTINA,0,TOTALS,ARGENTINA,200,26,62,41.9,18,40,45.0,8,22,36.4,11,15,73.3,13,21,34,13,21,15,8,3,71,1
1172,27791,43_05_06,NIGERIA,0,TOTALS,NIGERIA,200,26,73,35.6,20,55,36.4,6,18,33.3,29,36,80.6,27,19,46,11,22,11,7,0,87,1
1173,27804,43_05_06,CHINA,0,TOTALS,CHINA,200,28,62,45.2,16,33,48.5,12,29,41.4,13,19,68.4,12,15,27,9,29,15,4,6,81,0
1174,27817,43_05_07,USA,0,TOTALS,USA,200,42,82,51.2,32,56,57.1,10,26,38.5,9,12,75.0,16,17,33,12,27,9,18,4,103,0
1175,27830,43_05_07,LITHUANIA,0,TOTALS,LITHUANIA,200,28,54,51.9,19,34,55.9,9,20,45.0,18,32,56.2,11,20,31,20,17,25,3,6,83,1
1176,27843,43_05_08,PUERTO RICO,0,TOTALS,PUERTO RICO,200,30,70,42.9,26,57,45.6,4,13,30.8,7,12,58.3,12,30,42,12,17,16,10,2,71,1
1177,27854,43_05_08,SLOVENIA,0,TOTALS,SLOVENIA,200,19,65,29.2,15,45,33.3,4,20,20.0,8,18,44.4,15,18,33,9,19,13,7,1,50,0
1178,27867,43_05_09,CANADA,0,TOTALS,CANADA,200,25,66,37.9,20,42,47.6,5,24,20.8,16,27,59.3,10,24,34,12,29,22,8,7,71,0
1179,27879,43_05_09,AUSTRALIA,0,TOTALS,AUSTRALIA,200,29,62,46.8,24,46,52.2,5,16,31.2,25,36,69.4,12,29,41,16,27,24,8,0,88,1
1180,27892,43_05_10,ARGENTINA,0,TOTALS,ARGENTINA,200,19,52,36.5,12,33,36.4,7,19,36.8,14,18,77.8,6,31,37,12,27,23,7,6,59,0
1181,27905,43_05_10,GREECE,0,TOTALS,GREECE,200,19,54,35.2,14,41,34.1,5,13,38.5,20,29,69.0,7,21,28,12,18,17,16,8,63,1
1182,27918,43_05_11,LITHUANIA,0,TOTALS,LITHUANIA,200,39,65,60.0,31,50,62.0,8,15,53.3,24,37,64.9,12,27,39,29,33,20,9,6,110,0
1183,27930,43_05_11,NIGERIA,0,TOTALS,NIGERIA,200,22,67,32.8,16,46,34.8,6,21,28.6,25,43,58.1,18,18,36,7,27,18,9,1,75,1
1184,27943,43_05_12,CHINA,0,TOTALS,CHINA,200,24,60,40.0,17,38,44.7,7,22,31.8,8,9,88.9,11,18,29,10,29,18,13,8,63,0
1185,27954,43_05_12,SLOVENIA,0,TOTALS,SLOVENIA,200,19,45,42.2,16,36,44.4,3,9,33.3,25,30,83.3,9,22,31,6,18,27,8,1,66,1
1186,27967,43_05_13,GREECE,0,TOTALS,GREECE,200,30,61,49.2,22,44,50.0,8,17,47.1,11,17,64.7,7,23,30,18,20,15,10,4,79,1
1187,27979,43_05_13,ISRAEL,0,TOTALS,ISRAEL,200,32,61,52.5,31,54,57.4,1,7,14.3,10,17,58.8,9,20,29,12,20,16,8,1,75,0
1188,27992,43_05_14,USA,0,TOTALS,USA,200,31,74,41.9,20,51,39.2,11,23,47.8,21,30,70.0,16,31,47,18,23,12,9,4,94,1
1189,28005,43_05_14,PUERTO RICO,0,TOTALS,PUERTO RICO,200,30,76,39.5,26,55,47.3,4,21,19.0,15,26,57.7,13,29,42,18,21,16,5,4,79,0
1190,28018,43_05_15,ARGENTINA,0,TOTALS,ARGENTINA,200,30,52,57.7,23,40,57.5,7,12,58.3,19,26,73.1,9,27,36,13,22,19,8,7,86,1
1191,28031,43_05_15,CANADA,0,TOTALS,CANADA,200,12,63,19.0,10,46,21.7,2,17,11.8,20,27,74.1,16,13,29,5,29,16,6,7,46,0
1192,28039,43_05_16,SLOVENIA,0,TOTALS,SLOVENIA,200,29,57,50.9,22,39,56.4,7,18,38.9,9,14,64.3,7,8,15,11,19,13,5,2,74,0
1193,28050,43_05_16,LITHUANIA,0,TOTALS,LITHUANIA,200,36,57,63.2,29,42,69.0,7,15,46.7,13,16,81.2,10,19,29,27,20,15,8,3,92,1
1194,28063,43_05_17,NIGERIA,0,TOTALS,NIGERIA,200,35,85,41.2,31,64,48.4,4,21,19.0,4,5,80.0,12,27,39,11,13,20,8,5,78,1
1195,28076,43_05_17,USA,0,TOTALS,USA,200,47,93,50.5,35,58,60.3,12,35,34.3,7,13,53.8,20,31,51,24,9,14,14,8,113,0
1196,28088,43_05_18,AUSTRALIA,0,TOTALS,AUSTRALIA,200,35,72,48.6,24,45,53.3,11,27,40.7,24,26,92.3,19,19,38,19,24,17,5,2,105,1
1197,28098,43_05_18,ISRAEL,0,TOTALS,ISRAEL,200,35,64,54.7,26,45,57.8,9,19,47.4,25,33,75.8,7,18,25,17,25,12,9,2,104,0
1198,28111,43_05_19,PUERTO RICO,0,TOTALS,PUERTO RICO,200,34,71,47.9,25,47,53.2,9,24,37.5,24,35,68.6,13,33,46,19,11,12,12,2,101,0
1199,28122,43_05_19,CHINA,0,TOTALS,CHINA,200,24,66,36.4,15,39,38.5,9,27,33.3,8,9,88.9,5,22,27,9,30,18,6,1,65,1
1200,28133,43_05_20,GREECE,0,TOTALS,GREECE,200,24,51,47.1,22,39,56.4,2,12,16.7,12,15,80.0,7,19,26,11,16,18,14,5,62,1
1201,28144,43_05_20,CANADA,0,TOTALS,CANADA,200,21,64,32.8,14,42,33.3,7,22,31.8,4,4,100.0,15,17,32,11,16,23,5,5,53,0
1202,28157,43_05_21,USA,0,TOTALS,USA,200,34,84,40.5,31,62,50.0,3,22,13.6,11,16,68.8,22,17,39,11,25,17,25,3,82,1
1203,28168,43_05_21,SLOVENIA,0,TOTALS,SLOVENIA,200,26,53,49.1,20,38,52.6,6,15,40.0,21,29,72.4,7,24,31,13,18,30,9,3,79,0
1204,28181,43_05_22,LITHUANIA,0,TOTALS,LITHUANIA,200,32,66,48.5,22,39,56.4,10,27,37.0,22,31,71.0,14,28,42,13,23,20,10,1,96,1
1205,28193,43_05_22,CHINA,0,TOTALS,CHINA,200,26,66,39.4,15,33,45.5,11,33,33.3,12,14,85.7,4,20,24,11,24,16,11,2,75,0
1206,28204,43_05_23,ISRAEL,0,TOTALS,ISRAEL,200,21,59,35.6,13,42,31.0,8,17,47.1,16,21,76.2,10,24,34,9,13,17,6,3,66,0
1207,28216,43_05_23,CANADA,0,TOTALS,CANADA,200,31,69,44.9,20,45,44.4,11,24,45.8,5,10,50.0,14,25,39,13,19,14,7,5,78,1
1208,28226,43_05_24,NIGERIA,0,TOTALS,NIGERIA,200,31,80,38.8,25,57,43.9,6,23,26.1,4,6,66.7,15,14,29,14,23,18,15,2,72,0
1209,28239,43_05_24,PUERTO RICO,0,TOTALS,PUERTO RICO,200,32,58,55.2,23,36,63.9,9,22,40.9,17,24,70.8,9,28,37,16,10,28,8,2,90,1
1210,28251,43_05_25,ARGENTINA,0,TOTALS,ARGENTINA,200,25,65,38.5,21,48,43.8,4,17,23.5,22,27,81.5,7,23,30,7,27,15,5,10,76,0
1211,28263,43_05_25,AUSTRALIA,0,TOTALS,AUSTRALIA,200,27,69,39.1,19,45,42.2,8,24,33.3,20,25,80.0,17,28,45,12,28,20,6,4,82,1
1212,28276,43_05_26,ISRAEL,0,TOTALS,ISRAEL,200,37,73,50.7,33,61,54.1,4,12,33.3,17,22,77.3,17,28,45,21,20,13,10,4,95,1
1213,28287,43_05_26,CHINA,0,TOTALS,CHINA,200,25,63,39.7,13,31,41.9,12,32,37.5,12,20,60.0,9,16,25,9,22,12,7,4,74,0
1214,28298,43_05_27,USA,0,TOTALS,USA,225,31,82,37.8,23,57,40.4,8,25,32.0,20,25,80.0,15,20,35,13,28,11,13,5,90,0
1215,28309,43_05_27,CANADA,0,TOTALS,CANADA,225,35,74,47.3,28,47,59.6,7,27,25.9,16,27,59.3,16,31,47,19,23,22,3,1,93,1
1216,28321,43_05_28,GREECE,0,TOTALS,GREECE,200,33,68,48.5,27,48,56.2,6,20,30.0,16,21,76.2,8,28,36,18,23,13,12,9,88,1
1217,28334,43_05_28,PUERTO RICO,0,TOTALS,PUERTO RICO,200,19,69,27.5,14,48,29.2,5,21,23.8,20,25,80.0,12,26,38,5,22,17,4,0,63,0
1218,28346,43_05_29,AUSTRALIA,0,TOTALS,AUSTRALIA,225,34,65,52.3,30,53,56.6,4,12,33.3,17,23,73.9,13,29,42,16,19,20,9,1,89,1
1219,28355,43_05_29,SLOVENIA,0,TOTALS,SLOVENIA,225,26,73,35.6,16,44,36.4,10,29,34.5,18,21,85.7,14,13,27,8,25,11,9,5,80,0
1220,28367,43_05_30,LITHUANIA,0,TOTALS,LITHUANIA,200,28,71,39.4,21,44,47.7,7,27,25.9,13,20,65.0,10,22,32,17,22,10,12,0,76,1
1221,28378,43_05_30,ARGENTINA,0,TOTALS,ARGENTINA,200,20,50,40.0,13,28,46.4,7,22,31.8,16,22,72.7,4,29,33,12,26,24,4,5,63,0
1222,28389,43_05_31,NIGERIA,0,TOTALS,NIGERIA,225,38,71,53.5,33,54,61.1,5,17,29.4,29,41,70.7,14,30,44,16,22,14,7,2,110,1
1223,28400,43_05_31,ISRAEL,0,TOTALS,ISRAEL,225,36,76,47.4,24,47,51.1,12,29,41.4,20,27,74.1,8,22,30,18,30,10,8,3,104,0
1224,28413,43_05_32,PUERTO RICO,0,TOTALS,PUERTO RICO,200,32,79,40.5,29,62,46.8,3,17,17.6,12,25,48.0,13,32,45,14,18,16,2,4,79,0
1225,28426,43_05_32,USA,0,TOTALS,USA,200,35,88,39.8,25,61,41.0,10,27,37.0,19,25,76.0,19,34,53,20,20,13,11,2,99,1
1226,28438,43_05_33,GREECE,0,TOTALS,GREECE,200,24,56,42.9,22,42,52.4,2,14,14.3,24,30,80.0,12,21,33,13,21,14,11,6,74,1
1227,28451,43_05_33,CANADA,0,TOTALS,CANADA,200,19,61,31.1,13,33,39.4,6,28,21.4,17,18,94.4,12,13,25,10,23,18,8,2,61,0
1228,28463,43_05_34,LITHUANIA,0,TOTALS,LITHUANIA,200,36,74,48.6,30,53,56.6,6,21,28.6,18,24,75.0,16,26,42,18,20,13,9,7,96,1
1229,28475,43_05_34,AUSTRALIA,0,TOTALS,AUSTRALIA,200,29,74,39.2,20,50,40.0,9,24,37.5,6,14,42.9,17,21,38,10,25,18,6,2,73,0
1230,28487,43_05_35,ARGENTINA,0,TOTALS,ARGENTINA,200,28,53,52.8,16,29,55.2,12,24,50.0,2,5,40.0,9,27,36,20,19,13,5,5,70,1
1231,28498,43_05_35,SLOVENIA,0,TOTALS,SLOVENIA,200,15,51,29.4,11,36,30.6,4,15,26.7,9,17,52.9,9,16,25,6,14,12,6,1,43,0
1232,28506,43_05_36,SLOVENIA,0,TOTALS,SLOVENIA,200,28,67,41.8,22,49,44.9,6,18,33.3,15,17,88.2,2,14,16,13,21,11,14,1,77,0
1233,28519,43_05_36,PUERTO RICO,0,TOTALS,PUERTO RICO,200,34,56,60.7,28,40,70.0,6,16,37.5,12,18,66.7,5,36,41,15,18,24,6,0,86,1
1234,28531,43_05_37,ARGENTINA,0,TOTALS,ARGENTINA,200,28,68,41.2,24,48,50.0,4,20,20.0,25,33,75.8,9,20,29,13,31,19,11,2,85,1
1235,28544,43_05_37,USA,0,TOTALS,USA,200,36,71,50.7,25,41,61.0,11,30,36.7,28,39,71.8,12,31,43,20,30,17,10,1,111,0
1236,28556,43_05_38,AUSTRALIA,0,TOTALS,AUSTRALIA,200,26,64,40.6,22,44,50.0,4,20,20.0,18,25,72.0,13,21,34,10,16,15,13,3,74,0
1237,28568,43_05_38,CANADA,0,TOTALS,CANADA,200,28,70,40.0,21,48,43.8,7,22,31.8,16,19,84.2,15,25,40,8,19,15,9,3,79,1
1238,28579,43_05_39,LITHUANIA,0,TOTALS,LITHUANIA,200,21,60,35.0,13,36,36.1,8,24,33.3,15,21,71.4,13,25,38,10,22,16,8,6,65,1
1239,28590,43_05_39,GREECE,0,TOTALS,GREECE,200,22,54,40.7,17,41,41.5,5,13,38.5,14,18,77.8,6,24,30,12,24,18,12,10,63,0
1240,29747,45_05_01,SOUTH AFRICA,0,TOTALS,SOUTH AFRICA,200,13,57,22.8,10,36,27.8,3,21,14.3,13,25,52.0,17,20,37,6,21,20,6,0,42,1
1241,29760,45_05_01,ANGOLA,0,TOTALS,ANGOLA,200,38,73,52.1,23,37,62.2,15,36,41.7,16,24,66.7,14,31,45,20,24,6,13,5,107,0
1242,29773,45_05_02,MOROCCO,0,TOTALS,MOROCCO,200,19,49,38.8,16,41,39.0,3,8,37.5,19,31,61.3,6,30,36,5,10,19,5,0,60,0
1243,29786,45_05_02,SENEGAL,0,TOTALS,SENEGAL,200,27,68,39.7,18,38,47.4,9,30,30.0,7,10,70.0,16,28,44,11,19,17,9,3,70,1
1244,29799,45_05_03,MALI,0,TOTALS,MALI,200,21,51,41.2,15,31,48.4,6,20,30.0,13,22,59.1,12,24,36,8,26,21,1,1,61,0
1245,29812,45_05_03,TUNISIA,0,TOTALS,TUNISIA,200,28,64,43.8,23,47,48.9,5,17,29.4,19,27,70.4,12,17,29,12,22,9,7,0,80,1
1246,29823,45_05_04,MOZAMBIQUE,0,TOTALS,MOZAMBIQUE,200,17,62,27.4,11,41,26.8,6,21,28.6,10,31,32.3,13,20,33,9,19,24,16,2,50,0
1247,29836,45_05_04,CAF,0,TOTALS,CAF,200,22,63,34.9,17,41,41.5,5,22,22.7,16,28,57.1,20,37,57,14,23,29,8,3,65,1
1248,29849,45_05_05,NIGERIA,0,TOTALS,NIGERIA,200,29,55,52.7,18,33,54.5,11,22,50.0,18,28,64.3,8,43,51,14,28,25,8,0,87,1
1249,29862,45_05_05,COTE D'IVOIRE,0,TOTALS,COTE D'IVOIRE,200,17,74,23.0,13,48,27.1,4,26,15.4,18,28,64.3,19,15,34,4,23,16,9,1,56,0
1250,29875,45_05_06,ALGERIA,0,TOTALS,ALGERIA,200,29,70,41.4,17,42,40.5,12,28,42.9,10,20,50.0,14,22,36,17,23,20,12,2,80,1
1251,29888,45_05_06,GABON,0,TOTALS,GABON,200,16,61,26.2,13,43,30.2,3,18,16.7,17,32,53.1,23,29,52,8,19,30,14,4,52,0
1252,29901,45_05_07,GABON,0,TOTALS,GABON,200,20,55,36.4,14,36,38.9,6,19,31.6,19,40,47.5,7,18,25,7,32,20,7,4,65,0
1253,29914,45_05_07,COTE D'IVOIRE,0,TOTALS,COTE D'IVOIRE,200,22,51,43.1,15,34,44.1,7,17,41.2,23,35,65.7,13,22,35,9,26,16,3,2,74,1
1254,29927,45_05_08,SOUTH AFRICA,0,TOTALS,SOUTH AFRICA,200,21,60,35.0,15,42,35.7,6,18,33.3,17,19,89.5,8,32,40,12,20,18,6,0,65,0
1255,29940,45_05_08,CAF,0,TOTALS,CAF,200,24,79,30.4,20,48,41.7,4,31,12.9,14,21,66.7,18,26,44,7,21,14,9,3,66,1
1256,29953,45_05_09,MALI,0,TOTALS,MALI,200,26,58,44.8,20,36,55.6,6,22,27.3,19,29,65.5,11,21,32,9,26,12,10,4,77,0
1257,29966,45_05_09,NIGERIA,0,TOTALS,NIGERIA,200,30,61,49.2,27,45,60.0,3,16,18.8,20,33,60.6,7,22,29,10,21,7,3,1,83,1
1258,29979,45_05_10,MOROCCO,0,TOTALS,MOROCCO,200,25,60,41.7,21,40,52.5,4,20,20.0,15,27,55.6,13,24,37,9,22,27,13,4,69,1
1259,29990,45_05_10,MOZAMBIQUE,0,TOTALS,MOZAMBIQUE,200,23,62,37.1,18,39,46.2,5,23,21.7,14,22,63.6,17,26,43,10,24,24,12,6,65,0
1260,30003,45_05_11,ALGERIA,0,TOTALS,ALGERIA,200,28,68,41.2,17,34,50.0,11,34,32.4,17,24,70.8,11,27,38,18,26,15,8,1,84,1
1261,30016,45_05_11,TUNISIA,0,TOTALS,TUNISIA,200,21,54,38.9,18,35,51.4,3,19,15.8,27,37,73.0,10,32,42,6,25,17,7,0,72,0
1262,30029,45_05_12,ANGOLA,0,TOTALS,ANGOLA,200,25,58,43.1,16,30,53.3,9,28,32.1,8,11,72.7,9,26,35,15,17,18,10,1,67,1
1263,30042,45_05_12,SENEGAL,0,TOTALS,SENEGAL,200,22,61,36.1,14,40,35.0,8,21,38.1,7,13,53.8,13,20,33,8,13,17,6,4,59,0
1264,30055,45_05_13,MALI,0,TOTALS,MALI,200,24,55,43.6,22,44,50.0,2,11,18.2,24,47,51.1,13,25,38,9,26,22,7,4,74,0
1265,30068,45_05_13,GABON,0,TOTALS,GABON,200,23,55,41.8,16,34,47.1,7,21,33.3,23,39,59.0,8,24,32,9,33,23,6,2,76,1
1266,30081,45_05_14,SOUTH AFRICA,0,TOTALS,SOUTH AFRICA,200,23,71,32.4,20,53,37.7,3,18,16.7,11,18,61.1,20,28,48,11,20,23,8,1,60,0
1267,30094,45_05_14,MOROCCO,0,TOTALS,MOROCCO,200,24,57,42.1,18,39,46.2,6,18,33.3,13,28,46.4,8,29,37,12,20,20,12,7,67,1
1268,30107,45_05_15,TUNISIA,0,TOTALS,TUNISIA,200,21,59,35.6,12,34,35.3,9,25,36.0,14,26,53.8,7,24,31,8,25,12,3,1,65,0
1269,30120,45_05_15,NIGERIA,0,TOTALS,NIGERIA,200,27,66,40.9,21,44,47.7,6,22,27.3,18,30,60.0,10,29,39,13,24,12,6,1,78,1
1270,30133,45_05_16,CAF,0,TOTALS,CAF,200,17,53,32.1,13,41,31.7,4,12,33.3,8,25,32.0,9,27,36,7,14,21,9,4,46,0
1271,30146,45_05_16,ANGOLA,0,TOTALS,ANGOLA,200,31,68,45.6,24,48,50.0,7,20,35.0,8,15,53.3,15,35,50,17,18,17,11,4,77,1
1272,30159,45_05_17,ALGERIA,0,TOTALS,ALGERIA,200,26,65,40.0,18,38,47.4,8,27,29.6,11,17,64.7,15,28,43,17,21,21,12,0,71,1
1273,30172,45_05_17,COTE D'IVOIRE,0,TOTALS,COTE D'IVOIRE,200,23,60,38.3,16,35,45.7,7,25,28.0,5,11,45.5,12,25,37,9,22,24,8,3,58,0
1274,30185,45_05_18,SENEGAL,0,TOTALS,SENEGAL,200,32,67,47.8,26,39,66.7,6,28,21.4,9,13,69.2,16,40,56,20,13,24,13,4,79,1
1275,30196,45_05_18,MOZAMBIQUE,0,TOTALS,MOZAMBIQUE,200,17,60,28.3,8,28,28.6,9,32,28.1,4,10,40.0,6,19,25,7,12,18,10,1,47,0
1276,30209,45_05_19,COTE D'IVOIRE,0,TOTALS,COTE D'IVOIRE,200,22,72,30.6,11,38,28.9,11,34,32.4,16,23,69.6,16,23,39,13,23,21,11,0,71,0
1277,30222,45_05_19,MALI,0,TOTALS,MALI,200,31,58,53.4,24,43,55.8,7,15,46.7,18,31,58.1,10,32,42,12,19,27,11,3,87,1
1278,30235,45_05_20,SENEGAL,0,TOTALS,SENEGAL,200,31,74,41.9,22,40,55.0,9,34,26.5,14,21,66.7,21,32,53,17,20,12,14,5,85,1
1279,30248,45_05_20,SOUTH AFRICA,0,TOTALS,SOUTH AFRICA,200,17,61,27.9,13,43,30.2,4,18,22.2,7,14,50.0,15,23,38,8,17,26,2,1,45,0
1280,30261,45_05_21,TUNISIA,0,TOTALS,TUNISIA,200,24,51,47.1,21,35,60.0,3,16,18.8,22,36,61.1,4,34,38,8,17,23,5,2,73,1
1281,30274,45_05_21,GABON,0,TOTALS,GABON,200,26,74,35.1,24,52,46.2,2,22,9.1,11,19,57.9,18,26,44,12,27,17,12,4,65,0
1282,30287,45_05_22,ANGOLA,0,TOTALS,ANGOLA,200,39,63,61.9,31,37,83.8,8,26,30.8,14,27,51.9,12,38,50,24,13,16,13,3,100,0
1283,30298,45_05_22,MOZAMBIQUE,0,TOTALS,MOZAMBIQUE,200,14,64,21.9,12,46,26.1,2,18,11.1,7,12,58.3,12,20,32,5,17,19,10,2,37,1
1284,30311,45_05_23,ALGERIA,0,TOTALS,ALGERIA,200,25,64,39.1,15,33,45.5,10,31,32.3,13,20,65.0,13,18,31,16,24,17,10,1,73,1
1285,30324,45_05_23,NIGERIA,0,TOTALS,NIGERIA,200,27,57,47.4,23,41,56.1,4,16,25.0,14,26,53.8,17,31,48,9,23,22,11,1,72,0
1286,30337,45_05_24,CAF,0,TOTALS,CAF,200,22,60,36.7,17,42,40.5,5,18,27.8,11,15,73.3,16,28,44,12,21,27,14,5,60,1
1287,30350,45_05_24,MOROCCO,0,TOTALS,MOROCCO,200,19,64,29.7,17,44,38.6,2,20,10.0,9,24,37.5,20,22,42,8,15,25,11,2,49,0
1288,30363,45_05_25,NIGERIA,0,TOTALS,NIGERIA,200,22,62,35.5,18,39,46.2,4,23,17.4,18,22,81.8,17,27,44,13,24,36,12,4,66,1
1289,30376,45_05_25,GABON,0,TOTALS,GABON,200,17,55,30.9,14,34,41.2,3,21,14.3,20,32,62.5,15,25,40,5,26,32,14,3,57,0
1290,30387,45_05_26,MOZAMBIQUE,0,TOTALS,MOZAMBIQUE,200,18,73,24.7,13,47,27.7,5,26,19.2,18,30,60.0,16,21,37,8,24,8,8,0,59,0
1291,30400,45_05_26,SOUTH AFRICA,0,TOTALS,SOUTH AFRICA,200,31,58,53.4,27,49,55.1,4,9,44.4,14,26,53.8,15,41,56,16,25,27,3,2,80,1
1292,30413,45_05_27,COTE D'IVOIRE,0,TOTALS,COTE D'IVOIRE,200,26,57,45.6,16,37,43.2,10,20,50.0,7,13,53.8,7,19,26,11,20,21,13,1,69,1
1293,30426,45_05_27,TUNISIA,0,TOTALS,TUNISIA,200,24,52,46.2,18,33,54.5,6,19,31.6,11,14,78.6,5,27,32,8,15,22,9,1,65,0
1294,30439,45_05_28,CAF,0,TOTALS,CAF,200,17,67,25.4,13,43,30.2,4,24,16.7,4,10,40.0,21,26,47,4,19,19,14,1,42,0
1295,30452,45_05_28,SENEGAL,0,TOTALS,SENEGAL,200,14,63,22.2,9,37,24.3,5,26,19.2,17,23,73.9,20,33,53,6,13,19,9,5,50,1
1296,30465,45_05_29,ALGERIA,0,TOTALS,ALGERIA,200,26,79,32.9,23,53,43.4,3,26,11.5,11,16,68.8,19,12,31,13,19,13,14,0,66,0
1297,30478,45_05_29,MALI,0,TOTALS,MALI,200,30,45,66.7,26,36,72.2,4,9,44.4,19,28,67.9,6,35,41,12,18,23,8,3,83,1
1298,30491,45_05_30,ANGOLA,0,TOTALS,ANGOLA,200,30,70,42.9,21,41,51.2,9,29,31.0,6,12,50.0,18,33,51,16,17,14,14,2,75,1
1299,30504,45_05_30,MOROCCO,0,TOTALS,MOROCCO,200,17,52,32.7,16,39,41.0,1,13,7.7,8,16,50.0,9,23,32,10,12,20,10,7,43,0
1300,30517,45_05_31,COTE D'IVOIRE,0,TOTALS,COTE D'IVOIRE,200,28,53,52.8,21,33,63.6,7,20,35.0,14,25,56.0,8,25,33,10,20,25,11,3,77,1
1301,30528,45_05_31,MOZAMBIQUE,0,TOTALS,MOZAMBIQUE,200,21,56,37.5,15,28,53.6,6,28,21.4,16,23,69.6,12,24,36,9,23,28,8,1,64,0
1302,30541,45_05_32,CAF,0,TOTALS,CAF,200,15,55,27.3,9,32,28.1,6,23,26.1,15,23,65.2,8,20,28,4,18,19,9,1,51,0
1303,30554,45_05_32,NIGERIA,0,TOTALS,NIGERIA,200,23,56,41.1,17,36,47.2,6,20,30.0,11,23,47.8,14,30,44,14,18,27,9,6,63,1
1304,30567,45_05_33,SOUTH AFRICA,0,TOTALS,SOUTH AFRICA,200,23,69,33.3,17,49,34.7,6,20,30.0,19,27,70.4,18,27,45,11,23,25,10,0,71,0
1305,30580,45_05_33,GABON,0,TOTALS,GABON,200,25,62,40.3,12,31,38.7,13,31,41.9,16,24,66.7,14,29,43,16,27,33,7,11,79,1
1306,30593,45_05_34,TUNISIA,0,TOTALS,TUNISIA,200,20,58,34.5,16,35,45.7,4,23,17.4,23,34,67.6,10,25,35,4,13,14,11,4,67,0
1307,30606,45_05_34,SENEGAL,0,TOTALS,SENEGAL,200,29,72,40.3,21,49,42.9,8,23,34.8,6,14,42.9,21,33,54,17,22,20,8,4,72,1
1308,30619,45_05_35,MALI,0,TOTALS,MALI,200,18,54,33.3,16,44,36.4,2,10,20.0,12,17,70.6,11,21,32,6,19,17,8,4,50,0
1309,30632,45_05_35,ANGOLA,0,TOTALS,ANGOLA,200,24,65,36.9,17,43,39.5,7,22,31.8,12,16,75.0,16,27,43,10,20,13,13,4,67,1
1310,30645,45_05_36,MOROCCO,0,TOTALS,MOROCCO,200,24,51,47.1,22,37,59.5,2,14,14.3,16,28,57.1,6,26,32,8,27,25,10,2,66,0
1311,30658,45_05_36,ALGERIA,0,TOTALS,ALGERIA,200,24,64,37.5,18,42,42.9,6,22,27.3,27,37,73.0,15,29,44,12,22,20,15,2,81,1
1312,30669,45_05_37,MOZAMBIQUE,0,TOTALS,MOZAMBIQUE,200,26,59,44.1,13,32,40.6,13,27,48.1,9,18,50.0,12,26,38,13,23,21,10,4,74,1
1313,30682,45_05_37,SOUTH AFRICA,0,TOTALS,SOUTH AFRICA,200,19,60,31.7,16,40,40.0,3,20,15.0,15,24,62.5,17,28,45,7,16,26,8,3,56,0
1314,30695,45_05_38,MOROCCO,0,TOTALS,MOROCCO,200,30,62,48.4,23,44,52.3,7,18,38.9,16,26,61.5,14,30,44,12,20,19,17,5,83,1
1315,30708,45_05_38,TUNISIA,0,TOTALS,TUNISIA,200,24,63,38.1,18,44,40.9,6,19,31.6,18,25,72.0,12,22,34,11,22,19,5,0,72,0
1316,30721,45_05_39,COTE D'IVOIRE,0,TOTALS,COTE D'IVOIRE,200,23,67,34.3,13,31,41.9,10,36,27.8,9,11,81.8,10,24,34,12,22,19,10,5,65,0
1317,30734,45_05_39,GABON,0,TOTALS,GABON,200,30,68,44.1,19,46,41.3,11,22,50.0,14,23,60.9,14,34,48,12,14,19,5,3,85,1
1318,30747,45_05_40,MALI,0,TOTALS,MALI,200,24,54,44.4,18,39,46.2,6,15,40.0,10,20,50.0,13,26,39,12,17,28,4,2,64,0
1319,30760,45_05_40,CAF,0,TOTALS,CAF,200,26,59,44.1,22,44,50.0,4,15,26.7,12,20,60.0,10,22,32,10,20,14,13,2,68,1
1320,30773,45_05_41,ANGOLA,0,TOTALS,ANGOLA,200,20,53,37.7,11,29,37.9,9,24,37.5,18,29,62.1,12,22,34,13,22,18,10,3,67,1
1321,30786,45_05_41,NIGERIA,0,TOTALS,NIGERIA,200,19,52,36.5,12,30,40.0,7,22,31.8,17,25,68.0,11,22,33,6,23,18,12,6,62,0
1322,30799,45_05_42,ALGERIA,0,TOTALS,ALGERIA,200,19,67,28.4,14,35,40.0,5,32,15.6,5,13,38.5,12,23,35,10,14,19,10,2,48,0
1323,30812,45_05_42,SENEGAL,0,TOTALS,SENEGAL,200,28,64,43.8,16,33,48.5,12,31,38.7,12,14,85.7,14,37,51,17,13,21,11,4,80,1
1324,30825,45_05_43,TUNISIA,0,TOTALS,TUNISIA,200,32,80,40.0,17,45,37.8,15,35,42.9,10,14,71.4,13,12,25,17,18,9,7,4,89,1
1325,30838,45_05_43,MALI,0,TOTALS,MALI,200,38,66,57.6,29,45,64.4,9,21,42.9,15,28,53.6,14,31,45,14,18,17,6,6,100,0
1326,30851,45_05_44,MOROCCO,0,TOTALS,MOROCCO,200,23,62,37.1,23,48,47.9,0,14,0.0,14,23,60.9,9,18,27,5,19,13,10,1,60,0
1327,30864,45_05_44,CAF,0,TOTALS,CAF,200,32,60,53.3,29,51,56.9,3,9,33.3,19,24,79.2,8,32,40,11,23,14,5,2,86,1
1328,30877,45_05_45,ALGERIA,0,TOTALS,ALGERIA,200,25,66,37.9,20,38,52.6,5,28,17.9,21,27,77.8,13,26,39,9,18,18,10,1,76,0
1329,30890,45_05_45,NIGERIA,0,TOTALS,NIGERIA,200,32,69,46.4,22,46,47.8,10,23,43.5,14,20,70.0,10,31,41,17,24,16,15,1,88,1
1330,30903,45_05_46,SENEGAL,0,TOTALS,SENEGAL,200,25,55,45.5,19,30,63.3,6,25,24.0,5,11,45.5,5,30,35,9,15,14,5,3,61,0
1331,30916,45_05_46,ANGOLA,0,TOTALS,ANGOLA,200,24,62,38.7,13,34,38.2,11,28,39.3,11,19,57.9,12,26,38,13,13,11,5,2,70,1
1332,30929,46_05_01,GABON,0,TOTALS,GABON,200,23,73,31.5,18,41,43.9,5,32,15.6,6,14,42.9,16,17,33,10,22,9,1,2,57,0
1333,30942,46_05_01,CAF,0,TOTALS,CAF,200,27,58,46.6,24,44,54.5,3,14,21.4,15,23,65.2,5,11,16,19,15,4,7,3,72,1
1334,30955,46_05_02,CAF,0,TOTALS,CAF,200,22,63,34.9,13,35,37.1,9,28,32.1,11,25,44.0,15,21,36,34,13,22,8,6,64,1
1335,30967,46_05_02,DEM.REP. OF CONGO,0,TOTALS,DEM.REP. OF CONGO,200,20,53,37.7,16,35,45.7,4,18,22.2,11,17,64.7,5,18,23,9,19,33,5,14,55,0
1336,30979,46_05_03,DEM.REP. OF CONGO,0,TOTALS,DEM.REP. OF CONGO,200,20,65,30.8,16,41,39.0,4,24,16.7,8,28,28.6,14,23,37,12,18,12,20,3,52,0
1337,30992,46_05_03,GABON,0,TOTALS,GABON,200,24,56,42.9,12,24,50.0,12,32,37.5,12,26,46.2,12,34,46,12,19,16,3,0,72,1
1338,31004,46_05_04,DEM.REP. OF CONGO,0,TOTALS,DEM.REP. OF CONGO,200,13,47,27.7,10,32,31.2,3,15,20.0,13,24,54.2,9,17,26,9,26,17,4,1,42,0
1339,31017,46_05_04,CAF,0,TOTALS,CAF,200,18,46,39.1,13,24,54.2,5,22,22.7,21,38,55.3,20,27,47,17,19,11,3,5,62,1
1340,31030,46_05_05,GABON,0,TOTALS,GABON,200,30,70,42.9,23,43,53.5,7,27,25.9,20,37,54.1,16,26,42,18,19,12,5,5,87,1
1341,31042,46_05_05,DEM.REP. OF CONGO,0,TOTALS,DEM.REP. OF CONGO,200,25,76,32.9,15,54,27.8,10,22,45.5,14,28,50.0,9,25,34,15,31,9,1,0,74,0
1342,31055,46_05_06,MOROCCO,0,TOTALS,MOROCCO,200,24,56,42.9,22,40,55.0,2,16,12.5,11,22,50.0,8,13,21,1,24,26,11,1,61,0
1343,31068,46_05_06,TUNISIA,0,TOTALS,TUNISIA,200,27,63,42.9,23,38,60.5,4,25,16.0,12,24,50.0,4,6,10,3,23,19,4,0,70,1
1344,31081,46_05_07,CAF,0,TOTALS,CAF,200,27,42,64.3,21,29,72.4,6,13,46.2,11,18,61.1,15,28,43,20,22,15,1,5,71,1
1345,31094,46_05_07,GABON,0,TOTALS,GABON,200,18,54,33.3,16,29,55.2,2,25,8.0,16,31,51.6,11,14,25,11,18,21,1,3,54,0
1346,31107,46_05_08,TUNISIA,0,TOTALS,TUNISIA,200,26,59,44.1,18,42,42.9,8,17,47.1,21,32,65.6,0,14,14,7,17,12,2,3,81,1
1347,31120,46_05_08,LIBYA,0,TOTALS,LIBYA,200,26,67,38.8,20,39,51.3,6,28,21.4,10,19,52.6,10,17,27,6,26,21,9,1,68,0
1348,31133,46_05_09,BOTSWANA,0,TOTALS,BOTSWANA,200,12,46,26.1,12,42,28.6,0,4,0.0,9,14,64.3,4,19,23,3,25,20,7,0,33,0
1349,31145,46_05_09,MOZAMBIQUE,0,TOTALS,MOZAMBIQUE,200,31,71,43.7,20,42,47.6,11,29,37.9,17,33,51.5,20,49,69,10,14,18,9,0,90,1
1350,31158,46_05_10,ZAMBIA,0,TOTALS,ZAMBIA,200,29,71,40.8,28,53,52.8,1,18,5.6,7,13,53.8,9,21,30,5,25,17,8,2,66,0
1351,31171,46_05_10,SOUTH AFRICA,0,TOTALS,SOUTH AFRICA,200,27,60,45.0,23,48,47.9,4,12,33.3,16,34,47.1,15,28,43,7,16,20,10,0,74,1
1352,31184,46_05_11,LIBYA,0,TOTALS,LIBYA,200,21,45,46.7,16,25,64.0,5,20,25.0,12,24,50.0,2,19,21,6,23,28,3,0,59,0
1353,31197,46_05_11,MOROCCO,0,TOTALS,MOROCCO,200,23,66,34.8,20,40,50.0,3,26,11.5,22,32,68.8,9,17,26,4,23,9,11,10,71,1
1354,31209,46_05_12,LESOTHO,0,TOTALS,LESOTHO,200,22,59,37.3,17,30,56.7,5,29,17.2,6,18,33.3,7,14,21,0,24,25,13,1,55,0
1355,31222,46_05_12,SOUTH AFRICA,0,TOTALS,SOUTH AFRICA,200,26,54,48.1,20,31,64.5,6,23,26.1,16,22,72.7,9,22,31,10,18,33,11,2,74,1
1356,31235,46_05_13,BOTSWANA,0,TOTALS,BOTSWANA,200,22,65,33.8,19,52,36.5,3,13,23.1,6,19,31.6,11,27,38,2,25,23,11,0,53,0
1357,31248,46_05_13,ZAMBIA,0,TOTALS,ZAMBIA,200,22,54,40.7,21,44,47.7,1,10,10.0,17,29,58.6,12,34,46,7,20,26,8,1,62,1
1358,31260,46_05_14,LESOTHO,0,TOTALS,LESOTHO,200,27,50,54.0,26,42,61.9,1,8,12.5,19,35,54.3,5,20,25,7,20,21,18,1,74,1
1359,31273,46_05_14,BOTSWANA,0,TOTALS,BOTSWANA,200,19,55,34.5,16,42,38.1,3,13,23.1,9,25,36.0,15,18,33,0,28,37,8,1,50,0
1360,31286,46_05_15,TUNISIA,0,TOTALS,TUNISIA,200,23,58,39.7,14,31,45.2,9,27,33.3,17,26,65.4,20,25,45,1,25,20,1,0,72,0
1361,31299,46_05_15,MOROCCO,0,TOTALS,MOROCCO,200,28,60,46.7,24,42,57.1,4,18,22.2,21,38,55.3,9,7,16,3,24,7,7,3,81,1
1362,31311,46_05_16,MOZAMBIQUE,0,TOTALS,MOZAMBIQUE,200,22,61,36.1,17,39,43.6,5,22,22.7,16,27,59.3,16,13,29,5,26,26,14,4,65,1
1363,31324,46_05_16,ZAMBIA,0,TOTALS,ZAMBIA,200,23,50,46.0,21,41,51.2,2,9,22.2,10,25,40.0,11,23,34,2,23,26,4,2,58,0
1364,31337,46_05_17,SOUTH AFRICA,0,TOTALS,SOUTH AFRICA,200,31,56,55.4,23,34,67.6,8,22,36.4,26,33,78.8,10,33,43,13,16,18,10,2,96,1
1365,31350,46_05_17,BOTSWANA,0,TOTALS,BOTSWANA,200,16,59,27.1,11,34,32.4,5,25,20.0,4,8,50.0,10,13,23,1,25,25,8,1,41,0
1366,31363,46_05_18,LIBYA,0,TOTALS,LIBYA,200,27,58,46.6,22,45,48.9,5,13,38.5,17,22,77.3,6,7,13,3,21,19,9,0,76,1
1367,31376,46_05_18,TUNISIA,0,TOTALS,TUNISIA,200,48,76,63.2,36,47,76.6,12,29,41.4,12,21,57.1,12,25,37,0,21,18,11,0,120,0
1368,31388,46_05_19,MOZAMBIQUE,0,TOTALS,MOZAMBIQUE,200,31,80,38.8,28,53,52.8,3,27,11.1,16,33,48.5,26,26,52,8,23,15,9,4,81,1
1369,31400,46_05_19,LESOTHO,0,TOTALS,LESOTHO,200,18,49,36.7,17,32,53.1,1,17,5.9,15,23,65.2,3,18,21,3,30,22,5,1,52,0
1370,31413,46_05_20,SOUTH AFRICA,0,TOTALS,SOUTH AFRICA,200,21,51,41.2,17,41,41.5,4,10,40.0,26,42,61.9,11,24,35,6,28,20,6,1,72,1
1371,31425,46_05_20,MOZAMBIQUE,0,TOTALS,MOZAMBIQUE,200,24,67,35.8,20,52,38.5,4,15,26.7,11,32,34.4,16,20,36,3,32,17,7,2,63,0
1372,31438,49_05_01,USA,0,TOTALS,USA,200,36,64,56.2,27,45,60.0,9,19,47.4,13,17,76.5,8,28,36,18,22,18,8,5,94,1
1373,31450,49_05_01,PANAMA,0,TOTALS,PANAMA,200,24,69,34.8,18,51,35.3,6,18,33.3,18,24,75.0,15,15,30,9,19,16,10,2,72,0
1374,31463,49_05_02,VENEZUELA,0,TOTALS,VENEZUELA,200,27,59,45.8,24,41,58.5,3,18,16.7,31,40,77.5,9,23,32,14,22,25,11,5,88,1
1375,31476,49_05_02,BRAZIL,0,TOTALS,BRAZIL,200,41,90,45.6,28,63,44.4,13,27,48.1,16,21,76.2,19,24,43,23,28,17,17,1,111,0
1376,31488,49_05_03,ARGENTINA,0,TOTALS,ARGENTINA,200,32,67,47.8,21,32,65.6,11,35,31.4,7,15,46.7,8,17,25,23,17,13,9,5,82,0
1377,31499,49_05_03,MEXICO,0,TOTALS,MEXICO,200,36,65,55.4,28,51,54.9,8,14,57.1,16,22,72.7,11,25,36,19,16,18,7,4,96,1
1378,31508,49_05_04,URUGUAY,0,TOTALS,URUGUAY,200,26,67,38.8,15,29,51.7,11,38,28.9,6,14,42.9,13,24,37,12,22,18,11,1,69,0
1379,31521,49_05_04,DOMINICAN REPUBLIC,0,TOTALS,DOMINICAN REPUBLIC,200,25,65,38.5,19,45,42.2,6,20,30.0,16,23,69.6,15,32,47,7,24,19,6,6,72,1
1380,31530,49_05_05,BRAZIL,0,TOTALS,BRAZIL,200,33,78,42.3,26,55,47.3,7,23,30.4,21,28,75.0,14,25,39,13,20,12,11,5,94,0
1381,31541,49_05_05,USA,0,TOTALS,USA,200,34,72,47.2,20,45,44.4,14,27,51.9,14,18,77.8,10,29,39,19,24,16,7,2,96,1
1382,31553,49_05_06,CANADA,0,TOTALS,CANADA,200,34,82,41.5,27,54,50.0,7,28,25.0,16,17,94.1,16,14,30,8,27,12,6,1,91,1
1383,31564,49_05_06,VENEZUELA,0,TOTALS,VENEZUELA,200,32,66,48.5,23,42,54.8,9,24,37.5,27,34,79.4,14,22,36,14,16,15,7,4,100,0
1384,31576,49_05_07,MEXICO,0,TOTALS,MEXICO,200,21,57,36.8,16,43,37.2,5,14,35.7,13,20,65.0,9,21,30,10,28,18,5,2,60,0
1385,31588,49_05_07,URUGUAY,0,TOTALS,URUGUAY,200,29,70,41.4,19,36,52.8,10,34,29.4,23,33,69.7,19,27,46,14,20,10,7,6,91,1
1386,31600,49_05_08,PUERTO RICO,0,TOTALS,PUERTO RICO,200,23,50,46.0,13,30,43.3,10,20,50.0,23,29,79.3,7,15,22,12,23,20,7,2,79,0
1387,31612,49_05_08,ARGENTINA,0,TOTALS,ARGENTINA,200,34,64,53.1,22,36,61.1,12,28,42.9,16,20,80.0,10,20,30,17,26,17,14,1,96,1
1388,31623,49_05_09,PANAMA,0,TOTALS,PANAMA,200,27,65,41.5,24,55,43.6,3,10,30.0,20,32,62.5,13,22,35,8,23,16,5,3,77,0
1389,31635,49_05_09,BRAZIL,0,TOTALS,BRAZIL,200,29,66,43.9,19,43,44.2,10,23,43.5,15,21,71.4,13,22,35,16,25,16,8,2,83,1
1390,31648,49_05_10,USA,0,TOTALS,USA,200,28,65,43.1,20,45,44.4,8,20,40.0,12,20,60.0,7,18,25,9,29,19,9,3,76,0
1391,31659,49_05_10,CANADA,0,TOTALS,CANADA,200,32,57,56.1,26,44,59.1,6,13,46.2,22,29,75.9,7,28,35,16,25,21,6,3,92,1
1392,31670,49_05_11,URUGUAY,0,TOTALS,URUGUAY,200,28,72,38.9,20,46,43.5,8,26,30.8,16,26,61.5,11,23,34,13,25,13,7,3,80,0
1393,31680,49_05_11,PUERTO RICO,0,TOTALS,PUERTO RICO,200,36,69,52.2,31,53,58.5,5,16,31.2,18,28,64.3,11,32,43,16,20,11,7,8,95,1
1394,31693,49_05_12,DOMINICAN REPUBLIC,0,TOTALS,DOMINICAN REPUBLIC,200,35,80,43.8,24,51,47.1,11,29,37.9,23,30,76.7,19,31,50,14,25,13,2,5,104,0
1395,31703,49_05_12,MEXICO,0,TOTALS,MEXICO,200,35,77,45.5,31,55,56.4,4,22,18.2,20,27,74.1,11,26,37,15,25,8,5,5,94,1
1396,31714,49_05_13,ARGENTINA,0,TOTALS,ARGENTINA,200,27,53,50.9,21,36,58.3,6,17,35.3,26,32,81.2,6,18,24,14,24,17,6,2,86,1
1397,31724,49_05_13,URUGUAY,0,TOTALS,URUGUAY,200,26,59,44.1,20,40,50.0,6,19,31.6,14,20,70.0,11,21,32,10,30,21,5,2,72,0
1398,31736,49_05_14,VENEZUELA,0,TOTALS,VENEZUELA,200,27,68,39.7,21,48,43.8,6,20,30.0,11,18,61.1,15,25,40,13,20,20,9,10,71,1
1399,31747,49_05_14,USA,0,TOTALS,USA,200,28,83,33.7,24,66,36.4,4,17,23.5,10,14,71.4,23,22,45,12,21,16,11,2,70,0
1400,31760,49_05_15,PANAMA,0,TOTALS,PANAMA,200,33,66,50.0,30,53,56.6,3,13,23.1,10,16,62.5,9,40,49,14,17,15,10,7,79,1
1401,31773,49_05_15,CANADA,0,TOTALS,CANADA,200,20,72,27.8,12,46,26.1,8,26,30.8,6,13,46.2,11,24,35,9,17,14,8,4,54,0
1402,31784,49_05_16,PUERTO RICO,0,TOTALS,PUERTO RICO,200,36,79,45.6,29,56,51.8,7,23,30.4,7,14,50.0,12,23,35,19,22,14,8,3,86,0
1403,31797,49_05_16,DOMINICAN REPUBLIC,0,TOTALS,DOMINICAN REPUBLIC,200,31,78,39.7,27,65,41.5,4,13,30.8,23,33,69.7,25,27,52,11,15,9,6,7,89,1
1404,31806,49_05_17,BRAZIL,0,TOTALS,BRAZIL,200,37,76,48.7,19,40,47.5,18,36,50.0,13,23,56.5,15,22,37,26,17,15,11,3,105,0
1405,31818,49_05_17,CANADA,0,TOTALS,CANADA,200,31,70,44.3,22,49,44.9,9,21,42.9,10,16,62.5,12,22,34,14,17,17,7,3,81,1
1406,31829,49_05_18,PANAMA,0,TOTALS,PANAMA,200,27,66,40.9,25,52,48.1,2,14,14.3,14,21,66.7,12,26,38,6,23,16,9,4,70,0
1407,31841,49_05_18,VENEZUELA,0,TOTALS,VENEZUELA,200,25,63,39.7,16,40,40.0,9,23,39.1,12,16,75.0,12,22,34,17,20,19,5,4,71,1
1408,31854,49_05_19,MEXICO,0,TOTALS,MEXICO,200,29,76,38.2,22,52,42.3,7,24,29.2,9,10,90.0,8,21,29,15,18,13,9,3,74,0
1409,31866,49_05_19,PUERTO RICO,0,TOTALS,PUERTO RICO,200,38,66,57.6,31,51,60.8,7,15,46.7,11,14,78.6,5,36,41,16,12,15,5,4,94,1
1410,31877,49_05_20,DOMINICAN REPUBLIC,0,TOTALS,DOMINICAN REPUBLIC,200,18,68,26.5,13,48,27.1,5,20,25.0,19,24,79.2,17,18,35,8,15,20,10,8,60,0
1411,31890,49_05_20,ARGENTINA,0,TOTALS,ARGENTINA,200,29,61,47.5,18,37,48.6,11,24,45.8,15,18,83.3,11,31,42,21,19,21,10,5,84,1
1412,31901,49_05_21,PUERTO RICO,0,TOTALS,PUERTO RICO,250,39,87,44.8,31,61,50.8,8,26,30.8,21,28,75.0,16,29,45,13,23,12,6,4,107,1
1413,31910,49_05_21,BRAZIL,0,TOTALS,BRAZIL,250,37,85,43.5,30,58,51.7,7,27,25.9,20,28,71.4,14,29,43,19,28,13,5,1,101,0
1414,31922,49_05_22,ARGENTINA,0,TOTALS,ARGENTINA,200,28,66,42.4,22,41,53.7,6,25,24.0,16,18,88.9,9,26,35,15,11,11,8,3,78,1
1415,31934,49_05_22,VENEZUELA,0,TOTALS,VENEZUELA,200,22,74,29.7,16,50,32.0,6,24,25.0,10,13,76.9,21,26,47,9,20,15,6,2,60,0
1416,31947,49_05_23,USA,0,TOTALS,USA,200,31,72,43.1,29,57,50.9,2,15,13.3,11,16,68.8,15,22,37,15,17,16,4,3,75,0
1417,31956,49_05_23,BRAZIL,0,TOTALS,BRAZIL,200,32,72,44.4,22,46,47.8,10,26,38.5,19,22,86.4,13,27,40,16,18,11,9,4,93,1
1418,31968,49_05_24,ARGENTINA,0,TOTALS,ARGENTINA,200,35,67,52.2,25,44,56.8,10,23,43.5,24,29,82.8,13,18,31,17,24,10,7,2,104,0
1419,31980,49_05_24,VENEZUELA,0,TOTALS,VENEZUELA,200,31,58,53.4,23,41,56.1,8,17,47.1,23,29,79.3,8,16,24,16,26,15,5,1,93,1
1420,31991,49_05_25,USA,0,TOTALS,USA,200,33,66,50.0,26,45,57.8,7,21,33.3,10,14,71.4,6,30,36,18,17,11,6,2,83,0
1421,32002,49_05_25,VENEZUELA,0,TOTALS,VENEZUELA,200,32,68,47.1,19,43,44.2,13,25,52.0,16,18,88.9,5,23,28,20,14,7,8,1,93,1
1422,32011,49_05_26,BRAZIL,0,TOTALS,BRAZIL,200,36,62,58.1,24,41,58.5,12,21,57.1,16,19,84.2,7,23,30,18,17,14,5,2,100,0
1423,32022,49_05_26,ARGENTINA,0,TOTALS,ARGENTINA,200,33,69,47.8,23,41,56.1,10,28,35.7,12,19,63.2,11,15,26,14,19,9,6,4,88,1
1424,32785,54_05_01,PERU,0,TOTALS,PERU,200,22,66,33.3,16,39,41.0,6,27,22.2,2,10,20.0,16,26,42,13,20,30,7,3,52,0
1425,32798,54_05_01,VENEZUELA,0,TOTALS,VENEZUELA,200,32,70,45.7,20,45,44.4,12,25,48.0,15,25,60.0,7,16,23,10,16,17,19,1,91,1
1426,32811,54_05_02,PARAGUAY,0,TOTALS,PARAGUAY,200,39,74,52.7,36,55,65.5,3,19,15.8,18,31,58.1,10,22,32,1,29,23,8,0,99,1
1427,32824,54_05_02,ECUADOR,0,TOTALS,ECUADOR,200,14,58,24.1,9,41,22.0,5,17,29.4,17,35,48.6,10,22,32,1,29,23,8,0,50,0
1428,32837,54_05_03,URUGUAY,0,TOTALS,URUGUAY,200,61,106,57.5,52,83,62.7,9,23,39.1,19,31,61.3,32,25,57,30,9,26,34,0,150,0
1429,32849,54_05_03,BOLIVIA,0,TOTALS,BOLIVIA,200,19,49,38.8,17,37,45.9,2,12,16.7,5,9,55.6,5,16,21,6,22,58,14,1,45,1
1430,32862,54_05_04,ARGENTINA,0,TOTALS,ARGENTINA,200,57,95,60.0,51,74,68.9,6,21,28.6,21,28,75.0,25,17,42,33,18,20,45,5,141,0
1431,32875,54_05_04,ECUADOR,0,TOTALS,ECUADOR,200,13,42,31.0,6,26,23.1,7,16,43.8,11,22,50.0,7,17,24,11,23,58,7,0,44,1
1432,32888,54_05_05,VENEZUELA,0,TOTALS,VENEZUELA,200,28,81,34.6,25,60,41.7,3,21,14.3,20,35,57.1,19,28,47,12,19,20,18,2,79,1
1433,32901,54_05_05,PARAGUAY,0,TOTALS,PARAGUAY,200,19,58,32.8,18,43,41.9,1,15,6.7,5,19,26.3,8,21,29,8,24,29,15,6,44,0
1434,32914,54_05_06,BRAZIL,0,TOTALS,BRAZIL,200,32,66,48.5,25,48,52.1,7,18,38.9,22,34,64.7,20,28,48,8,21,28,5,3,93,1
1435,32927,54_05_06,CHILE,0,TOTALS,CHILE,200,31,77,40.3,22,47,46.8,9,30,30.0,15,29,51.7,14,15,29,16,27,11,15,6,86,0
1436,32940,54_05_07,PARAGUAY,0,TOTALS,PARAGUAY,200,30,66,45.5,24,49,49.0,6,17,35.3,18,30,60.0,11,37,48,18,19,9,6,3,84,1
1437,32953,54_05_07,PERU,0,TOTALS,PERU,200,21,73,28.8,16,48,33.3,5,25,20.0,1,8,12.5,12,23,35,8,22,11,4,3,48,0
1438,32966,54_05_08,ARGENTINA,0,TOTALS,ARGENTINA,200,36,70,51.4,32,60,53.3,4,10,40.0,15,28,53.6,17,28,45,22,27,23,19,10,91,1
1439,32979,54_05_08,VENEZUELA,0,TOTALS,VENEZUELA,200,24,67,35.8,21,51,41.2,3,16,18.8,21,34,61.8,11,19,30,5,24,26,13,5,72,0
1440,32992,54_05_09,URUGUAY,0,TOTALS,URUGUAY,200,23,63,36.5,16,34,47.1,7,29,24.1,21,28,75.0,8,21,29,11,29,9,13,1,74,1
1441,33005,54_05_09,BRAZIL,0,TOTALS,BRAZIL,200,19,52,36.5,13,32,40.6,6,20,30.0,21,34,61.8,9,28,37,3,30,22,3,1,65,0
1442,33018,54_05_10,CHILE,0,TOTALS,CHILE,200,45,76,59.2,41,61,67.2,4,15,26.7,19,31,61.3,9,19,28,26,19,19,17,2,113,0
1443,33030,54_05_10,BOLIVIA,0,TOTALS,BOLIVIA,200,33,68,48.5,30,50,60.0,3,18,16.7,8,22,36.4,7,14,21,10,21,33,11,3,77,1
1444,33043,54_05_11,PARAGUAY,0,TOTALS,PARAGUAY,200,19,49,38.8,15,40,37.5,4,9,44.4,12,18,66.7,3,19,22,6,15,23,9,0,54,1
1445,33056,54_05_11,ARGENTINA,0,TOTALS,ARGENTINA,200,42,81,51.9,32,59,54.2,10,22,45.5,15,22,68.2,15,20,35,18,20,16,15,2,109,0
1446,33069,54_05_12,BRAZIL,0,TOTALS,BRAZIL,200,51,82,62.2,48,70,68.6,3,12,25.0,21,36,58.3,19,46,65,27,12,29,22,10,126,0
1447,33081,54_05_12,BOLIVIA,0,TOTALS,BOLIVIA,200,15,76,19.7,11,46,23.9,4,30,13.3,5,15,33.3,8,11,19,5,23,20,11,2,39,1
1448,33094,54_05_13,URUGUAY,0,TOTALS,URUGUAY,200,28,65,43.1,24,50,48.0,4,15,26.7,20,35,57.1,22,26,48,9,29,19,10,4,80,1
1449,33107,54_05_13,CHILE,0,TOTALS,CHILE,200,23,61,37.7,19,42,45.2,4,19,21.1,25,42,59.5,13,17,30,2,24,10,13,3,75,0
1450,33120,54_05_14,PERU,0,TOTALS,PERU,200,41,89,46.1,33,62,53.2,8,27,29.6,12,34,35.3,26,39,65,17,10,17,12,0,102,0
1451,33132,54_05_14,BOLIVIA,0,TOTALS,BOLIVIA,200,21,81,25.9,16,39,41.0,5,42,11.9,3,6,50.0,9,24,33,1,23,21,11,2,50,1
1452,33145,54_05_15,PARAGUAY,0,TOTALS,PARAGUAY,200,26,55,47.3,24,43,55.8,2,12,16.7,13,22,59.1,9,21,30,11,20,38,11,4,67,0
1453,33158,54_05_15,CHILE,0,TOTALS,CHILE,200,36,61,59.0,34,52,65.4,2,9,22.2,24,32,75.0,8,16,24,14,20,23,29,2,98,1
1454,33171,54_05_16,ARGENTINA,0,TOTALS,ARGENTINA,200,35,80,43.8,23,52,44.2,12,28,42.9,16,20,80.0,10,17,27,18,26,17,19,2,98,1
1455,33184,54_05_16,BRAZIL,0,TOTALS,BRAZIL,200,28,58,48.3,22,42,52.4,6,16,37.5,12,24,50.0,15,23,38,19,22,33,7,0,74,0
1456,33197,54_05_17,URUGUAY,0,TOTALS,URUGUAY,200,22,60,36.7,18,35,51.4,4,25,16.0,20,27,74.1,6,22,28,10,12,13,15,1,68,1
1457,33210,54_05_17,VENEZUELA,0,TOTALS,VENEZUELA,200,22,48,45.8,13,25,52.0,9,23,39.1,8,16,50.0,2,25,27,5,25,22,4,3,61,0
1458,33223,54_05_18,BRAZIL,0,TOTALS,BRAZIL,200,33,63,52.4,30,48,62.5,3,15,20.0,19,24,79.2,13,22,35,15,19,25,11,0,88,1
1459,33236,54_05_18,VENEZUELA,0,TOTALS,VENEZUELA,200,31,65,47.7,24,45,53.3,7,20,35.0,14,22,63.6,6,18,24,22,19,16,18,4,83,0
1460,33249,54_05_19,ARGENTINA,0,TOTALS,ARGENTINA,200,31,54,57.4,25,41,61.0,6,13,46.2,18,29,62.1,7,29,36,15,20,18,10,7,86,1
1461,33262,54_05_19,URUGUAY,0,TOTALS,URUGUAY,200,21,62,33.9,11,33,33.3,10,29,34.5,9,19,47.4,11,21,32,10,26,14,11,2,61,0
1462,33814,61_05_01,COSTA RICA,0,TOTALS,COSTA RICA,200,40,97,41.2,39,84,46.4,1,13,7.7,6,19,31.6,16,21,37,10,21,29,15,0,87,1
1463,33827,61_05_01,NICARAGUA,0,TOTALS,NICARAGUA,200,23,72,31.9,22,64,34.4,1,8,12.5,16,27,59.3,7,20,27,6,16,27,19,0,63,0
1464,33840,61_05_02,NICARAGUA,0,TOTALS,NICARAGUA,200,15,60,25.0,15,56,26.8,0,4,0.0,15,28,53.6,6,19,25,3,24,37,8,0,45,1
1465,33853,61_05_02,PANAMA,0,TOTALS,PANAMA,200,43,110,39.1,40,92,43.5,3,18,16.7,13,26,50.0,11,21,32,6,18,16,26,0,102,0
1466,33866,61_05_03,COSTA RICA,0,TOTALS,COSTA RICA,0,15,62,24.2,13,49,26.5,2,13,15.4,14,27,51.9,8,28,36,5,27,28,4,0,46,0
1467,33879,61_05_03,PANAMA,0,TOTALS,PANAMA,200,17,81,21.0,13,57,22.8,4,24,16.7,22,36,61.1,12,20,32,6,27,12,18,0,60,1
1468,33892,62_04_01,HUNGARY,0,TOTALS,HUNGARY,200,37,58,63.8,29,39,74.4,8,19,42.1,14,17,82.4,8,14,22,27,18,10,16,3,96,1
1469,33904,62_04_01,BELGIUM,0,TOTALS,BELGIUM,200,24,49,49.0,15,32,46.9,9,17,52.9,13,17,76.5,8,12,20,11,17,16,7,0,70,0
1470,33917,62_04_02,BOSNIA AND HERZEGOVINA,0,TOTALS,BOSNIA AND HERZEGOVINA,200,22,45,48.9,17,27,63.0,5,18,27.8,16,20,80.0,2,15,17,7,23,19,7,1,65,0
1471,33930,62_04_02,TURKEY,0,TOTALS,TURKEY,200,25,49,51.0,17,34,50.0,8,15,53.3,17,21,81.0,6,17,23,5,25,13,8,4,75,1
1472,33943,62_04_03,CROATIA,0,TOTALS,CROATIA,200,31,59,52.5,26,36,72.2,5,23,21.7,19,24,79.2,12,18,30,6,21,10,10,0,86,1
1473,33955,62_04_03,RUSSIA,0,TOTALS,RUSSIA,200,21,54,38.9,16,41,39.0,5,13,38.5,16,22,72.7,12,19,31,4,23,10,6,1,63,0
1474,33968,62_04_04,LATVIA,0,TOTALS,LATVIA,200,29,50,58.0,22,36,61.1,7,14,50.0,15,24,62.5,5,36,41,18,25,11,2,2,80,1
1475,33981,62_04_04,ISRAEL,0,TOTALS,ISRAEL,200,18,59,30.5,14,44,31.8,4,15,26.7,17,28,60.7,12,23,35,10,23,7,5,1,57,0
1476,33994,62_04_05,ESTONIA,0,TOTALS,ESTONIA,200,27,65,41.5,18,35,51.4,9,30,30.0,28,36,77.8,12,23,35,17,23,11,5,4,91,1
1477,34007,62_04_05,NETHERLANDS,0,TOTALS,NETHERLANDS,200,32,68,47.1,26,56,46.4,6,12,50.0,18,27,66.7,12,27,39,10,35,14,8,1,88,0
1478,34020,62_04_06,SLOVENIA,0,TOTALS,SLOVENIA,200,30,68,44.1,23,52,44.2,7,16,43.8,10,20,50.0,12,29,41,12,23,12,9,1,77,1
1479,34033,62_04_06,FRANCE,0,TOTALS,FRANCE,200,23,55,41.8,21,37,56.8,2,18,11.1,13,26,50.0,7,21,28,13,19,15,11,4,61,0
1480,34046,62_04_07,CZECH REPUBLIC,0,TOTALS,CZECH REPUBLIC,200,34,71,47.9,28,51,54.9,6,20,30.0,8,11,72.7,8,27,35,20,20,13,11,2,82,1
1481,34059,62_04_07,POLAND,0,TOTALS,POLAND,200,21,56,37.5,20,40,50.0,1,16,6.2,14,23,60.9,7,20,27,8,17,16,9,4,57,0
1482,34072,62_04_08,UKRAINE,0,TOTALS,UKRAINE,200,20,61,32.8,13,35,37.1,7,26,26.9,14,20,70.0,10,16,26,11,20,16,6,2,61,0
1483,34085,62_04_08,GERMANY,0,TOTALS,GERMANY,200,28,60,46.7,24,43,55.8,4,17,23.5,21,27,77.8,11,28,39,15,19,17,10,1,81,1
1484,34098,62_04_09,BULGARIA,0,TOTALS,BULGARIA,200,25,57,43.9,17,34,50.0,8,23,34.8,31,42,73.8,14,24,38,11,26,19,6,1,89,1
1485,34111,62_04_09,PORTUGAL,0,TOTALS,PORTUGAL,200,30,61,49.2,23,36,63.9,7,25,28.0,20,25,80.0,9,24,33,11,30,14,8,4,87,0
1486,34124,62_04_10,POLAND,0,TOTALS,POLAND,200,24,60,40.0,22,45,48.9,2,15,13.3,21,24,87.5,9,17,26,5,25,12,8,0,71,0
1487,34137,62_04_10,SLOVENIA,0,TOTALS,SLOVENIA,200,28,60,46.7,24,47,51.1,4,13,30.8,20,23,87.0,6,20,26,9,22,10,4,0,80,1
1488,34150,62_04_11,PORTUGAL,0,TOTALS,PORTUGAL,200,28,65,43.1,19,37,51.4,9,28,32.1,11,18,61.1,11,17,28,19,23,8,12,3,76,0
1489,34163,62_04_11,LATVIA,0,TOTALS,LATVIA,200,28,54,51.9,21,33,63.6,7,21,33.3,18,23,78.3,4,20,24,12,20,13,7,2,81,1
1490,34176,62_04_12,FRANCE,0,TOTALS,FRANCE,200,27,53,50.9,14,23,60.9,13,30,43.3,22,33,66.7,8,29,37,26,24,19,13,0,89,1
1491,34189,62_04_12,CZECH REPUBLIC,0,TOTALS,CZECH REPUBLIC,200,16,53,30.2,10,42,23.8,6,11,54.5,18,23,78.3,8,17,25,11,28,21,10,0,56,0
1492,34202,62_04_13,GERMANY,0,TOTALS,GERMANY,200,26,56,46.4,21,41,51.2,5,15,33.3,25,32,78.1,10,22,32,14,18,12,9,3,82,1
1493,34215,62_04_13,HUNGARY,0,TOTALS,HUNGARY,200,25,60,41.7,17,37,45.9,8,23,34.8,14,18,77.8,12,16,28,14,23,12,9,2,72,0
1494,34228,62_04_14,RUSSIA,0,TOTALS,RUSSIA,200,36,72,50.0,28,49,57.1,8,23,34.8,17,22,77.3,18,30,48,24,20,11,11,8,97,1
1495,34241,62_04_14,SWEDEN,0,TOTALS,SWEDEN,200,23,63,36.5,19,52,36.5,4,11,36.4,14,22,63.6,14,20,34,14,19,16,5,3,64,0
1496,34254,62_04_15,TURKEY,0,TOTALS,TURKEY,200,30,58,51.7,25,38,65.8,5,20,25.0,20,25,80.0,7,29,36,18,13,10,10,2,85,1
1497,34267,62_04_15,ESTONIA,0,TOTALS,ESTONIA,200,25,74,33.8,22,47,46.8,3,27,11.1,4,12,33.3,11,20,31,11,22,10,5,0,57,0
1498,34280,62_04_16,NETHERLANDS,0,TOTALS,NETHERLANDS,200,30,66,45.5,24,49,49.0,6,17,35.3,11,15,73.3,15,18,33,19,20,12,9,0,77,0
1499,34293,62_04_16,BOSNIA AND HERZEGOVINA,0,TOTALS,BOSNIA AND HERZEGOVINA,200,29,59,49.2,16,25,64.0,13,34,38.2,11,17,64.7,8,18,26,19,20,12,6,0,82,1
1500,34306,62_04_17,ISRAEL,0,TOTALS,ISRAEL,200,28,56,50.0,21,43,48.8,7,13,53.8,21,29,72.4,6,24,30,16,23,9,15,1,84,1
1501,34319,62_04_17,BULGARIA,0,TOTALS,BULGARIA,200,25,54,46.3,20,37,54.1,5,17,29.4,9,18,50.0,6,22,28,8,28,18,3,2,64,0
1502,34332,62_04_18,BELGIUM,0,TOTALS,BELGIUM,200,29,69,42.0,17,44,38.6,12,25,48.0,11,15,73.3,12,22,34,15,27,11,5,1,81,0
1503,34345,62_04_18,UKRAINE,0,TOTALS,UKRAINE,200,30,58,51.7,28,51,54.9,2,7,28.6,23,36,63.9,9,22,31,5,18,7,4,3,85,1
1504,34358,62_04_19,ISRAEL,0,TOTALS,ISRAEL,225,27,57,47.4,20,42,47.6,7,15,46.7,35,46,76.1,7,20,27,18,25,14,15,4,96,1
1505,34371,62_04_19,PORTUGAL,0,TOTALS,PORTUGAL,225,33,62,53.2,18,35,51.4,15,27,55.6,20,27,74.1,6,23,29,17,35,20,11,5,101,0
1506,34384,62_04_20,BULGARIA,0,TOTALS,BULGARIA,200,25,52,48.1,19,34,55.9,6,18,33.3,40,44,90.9,9,30,39,21,24,16,6,5,96,1
1507,34397,62_04_20,LATVIA,0,TOTALS,LATVIA,200,28,75,37.3,17,47,36.2,11,28,39.3,18,22,81.8,17,20,37,10,30,13,8,1,85,0
1508,34410,62_04_21,CZECH REPUBLIC,0,TOTALS,CZECH REPUBLIC,200,24,52,46.2,15,35,42.9,9,17,52.9,13,19,68.4,10,24,34,16,23,15,6,2,70,0
1509,34423,62_04_21,SLOVENIA,0,TOTALS,SLOVENIA,200,27,62,43.5,18,37,48.6,9,25,36.0,8,15,53.3,12,16,28,17,22,8,12,2,71,1
1510,34436,62_04_22,HUNGARY,0,TOTALS,HUNGARY,200,35,62,56.5,31,50,62.0,4,12,33.3,16,25,64.0,10,17,27,15,30,16,19,5,90,1
1511,34449,62_04_22,UKRAINE,0,TOTALS,UKRAINE,200,21,46,45.7,18,25,72.0,3,21,14.3,22,34,64.7,4,17,21,7,25,17,11,2,67,0
1512,34462,62_04_23,ESTONIA,0,TOTALS,ESTONIA,200,17,56,30.4,11,32,34.4,6,24,25.0,21,27,77.8,7,20,27,9,27,17,15,2,61,0
1513,34475,62_04_23,BOSNIA AND HERZEGOVINA,0,TOTALS,BOSNIA AND HERZEGOVINA,200,26,58,44.8,23,38,60.5,3,20,15.0,15,23,65.2,10,27,37,5,24,18,10,3,70,1
1514,34488,62_04_24,SWEDEN,0,TOTALS,SWEDEN,200,25,61,41.0,15,44,34.1,10,17,58.8,9,16,56.2,9,26,35,13,27,12,3,6,69,0
1515,34501,62_04_24,CROATIA,0,TOTALS,CROATIA,200,28,68,41.2,20,41,48.8,8,27,29.6,22,34,64.7,20,30,50,18,17,7,7,0,86,1
1516,34514,62_04_25,GERMANY,0,TOTALS,GERMANY,200,30,64,46.9,21,40,52.5,9,24,37.5,12,21,57.1,10,35,45,15,21,13,2,7,81,1
1517,34526,62_04_25,BELGIUM,0,TOTALS,BELGIUM,200,23,74,31.1,19,52,36.5,4,22,18.2,11,20,55.0,16,21,37,10,18,10,7,1,61,0
1518,34539,62_04_26,TURKEY,0,TOTALS,TURKEY,200,29,52,55.8,19,34,55.9,10,18,55.6,15,20,75.0,1,26,27,20,17,18,12,8,83,1
1519,34551,62_04_26,NETHERLANDS,0,TOTALS,NETHERLANDS,200,21,62,33.9,16,45,35.6,5,17,29.4,12,20,60.0,12,20,32,14,22,18,9,0,59,0
1520,34564,62_04_27,FRANCE,0,TOTALS,FRANCE,200,33,71,46.5,23,43,53.5,10,28,35.7,9,18,50.0,13,27,40,18,22,14,10,6,85,1
1521,34577,62_04_27,POLAND,0,TOTALS,POLAND,200,24,58,41.4,17,41,41.5,7,17,41.2,10,19,52.6,7,24,31,20,19,20,9,0,65,0
1522,34590,62_04_28,POLAND,0,TOTALS,POLAND,200,30,55,54.5,27,43,62.8,3,12,25.0,23,32,71.9,6,22,28,18,23,13,6,3,86,1
1523,34603,62_04_28,CZECH REPUBLIC,0,TOTALS,CZECH REPUBLIC,200,26,69,37.7,17,35,48.6,9,34,26.5,17,24,70.8,13,20,33,14,28,10,8,1,78,0
1524,34616,62_04_29,GERMANY,0,TOTALS,GERMANY,200,37,70,52.9,29,49,59.2,8,21,38.1,13,19,68.4,13,31,44,22,22,11,6,4,95,1
1525,34628,62_04_29,UKRAINE,0,TOTALS,UKRAINE,200,25,65,38.5,18,40,45.0,7,25,28.0,12,20,60.0,6,23,29,12,19,12,3,5,69,0
1526,34641,62_04_30,PORTUGAL,0,TOTALS,PORTUGAL,200,23,61,37.7,12,32,37.5,11,29,37.9,15,19,78.9,6,17,23,21,26,13,8,2,72,0
1527,34654,62_04_30,BULGARIA,0,TOTALS,BULGARIA,200,28,58,48.3,22,37,59.5,6,21,28.6,25,27,92.6,5,24,29,22,23,8,10,2,87,1
1528,34666,62_04_31,FRANCE,0,TOTALS,FRANCE,200,27,58,46.6,22,39,56.4,5,19,26.3,26,35,74.3,11,22,33,15,32,13,10,4,85,1
1529,34677,62_04_31,SLOVENIA,0,TOTALS,SLOVENIA,200,22,57,38.6,19,43,44.2,3,14,21.4,22,40,55.0,19,20,39,10,29,17,4,2,69,0
1530,34690,62_04_32,RUSSIA,0,TOTALS,RUSSIA,200,25,58,43.1,21,44,47.7,4,14,28.6,21,27,77.8,8,31,39,18,27,11,8,5,75,1
1531,34702,62_04_32,CROATIA,0,TOTALS,CROATIA,200,19,58,32.8,10,29,34.5,9,29,31.0,18,25,72.0,7,22,29,12,23,10,6,3,65,0
1532,34713,62_04_33,NETHERLANDS,0,TOTALS,NETHERLANDS,200,24,55,43.6,21,40,52.5,3,15,20.0,25,34,73.5,9,26,35,15,26,10,6,0,76,1
1533,34726,62_04_33,ESTONIA,0,TOTALS,ESTONIA,200,23,52,44.2,11,27,40.7,12,25,48.0,14,26,53.8,8,18,26,11,31,17,6,2,72,0
1534,34739,62_04_34,TURKEY,0,TOTALS,TURKEY,200,27,64,42.2,19,45,42.2,8,19,42.1,15,19,78.9,5,28,33,16,23,10,9,4,77,1
1535,34752,62_04_34,BOSNIA AND HERZEGOVINA,0,TOTALS,BOSNIA AND HERZEGOVINA,200,18,61,29.5,16,40,40.0,2,21,9.5,21,27,77.8,12,30,42,8,18,16,6,2,59,0
1536,34765,62_04_35,ISRAEL,0,TOTALS,ISRAEL,200,25,55,45.5,19,42,45.2,6,13,46.2,23,29,79.3,3,17,20,14,27,11,17,3,79,1
1537,34778,62_04_35,LATVIA,0,TOTALS,LATVIA,200,19,45,42.2,10,28,35.7,9,17,52.9,30,35,85.7,8,27,35,15,26,22,7,6,77,0
1538,34790,62_04_36,BELGIUM,0,TOTALS,BELGIUM,275,30,79,38.0,21,49,42.9,9,30,30.0,32,48,66.7,27,16,43,15,25,18,16,1,101,0
1539,34803,62_04_36,HUNGARY,0,TOTALS,HUNGARY,275,33,73,45.2,26,51,51.0,7,22,31.8,24,35,68.6,33,13,46,13,32,23,6,8,97,1
1540,34815,62_04_37,BULGARIA,0,TOTALS,BULGARIA,200,24,54,44.4,16,31,51.6,8,23,34.8,16,25,64.0,9,27,36,11,22,13,6,4,72,1
1541,34828,62_04_37,ISRAEL,0,TOTALS,ISRAEL,200,22,55,40.0,16,37,43.2,6,18,33.3,15,22,68.2,7,23,30,14,26,14,5,2,65,0
1542,34841,62_04_38,CZECH REPUBLIC,0,TOTALS,CZECH REPUBLIC,250,35,66,53.0,29,54,53.7,6,12,50.0,19,35,54.3,9,25,34,15,30,13,8,5,95,1
1543,34854,62_04_38,FRANCE,0,TOTALS,FRANCE,250,32,74,43.2,21,39,53.8,11,35,31.4,29,37,78.4,18,25,43,9,28,11,9,3,104,0
1544,34867,62_04_39,ESTONIA,0,TOTALS,ESTONIA,200,24,54,44.4,16,25,64.0,8,29,27.6,20,27,74.1,11,24,35,12,26,19,5,0,76,0
1545,34880,62_04_39,TURKEY,0,TOTALS,TURKEY,200,29,60,48.3,20,39,51.3,9,21,42.9,11,25,44.0,9,19,28,8,25,12,12,1,78,1
1546,34893,62_04_40,HUNGARY,0,TOTALS,HUNGARY,200,27,69,39.1,18,48,37.5,9,21,42.9,7,11,63.6,9,23,32,12,28,9,15,6,70,0
1547,34905,62_04_40,GERMANY,0,TOTALS,GERMANY,200,22,54,40.7,18,38,47.4,4,16,25.0,30,38,78.9,7,26,33,6,16,10,8,0,78,1
1548,34918,62_04_41,SWEDEN,0,TOTALS,SWEDEN,200,28,65,43.1,23,42,54.8,5,23,21.7,20,25,80.0,14,18,32,15,26,16,9,4,81,0
1549,34930,62_04_41,RUSSIA,0,TOTALS,RUSSIA,200,31,66,47.0,25,48,52.1,6,18,33.3,24,31,77.4,16,23,39,18,21,17,11,3,92,1
1550,34943,62_04_42,LATVIA,0,TOTALS,LATVIA,200,31,63,49.2,24,40,60.0,7,23,30.4,23,28,82.1,10,32,42,18,26,11,7,4,92,1
1551,34955,62_04_42,PORTUGAL,0,TOTALS,PORTUGAL,200,22,57,38.6,13,37,35.1,9,20,45.0,11,27,40.7,9,23,32,13,28,13,9,0,64,0
1552,34968,62_04_43,UKRAINE,0,TOTALS,UKRAINE,200,31,58,53.4,26,38,68.4,5,20,25.0,22,31,71.0,9,24,33,17,21,10,7,6,89,1
1553,34979,62_04_43,BELGIUM,0,TOTALS,BELGIUM,200,32,61,52.5,28,50,56.0,4,11,36.4,10,21,47.6,6,23,29,15,22,14,4,1,78,0
1554,34992,62_04_44,SLOVENIA,0,TOTALS,SLOVENIA,200,29,59,49.2,21,37,56.8,8,22,36.4,16,27,59.3,14,19,33,12,21,16,12,0,82,1
1555,35005,62_04_44,POLAND,0,TOTALS,POLAND,200,22,50,44.0,17,35,48.6,5,15,33.3,13,17,76.5,5,16,21,1,25,23,10,0,62,0
1556,35018,62_04_45,BOSNIA AND HERZEGOVINA,0,TOTALS,BOSNIA AND HERZEGOVINA,200,32,69,46.4,24,44,54.5,8,25,32.0,14,19,73.7,9,27,36,24,16,11,5,2,86,1
1557,35029,62_04_45,NETHERLANDS,0,TOTALS,NETHERLANDS,200,24,68,35.3,20,56,35.7,4,12,33.3,7,11,63.6,12,23,35,6,16,12,3,0,59,0
1558,35042,62_04_46,POLAND,0,TOTALS,POLAND,200,24,59,40.7,20,41,48.8,4,18,22.2,31,39,79.5,7,17,24,16,17,13,10,4,83,0
1559,35055,62_04_46,FRANCE,0,TOTALS,FRANCE,200,34,62,54.8,24,40,60.0,10,22,45.5,8,11,72.7,4,25,29,18,31,19,9,1,86,1
1560,35068,62_04_47,CROATIA,0,TOTALS,CROATIA,200,28,58,48.3,19,32,59.4,9,26,34.6,10,14,71.4,12,19,31,9,21,7,3,4,75,1
1561,35081,62_04_47,SWEDEN,0,TOTALS,SWEDEN,200,22,59,37.3,18,46,39.1,4,13,30.8,13,16,81.2,13,17,30,10,18,7,3,4,61,0
1562,35094,62_04_48,UKRAINE,0,TOTALS,UKRAINE,200,22,60,36.7,15,44,34.1,7,16,43.8,26,33,78.8,15,29,44,12,21,11,4,7,77,1
1563,35107,62_04_48,HUNGARY,0,TOTALS,HUNGARY,200,23,62,37.1,14,42,33.3,9,20,45.0,15,18,83.3,9,23,32,14,30,10,4,1,70,0
1564,35118,62_04_49,SLOVENIA,0,TOTALS,SLOVENIA,200,29,58,50.0,20,37,54.1,9,21,42.9,28,34,82.4,13,15,28,17,20,16,5,0,95,1
1565,35131,62_04_49,CZECH REPUBLIC,0,TOTALS,CZECH REPUBLIC,200,24,44,54.5,19,26,73.1,5,18,27.8,13,19,68.4,9,13,22,9,22,26,3,0,66,0
1566,35144,62_04_50,LATVIA,0,TOTALS,LATVIA,200,33,66,50.0,24,41,58.5,9,25,36.0,27,36,75.0,10,19,29,23,21,14,15,4,102,0
1567,35156,62_04_50,BULGARIA,0,TOTALS,BULGARIA,200,25,60,41.7,16,34,47.1,9,26,34.6,20,24,83.3,11,23,34,12,26,24,9,1,79,1
1568,35168,62_04_51,NETHERLANDS,0,TOTALS,NETHERLANDS,200,16,57,28.1,11,33,33.3,5,24,20.8,10,16,62.5,11,26,37,6,22,15,11,0,47,0
1569,35180,62_04_51,TURKEY,0,TOTALS,TURKEY,200,23,52,44.2,17,36,47.2,6,16,37.5,15,20,75.0,4,29,33,8,19,13,8,1,67,1
1570,35191,62_04_52,BELGIUM,0,TOTALS,BELGIUM,200,26,69,37.7,20,47,42.6,6,22,27.3,14,22,63.6,24,21,45,9,26,16,7,7,72,0
1571,35202,62_04_52,GERMANY,0,TOTALS,GERMANY,200,30,57,52.6,28,50,56.0,2,7,28.6,22,32,68.8,26,8,34,13,20,12,5,2,84,1
1572,35214,62_04_53,BOSNIA AND HERZEGOVINA,0,TOTALS,BOSNIA AND HERZEGOVINA,200,33,62,53.2,25,43,58.1,8,19,42.1,18,23,78.3,11,24,35,19,27,0,0,0,92,1
1573,35225,62_04_53,ESTONIA,0,TOTALS,ESTONIA,200,20,53,37.7,16,38,42.1,4,15,26.7,27,38,71.1,3,11,14,5,22,0,0,0,71,0
1574,35237,62_04_54,PORTUGAL,0,TOTALS,PORTUGAL,200,25,67,37.3,14,32,43.8,11,35,31.4,12,20,60.0,6,18,24,16,26,12,6,1,73,0
1575,35250,62_04_54,ISRAEL,0,TOTALS,ISRAEL,200,30,66,45.5,22,49,44.9,8,17,47.1,22,30,73.3,10,26,36,21,22,12,6,3,90,1
1576,35263,62_05_55,ESTONIA,0,TOTALS,ESTONIA,200,18,44,40.9,13,30,43.3,5,14,35.7,16,22,72.7,7,22,29,5,23,21,8,1,57,0
1577,35276,62_05_55,CZECH REPUBLIC,0,TOTALS,CZECH REPUBLIC,200,25,55,45.5,18,31,58.1,7,24,29.2,18,21,85.7,8,22,30,13,21,13,10,2,75,1
1578,35289,62_05_56,PORTUGAL,0,TOTALS,PORTUGAL,200,24,53,45.3,18,36,50.0,6,17,35.3,22,33,66.7,7,15,22,16,27,12,13,0,76,0
1579,35302,62_05_56,HUNGARY,0,TOTALS,HUNGARY,200,28,53,52.8,20,38,52.6,8,15,53.3,23,31,74.2,10,25,35,12,33,21,6,1,87,1
1580,35315,62_05_57,BELGIUM,0,TOTALS,BELGIUM,200,24,57,42.1,19,36,52.8,5,21,23.8,22,31,71.0,14,27,41,12,32,17,5,7,75,0
1581,35328,62_05_57,ISRAEL,0,TOTALS,ISRAEL,200,21,55,38.2,14,39,35.9,7,16,43.8,30,43,69.8,14,23,37,13,32,14,9,1,79,1
1582,35341,62_05_58,CZECH REPUBLIC,0,TOTALS,CZECH REPUBLIC,200,28,73,38.4,20,47,42.6,8,26,30.8,9,15,60.0,11,26,37,13,18,7,14,3,73,1
1583,35354,62_05_58,POLAND,0,TOTALS,POLAND,200,25,56,44.6,20,40,50.0,5,16,31.2,9,17,52.9,8,33,41,11,19,18,3,4,64,0
1584,35367,62_05_59,HUNGARY,0,TOTALS,HUNGARY,200,31,58,53.4,24,41,58.5,7,17,41.2,6,11,54.5,11,20,31,20,21,15,8,4,75,1
1585,35380,62_05_59,SWEDEN,0,TOTALS,SWEDEN,200,25,55,45.5,17,37,45.9,8,18,44.4,10,16,62.5,9,15,24,10,14,12,9,4,68,0
1586,35393,62_05_60,ISRAEL,0,TOTALS,ISRAEL,200,35,60,58.3,26,38,68.4,9,22,40.9,10,11,90.9,3,24,27,24,19,16,12,2,89,1
1587,35404,62_05_60,NETHERLANDS,0,TOTALS,NETHERLANDS,200,22,60,36.7,19,44,43.2,3,16,18.8,13,16,81.2,11,22,33,8,13,23,3,1,60,0
1588,35417,62_05_61,POLAND,0,TOTALS,POLAND,200,26,50,52.0,20,33,60.6,6,17,35.3,24,34,70.6,10,25,35,13,27,21,4,3,82,1
1589,35430,62_05_61,ESTONIA,0,TOTALS,ESTONIA,200,28,64,43.8,20,39,51.3,8,25,32.0,12,24,50.0,8,15,23,15,30,13,12,2,76,0
1590,35443,62_05_62,SWEDEN,0,TOTALS,SWEDEN,200,23,54,42.6,14,29,48.3,9,25,36.0,16,22,72.7,10,16,26,17,21,13,7,2,71,0
1591,35456,62_05_62,PORTUGAL,0,TOTALS,PORTUGAL,200,29,62,46.8,21,46,45.7,8,16,50.0,11,21,52.4,20,21,41,15,25,17,6,3,77,1
1592,35469,62_05_63,NETHERLANDS,0,TOTALS,NETHERLANDS,200,17,45,37.8,15,35,42.9,2,10,20.0,15,26,57.7,12,26,38,4,18,20,8,1,51,0
1593,35482,62_05_63,BELGIUM,0,TOTALS,BELGIUM,200,24,48,50.0,17,28,60.7,7,20,35.0,7,21,33.3,4,19,23,8,22,15,13,0,62,1
1594,35495,62_05_64,CZECH REPUBLIC,0,TOTALS,CZECH REPUBLIC,200,24,52,46.2,18,31,58.1,6,21,28.6,42,49,85.7,8,18,26,14,27,8,9,2,96,1
1595,35508,62_05_64,ESTONIA,0,TOTALS,ESTONIA,200,29,54,53.7,20,37,54.1,9,17,52.9,19,32,59.4,7,20,27,10,37,13,3,0,86,0
1596,35521,62_05_65,HUNGARY,0,TOTALS,HUNGARY,225,27,62,43.5,22,44,50.0,5,18,27.8,18,21,85.7,14,46,60,16,46,40,15,2,77,1
1597,35534,62_05_65,PORTUGAL,0,TOTALS,PORTUGAL,225,26,56,46.4,20,38,52.6,6,18,33.3,18,23,78.3,18,42,60,9,54,44,19,2,76,0
1598,35547,62_05_66,ISRAEL,0,TOTALS,ISRAEL,200,25,66,37.9,21,53,39.6,4,13,30.8,15,25,60.0,16,16,32,10,21,6,10,1,69,1
1599,35560,62_05_66,BELGIUM,0,TOTALS,BELGIUM,200,23,51,45.1,17,35,48.6,6,16,37.5,15,17,88.2,11,26,37,9,19,16,2,8,67,0
1600,35573,62_05_67,POLAND,0,TOTALS,POLAND,200,22,47,46.8,17,31,54.8,5,16,31.2,15,27,55.6,10,20,30,14,26,21,13,4,64,0
1601,35586,62_05_67,CZECH REPUBLIC,0,TOTALS,CZECH REPUBLIC,200,19,53,35.8,13,35,37.1,6,18,33.3,25,33,75.8,11,16,27,10,25,18,12,1,69,1
1602,35599,62_05_68,SWEDEN,0,TOTALS,SWEDEN,200,25,63,39.7,21,44,47.7,4,19,21.1,19,30,63.3,12,27,39,13,25,9,7,5,73,1
1603,35612,62_05_68,HUNGARY,0,TOTALS,HUNGARY,200,20,50,40.0,17,38,44.7,3,12,25.0,24,33,72.7,8,30,38,12,30,15,5,11,67,0
1604,35625,62_05_69,NETHERLANDS,0,TOTALS,NETHERLANDS,200,27,64,42.2,17,38,44.7,10,26,38.5,14,22,63.6,16,20,36,16,25,13,15,2,78,0
1605,35638,62_05_69,ISRAEL,0,TOTALS,ISRAEL,200,23,46,50.0,12,26,46.2,11,20,55.0,25,28,89.3,2,21,23,11,19,23,7,0,82,1
1606,35651,62_05_70,BELGIUM,0,TOTALS,BELGIUM,200,28,64,43.8,21,38,55.3,7,26,26.9,13,21,61.9,11,29,40,14,24,12,7,7,76,1
1607,35664,62_05_70,NETHERLANDS,0,TOTALS,NETHERLANDS,200,22,62,35.5,16,39,41.0,6,23,26.1,13,20,65.0,14,26,40,9,22,18,4,1,63,0
1608,35677,62_05_71,PORTUGAL,0,TOTALS,PORTUGAL,200,24,48,50.0,21,34,61.8,3,14,21.4,23,36,63.9,7,18,25,11,29,19,16,6,74,1
1609,35690,62_05_71,SWEDEN,0,TOTALS,SWEDEN,200,19,56,33.9,13,34,38.2,6,22,27.3,23,37,62.2,9,14,23,7,30,20,12,1,67,0
1610,35703,62_05_72,ESTONIA,0,TOTALS,ESTONIA,200,29,64,45.3,17,36,47.2,12,28,42.9,4,6,66.7,4,18,22,12,20,19,21,2,74,1
1611,35716,62_05_72,POLAND,0,TOTALS,POLAND,200,18,47,38.3,14,31,45.2,4,16,25.0,5,12,41.7,10,27,37,9,15,37,7,0,45,0
1612,35728,62_05_73,POLAND,0,TOTALS,POLAND,200,18,46,39.1,12,23,52.2,6,23,26.1,13,22,59.1,9,29,38,4,24,20,6,2,55,0
1613,35741,62_05_73,SWEDEN,0,TOTALS,SWEDEN,200,23,62,37.1,17,36,47.2,6,26,23.1,15,23,65.2,11,20,31,9,19,14,14,1,67,1
1614,35754,62_05_74,HUNGARY,0,TOTALS,HUNGARY,200,28,51,54.9,21,31,67.7,7,20,35.0,21,28,75.0,4,22,26,14,25,16,9,3,84,1
1615,35767,62_05_74,CZECH REPUBLIC,0,TOTALS,CZECH REPUBLIC,200,27,63,42.9,17,37,45.9,10,26,38.5,15,22,68.2,16,18,34,14,25,12,10,2,79,0
1616,35780,62_05_75,SWEDEN,0,TOTALS,SWEDEN,200,25,59,42.4,18,33,54.5,7,26,26.9,21,31,67.7,13,24,37,9,22,9,10,3,78,1
1617,35793,62_05_75,NETHERLANDS,0,TOTALS,NETHERLANDS,200,26,60,43.3,21,42,50.0,5,18,27.8,8,19,42.1,16,24,40,8,23,15,4,1,65,0
1618,35806,62_05_76,CZECH REPUBLIC,0,TOTALS,CZECH REPUBLIC,200,28,62,45.2,21,38,55.3,7,24,29.2,15,21,71.4,15,24,39,15,33,22,10,2,78,0
1619,35819,62_05_76,ISRAEL,0,TOTALS,ISRAEL,200,24,51,47.1,18,35,51.4,6,16,37.5,29,45,64.4,8,21,29,14,24,13,11,2,83,1
1620,35832,62_05_77,NETHERLANDS,0,TOTALS,NETHERLANDS,200,35,74,47.3,24,45,53.3,11,29,37.9,15,20,75.0,10,23,33,18,14,12,17,0,96,1
1621,35844,62_05_77,POLAND,0,TOTALS,POLAND,200,30,61,49.2,26,43,60.5,4,18,22.2,12,15,80.0,7,31,38,11,20,25,10,4,76,0
1622,35857,62_05_78,ISRAEL,0,TOTALS,ISRAEL,200,25,52,48.1,20,38,52.6,5,14,35.7,28,39,71.8,10,22,32,6,25,9,13,1,83,1
1623,35870,62_05_78,HUNGARY,0,TOTALS,HUNGARY,200,24,55,43.6,19,39,48.7,5,16,31.2,16,20,80.0,8,20,28,11,33,13,6,2,69,0
1624,35883,63_04_01,DENMARK,0,TOTALS,DENMARK,200,31,68,45.6,22,44,50.0,9,24,37.5,10,16,62.5,14,19,33,19,22,16,15,3,81,1
1625,35896,63_04_01,ICELAND,0,TOTALS,ICELAND,200,26,60,43.3,20,37,54.1,6,23,26.1,13,16,81.2,7,22,29,7,15,19,6,1,71,0
1626,35907,63_04_02,MALTA,0,TOTALS,MALTA,200,20,67,29.9,16,47,34.0,4,20,20.0,7,11,63.6,7,18,25,9,22,11,12,0,51,0
1627,35917,63_04_02,IRELAND,0,TOTALS,IRELAND,200,30,67,44.8,18,41,43.9,12,26,46.2,18,28,64.3,14,32,46,16,14,16,6,0,90,1
1628,35929,63_04_03,SWITZERLAND,0,TOTALS,SWITZERLAND,200,23,61,37.7,18,47,38.3,5,14,35.7,5,13,38.5,10,21,31,10,21,16,12,1,56,0
1629,35942,63_04_03,SLOVAK REPUBLIC,0,TOTALS,SLOVAK REPUBLIC,200,27,63,42.9,21,43,48.8,6,20,30.0,13,19,68.4,10,30,40,10,19,14,9,2,73,1
1630,35955,63_04_04,CYPRUS,0,TOTALS,CYPRUS,200,27,66,40.9,22,45,48.9,5,21,23.8,6,13,46.2,11,20,31,11,20,10,10,2,65,0
1631,35968,63_04_04,AUSTRIA,0,TOTALS,AUSTRIA,200,28,53,52.8,21,31,67.7,7,22,31.8,11,17,64.7,3,25,28,11,18,14,8,0,74,1
1632,35981,63_04_05,ALBANIA,0,TOTALS,ALBANIA,200,24,58,41.4,15,36,41.7,9,22,40.9,15,20,75.0,13,22,35,4,26,17,12,4,72,0
1633,35992,63_04_05,BELARUS,0,TOTALS,BELARUS,200,29,56,51.8,25,42,59.5,4,14,28.6,22,30,73.3,10,25,35,2,22,20,11,4,84,1
1634,36005,63_04_06,GEORGIA,0,TOTALS,GEORGIA,200,25,62,40.3,19,38,50.0,6,24,25.0,29,34,85.3,14,28,42,19,20,10,8,3,85,1
1635,36018,63_04_06,FINLAND,0,TOTALS,FINLAND,200,25,58,43.1,10,26,38.5,15,32,46.9,13,16,81.2,4,21,25,24,28,14,4,1,78,0
1636,36031,63_04_07,LUXEMBOURG,0,TOTALS,LUXEMBOURG,200,27,57,47.4,23,41,56.1,4,16,25.0,11,19,57.9,6,18,24,5,11,14,7,2,69,0
1637,36042,63_04_07,MKD,0,TOTALS,MKD,200,36,68,52.9,21,33,63.6,15,35,42.9,7,7,100.0,4,20,24,9,23,11,10,2,94,1
1638,36053,63_04_08,MALTA,0,TOTALS,MALTA,200,16,59,27.1,11,43,25.6,5,16,31.2,16,25,64.0,3,13,16,9,17,18,6,1,53,1
1639,36066,63_04_08,SLOVAK REPUBLIC,0,TOTALS,SLOVAK REPUBLIC,200,41,81,50.6,35,60,58.3,6,21,28.6,19,28,67.9,17,27,44,24,21,11,19,3,107,0
1640,36078,63_04_09,BELARUS,0,TOTALS,BELARUS,200,28,56,50.0,23,42,54.8,5,14,35.7,16,21,76.2,5,23,28,18,32,22,16,2,77,1
1641,36091,63_04_09,CYPRUS,0,TOTALS,CYPRUS,200,22,49,44.9,18,41,43.9,4,8,50.0,24,41,58.5,7,16,23,5,24,22,13,1,72,0
1642,36104,63_04_10,AUSTRIA,0,TOTALS,AUSTRIA,200,27,62,43.5,19,37,51.4,8,25,32.0,21,28,75.0,10,23,33,6,19,13,12,2,83,1
1643,36117,63_04_10,ALBANIA,0,TOTALS,ALBANIA,200,26,59,44.1,15,28,53.6,11,31,35.5,3,7,42.9,8,20,28,2,23,16,6,0,66,0
1644,36129,63_04_11,FINLAND,0,TOTALS,FINLAND,200,35,82,42.7,29,54,53.7,6,28,21.4,21,25,84.0,15,29,44,14,26,10,14,3,97,1
1645,36140,63_04_11,LUXEMBOURG,0,TOTALS,LUXEMBOURG,200,25,63,39.7,23,51,45.1,2,12,16.7,12,18,66.7,7,21,28,11,19,25,6,5,64,0
1646,36152,63_04_12,MKD,0,TOTALS,MKD,200,30,61,49.2,20,32,62.5,10,29,34.5,11,19,57.9,8,18,26,18,21,14,10,5,81,1
1647,36165,63_04_12,GEORGIA,0,TOTALS,GEORGIA,200,27,50,54.0,18,26,69.2,9,24,37.5,14,22,63.6,5,19,24,10,18,18,9,2,77,0
1648,36178,63_04_13,ROMANIA,0,TOTALS,ROMANIA,200,26,54,48.1,21,34,61.8,5,20,25.0,16,30,53.3,10,21,31,9,28,17,14,0,73,0
1649,36191,63_04_13,DENMARK,0,TOTALS,DENMARK,200,25,58,43.1,20,40,50.0,5,18,27.8,19,28,67.9,12,20,32,5,31,8,7,0,74,1
1650,36202,63_04_14,IRELAND,0,TOTALS,IRELAND,200,26,59,44.1,18,37,48.6,8,22,36.4,19,30,63.3,14,24,38,16,19,11,6,3,79,1
1651,36214,63_04_14,SWITZERLAND,0,TOTALS,SWITZERLAND,200,21,59,35.6,12,35,34.3,9,24,37.5,17,23,73.9,7,17,24,9,29,11,3,2,68,0
1652,36227,63_04_15,FINLAND,0,TOTALS,FINLAND,200,28,60,46.7,25,38,65.8,3,22,13.6,19,29,65.5,10,17,27,7,26,13,10,3,78,0
1653,36239,63_04_15,MKD,0,TOTALS,MKD,200,28,49,57.1,18,30,60.0,10,19,52.6,21,30,70.0,6,22,28,12,26,18,5,1,87,1
1654,36250,63_04_16,MALTA,0,TOTALS,MALTA,200,19,59,32.2,15,42,35.7,4,17,23.5,15,18,83.3,8,22,30,16,17,19,5,0,57,0
1655,36262,63_04_16,SWITZERLAND,0,TOTALS,SWITZERLAND,200,36,77,46.8,27,52,51.9,9,25,36.0,9,14,64.3,8,18,26,18,21,10,9,0,90,1
1656,36275,63_04_17,SLOVAK REPUBLIC,0,TOTALS,SLOVAK REPUBLIC,200,28,71,39.4,20,44,45.5,8,27,29.6,6,12,50.0,10,27,37,12,19,11,12,1,70,1
1657,36286,63_04_17,IRELAND,0,TOTALS,IRELAND,200,23,63,36.5,16,38,42.1,7,25,28.0,14,20,70.0,16,29,45,10,15,17,10,6,67,0
1658,36299,63_04_18,ALBANIA,0,TOTALS,ALBANIA,200,26,57,45.6,21,44,47.7,5,13,38.5,10,16,62.5,13,16,29,5,25,21,10,4,67,0
1659,36312,63_04_18,CYPRUS,0,TOTALS,CYPRUS,200,25,67,37.3,20,48,41.7,5,19,26.3,21,30,70.0,19,22,41,4,19,15,12,4,76,1
1660,36325,63_04_19,AUSTRIA,0,TOTALS,AUSTRIA,200,31,66,47.0,23,41,56.1,8,25,32.0,21,28,75.0,13,17,30,16,28,9,10,0,91,0
1661,36336,63_04_19,BELARUS,0,TOTALS,BELARUS,200,33,62,53.2,26,46,56.5,7,16,43.8,19,31,61.3,14,24,38,8,27,15,8,2,92,1
1662,36349,63_04_20,LUXEMBOURG,0,TOTALS,LUXEMBOURG,200,24,49,49.0,21,37,56.8,3,12,25.0,10,18,55.6,7,31,38,7,22,32,9,5,61,0
1663,36362,63_04_20,GEORGIA,0,TOTALS,GEORGIA,200,33,87,37.9,26,63,41.3,7,24,29.2,14,23,60.9,18,23,41,19,19,12,23,2,87,1
1664,36375,63_04_21,ICELAND,0,TOTALS,ICELAND,200,27,55,49.1,19,35,54.3,8,20,40.0,17,24,70.8,3,23,26,23,21,15,7,2,79,1
1665,36388,63_04_21,ROMANIA,0,TOTALS,ROMANIA,200,26,56,46.4,20,36,55.6,6,20,30.0,15,24,62.5,7,22,29,15,20,16,12,4,73,0
1666,36401,63_05_22,AUSTRIA,0,TOTALS,AUSTRIA,200,26,54,48.1,21,36,58.3,5,18,27.8,16,22,72.7,7,28,35,12,21,17,7,6,73,1
1667,36414,63_05_22,CYPRUS,0,TOTALS,CYPRUS,200,24,58,41.4,14,35,40.0,10,23,43.5,8,16,50.0,13,20,33,11,23,15,9,0,66,0
1668,36428,63_05_23,ICELAND,0,TOTALS,ICELAND,200,14,57,24.6,7,31,22.6,7,26,26.9,25,34,73.5,9,23,32,8,29,17,9,2,60,0
1669,36441,63_05_23,DENMARK,0,TOTALS,DENMARK,200,27,57,47.4,20,37,54.1,7,20,35.0,16,29,55.2,10,37,47,18,25,21,9,6,77,1
1670,36454,63_05_24,FINLAND,0,TOTALS,FINLAND,200,30,63,47.6,19,42,45.2,11,21,52.4,16,21,76.2,13,25,38,6,22,8,6,2,87,1
1671,36467,63_05_24,GEORGIA,0,TOTALS,GEORGIA,200,28,61,45.9,16,29,55.2,12,32,37.5,11,19,57.9,10,23,33,8,23,12,6,4,79,0
1672,36479,63_05_25,BELARUS,0,TOTALS,BELARUS,200,36,65,55.4,24,44,54.5,12,21,57.1,26,39,66.7,15,34,49,32,12,14,11,0,110,0
1673,36492,63_05_25,ALBANIA,0,TOTALS,ALBANIA,200,21,69,30.4,12,40,30.0,9,29,31.0,7,9,77.8,5,18,23,7,28,17,11,2,58,1
1674,36507,63_05_26,IRELAND,0,TOTALS,IRELAND,200,40,79,50.6,29,47,61.7,11,32,34.4,7,17,41.2,23,37,60,23,14,14,14,3,98,1
1675,36519,63_05_26,MALTA,0,TOTALS,MALTA,200,20,62,32.3,17,43,39.5,3,19,15.8,6,12,50.0,6,17,23,9,13,15,5,0,49,0
1676,36532,63_05_27,SLOVAK REPUBLIC,0,TOTALS,SLOVAK REPUBLIC,200,17,52,32.7,12,33,36.4,5,19,26.3,21,31,67.7,4,16,20,7,21,13,9,1,60,0
1677,36545,63_05_27,SWITZERLAND,0,TOTALS,SWITZERLAND,200,24,45,53.3,20,31,64.5,4,14,28.6,14,18,77.8,6,27,33,7,23,23,14,5,66,1
1678,36558,63_05_28,MKD,0,TOTALS,MKD,200,38,68,55.9,30,53,56.6,8,15,53.3,21,27,77.8,30,60,90,20,32,22,6,6,105,0
1679,36571,63_05_28,LUXEMBOURG,0,TOTALS,LUXEMBOURG,200,24,65,36.9,19,45,42.2,5,20,25.0,13,16,81.2,8,16,24,7,20,12,8,2,66,1
1680,36584,63_05_29,SLOVAK REPUBLIC,0,TOTALS,SLOVAK REPUBLIC,200,40,76,52.6,38,55,69.1,2,21,9.5,18,26,69.2,17,27,44,22,14,18,26,11,100,0
1681,36596,63_05_29,MALTA,0,TOTALS,MALTA,200,15,54,27.8,15,41,36.6,0,13,0.0,9,10,90.0,7,20,27,3,17,38,15,0,39,1
1682,36609,63_05_30,ALBANIA,0,TOTALS,ALBANIA,200,24,50,48.0,15,28,53.6,9,22,40.9,25,36,69.4,4,22,26,2,23,11,4,1,82,0
1683,36621,63_05_30,AUSTRIA,0,TOTALS,AUSTRIA,200,30,65,46.2,20,40,50.0,10,25,40.0,20,30,66.7,13,23,36,5,25,14,3,3,90,1
1684,36634,63_05_31,GEORGIA,0,TOTALS,GEORGIA,200,27,74,36.5,20,42,47.6,7,32,21.9,12,18,66.7,16,27,43,23,20,13,10,0,73,1
1685,36647,63_05_31,MKD,0,TOTALS,MKD,200,22,57,38.6,18,37,48.6,4,20,20.0,12,20,60.0,7,21,28,16,15,15,10,0,60,0
1686,36660,63_05_32,DENMARK,0,TOTALS,DENMARK,200,23,47,48.9,16,32,50.0,7,15,46.7,14,23,60.9,10,19,29,9,31,24,4,4,67,0
1687,36673,63_05_32,ROMANIA,0,TOTALS,ROMANIA,200,21,51,41.2,17,37,45.9,4,14,28.6,23,37,62.2,16,14,30,6,24,11,16,2,69,1
1688,36686,63_05_33,SWITZERLAND,0,TOTALS,SWITZERLAND,200,25,59,42.4,15,33,45.5,10,26,38.5,16,22,72.7,9,20,29,14,21,18,9,4,76,1
1689,36699,63_05_33,IRELAND,0,TOTALS,IRELAND,200,17,42,40.5,10,21,47.6,7,21,33.3,16,20,80.0,1,19,20,7,23,20,4,1,57,0
1690,36712,63_05_34,CYPRUS,0,TOTALS,CYPRUS,200,27,54,50.0,21,38,55.3,6,16,37.5,27,33,81.8,9,17,26,5,30,14,7,4,87,1
1691,36724,63_05_34,BELARUS,0,TOTALS,BELARUS,200,24,52,46.2,17,28,60.7,7,24,29.2,22,29,75.9,6,16,22,15,28,24,6,2,77,0
1692,36737,63_05_35,LUXEMBOURG,0,TOTALS,LUXEMBOURG,200,19,56,33.9,12,35,34.3,7,21,33.3,17,28,60.7,9,20,29,11,20,17,8,3,62,0
1693,36749,63_05_35,FINLAND,0,TOTALS,FINLAND,200,24,60,40.0,13,32,40.6,11,28,39.3,23,30,76.7,17,28,45,14,24,12,21,3,82,1
1694,36762,63_05_36,ROMANIA,0,TOTALS,ROMANIA,200,25,72,34.7,17,45,37.8,8,27,29.6,14,23,60.9,18,31,49,8,22,19,11,1,72,0
1695,36773,63_05_36,ICELAND,0,TOTALS,ICELAND,200,27,60,45.0,17,34,50.0,10,26,38.5,16,24,66.7,5,32,37,8,20,14,9,2,80,1
1696,36786,63_05_37,BELARUS,0,TOTALS,BELARUS,200,17,56,30.4,11,32,34.4,6,24,25.0,20,27,74.1,13,22,35,7,18,14,8,1,60,0
1697,36799,63_05_37,AUSTRIA,0,TOTALS,AUSTRIA,200,25,60,41.7,17,40,42.5,8,20,40.0,11,12,91.7,9,30,39,7,23,15,6,1,69,1
1698,36812,63_05_38,IRELAND,0,TOTALS,IRELAND,200,27,64,42.2,15,30,50.0,12,34,35.3,16,21,76.2,13,31,44,16,23,15,7,0,82,1
1699,36825,63_05_38,SLOVAK REPUBLIC,0,TOTALS,SLOVAK REPUBLIC,200,22,60,36.7,14,34,41.2,8,26,30.8,16,27,59.3,8,22,30,8,20,11,9,2,68,0
1700,36838,63_05_39,SWITZERLAND,0,TOTALS,SWITZERLAND,200,33,74,44.6,26,51,51.0,7,23,30.4,10,18,55.6,22,24,46,23,16,17,12,4,83,1
1701,36849,63_05_39,MALTA,0,TOTALS,MALTA,200,16,48,33.3,13,32,40.6,3,16,18.8,2,6,33.3,5,13,18,3,16,27,7,1,37,0
1702,36862,63_05_40,CYPRUS,0,TOTALS,CYPRUS,200,29,61,47.5,16,30,53.3,13,31,41.9,25,34,73.5,10,26,36,16,15,12,6,4,96,1
1703,36874,63_05_40,ALBANIA,0,TOTALS,ALBANIA,200,29,70,41.4,17,40,42.5,12,30,40.0,5,10,50.0,14,19,33,6,24,12,5,0,75,0
1704,36887,63_05_41,GEORGIA,0,TOTALS,GEORGIA,200,34,62,54.8,29,41,70.7,5,21,23.8,14,23,60.9,13,24,37,30,13,13,9,2,87,1
1705,36900,63_05_41,LUXEMBOURG,0,TOTALS,LUXEMBOURG,200,25,58,43.1,18,32,56.2,7,26,26.9,8,13,61.5,5,20,25,16,20,16,7,1,65,0
1706,36913,63_05_42,MKD,0,TOTALS,MKD,200,27,54,50.0,16,28,57.1,11,26,42.3,18,26,69.2,3,18,21,19,22,7,6,5,83,1
1707,36925,63_05_42,FINLAND,0,TOTALS,FINLAND,200,26,55,47.3,18,30,60.0,8,25,32.0,10,19,52.6,6,25,31,9,24,10,2,1,70,0
1708,36937,63_05_43,IRELAND,0,TOTALS,IRELAND,200,26,57,45.6,17,40,42.5,9,17,52.9,19,24,79.2,7,24,31,12,23,12,11,4,80,1
1709,36950,63_05_43,DENMARK,0,TOTALS,DENMARK,200,24,54,44.4,20,41,48.8,4,13,30.8,14,25,56.0,9,20,29,2,22,17,4,2,66,0
1710,36963,63_05_44,AUSTRIA,0,TOTALS,AUSTRIA,200,29,67,43.3,23,51,45.1,6,16,37.5,11,16,68.8,9,11,20,6,20,4,4,0,75,1
1711,36976,63_05_44,MKD,0,TOTALS,MKD,200,38,54,70.4,23,27,85.2,15,27,55.6,10,16,62.5,5,23,28,10,15,9,2,0,101,0
1712,36989,63_05_45,DENMARK,0,TOTALS,DENMARK,225,29,65,44.6,21,40,52.5,8,25,32.0,20,32,62.5,8,48,56,19,41,25,4,5,86,1
1713,37001,63_05_45,IRELAND,0,TOTALS,IRELAND,225,23,57,40.4,15,40,37.5,8,17,47.1,16,22,72.7,11,43,54,11,47,24,7,2,70,0
1714,37014,63_05_46,MKD,0,TOTALS,MKD,200,37,63,58.7,28,36,77.8,9,27,33.3,16,24,66.7,5,26,31,22,10,10,7,8,99,1
1715,37027,63_05_46,AUSTRIA,0,TOTALS,AUSTRIA,200,27,63,42.9,22,46,47.8,5,17,29.4,3,4,75.0,6,20,26,14,19,12,6,0,62,0
1716,37040,64_05_01,SLOVENIA,0,TOTALS,SLOVENIA,200,26,59,44.1,21,43,48.8,5,16,31.2,17,24,70.8,10,31,41,11,26,16,7,3,74,1
1717,37053,64_05_01,BOSNIA AND HERZEGOVINA,0,TOTALS,BOSNIA AND HERZEGOVINA,200,20,51,39.2,16,35,45.7,4,16,25.0,21,28,75.0,3,29,32,11,27,15,6,2,65,0
1718,37066,64_05_02,LATVIA,0,TOTALS,LATVIA,200,23,65,35.4,16,34,47.1,7,31,22.6,12,16,75.0,6,25,31,8,22,11,11,8,65,0
1719,37079,64_05_02,ISRAEL,0,TOTALS,ISRAEL,200,24,59,40.7,17,39,43.6,7,20,35.0,19,25,76.0,9,29,38,9,19,12,11,3,74,1
1720,37092,64_05_03,GERMANY,0,TOTALS,GERMANY,225,27,65,41.5,20,39,51.3,7,26,26.9,21,31,67.7,13,30,43,10,23,12,6,4,82,0
1721,37105,64_05_03,ITALY,0,TOTALS,ITALY,225,33,70,47.1,24,46,52.2,9,24,37.5,9,20,45.0,12,29,41,13,21,10,6,3,84,1
1722,37118,64_05_04,CROATIA,0,TOTALS,CROATIA,200,31,59,52.5,26,44,59.1,5,15,33.3,21,29,72.4,10,26,36,12,16,20,11,5,88,1
1723,37131,64_05_04,BULGARIA,0,TOTALS,BULGARIA,200,31,72,43.1,20,45,44.4,11,27,40.7,11,16,68.8,7,18,25,11,27,17,14,0,84,0
1724,37144,64_05_05,FRANCE,0,TOTALS,FRANCE,200,21,50,42.0,20,38,52.6,1,12,8.3,7,15,46.7,11,24,35,9,27,22,2,4,50,0
1725,37157,64_05_05,GREECE,0,TOTALS,GREECE,200,22,46,47.8,18,36,50.0,4,10,40.0,16,31,51.6,10,21,31,12,22,16,9,1,64,1
1726,37170,64_05_06,SERBIA & MONTENEGRO,0,TOTALS,SERBIA & MONTENEGRO,200,23,57,40.4,16,35,45.7,7,22,31.8,17,19,89.5,8,21,29,10,28,14,5,6,70,0
1727,37183,64_05_06,SPAIN,0,TOTALS,SPAIN,200,29,62,46.8,19,37,51.4,10,25,40.0,21,29,72.4,10,23,33,9,20,8,14,3,89,1
1728,37196,64_05_07,RUSSIA,0,TOTALS,RUSSIA,200,30,73,41.1,23,50,46.0,7,23,30.4,19,33,57.6,20,27,47,14,17,12,7,5,86,1
1729,37209,64_05_07,UKRAINE,0,TOTALS,UKRAINE,200,28,72,38.9,22,53,41.5,6,19,31.6,12,21,57.1,19,26,45,11,27,14,4,2,74,0
1730,37222,64_05_08,TURKEY,0,TOTALS,TURKEY,200,27,63,42.9,21,38,55.3,6,25,24.0,15,20,75.0,6,16,22,8,24,9,13,3,75,0
1731,37235,64_05_08,LITHUANIA,0,TOTALS,LITHUANIA,200,30,57,52.6,21,34,61.8,9,23,39.1,18,22,81.8,9,27,36,10,28,20,8,2,87,1
1732,37248,64_05_09,BOSNIA AND HERZEGOVINA,0,TOTALS,BOSNIA AND HERZEGOVINA,200,23,61,37.7,13,36,36.1,10,25,40.0,6,14,42.9,10,27,37,12,28,16,3,0,62,0
1733,37261,64_05_09,FRANCE,0,TOTALS,FRANCE,200,28,66,42.4,23,46,50.0,5,20,25.0,18,36,50.0,20,28,48,16,19,9,7,7,79,1
1734,37274,64_05_10,SPAIN,0,TOTALS,SPAIN,225,25,57,43.9,12,31,38.7,13,26,50.0,51,63,81.0,12,25,37,11,20,16,13,2,114,1
1735,37287,64_05_10,LATVIA,0,TOTALS,LATVIA,225,37,80,46.2,19,35,54.3,18,45,40.0,17,26,65.4,17,23,40,16,39,18,13,3,109,0
1736,37300,64_05_11,ITALY,0,TOTALS,ITALY,200,19,58,32.8,15,35,42.9,4,23,17.4,19,21,90.5,10,22,32,13,24,16,6,1,61,0
1737,37313,64_05_11,RUSSIA,0,TOTALS,RUSSIA,200,33,60,55.0,26,45,57.8,7,15,46.7,14,22,63.6,10,29,39,15,20,13,12,4,87,1
1738,37326,64_05_12,LITHUANIA,0,TOTALS,LITHUANIA,200,27,58,46.6,15,33,45.5,12,25,48.0,19,23,82.6,8,26,34,14,23,20,12,4,85,1
1739,37339,64_05_12,CROATIA,0,TOTALS,CROATIA,200,24,59,40.7,19,44,43.2,5,15,33.3,14,18,77.8,10,15,25,8,21,20,11,1,67,0
1740,37352,64_05_13,GREECE,0,TOTALS,GREECE,200,18,50,36.0,15,29,51.7,3,21,14.3,17,28,60.7,6,22,28,11,25,16,5,1,56,0
1741,37365,64_05_13,SLOVENIA,0,TOTALS,SLOVENIA,200,25,57,43.9,21,44,47.7,4,13,30.8,14,26,53.8,10,29,39,6,29,15,8,3,68,1
1742,37378,64_05_14,ISRAEL,0,TOTALS,ISRAEL,200,29,61,47.5,21,39,53.8,8,22,36.4,11,21,52.4,11,15,26,16,26,15,12,2,77,0
1743,37391,64_05_14,SERBIA & MONTENEGRO,0,TOTALS,SERBIA & MONTENEGRO,200,34,58,58.6,29,42,69.0,5,16,31.2,20,26,76.9,9,27,36,15,22,18,8,3,93,1
1744,37404,64_05_15,UKRAINE,0,TOTALS,UKRAINE,200,22,60,36.7,20,43,46.5,2,17,11.8,12,19,63.2,12,19,31,10,20,15,6,3,58,0
1745,37417,64_05_15,GERMANY,0,TOTALS,GERMANY,200,29,54,53.7,23,37,62.2,6,17,35.3,20,25,80.0,6,27,33,13,16,14,10,3,84,1
1746,37430,64_05_16,BULGARIA,0,TOTALS,BULGARIA,225,33,66,50.0,23,39,59.0,10,27,37.0,13,21,61.9,14,22,36,13,31,19,7,0,89,0
1747,37443,64_05_16,TURKEY,0,TOTALS,TURKEY,225,30,58,51.7,21,38,55.3,9,20,45.0,25,42,59.5,9,16,25,6,21,12,12,2,94,1
1748,37456,64_05_17,SLOVENIA,0,TOTALS,SLOVENIA,200,22,56,39.3,17,42,40.5,5,14,35.7,19,35,54.3,12,33,45,11,22,15,5,0,68,1
1749,37469,64_05_17,FRANCE,0,TOTALS,FRANCE,200,22,58,37.9,18,41,43.9,4,17,23.5,10,21,47.6,6,33,39,8,28,16,10,3,58,0
1750,37482,64_05_18,SPAIN,0,TOTALS,SPAIN,200,21,54,38.9,17,37,45.9,4,17,23.5,31,39,79.5,12,25,37,10,15,17,8,1,77,0
1751,37495,64_05_18,ISRAEL,0,TOTALS,ISRAEL,200,35,65,53.8,26,44,59.1,9,21,42.9,6,8,75.0,8,21,29,15,34,13,13,2,85,1
1752,37508,64_05_19,ITALY,0,TOTALS,ITALY,200,34,66,51.5,19,37,51.4,15,29,51.7,16,22,72.7,16,24,40,20,21,13,10,1,99,1
1753,37521,64_05_19,UKRAINE,0,TOTALS,UKRAINE,200,22,56,39.3,19,39,48.7,3,17,17.6,15,22,68.2,11,19,30,9,24,16,2,0,62,0
1754,37534,64_05_20,LITHUANIA,0,TOTALS,LITHUANIA,200,32,65,49.2,19,33,57.6,13,32,40.6,15,19,78.9,12,16,28,18,18,18,19,2,92,1
1755,37547,64_05_20,BULGARIA,0,TOTALS,BULGARIA,200,27,54,50.0,18,31,58.1,9,23,39.1,16,22,72.7,8,8,16,7,22,24,13,2,79,0
1756,37560,64_05_21,GREECE,0,TOTALS,GREECE,200,29,56,51.8,21,33,63.6,8,23,34.8,1,6,16.7,10,27,37,20,14,18,6,1,67,1
1757,37573,64_05_21,BOSNIA AND HERZEGOVINA,0,TOTALS,BOSNIA AND HERZEGOVINA,200,17,45,37.8,10,24,41.7,7,21,33.3,9,16,56.2,5,27,32,8,16,19,6,0,50,0
1758,37586,64_05_22,LATVIA,0,TOTALS,LATVIA,200,21,62,33.9,15,30,50.0,6,32,18.8,19,25,76.0,9,30,39,7,31,11,7,1,67,0
1759,37599,64_05_22,SERBIA & MONTENEGRO,0,TOTALS,SERBIA & MONTENEGRO,200,24,56,42.9,17,35,48.6,7,21,33.3,27,38,71.1,8,35,43,13,26,9,6,2,82,1
1760,37612,64_05_23,RUSSIA,0,TOTALS,RUSSIA,200,17,54,31.5,11,33,33.3,6,21,28.6,10,17,58.8,8,29,37,6,15,19,14,3,50,0
1761,37625,64_05_23,GERMANY,0,TOTALS,GERMANY,200,17,56,30.4,10,29,34.5,7,27,25.9,10,15,66.7,10,29,39,8,18,18,10,2,51,1
1762,37638,64_05_24,CROATIA,0,TOTALS,CROATIA,200,29,49,59.2,21,33,63.6,8,16,50.0,14,19,73.7,5,20,25,17,17,27,10,2,80,1
1763,37651,64_05_24,TURKEY,0,TOTALS,TURKEY,200,26,57,45.6,21,40,52.5,5,17,29.4,10,12,83.3,9,14,23,11,23,27,18,2,67,0
1764,37664,64_05_25,GERMANY,0,TOTALS,GERMANY,200,21,49,42.9,14,32,43.8,7,17,41.2,17,19,89.5,4,28,32,11,20,15,3,3,66,1
1765,37677,64_05_25,TURKEY,0,TOTALS,TURKEY,200,21,61,34.4,17,43,39.5,4,18,22.2,11,18,61.1,8,23,31,9,21,8,10,2,57,0
1766,37690,64_05_26,CROATIA,0,TOTALS,CROATIA,200,24,54,44.4,20,37,54.1,4,17,23.5,22,28,78.6,11,29,40,11,20,19,5,2,74,1
1767,37703,64_05_26,ITALY,0,TOTALS,ITALY,200,22,60,36.7,16,35,45.7,6,25,24.0,16,19,84.2,7,15,22,9,23,21,16,4,66,0
1768,37716,64_05_27,GREECE,0,TOTALS,GREECE,200,23,57,40.4,20,44,45.5,3,13,23.1,18,30,60.0,13,25,38,14,20,25,13,1,67,1
1769,37729,64_05_27,ISRAEL,0,TOTALS,ISRAEL,200,22,50,44.0,12,27,44.4,10,23,43.5,7,12,58.3,5,23,28,17,27,20,11,4,61,0
1770,37742,64_05_28,SERBIA & MONTENEGRO,0,TOTALS,SERBIA & MONTENEGRO,200,22,53,41.5,13,28,46.4,9,25,36.0,18,30,60.0,4,27,31,14,23,16,11,0,71,0
1771,37755,64_05_28,FRANCE,0,TOTALS,FRANCE,200,27,56,48.2,23,39,59.0,4,17,23.5,16,23,69.6,8,28,36,10,22,15,5,4,74,1
1772,37768,64_05_29,RUSSIA,0,TOTALS,RUSSIA,200,20,60,33.3,16,33,48.5,4,27,14.8,17,26,65.4,10,36,46,8,28,20,7,7,61,0
1773,37781,64_05_29,GREECE,0,TOTALS,GREECE,200,23,59,39.0,20,40,50.0,3,19,15.8,17,26,65.4,8,38,46,6,25,15,9,2,66,1
1774,37794,64_05_30,LITHUANIA,0,TOTALS,LITHUANIA,200,19,57,33.3,17,37,45.9,2,20,10.0,7,10,70.0,11,24,35,5,24,15,6,3,47,0
1775,37807,64_05_30,FRANCE,0,TOTALS,FRANCE,200,21,54,38.9,15,36,41.7,6,18,33.3,15,24,62.5,14,33,47,12,20,15,8,1,63,1
1776,37820,64_05_31,RUSSIA,0,TOTALS,RUSSIA,200,26,62,41.9,15,38,39.5,11,24,45.8,15,23,65.2,14,20,34,9,18,12,7,1,78,0
1777,37833,64_05_31,LITHUANIA,0,TOTALS,LITHUANIA,200,37,59,62.7,30,44,68.2,7,15,46.7,8,14,57.1,4,29,33,23,23,11,8,5,89,1
1778,37846,64_05_32,SLOVENIA,0,TOTALS,SLOVENIA,200,20,63,31.7,14,41,34.1,6,22,27.3,16,27,59.3,15,27,42,8,26,14,8,4,62,0
1779,37859,64_05_32,GERMANY,0,TOTALS,GERMANY,200,24,57,42.1,13,34,38.2,11,23,47.8,17,21,81.0,9,31,40,9,26,16,8,5,76,1
1780,37872,64_05_33,SPAIN,0,TOTALS,SPAIN,225,29,61,47.5,24,40,60.0,5,21,23.8,38,49,77.6,12,30,42,12,14,14,6,4,101,0
1781,37885,64_05_33,CROATIA,0,TOTALS,CROATIA,225,34,71,47.9,25,47,53.2,9,24,37.5,8,12,66.7,7,25,32,16,38,14,7,1,85,1
1782,37898,64_05_34,SLOVENIA,0,TOTALS,SLOVENIA,200,27,63,42.9,19,43,44.2,8,20,40.0,27,34,79.4,15,26,41,11,29,12,9,3,89,1
1783,37911,64_05_34,CROATIA,0,TOTALS,CROATIA,200,26,62,41.9,18,44,40.9,8,18,44.4,20,29,69.0,12,26,38,12,34,18,5,2,80,0
1784,37924,64_05_35,GREECE,0,TOTALS,GREECE,200,25,64,39.1,22,49,44.9,3,15,20.0,14,26,53.8,12,25,37,8,25,10,5,0,67,1
1785,37937,64_05_35,FRANCE,0,TOTALS,FRANCE,200,23,53,43.4,16,31,51.6,7,22,31.8,13,19,68.4,9,31,40,10,25,21,3,4,66,0
1786,37950,64_05_36,GERMANY,0,TOTALS,GERMANY,200,28,61,45.9,15,28,53.6,13,33,39.4,5,9,55.6,3,19,22,18,31,11,5,0,74,1
1787,37963,64_05_36,SPAIN,0,TOTALS,SPAIN,200,24,61,39.3,22,42,52.4,2,19,10.5,23,32,71.9,13,26,39,5,19,14,5,1,73,0
1788,37976,64_05_37,RUSSIA,0,TOTALS,RUSSIA,200,30,72,41.7,23,44,52.3,7,28,25.0,7,15,46.7,12,32,44,19,17,18,6,3,74,0
1789,37989,64_05_37,CROATIA,0,TOTALS,CROATIA,200,34,74,45.9,22,50,44.0,12,24,50.0,12,14,85.7,9,27,36,18,17,12,9,2,92,1
1790,38002,64_05_38,LITHUANIA,0,TOTALS,LITHUANIA,200,26,53,49.1,19,39,48.7,7,14,50.0,20,33,60.6,8,27,35,14,27,17,9,5,79,1
1791,38015,64_05_38,SLOVENIA,0,TOTALS,SLOVENIA,200,23,62,37.1,20,42,47.6,3,20,15.0,21,30,70.0,13,24,37,9,29,16,8,4,70,0
1792,38028,64_05_39,FRANCE,0,TOTALS,FRANCE,200,39,75,52.0,28,53,52.8,11,22,50.0,9,13,69.2,24,17,41,18,26,14,12,4,98,1
1793,38041,64_05_39,SPAIN,0,TOTALS,SPAIN,200,18,47,38.3,10,30,33.3,8,17,47.1,24,33,72.7,12,13,25,6,17,18,7,4,68,0
1794,38054,64_05_40,GREECE,0,TOTALS,GREECE,200,27,60,45.0,20,39,51.3,7,21,33.3,17,24,70.8,10,19,29,15,21,8,14,0,78,1
1795,38067,64_05_40,GERMANY,0,TOTALS,GERMANY,200,20,42,47.6,17,26,65.4,3,16,18.8,19,20,95.0,3,25,28,6,23,21,1,3,62,0
1796,42030,68_05_01,BELARUS,0,TOTALS,BELARUS,200,26,54,48.1,22,41,53.7,4,13,30.8,16,21,76.2,9,30,39,10,17,15,11,5,72,1
1797,42043,68_05_01,CZECH REPUBLIC,0,TOTALS,CZECH REPUBLIC,200,19,52,36.5,13,37,35.1,6,15,40.0,8,16,50.0,8,20,28,10,19,16,3,1,52,0
1798,42056,68_05_02,SERBIA & MONTENEGRO,0,TOTALS,SERBIA & MONTENEGRO,200,33,65,50.8,28,55,50.9,5,10,50.0,9,16,56.2,6,20,26,14,22,9,6,2,80,1
1799,42069,68_05_02,SPAIN,0,TOTALS,SPAIN,200,27,58,46.6,21,41,51.2,6,17,35.3,13,20,65.0,12,28,40,10,17,19,8,1,73,0
1800,42082,68_05_03,ITALY,0,TOTALS,ITALY,200,28,56,50.0,23,37,62.2,5,19,26.3,16,20,80.0,9,18,27,14,34,28,11,1,77,1
1801,42095,68_05_03,LITHUANIA,0,TOTALS,LITHUANIA,200,33,57,57.9,26,44,59.1,7,13,53.8,36,49,73.5,9,22,31,10,23,19,13,1,109,0
1802,42108,68_05_04,FRANCE,0,TOTALS,FRANCE,200,23,56,41.1,15,29,51.7,8,27,29.6,12,20,60.0,12,24,36,10,21,18,8,2,66,1
1803,42121,68_05_04,SLOVENIA,0,TOTALS,SLOVENIA,200,22,53,41.5,17,35,48.6,5,18,27.8,8,12,66.7,8,22,30,10,21,22,4,6,57,0
1804,42134,68_05_05,GERMANY,0,TOTALS,GERMANY,200,20,58,34.5,12,34,35.3,8,24,33.3,12,20,60.0,7,23,30,9,22,15,6,0,60,0
1805,42147,68_05_05,GREECE,0,TOTALS,GREECE,200,32,61,52.5,20,37,54.1,12,24,50.0,13,20,65.0,9,32,41,14,19,14,7,7,89,1
1806,42160,68_05_06,CROATIA,0,TOTALS,CROATIA,200,28,66,42.4,22,45,48.9,6,21,28.6,6,9,66.7,11,31,42,8,27,14,1,0,68,0
1807,42173,68_05_06,RUSSIA,0,TOTALS,RUSSIA,200,30,60,50.0,27,44,61.4,3,16,18.8,20,37,54.1,7,29,36,9,14,4,9,5,83,1
1808,42186,68_05_07,UKRAINE,0,TOTALS,UKRAINE,200,23,61,37.7,13,38,34.2,10,23,43.5,16,20,80.0,17,25,42,12,31,18,5,4,72,0
1809,42199,68_05_07,LATVIA,0,TOTALS,LATVIA,200,24,57,42.1,17,37,45.9,7,20,35.0,18,31,58.1,12,23,35,6,26,12,8,3,73,1
1810,42212,68_05_08,ISRAEL,0,TOTALS,ISRAEL,200,24,59,40.7,21,49,42.9,3,10,30.0,22,35,62.9,16,25,41,13,29,19,11,0,73,1
1811,42225,68_05_08,TURKEY,0,TOTALS,TURKEY,200,21,53,39.6,16,39,41.0,5,14,35.7,18,36,50.0,13,25,38,5,29,21,9,2,65,0
1812,42238,68_05_09,BELARUS,0,TOTALS,BELARUS,200,19,55,34.5,15,35,42.9,4,20,20.0,7,12,58.3,11,22,33,9,20,27,13,6,49,0
1813,42251,68_05_09,LITHUANIA,0,TOTALS,LITHUANIA,200,34,64,53.1,26,44,59.1,8,20,40.0,17,25,68.0,14,28,42,17,15,19,16,4,93,1
1814,42264,68_05_10,SLOVENIA,0,TOTALS,SLOVENIA,200,24,56,42.9,20,31,64.5,4,25,16.0,10,16,62.5,6,24,30,11,20,13,3,7,62,0
1815,42277,68_05_10,CROATIA,0,TOTALS,CROATIA,200,32,69,46.4,23,49,46.9,9,20,45.0,8,13,61.5,15,28,43,12,23,14,5,3,81,1
1816,42290,68_05_11,GREECE,0,TOTALS,GREECE,200,31,61,50.8,23,48,47.9,8,13,61.5,17,26,65.4,14,26,40,13,23,7,11,1,87,1
1817,42303,68_05_11,UKRAINE,0,TOTALS,UKRAINE,200,19,54,35.2,11,24,45.8,8,30,26.7,14,27,51.9,13,25,38,8,21,20,4,5,60,0
1818,42316,68_05_12,ISRAEL,0,TOTALS,ISRAEL,200,28,63,44.4,26,47,55.3,2,16,12.5,13,15,86.7,12,15,27,14,25,12,12,3,71,1
1819,42329,68_05_12,SPAIN,0,TOTALS,SPAIN,200,22,48,45.8,17,31,54.8,5,17,29.4,16,26,61.5,15,22,37,12,21,25,3,3,65,0
1820,42342,68_05_13,LATVIA,0,TOTALS,LATVIA,200,29,54,53.7,22,38,57.9,7,16,43.8,24,33,72.7,10,28,38,10,20,17,7,5,89,1
1821,42355,68_05_13,GERMANY,0,TOTALS,GERMANY,200,26,66,39.4,21,43,48.8,5,23,21.7,10,14,71.4,10,16,26,11,25,14,8,1,67,0
1822,42368,68_05_14,RUSSIA,0,TOTALS,RUSSIA,200,28,61,45.9,21,44,47.7,7,17,41.2,13,19,68.4,17,24,41,11,26,17,8,2,76,1
1823,42381,68_05_14,FRANCE,0,TOTALS,FRANCE,200,20,51,39.2,17,39,43.6,3,12,25.0,17,29,58.6,14,18,32,3,20,16,11,2,60,0
1824,42394,68_05_15,CZECH REPUBLIC,0,TOTALS,CZECH REPUBLIC,200,20,59,33.9,17,40,42.5,3,19,15.8,9,15,60.0,11,28,39,8,24,20,7,3,52,0
1825,42407,68_05_15,ITALY,0,TOTALS,ITALY,200,24,61,39.3,18,37,48.6,6,24,25.0,19,24,79.2,11,28,39,10,21,13,9,3,73,1
1826,42420,68_05_16,SERBIA & MONTENEGRO,0,TOTALS,SERBIA & MONTENEGRO,200,31,62,50.0,26,46,56.5,5,16,31.2,11,18,61.1,10,30,40,6,21,11,5,1,78,1
1827,42433,68_05_16,TURKEY,0,TOTALS,TURKEY,200,18,53,34.0,15,36,41.7,3,17,17.6,13,21,61.9,6,18,24,7,20,9,7,1,52,0
1828,42446,68_05_17,GERMANY,0,TOTALS,GERMANY,200,24,73,32.9,20,57,35.1,4,16,25.0,11,24,45.8,19,18,37,8,29,10,9,2,63,0
1829,42459,68_05_17,UKRAINE,0,TOTALS,UKRAINE,200,24,48,50.0,18,33,54.5,6,15,40.0,17,28,60.7,9,33,42,13,22,20,1,6,71,1
1830,42472,68_05_18,FRANCE,0,TOTALS,FRANCE,200,28,60,46.7,20,44,45.5,8,16,50.0,12,12,100.0,8,23,31,12,13,14,11,1,76,1
1831,42485,68_05_18,CROATIA,0,TOTALS,CROATIA,200,25,56,44.6,23,40,57.5,2,16,12.5,5,7,71.4,8,22,30,8,17,20,6,3,57,0
1832,42498,68_05_19,ISRAEL,0,TOTALS,ISRAEL,200,22,62,35.5,19,49,38.8,3,13,23.1,8,11,72.7,9,19,28,5,16,11,11,1,55,0
1833,42511,68_05_19,SERBIA & MONTENEGRO,0,TOTALS,SERBIA & MONTENEGRO,200,26,60,43.3,24,47,51.1,2,13,15.4,14,18,77.8,13,31,44,10,18,17,6,3,68,1
1834,42524,68_05_20,CZECH REPUBLIC,0,TOTALS,CZECH REPUBLIC,200,21,54,38.9,16,33,48.5,5,21,23.8,10,14,71.4,5,22,27,15,33,26,6,2,57,1
1835,42537,68_05_20,LITHUANIA,0,TOTALS,LITHUANIA,200,32,65,49.2,24,40,60.0,8,25,32.0,29,48,60.4,20,28,48,16,21,13,17,4,101,0
1836,42550,68_05_21,RUSSIA,0,TOTALS,RUSSIA,200,22,57,38.6,15,36,41.7,7,21,33.3,13,17,76.5,24,19,43,11,25,22,9,1,64,0
1837,42563,68_05_21,SLOVENIA,0,TOTALS,SLOVENIA,200,20,45,44.4,18,32,56.2,2,13,15.4,23,26,88.5,8,14,22,6,22,19,8,8,65,1
1838,42576,68_05_22,ITALY,0,TOTALS,ITALY,200,22,57,38.6,15,31,48.4,7,26,26.9,13,17,76.5,8,25,33,11,25,17,10,1,64,1
1839,42589,68_05_22,BELARUS,0,TOTALS,BELARUS,200,18,59,30.5,14,37,37.8,4,22,18.2,13,32,40.6,24,27,51,10,19,22,11,1,53,0
1840,42602,68_05_23,SPAIN,0,TOTALS,SPAIN,200,30,57,52.6,22,37,59.5,8,20,40.0,10,16,62.5,16,28,44,15,19,16,11,5,78,1
1841,42615,68_05_23,TURKEY,0,TOTALS,TURKEY,200,19,51,37.3,13,25,52.0,6,26,23.1,9,18,50.0,14,16,30,5,20,16,4,3,53,0
1842,42628,68_05_24,LATVIA,0,TOTALS,LATVIA,200,18,66,27.3,11,34,32.4,7,32,21.9,10,16,62.5,17,22,39,4,24,15,8,2,53,0
1843,42641,68_05_24,SERBIA & MONTENEGRO,0,TOTALS,SERBIA & MONTENEGRO,200,27,58,46.6,22,46,47.8,5,12,41.7,14,23,60.9,15,30,45,6,17,17,9,2,73,1
1844,42654,68_05_25,GERMANY,0,TOTALS,GERMANY,200,18,55,32.7,15,43,34.9,3,12,25.0,13,20,65.0,11,20,31,7,20,19,7,2,52,0
1845,42667,68_05_25,SPAIN,0,TOTALS,SPAIN,200,25,48,52.1,14,26,53.8,11,22,50.0,12,17,70.6,3,30,33,17,25,22,7,7,73,1
1846,42680,68_05_26,GREECE,0,TOTALS,GREECE,200,19,50,38.0,14,33,42.4,5,17,29.4,8,16,50.0,6,25,31,5,12,17,7,2,51,0
1847,42693,68_05_26,ISRAEL,0,TOTALS,ISRAEL,200,27,63,42.9,23,48,47.9,4,15,26.7,2,6,33.3,13,28,41,12,20,16,10,2,60,1
1848,42706,68_05_27,UKRAINE,0,TOTALS,UKRAINE,200,19,62,30.6,11,33,33.3,8,29,27.6,13,19,68.4,14,31,45,13,24,20,9,4,59,0
1849,42719,68_05_27,TURKEY,0,TOTALS,TURKEY,200,23,65,35.4,18,49,36.7,5,16,31.2,17,25,68.0,15,31,46,15,21,18,12,5,68,1
1850,42732,68_05_28,ITALY,0,TOTALS,ITALY,200,22,58,37.9,11,29,37.9,11,29,37.9,17,22,77.3,5,22,27,9,21,8,6,2,72,0
1851,42745,68_05_28,RUSSIA,0,TOTALS,RUSSIA,200,31,62,50.0,23,40,57.5,8,22,36.4,6,15,40.0,14,32,46,10,20,14,6,4,76,1
1852,42758,68_05_29,CZECH REPUBLIC,0,TOTALS,CZECH REPUBLIC,200,20,57,35.1,17,43,39.5,3,14,21.4,13,22,59.1,6,19,25,12,21,16,8,2,56,0
1853,42771,68_05_29,CROATIA,0,TOTALS,CROATIA,200,29,53,54.7,27,39,69.2,2,14,14.3,12,21,57.1,10,33,43,14,24,24,10,6,72,1
1854,42784,68_05_30,LITHUANIA,0,TOTALS,LITHUANIA,200,33,58,56.9,28,42,66.7,5,16,31.2,16,28,57.1,9,29,38,12,20,9,3,0,87,1
1855,42797,68_05_30,FRANCE,0,TOTALS,FRANCE,200,26,56,46.4,19,37,51.4,7,19,36.8,6,18,33.3,7,23,30,13,24,13,7,2,65,0
1856,42810,68_05_31,BELARUS,0,TOTALS,BELARUS,200,19,69,27.5,13,41,31.7,6,28,21.4,12,14,85.7,19,15,34,11,24,19,10,6,56,0
1857,42823,68_05_31,SLOVENIA,0,TOTALS,SLOVENIA,200,28,53,52.8,26,43,60.5,2,10,20.0,16,19,84.2,10,28,38,16,18,25,9,9,74,1
1858,42836,68_05_32,ISRAEL,0,TOTALS,ISRAEL,200,22,49,44.9,22,43,51.2,0,6,0.0,16,31,51.6,11,30,41,11,29,19,7,2,60,0
1859,42849,68_05_32,ITALY,0,TOTALS,ITALY,200,20,65,30.8,15,42,35.7,5,23,21.7,19,32,59.4,16,23,39,7,24,14,7,3,64,1
1860,42862,68_05_33,CROATIA,0,TOTALS,CROATIA,200,38,78,48.7,27,54,50.0,11,24,45.8,3,3,100.0,10,20,30,16,13,13,19,2,90,1
1861,42875,68_05_33,UKRAINE,0,TOTALS,UKRAINE,200,25,55,45.5,21,40,52.5,4,15,26.7,7,8,87.5,8,30,38,10,7,29,8,7,61,0
1862,42888,68_05_34,FRANCE,0,TOTALS,FRANCE,200,20,49,40.8,14,32,43.8,6,17,35.3,10,18,55.6,11,23,34,10,22,16,9,2,56,1
1863,42901,68_05_34,LATVIA,0,TOTALS,LATVIA,200,25,58,43.1,25,45,55.6,0,13,0.0,4,13,30.8,15,20,35,8,16,17,4,1,54,0
1864,42914,68_05_35,TURKEY,0,TOTALS,TURKEY,225,26,60,43.3,22,43,51.2,4,17,23.5,17,29,58.6,8,30,38,10,22,12,8,6,73,1
1865,42927,68_05_35,CZECH REPUBLIC,0,TOTALS,CZECH REPUBLIC,225,22,69,31.9,17,42,40.5,5,27,18.5,16,23,69.6,20,29,49,8,29,17,7,4,65,0
1866,42940,68_05_36,RUSSIA,0,TOTALS,RUSSIA,200,24,56,42.9,17,30,56.7,7,26,26.9,16,20,80.0,14,31,45,13,16,16,11,4,71,1
1867,42953,68_05_36,GREECE,0,TOTALS,GREECE,200,19,61,31.1,16,43,37.2,3,18,16.7,9,21,42.9,17,18,35,9,19,14,7,1,50,0
1868,42966,68_05_37,SLOVENIA,0,TOTALS,SLOVENIA,200,26,57,45.6,21,35,60.0,5,22,22.7,19,26,73.1,11,28,39,15,19,10,9,8,76,1
1869,42979,68_05_37,GERMANY,0,TOTALS,GERMANY,200,23,66,34.8,16,44,36.4,7,22,31.8,8,14,57.1,13,21,34,11,21,16,4,2,61,0
1870,42992,68_05_38,SERBIA & MONTENEGRO,0,TOTALS,SERBIA & MONTENEGRO,200,26,48,54.2,21,33,63.6,5,15,33.3,5,14,35.7,6,27,33,13,23,18,5,3,62,0
1871,43005,68_05_38,LITHUANIA,0,TOTALS,LITHUANIA,200,19,59,32.2,16,43,37.2,3,16,18.8,26,33,78.8,16,20,36,5,17,12,13,0,67,1
1872,43018,68_05_39,SPAIN,0,TOTALS,SPAIN,200,28,57,49.1,22,43,51.2,6,14,42.9,24,36,66.7,13,31,44,19,12,16,15,3,86,1
1873,43031,68_05_39,BELARUS,0,TOTALS,BELARUS,200,21,65,32.3,13,39,33.3,8,26,30.8,6,9,66.7,11,22,33,12,22,20,13,2,56,0
1874,43044,68_05_40,GREECE,0,TOTALS,GREECE,200,27,60,45.0,20,40,50.0,7,20,35.0,18,25,72.0,9,36,45,9,27,16,8,4,79,1
1875,43057,68_05_40,ITALY,0,TOTALS,ITALY,200,23,66,34.8,14,36,38.9,9,30,30.0,16,27,59.3,13,25,38,13,25,13,11,3,71,0
1876,43070,68_05_41,UKRAINE,0,TOTALS,UKRAINE,200,26,56,46.4,21,44,47.7,5,12,41.7,22,30,73.3,15,30,45,17,16,19,6,8,79,1
1877,43083,68_05_41,CZECH REPUBLIC,0,TOTALS,CZECH REPUBLIC,200,28,65,43.1,24,52,46.2,4,13,30.8,11,17,64.7,10,18,28,13,23,11,9,5,71,0
1878,43096,68_05_42,LATVIA,0,TOTALS,LATVIA,200,30,68,44.1,24,44,54.5,6,24,25.0,11,20,55.0,15,26,41,8,26,14,8,8,77,1
1879,43109,68_05_42,LITHUANIA,0,TOTALS,LITHUANIA,200,21,70,30.0,16,45,35.6,5,25,20.0,27,37,73.0,24,28,52,4,20,15,5,4,74,0
1880,43122,68_05_43,GERMANY,0,TOTALS,GERMANY,200,24,65,36.9,19,49,38.8,5,16,31.2,7,11,63.6,20,26,46,15,19,24,11,1,60,0
1881,43135,68_05_43,BELARUS,0,TOTALS,BELARUS,200,28,63,44.4,18,37,48.6,10,26,38.5,8,19,42.1,13,23,36,13,16,17,15,8,74,1
1882,43148,68_05_44,RUSSIA,0,TOTALS,RUSSIA,200,32,52,61.5,25,36,69.4,7,16,43.8,15,20,75.0,5,24,29,17,17,13,13,4,86,1
1883,43161,68_05_44,ISRAEL,0,TOTALS,ISRAEL,200,21,60,35.0,16,46,34.8,5,14,35.7,16,20,80.0,14,17,31,8,18,14,10,2,63,0
1884,43174,68_05_45,SLOVENIA,0,TOTALS,SLOVENIA,200,20,59,33.9,15,41,36.6,5,18,27.8,10,15,66.7,7,25,32,8,20,15,6,5,55,0
1885,43187,68_05_45,SPAIN,0,TOTALS,SPAIN,200,23,65,35.4,18,45,40.0,5,20,25.0,17,22,77.3,17,34,51,14,16,15,8,4,68,1
1886,43200,68_05_46,FRANCE,0,TOTALS,FRANCE,200,24,65,36.9,15,38,39.5,9,27,33.3,10,16,62.5,14,22,36,7,20,11,7,1,67,0
1887,43213,68_05_46,SERBIA & MONTENEGRO,0,TOTALS,SERBIA & MONTENEGRO,200,23,49,46.9,14,34,41.2,9,15,60.0,17,26,65.4,8,28,36,10,20,16,3,2,72,1
1888,43226,68_05_47,CROATIA,0,TOTALS,CROATIA,200,30,66,45.5,21,40,52.5,9,26,34.6,13,18,72.2,15,28,43,13,18,18,8,2,82,1
1889,43239,68_05_47,TURKEY,0,TOTALS,TURKEY,200,26,59,44.1,19,40,47.5,7,19,36.8,11,20,55.0,7,22,29,12,13,13,12,2,70,0
1890,43252,68_05_48,UKRAINE,0,TOTALS,UKRAINE,200,24,50,48.0,15,27,55.6,9,23,39.1,8,10,80.0,8,27,35,12,18,25,5,5,65,0
1891,43265,68_05_48,GERMANY,0,TOTALS,GERMANY,200,32,64,50.0,28,48,58.3,4,16,25.0,13,17,76.5,6,19,25,8,12,10,19,0,81,1
1892,43278,68_05_49,CROATIA,0,TOTALS,CROATIA,225,32,75,42.7,24,45,53.3,8,30,26.7,15,23,65.2,14,26,40,19,24,17,10,2,87,0
1893,43291,68_05_49,SLOVENIA,0,TOTALS,SLOVENIA,225,33,66,50.0,28,47,59.6,5,19,26.3,24,31,77.4,9,34,43,9,19,17,12,7,95,1
1894,43304,68_05_50,GREECE,0,TOTALS,GREECE,200,30,62,48.4,21,40,52.5,9,22,40.9,15,26,57.7,8,20,28,12,18,9,13,4,84,1
1895,43317,68_05_50,LATVIA,0,TOTALS,LATVIA,200,25,60,41.7,16,33,48.5,9,27,33.3,10,18,55.6,14,29,43,10,20,19,4,1,69,0
1896,43330,68_05_51,TURKEY,0,TOTALS,TURKEY,200,26,70,37.1,21,51,41.2,5,19,26.3,4,7,57.1,14,28,42,11,19,11,4,4,61,0
1897,43343,68_05_51,SPAIN,0,TOTALS,SPAIN,200,31,69,44.9,28,55,50.9,3,14,21.4,12,21,57.1,13,30,43,12,12,10,8,8,77,1
1898,43356,68_05_52,ITALY,0,TOTALS,ITALY,200,23,52,44.2,20,38,52.6,3,14,21.4,8,23,34.8,3,15,18,12,23,16,11,1,57,0
1899,43369,68_05_52,FRANCE,0,TOTALS,FRANCE,200,33,59,55.9,25,37,67.6,8,22,36.4,19,29,65.5,10,34,44,16,20,17,10,2,93,1
1900,43382,68_05_53,RUSSIA,0,TOTALS,RUSSIA,200,24,50,48.0,22,39,56.4,2,11,18.2,14,18,77.8,12,27,39,6,20,14,8,2,64,1
1901,43395,68_05_53,SERBIA & MONTENEGRO,0,TOTALS,SERBIA & MONTENEGRO,200,21,55,38.2,17,40,42.5,4,15,26.7,10,17,58.8,10,15,25,9,16,9,5,2,56,0
1902,43408,68_05_54,CZECH REPUBLIC,0,TOTALS,CZECH REPUBLIC,200,21,63,33.3,16,45,35.6,5,18,27.8,12,15,80.0,13,17,30,8,28,13,10,3,59,0
1903,43421,68_05_54,BELARUS,0,TOTALS,BELARUS,200,26,58,44.8,18,32,56.2,8,26,30.8,16,30,53.3,22,28,50,9,12,21,10,6,76,1
1904,43434,68_05_55,ISRAEL,0,TOTALS,ISRAEL,200,27,58,46.6,25,52,48.1,2,6,33.3,10,23,43.5,12,30,42,11,25,20,13,1,66,0
1905,43447,68_05_55,LITHUANIA,0,TOTALS,LITHUANIA,200,23,69,33.3,17,40,42.5,6,29,20.7,15,28,53.6,19,26,45,8,19,17,10,1,67,1
1906,43460,68_05_56,UKRAINE,0,TOTALS,UKRAINE,200,21,44,47.7,16,30,53.3,5,14,35.7,29,36,80.6,13,31,44,9,15,29,12,5,76,1
1907,43473,68_05_56,CZECH REPUBLIC,0,TOTALS,CZECH REPUBLIC,200,19,66,28.8,14,52,26.9,5,14,35.7,7,15,46.7,16,12,28,4,24,19,9,5,50,0
1908,43486,68_05_57,LATVIA,0,TOTALS,LATVIA,200,34,76,44.7,27,53,50.9,7,23,30.4,10,12,83.3,22,29,51,12,14,12,10,1,85,1
1909,43499,68_05_57,ITALY,0,TOTALS,ITALY,200,27,71,38.0,21,46,45.7,6,25,24.0,9,11,81.8,13,21,34,13,14,14,7,5,69,0
1910,43512,68_05_58,GERMANY,0,TOTALS,GERMANY,200,21,54,38.9,16,33,48.5,5,21,23.8,12,19,63.2,14,23,37,7,16,19,8,1,59,1
1911,43525,68_05_58,BELARUS,0,TOTALS,BELARUS,200,19,50,38.0,15,29,51.7,4,21,19.0,12,18,66.7,9,22,31,7,19,19,8,5,54,0
1912,43538,68_05_59,GREECE,0,TOTALS,GREECE,225,32,70,45.7,27,58,46.6,5,12,41.7,9,17,52.9,15,27,42,15,15,12,7,5,78,1
1913,43551,68_05_59,FRANCE,0,TOTALS,FRANCE,225,25,70,35.7,13,36,36.1,12,34,35.3,15,22,68.2,16,26,42,15,15,15,6,1,77,0
1914,43564,68_05_60,CROATIA,0,TOTALS,CROATIA,200,32,53,60.4,22,30,73.3,10,23,43.5,9,13,69.2,8,33,41,13,16,23,7,3,83,1
1915,43577,68_05_60,TURKEY,0,TOTALS,TURKEY,200,25,63,39.7,21,46,45.7,4,17,23.5,11,15,73.3,6,14,20,9,14,12,12,2,65,0
1916,43590,68_05_61,SERBIA & MONTENEGRO,0,TOTALS,SERBIA & MONTENEGRO,200,20,54,37.0,17,38,44.7,3,16,18.8,20,34,58.8,14,35,49,9,14,12,5,8,63,1
1917,43603,68_05_61,ISRAEL,0,TOTALS,ISRAEL,200,18,63,28.6,16,51,31.4,2,12,16.7,7,11,63.6,11,24,35,9,23,9,6,2,45,0
1918,43616,68_05_62,SLOVENIA,0,TOTALS,SLOVENIA,200,24,47,51.1,15,26,57.7,9,21,42.9,12,16,75.0,7,18,25,9,27,15,6,5,69,0
1919,43629,68_05_62,SPAIN,0,TOTALS,SPAIN,200,25,57,43.9,18,40,45.0,7,17,41.2,23,28,82.1,14,17,31,13,17,12,8,4,80,1
1920,43642,68_05_63,RUSSIA,0,TOTALS,RUSSIA,200,22,47,46.8,17,30,56.7,5,17,29.4,12,21,57.1,10,34,44,11,17,21,6,5,61,1
1921,43655,68_05_63,LITHUANIA,0,TOTALS,LITHUANIA,200,20,68,29.4,15,39,38.5,5,29,17.2,8,16,50.0,15,15,30,7,19,9,16,1,53,0
1922,43668,69_05_01,FINLAND,0,TOTALS,FINLAND,200,31,61,50.8,22,38,57.9,9,23,39.1,9,12,75.0,8,25,33,15,19,16,11,0,80,1
1923,43681,69_05_01,IRELAND,0,TOTALS,IRELAND,200,21,54,38.9,19,44,43.2,2,10,20.0,14,23,60.9,10,24,34,9,18,23,9,2,58,0
1924,43694,69_05_02,POLAND,0,TOTALS,POLAND,200,24,60,40.0,21,46,45.7,3,14,21.4,26,37,70.3,11,43,54,8,24,22,9,4,77,1
1925,43707,69_05_02,SLOVAK REPUBLIC,0,TOTALS,SLOVAK REPUBLIC,200,22,78,28.2,16,57,28.1,6,21,28.6,18,24,75.0,18,32,50,7,26,20,10,0,68,0
1926,43718,69_05_03,ICELAND,0,TOTALS,ICELAND,200,22,64,34.4,14,37,37.8,8,27,29.6,6,6,100.0,9,21,30,2,24,26,13,0,58,0
1927,43731,69_05_03,GEORGIA,0,TOTALS,GEORGIA,200,31,66,47.0,22,36,61.1,9,30,30.0,14,27,51.9,20,33,53,10,14,24,14,0,85,1
1928,43744,69_05_04,HUNGARY,0,TOTALS,HUNGARY,200,40,73,54.8,24,43,55.8,16,30,53.3,10,23,43.5,18,26,44,9,22,18,15,1,106,0
1929,43757,69_05_04,ALBANIA,0,TOTALS,ALBANIA,200,22,55,40.0,20,45,44.4,2,10,20.0,12,17,70.6,10,24,34,4,21,30,8,3,58,1
1930,43770,69_05_05,SWEDEN,0,TOTALS,SWEDEN,200,22,53,41.5,15,34,44.1,7,19,36.8,11,14,78.6,11,29,40,3,20,17,3,2,62,0
1931,43783,69_05_05,BULGARIA,0,TOTALS,BULGARIA,200,29,78,37.2,26,55,47.3,3,23,13.0,15,24,62.5,27,26,53,6,21,11,11,4,76,1
1932,43796,69_05_06,PORTUGAL,0,TOTALS,PORTUGAL,200,18,56,32.1,17,42,40.5,1,14,7.1,23,35,65.7,11,21,32,8,27,15,14,4,60,0
1933,43808,69_05_06,BELGIUM,0,TOTALS,BELGIUM,200,27,53,50.9,22,38,57.9,5,15,33.3,23,36,63.9,12,36,48,8,28,21,9,2,82,1
1934,43821,69_05_07,SLOVAK REPUBLIC,0,TOTALS,SLOVAK REPUBLIC,200,32,77,41.6,26,56,46.4,6,21,28.6,16,23,69.6,23,35,58,11,21,23,9,6,86,1
1935,43832,69_05_07,ICELAND,0,TOTALS,ICELAND,200,21,60,35.0,16,41,39.0,5,19,26.3,12,18,66.7,12,24,36,5,20,19,8,0,59,0
1936,43845,69_05_08,GEORGIA,0,TOTALS,GEORGIA,200,26,51,51.0,20,33,60.6,6,18,33.3,15,28,53.6,8,31,39,10,24,23,12,2,73,1
1937,43858,69_05_08,FINLAND,0,TOTALS,FINLAND,200,18,65,27.7,14,38,36.8,4,27,14.8,18,27,66.7,20,22,42,3,23,21,10,1,58,0
1938,43871,69_05_09,ALBANIA,0,TOTALS,ALBANIA,200,23,56,41.1,15,36,41.7,8,20,40.0,11,18,61.1,7,32,39,3,20,31,12,1,65,0
1939,43884,69_05_09,SWEDEN,0,TOTALS,SWEDEN,200,33,76,43.4,23,42,54.8,10,34,29.4,7,10,70.0,13,32,45,10,20,23,15,3,83,1
1940,43896,69_05_10,BELGIUM,0,TOTALS,BELGIUM,200,26,71,36.6,20,52,38.5,6,19,31.6,11,16,68.8,12,34,46,12,23,16,8,2,69,0
1941,43909,69_05_10,HUNGARY,0,TOTALS,HUNGARY,200,27,71,38.0,15,40,37.5,12,31,38.7,14,21,66.7,16,33,49,4,18,19,7,0,80,1
1942,43922,69_05_11,BULGARIA,0,TOTALS,BULGARIA,200,23,59,39.0,17,37,45.9,6,22,27.3,30,46,65.2,21,21,42,12,21,22,12,2,82,1
1943,43935,69_05_11,PORTUGAL,0,TOTALS,PORTUGAL,200,30,57,52.6,25,42,59.5,5,15,33.3,15,21,71.4,7,24,31,12,34,25,14,4,80,0
1944,43948,69_05_12,IRELAND,0,TOTALS,IRELAND,200,27,59,45.8,23,39,59.0,4,20,20.0,13,17,76.5,6,26,32,9,22,14,7,2,71,0
1945,43961,69_05_12,POLAND,0,TOTALS,POLAND,200,32,68,47.1,27,51,52.9,5,17,29.4,13,20,65.0,16,32,48,5,17,20,8,4,82,1
1946,43973,69_05_13,BELGIUM,0,TOTALS,BELGIUM,200,45,87,51.7,37,66,56.1,8,21,38.1,16,23,69.6,17,34,51,13,17,11,21,3,114,0
1947,43986,69_05_13,ALBANIA,0,TOTALS,ALBANIA,200,20,66,30.3,14,42,33.3,6,24,25.0,14,18,77.8,15,27,42,5,18,28,5,3,60,1
1948,43999,69_05_14,FINLAND,0,TOTALS,FINLAND,225,30,80,37.5,22,53,41.5,8,27,29.6,18,30,60.0,25,25,50,9,25,14,12,3,86,1
1949,44012,69_05_14,SLOVAK REPUBLIC,0,TOTALS,SLOVAK REPUBLIC,225,25,63,39.7,16,44,36.4,9,19,47.4,21,25,84.0,15,31,46,5,27,27,8,8,80,0
1950,44025,69_05_15,PORTUGAL,0,TOTALS,PORTUGAL,200,21,50,42.0,19,41,46.3,2,9,22.2,11,24,45.8,6,26,32,10,23,18,8,5,55,0
1951,44038,69_05_15,SWEDEN,0,TOTALS,SWEDEN,200,23,69,33.3,16,49,32.7,7,20,35.0,17,18,94.4,21,28,49,8,20,16,12,0,70,1
1952,44051,69_05_16,GEORGIA,0,TOTALS,GEORGIA,200,30,44,68.2,24,32,75.0,6,12,50.0,22,32,68.8,7,33,40,13,23,39,14,4,88,1
1953,44064,69_05_16,IRELAND,0,TOTALS,IRELAND,200,21,60,35.0,13,39,33.3,8,21,38.1,14,21,66.7,8,12,20,3,27,28,17,1,64,0
1954,44077,69_05_17,HUNGARY,0,TOTALS,HUNGARY,200,31,63,49.2,13,34,38.2,18,29,62.1,26,33,78.8,9,24,33,7,27,9,8,2,106,0
1955,44090,69_05_17,BULGARIA,0,TOTALS,BULGARIA,200,37,80,46.2,28,50,56.0,9,30,30.0,15,23,65.2,24,26,50,9,28,14,5,7,98,1
1956,44101,69_05_18,ICELAND,0,TOTALS,ICELAND,200,20,60,33.3,14,43,32.6,6,17,35.3,4,7,57.1,6,19,25,1,22,27,12,0,50,0
1957,44114,69_05_18,POLAND,0,TOTALS,POLAND,200,39,70,55.7,31,48,64.6,8,22,36.4,11,15,73.3,12,37,49,4,15,25,10,2,97,1
1958,44127,69_05_19,SLOVAK REPUBLIC,0,TOTALS,SLOVAK REPUBLIC,200,23,58,39.7,14,35,40.0,9,23,39.1,16,27,59.3,18,26,44,7,22,24,8,1,71,1
1959,44139,69_05_19,GEORGIA,0,TOTALS,GEORGIA,200,23,57,40.4,16,32,50.0,7,25,28.0,12,17,70.6,11,22,33,8,23,21,11,3,65,0
1960,44152,69_05_20,SWEDEN,0,TOTALS,SWEDEN,200,23,60,38.3,20,46,43.5,3,14,21.4,11,13,84.6,11,23,34,7,15,19,5,0,60,0
1961,44165,69_05_20,HUNGARY,0,TOTALS,HUNGARY,200,26,63,41.3,18,40,45.0,8,23,34.8,10,13,76.9,15,22,37,4,15,17,7,2,70,1
1962,44178,69_05_21,IRELAND,0,TOTALS,IRELAND,200,30,60,50.0,24,42,57.1,6,18,33.3,13,18,72.2,10,37,47,5,11,20,13,2,79,1
1963,44189,69_05_21,ICELAND,0,TOTALS,ICELAND,200,19,62,30.6,10,36,27.8,9,26,34.6,3,7,42.9,7,23,30,2,17,21,12,2,50,0
1964,44202,69_05_22,ALBANIA,0,TOTALS,ALBANIA,200,22,49,44.9,20,39,51.3,2,10,20.0,11,15,73.3,8,31,39,9,25,36,12,3,57,0
1965,44215,69_05_22,PORTUGAL,0,TOTALS,PORTUGAL,200,30,71,42.3,20,49,40.8,10,22,45.5,12,27,44.4,19,22,41,5,17,23,20,0,82,1
1966,44228,69_05_23,BULGARIA,0,TOTALS,BULGARIA,200,26,78,33.3,17,46,37.0,9,32,28.1,12,20,60.0,23,24,47,8,23,18,7,2,73,1
1967,44240,69_05_23,BELGIUM,0,TOTALS,BELGIUM,200,26,66,39.4,23,49,46.9,3,17,17.6,16,23,69.6,19,32,51,11,18,24,8,5,71,0
1968,44253,69_05_24,POLAND,0,TOTALS,POLAND,200,32,66,48.5,25,41,61.0,7,25,28.0,13,21,61.9,14,26,40,5,25,22,12,2,84,1
1969,44266,69_05_24,FINLAND,0,TOTALS,FINLAND,200,23,62,37.1,19,40,47.5,4,22,18.2,14,18,77.8,15,24,39,8,28,32,9,0,64,0
1970,44279,69_05_25,HUNGARY,0,TOTALS,HUNGARY,200,19,69,27.5,10,38,26.3,9,31,29.0,9,11,81.8,17,23,40,8,20,20,9,2,56,0
1971,44292,69_05_25,PORTUGAL,0,TOTALS,PORTUGAL,200,23,52,44.2,20,38,52.6,3,14,21.4,12,16,75.0,7,33,40,12,12,20,4,3,61,1
1972,44305,69_05_26,SLOVAK REPUBLIC,0,TOTALS,SLOVAK REPUBLIC,200,29,54,53.7,21,33,63.6,8,21,38.1,21,29,72.4,8,29,37,8,24,32,12,8,87,1
1973,44318,69_05_26,IRELAND,0,TOTALS,IRELAND,200,21,57,36.8,15,39,38.5,6,18,33.3,25,33,75.8,9,20,29,8,23,24,16,1,73,0
1974,44331,69_05_27,GEORGIA,0,TOTALS,GEORGIA,200,27,73,37.0,20,57,35.1,7,16,43.8,5,9,55.6,19,22,41,13,13,18,9,1,66,0
1975,44344,69_05_27,POLAND,0,TOTALS,POLAND,200,38,73,52.1,27,56,48.2,11,17,64.7,6,9,66.7,15,29,44,4,14,20,10,3,93,1
1976,44357,69_05_28,FINLAND,0,TOTALS,FINLAND,200,39,67,58.2,29,46,63.0,10,21,47.6,16,25,64.0,12,37,49,11,21,17,14,4,104,0
1977,44368,69_05_28,ICELAND,0,TOTALS,ICELAND,200,22,64,34.4,14,42,33.3,8,22,36.4,13,21,61.9,8,20,28,1,23,19,10,2,65,1
1978,44381,69_05_29,BULGARIA,0,TOTALS,BULGARIA,200,38,70,54.3,27,44,61.4,11,26,42.3,23,32,71.9,11,36,47,15,20,14,8,5,110,0
1979,44394,69_05_29,ALBANIA,0,TOTALS,ALBANIA,200,25,67,37.3,18,39,46.2,7,28,25.0,14,23,60.9,10,25,35,4,25,19,5,2,71,1
1980,44406,69_05_30,BELGIUM,0,TOTALS,BELGIUM,200,37,70,52.9,30,56,53.6,7,14,50.0,10,16,62.5,11,35,46,12,21,14,5,4,91,1
1981,44419,69_05_30,SWEDEN,0,TOTALS,SWEDEN,200,28,71,39.4,24,51,47.1,4,20,20.0,14,24,58.3,15,24,39,2,17,12,7,2,74,0
1982,44431,69_05_31,PORTUGAL,0,TOTALS,PORTUGAL,200,43,69,62.3,34,49,69.4,9,20,45.0,19,30,63.3,13,31,44,15,14,17,12,4,114,0
1983,44442,69_05_31,ICELAND,0,TOTALS,ICELAND,200,21,60,35.0,14,38,36.8,7,22,31.8,13,19,68.4,11,19,30,0,24,25,6,1,62,1
1984,44455,69_05_32,ALBANIA,0,TOTALS,ALBANIA,200,33,66,50.0,29,53,54.7,4,13,30.8,13,18,72.2,16,25,41,7,21,29,8,1,83,1
1985,44468,69_05_32,IRELAND,0,TOTALS,IRELAND,200,40,71,56.3,28,45,62.2,12,26,46.2,12,18,66.7,8,21,29,12,22,18,19,0,104,0
1986,44481,69_05_33,HUNGARY,0,TOTALS,HUNGARY,200,23,55,41.8,15,35,42.9,8,20,40.0,27,35,77.1,12,23,35,3,20,14,9,0,81,1
1987,44494,69_05_33,FINLAND,0,TOTALS,FINLAND,200,29,61,47.5,23,38,60.5,6,23,26.1,9,12,75.0,10,25,35,5,24,16,7,3,73,0
1988,44506,69_05_34,GEORGIA,0,TOTALS,GEORGIA,200,29,72,40.3,18,39,46.2,11,33,33.3,20,24,83.3,20,25,45,3,23,10,8,1,89,1
1989,44518,69_05_34,BELGIUM,0,TOTALS,BELGIUM,200,26,56,46.4,19,38,50.0,7,18,38.9,19,24,79.2,8,25,33,7,24,12,5,5,78,0
1990,44531,69_05_35,POLAND,0,TOTALS,POLAND,200,31,63,49.2,22,47,46.8,9,16,56.2,14,21,66.7,9,31,40,5,20,16,9,0,85,1
1991,44544,69_05_35,SWEDEN,0,TOTALS,SWEDEN,200,26,66,39.4,21,51,41.2,5,15,33.3,13,20,65.0,13,25,38,8,25,17,6,2,70,0
1992,44557,69_05_36,BULGARIA,0,TOTALS,BULGARIA,200,29,68,42.6,23,46,50.0,6,22,27.3,12,17,70.6,20,21,41,11,12,18,19,4,76,1
1993,44570,69_05_36,SLOVAK REPUBLIC,0,TOTALS,SLOVAK REPUBLIC,200,28,69,40.6,23,41,56.1,5,28,17.9,4,5,80.0,20,21,41,9,20,24,7,2,65,0
1994,44581,69_05_37,ICELAND,0,TOTALS,ICELAND,200,34,75,45.3,25,47,53.2,9,28,32.1,15,21,71.4,13,23,36,9,19,13,14,1,92,0
1995,44593,69_05_37,ALBANIA,0,TOTALS,ALBANIA,200,39,76,51.3,33,59,55.9,6,17,35.3,11,16,68.8,18,32,50,14,16,25,5,0,95,1
1996,44606,69_05_38,PORTUGAL,0,TOTALS,PORTUGAL,200,27,60,45.0,23,44,52.3,4,16,25.0,24,31,77.4,10,26,36,16,23,18,11,3,82,1
1997,44619,69_05_38,IRELAND,0,TOTALS,IRELAND,200,22,56,39.3,16,38,42.1,6,18,33.3,23,31,74.2,11,25,36,9,23,18,13,0,73,0
1998,44632,69_05_39,SWEDEN,0,TOTALS,SWEDEN,200,27,64,42.2,22,45,48.9,5,19,26.3,7,13,53.8,22,22,44,6,21,19,8,3,66,0
1999,44645,69_05_39,SLOVAK REPUBLIC,0,TOTALS,SLOVAK REPUBLIC,200,23,56,41.1,17,37,45.9,6,19,31.6,21,26,80.8,14,20,34,5,21,17,13,2,73,1
2000,44657,69_05_40,BELGIUM,0,TOTALS,BELGIUM,200,38,70,54.3,34,58,58.6,4,12,33.3,20,25,80.0,13,25,38,7,16,16,10,3,100,0
2001,44670,69_05_40,FINLAND,0,TOTALS,FINLAND,200,34,73,46.6,29,49,59.2,5,24,20.8,10,13,76.9,17,24,41,6,26,21,8,2,83,1
2002,44683,69_05_41,GEORGIA,0,TOTALS,GEORGIA,200,26,57,45.6,21,42,50.0,5,15,33.3,12,13,92.3,8,24,32,8,22,13,8,1,69,0
2003,44696,69_05_41,HUNGARY,0,TOTALS,HUNGARY,200,22,53,41.5,13,34,38.2,9,19,47.4,18,22,81.8,8,24,32,2,18,11,9,4,71,1
2004,44708,69_05_42,SWEDEN,0,TOTALS,SWEDEN,200,26,56,46.4,19,42,45.2,7,14,50.0,20,24,83.3,8,28,36,7,16,16,9,0,79,1
2005,44721,69_05_42,FINLAND,0,TOTALS,FINLAND,200,33,70,47.1,27,51,52.9,6,19,31.6,4,8,50.0,11,24,35,9,25,12,11,4,76,0
2006,44734,69_05_43,SLOVAK REPUBLIC,0,TOTALS,SLOVAK REPUBLIC,200,27,69,39.1,20,49,40.8,7,20,35.0,11,18,61.1,15,29,44,6,18,17,7,1,72,0
2007,44744,69_05_43,BELGIUM,0,TOTALS,BELGIUM,200,37,73,50.7,30,59,50.8,7,14,50.0,12,16,75.0,9,30,39,17,18,12,12,6,93,1
2008,44757,69_05_44,POLAND,0,TOTALS,POLAND,200,33,63,52.4,27,53,50.9,6,10,60.0,24,31,77.4,13,29,42,6,19,18,7,2,96,1
2009,44770,69_05_44,GEORGIA,0,TOTALS,GEORGIA,200,29,68,42.6,24,49,49.0,5,19,26.3,13,20,65.0,12,21,33,13,26,15,11,0,76,0
2010,44783,69_05_45,BULGARIA,0,TOTALS,BULGARIA,200,31,75,41.3,25,55,45.5,6,20,30.0,18,20,90.0,23,24,47,9,15,12,7,2,86,1
2011,44796,69_05_45,HUNGARY,0,TOTALS,HUNGARY,200,28,69,40.6,15,31,48.4,13,38,34.2,11,14,78.6,18,23,41,5,24,17,6,4,80,0
2012,46967,72_05_01,FRANCE,0,TOTALS,FRANCE,200,29,75,38.7,26,55,47.3,3,20,15.0,10,20,50.0,14,36,50,13,20,9,8,5,71,1
2013,46980,72_05_01,LITHUANIA,0,TOTALS,LITHUANIA,200,24,71,33.8,14,43,32.6,10,28,35.7,8,17,47.1,11,32,43,13,23,14,5,2,66,0
2014,46993,72_05_02,ITALY,0,TOTALS,ITALY,200,25,58,43.1,22,43,51.2,3,15,20.0,7,12,58.3,19,30,49,12,23,17,23,1,60,1
2015,47006,72_05_02,BULGARIA,0,TOTALS,BULGARIA,200,18,53,34.0,13,30,43.3,5,23,21.7,15,19,78.9,14,29,43,12,21,20,13,0,56,0
2016,47019,72_05_03,SPAIN,0,TOTALS,SPAIN,200,27,61,44.3,21,48,43.8,6,13,46.2,24,35,68.6,16,23,39,7,16,20,12,4,84,1
2017,47032,72_05_03,LATVIA,0,TOTALS,LATVIA,200,33,67,49.3,24,44,54.5,9,23,39.1,7,15,46.7,13,23,36,14,25,20,14,3,82,0
2018,47045,72_05_04,TURKEY,0,TOTALS,TURKEY,200,27,60,45.0,21,44,47.7,6,16,37.5,22,27,81.5,12,25,37,14,17,10,9,4,82,1
2019,47058,72_05_04,CROATIA,0,TOTALS,CROATIA,200,27,57,47.4,20,35,57.1,7,22,31.8,6,13,46.2,8,19,27,15,28,10,3,1,67,0
2020,47071,72_05_05,RUSSIA,0,TOTALS,RUSSIA,200,28,59,47.5,17,30,56.7,11,29,37.9,28,36,77.8,15,15,30,12,29,18,10,0,95,1
2021,47084,72_05_05,GERMANY,0,TOTALS,GERMANY,200,22,44,50.0,18,31,58.1,4,13,30.8,33,44,75.0,9,14,23,5,30,19,7,0,81,0
2022,47097,72_05_06,SERBIA & MONTENEGRO,0,TOTALS,SERBIA & MONTENEGRO,200,44,70,62.9,34,55,61.8,10,15,66.7,12,21,57.1,9,28,37,26,17,16,17,5,110,0
2023,47110,72_05_06,POLAND,0,TOTALS,POLAND,200,26,69,37.7,23,55,41.8,3,14,21.4,7,13,53.8,10,17,27,3,20,23,11,2,62,1
2024,47123,72_05_07,GREECE,0,TOTALS,GREECE,200,37,76,48.7,25,44,56.8,12,32,37.5,10,19,52.6,16,32,48,9,22,14,5,7,96,1
2025,47135,72_05_07,BELGIUM,0,TOTALS,BELGIUM,200,27,75,36.0,25,60,41.7,2,15,13.3,11,22,50.0,19,25,44,11,21,17,8,2,67,0
2026,47148,72_05_08,ISRAEL,0,TOTALS,ISRAEL,200,25,60,41.7,24,51,47.1,1,9,11.1,15,21,71.4,5,22,27,11,31,15,17,0,66,0
2027,47161,72_05_08,SLOVENIA,0,TOTALS,SLOVENIA,200,20,45,44.4,9,23,39.1,11,22,50.0,18,32,56.2,8,25,33,11,22,23,6,2,69,1
2028,47174,72_05_09,GERMANY,0,TOTALS,GERMANY,200,19,48,39.6,13,30,43.3,6,18,33.3,13,19,68.4,11,25,36,7,16,20,7,1,57,0
2029,47187,72_05_09,FRANCE,0,TOTALS,FRANCE,200,30,71,42.3,24,46,52.2,6,25,24.0,13,17,76.5,16,20,36,14,22,8,15,1,79,1
2030,47200,72_05_10,POLAND,0,TOTALS,POLAND,200,23,61,37.7,20,46,43.5,3,15,20.0,5,12,41.7,8,18,26,10,25,24,9,0,54,0
2031,47213,72_05_10,TURKEY,0,TOTALS,TURKEY,200,28,56,50.0,22,37,59.5,6,19,31.6,21,31,67.7,11,32,43,13,15,23,12,3,83,1
2032,47226,72_05_11,LITHUANIA,0,TOTALS,LITHUANIA,200,23,54,42.6,18,41,43.9,5,13,38.5,12,21,57.1,12,22,34,9,22,25,7,0,63,0
2033,47239,72_05_11,RUSSIA,0,TOTALS,RUSSIA,200,36,67,53.7,28,47,59.6,8,20,40.0,14,21,66.7,12,22,34,19,20,14,18,2,94,1
2034,47252,72_05_12,BULGARIA,0,TOTALS,BULGARIA,200,14,51,27.5,11,25,44.0,3,26,11.5,29,40,72.5,11,22,33,2,20,22,3,1,60,0
2035,47265,72_05_12,ISRAEL,0,TOTALS,ISRAEL,200,36,72,50.0,29,58,50.0,7,14,50.0,9,16,56.2,16,27,43,20,29,13,9,0,88,1
2036,47278,72_05_13,LATVIA,0,TOTALS,LATVIA,200,33,73,45.2,27,48,56.2,6,25,24.0,9,22,40.9,20,15,35,14,21,15,12,2,81,1
2037,47291,72_05_13,GREECE,0,TOTALS,GREECE,200,27,52,51.9,23,35,65.7,4,17,23.5,17,24,70.8,8,21,29,10,20,20,7,2,75,0
2038,47304,72_05_14,CROATIA,0,TOTALS,CROATIA,225,33,60,55.0,25,39,64.1,8,21,38.1,15,25,60.0,9,32,41,16,35,22,5,1,89,0
2039,47317,72_05_14,SERBIA & MONTENEGRO,0,TOTALS,SERBIA & MONTENEGRO,225,34,76,44.7,28,57,49.1,6,19,31.6,20,38,52.6,20,21,41,13,27,10,13,0,94,1
2040,47329,72_05_15,BELGIUM,0,TOTALS,BELGIUM,200,22,63,34.9,12,40,30.0,10,23,43.5,17,26,65.4,10,13,23,13,24,18,17,1,71,0
2041,47342,72_05_15,SPAIN,0,TOTALS,SPAIN,200,36,59,61.0,31,45,68.9,5,14,35.7,19,35,54.3,14,33,47,18,20,19,8,2,96,1
2042,47355,72_05_16,SLOVENIA,0,TOTALS,SLOVENIA,200,17,59,28.8,13,39,33.3,4,20,20.0,9,16,56.2,15,29,44,6,18,20,6,2,47,0
2043,47368,72_05_16,ITALY,0,TOTALS,ITALY,200,24,65,36.9,19,44,43.2,5,21,23.8,9,12,75.0,10,26,36,12,18,11,10,2,62,1
2044,47381,72_05_17,GERMANY,0,TOTALS,GERMANY,200,33,73,45.2,29,57,50.9,4,16,25.0,17,24,70.8,9,25,34,16,25,11,12,2,87,1
2045,47394,72_05_17,LITHUANIA,0,TOTALS,LITHUANIA,200,31,66,47.0,21,42,50.0,10,24,41.7,12,23,52.2,15,36,51,11,21,24,6,6,84,0
2046,47407,72_05_18,POLAND,0,TOTALS,POLAND,200,27,66,40.9,22,49,44.9,5,17,29.4,10,16,62.5,18,28,46,7,24,20,14,4,69,1
2047,47420,72_05_18,CROATIA,0,TOTALS,CROATIA,200,22,57,38.6,16,43,37.2,6,14,42.9,16,25,64.0,8,23,31,8,18,18,9,3,66,0
2048,47432,72_05_19,BELGIUM,0,TOTALS,BELGIUM,200,19,61,31.1,13,37,35.1,6,24,25.0,20,23,87.0,13,22,35,11,18,20,7,3,64,0
2049,47445,72_05_19,LATVIA,0,TOTALS,LATVIA,200,33,71,46.5,21,35,60.0,12,36,33.3,9,14,64.3,15,26,41,21,21,16,4,2,87,1
2050,47458,72_05_20,SLOVENIA,0,TOTALS,SLOVENIA,200,17,55,30.9,17,43,39.5,0,12,0.0,20,38,52.6,20,29,49,8,19,16,14,2,54,1
2051,47471,72_05_20,BULGARIA,0,TOTALS,BULGARIA,200,17,50,34.0,14,33,42.4,3,17,17.6,7,12,58.3,6,24,30,9,25,24,10,1,44,0
2052,47484,72_05_21,SPAIN,0,TOTALS,SPAIN,200,25,67,37.3,17,45,37.8,8,22,36.4,25,46,54.3,25,32,57,10,23,17,3,7,83,1
2053,47497,72_05_21,GREECE,0,TOTALS,GREECE,200,30,74,40.5,23,48,47.9,7,26,26.9,15,27,55.6,17,20,37,6,32,10,10,6,82,0
2054,47510,72_05_22,TURKEY,0,TOTALS,TURKEY,200,26,57,45.6,22,42,52.4,4,15,26.7,13,17,76.5,7,26,33,13,22,16,6,2,69,0
2055,47523,72_05_22,SERBIA & MONTENEGRO,0,TOTALS,SERBIA & MONTENEGRO,200,26,58,44.8,23,47,48.9,3,11,27.3,16,22,72.7,7,26,33,16,23,13,7,2,71,1
2056,47536,72_05_23,FRANCE,0,TOTALS,FRANCE,200,29,69,42.0,23,52,44.2,6,17,35.3,16,25,64.0,18,25,43,11,22,21,12,2,80,1
2057,47549,72_05_23,RUSSIA,0,TOTALS,RUSSIA,200,24,68,35.3,19,41,46.3,5,27,18.5,18,24,75.0,22,26,48,7,23,25,10,7,71,0
2058,47562,72_05_24,ITALY,0,TOTALS,ITALY,200,20,51,39.2,16,33,48.5,4,18,22.2,12,25,48.0,10,22,32,12,17,20,5,2,56,0
2059,47575,72_05_24,ISRAEL,0,TOTALS,ISRAEL,200,23,51,45.1,20,41,48.8,3,10,30.0,10,17,58.8,9,26,35,11,23,19,4,0,59,1
2060,47588,72_05_25,LATVIA,0,TOTALS,LATVIA,200,24,69,34.8,16,37,43.2,8,32,25.0,14,25,56.0,11,30,41,12,22,15,6,0,70,0
2061,47601,72_05_25,ITALY,0,TOTALS,ITALY,200,29,67,43.3,24,48,50.0,5,19,26.3,19,24,79.2,8,34,42,11,21,12,9,2,82,1
2062,47614,72_05_26,GERMANY,0,TOTALS,GERMANY,200,30,71,42.3,29,54,53.7,1,17,5.9,7,11,63.6,15,19,34,11,18,14,6,4,68,0
2063,47627,72_05_26,CROATIA,0,TOTALS,CROATIA,200,37,68,54.4,35,56,62.5,2,12,16.7,13,16,81.2,13,28,41,10,15,13,8,4,89,1
2064,47640,72_05_27,SPAIN,0,TOTALS,SPAIN,200,30,60,50.0,25,42,59.5,5,18,27.8,20,29,69.0,16,33,49,15,23,19,9,5,85,1
2065,47653,72_05_27,ISRAEL,0,TOTALS,ISRAEL,200,23,58,39.7,21,48,43.8,2,10,20.0,14,25,56.0,7,18,25,9,26,14,9,0,62,0
2066,47665,72_05_28,BELGIUM,0,TOTALS,BELGIUM,200,22,51,43.1,16,34,47.1,6,17,35.3,12,20,60.0,9,19,28,9,19,21,7,5,62,0
2067,47678,72_05_28,SLOVENIA,0,TOTALS,SLOVENIA,200,27,61,44.3,19,41,46.3,8,20,40.0,7,19,36.8,19,22,41,11,24,20,13,1,69,1
2068,47691,72_05_29,RUSSIA,0,TOTALS,RUSSIA,200,29,62,46.8,23,41,56.1,6,21,28.6,6,11,54.5,13,25,38,17,31,24,12,1,70,0
2069,47704,72_05_29,SERBIA & MONTENEGRO,0,TOTALS,SERBIA & MONTENEGRO,200,28,63,44.4,25,49,51.0,3,14,21.4,16,29,55.2,10,22,32,13,25,20,15,2,75,1
2070,47717,72_05_30,LITHUANIA,0,TOTALS,LITHUANIA,200,24,61,39.3,18,42,42.9,6,19,31.6,19,34,55.9,16,34,50,8,21,23,7,7,73,1
2071,47730,72_05_30,POLAND,0,TOTALS,POLAND,200,30,75,40.0,28,61,45.9,2,14,14.3,7,18,38.9,13,27,40,11,27,16,13,5,69,0
2072,47743,72_05_31,FRANCE,0,TOTALS,FRANCE,200,21,67,31.3,21,46,45.7,0,21,0.0,12,18,66.7,16,19,35,11,18,17,11,4,54,0
2073,47756,72_05_31,TURKEY,0,TOTALS,TURKEY,200,22,59,37.3,19,38,50.0,3,21,14.3,14,19,73.7,13,30,43,11,20,24,13,2,61,1
2074,47769,72_05_32,GREECE,0,TOTALS,GREECE,200,30,64,46.9,25,42,59.5,5,22,22.7,14,26,53.8,14,36,50,11,26,18,9,4,79,1
2075,47782,72_05_32,BULGARIA,0,TOTALS,BULGARIA,200,23,72,31.9,17,43,39.5,6,29,20.7,20,35,57.1,18,27,45,8,21,12,12,2,72,0
2076,47795,72_05_33,ISRAEL,0,TOTALS,ISRAEL,200,32,60,53.3,28,51,54.9,4,9,44.4,11,19,57.9,5,18,23,17,27,13,4,0,79,0
2077,47808,72_05_33,RUSSIA,0,TOTALS,RUSSIA,200,28,59,47.5,13,20,65.0,15,39,38.5,22,29,75.9,14,27,41,16,21,14,5,3,93,1
2078,47821,72_05_34,SLOVENIA,0,TOTALS,SLOVENIA,200,28,65,43.1,23,46,50.0,5,19,26.3,7,20,35.0,17,23,40,7,23,15,11,3,68,1
2079,47834,72_05_34,GERMANY,0,TOTALS,GERMANY,200,21,51,41.2,19,39,48.7,2,12,16.7,17,22,77.3,9,25,34,9,20,20,8,3,61,0
2080,47847,72_05_35,ITALY,0,TOTALS,ITALY,200,28,63,44.4,21,36,58.3,7,27,25.9,20,31,64.5,9,20,29,15,25,13,13,1,83,1
2081,47860,72_05_35,FRANCE,0,TOTALS,FRANCE,200,27,58,46.6,20,38,52.6,7,20,35.0,20,28,71.4,10,29,39,15,26,20,9,0,81,0
2082,47873,72_05_36,CROATIA,0,TOTALS,CROATIA,200,39,68,57.4,32,51,62.7,7,17,41.2,9,17,52.9,14,29,43,19,17,11,5,2,94,1
2083,47885,72_05_36,BELGIUM,0,TOTALS,BELGIUM,200,24,69,34.8,18,48,37.5,6,21,28.6,8,14,57.1,16,19,35,11,18,14,5,4,62,0
2084,47898,72_05_37,SERBIA & MONTENEGRO,0,TOTALS,SERBIA & MONTENEGRO,200,28,61,45.9,24,48,50.0,4,13,30.8,10,18,55.6,10,25,35,15,18,14,11,1,70,1
2085,47911,72_05_37,SPAIN,0,TOTALS,SPAIN,200,21,55,38.2,19,43,44.2,2,12,16.7,10,14,71.4,9,24,33,6,16,20,7,12,54,0
2086,47924,72_05_38,BULGARIA,0,TOTALS,BULGARIA,200,28,67,41.8,18,39,46.2,10,28,35.7,12,24,50.0,14,33,47,16,13,13,11,1,78,1
2087,47937,72_05_38,LITHUANIA,0,TOTALS,LITHUANIA,200,29,76,38.2,19,36,52.8,10,40,25.0,2,7,28.6,14,32,46,9,25,14,4,5,70,0
2088,47950,72_05_39,TURKEY,0,TOTALS,TURKEY,200,25,61,41.0,19,35,54.3,6,26,23.1,15,22,68.2,12,30,42,10,25,12,6,3,71,1
2089,47963,72_05_39,LATVIA,0,TOTALS,LATVIA,200,20,57,35.1,13,30,43.3,7,27,25.9,19,28,67.9,11,26,37,10,23,14,4,2,66,0
2090,47976,72_05_40,POLAND,0,TOTALS,POLAND,200,24,69,34.8,21,48,43.8,3,21,14.3,15,25,60.0,15,19,34,8,18,14,9,0,66,0
2091,47989,72_05_40,GREECE,0,TOTALS,GREECE,200,35,64,54.7,27,39,69.2,8,25,32.0,12,16,75.0,9,32,41,18,21,18,5,4,90,1
2092,48002,72_05_41,RUSSIA,0,TOTALS,RUSSIA,200,29,58,50.0,21,37,56.8,8,21,38.1,14,22,63.6,5,22,27,14,19,9,4,2,80,0
2093,48015,72_05_41,SPAIN,0,TOTALS,SPAIN,200,33,67,49.3,27,48,56.2,6,19,31.6,14,21,66.7,14,23,37,17,21,12,5,0,86,1
2094,48028,72_05_42,GERMANY,0,TOTALS,GERMANY,200,31,71,43.7,26,55,47.3,5,16,31.2,10,15,66.7,14,31,45,13,17,16,7,1,77,1
2095,48040,72_05_42,BELGIUM,0,TOTALS,BELGIUM,200,26,63,41.3,24,49,49.0,2,14,14.3,14,22,63.6,11,29,40,9,15,14,10,8,68,0
2096,48053,72_05_43,FRANCE,0,TOTALS,FRANCE,200,30,72,41.7,23,45,51.1,7,27,25.9,16,16,100.0,14,30,44,11,8,15,15,0,83,1
2097,48066,72_05_43,LATVIA,0,TOTALS,LATVIA,200,23,62,37.1,17,39,43.6,6,23,26.1,6,6,100.0,9,24,33,4,20,16,10,2,58,0
2098,48079,72_05_44,SLOVENIA,0,TOTALS,SLOVENIA,200,28,65,43.1,19,40,47.5,9,25,36.0,4,6,66.7,14,19,33,11,19,15,11,2,69,1
2099,48092,72_05_44,CROATIA,0,TOTALS,CROATIA,200,20,47,42.6,16,31,51.6,4,16,25.0,15,18,83.3,6,24,30,6,17,18,10,2,59,0
2100,48105,72_05_45,ISRAEL,0,TOTALS,ISRAEL,200,27,54,50.0,25,47,53.2,2,7,28.6,12,20,60.0,11,19,30,11,24,20,17,0,68,0
2101,48118,72_05_45,SERBIA & MONTENEGRO,0,TOTALS,SERBIA & MONTENEGRO,200,23,49,46.9,16,28,57.1,7,21,33.3,23,33,69.7,12,16,28,12,21,20,11,2,76,1
2102,48131,72_05_46,LITHUANIA,0,TOTALS,LITHUANIA,200,31,68,45.6,22,38,57.9,9,30,30.0,30,44,68.2,19,41,60,12,21,17,3,9,101,0
2103,48144,72_05_46,GREECE,0,TOTALS,GREECE,200,19,77,24.7,17,55,30.9,2,22,9.1,14,21,66.7,17,20,37,6,34,7,12,2,54,1
2104,48157,72_05_47,ITALY,0,TOTALS,ITALY,200,25,72,34.7,19,51,37.3,6,21,28.6,13,17,76.5,14,24,38,11,23,18,6,1,69,0
2105,48170,72_05_47,TURKEY,0,TOTALS,TURKEY,200,30,67,44.8,23,46,50.0,7,21,33.3,18,25,72.0,12,29,41,16,21,18,17,2,85,1
2106,48183,72_05_48,BULGARIA,0,TOTALS,BULGARIA,200,33,75,44.0,23,51,45.1,10,24,41.7,14,22,63.6,14,23,37,18,28,9,9,3,90,1
2107,48196,72_05_48,POLAND,0,TOTALS,POLAND,200,25,55,45.5,20,40,50.0,5,15,33.3,21,30,70.0,11,26,37,9,22,19,5,1,76,0
2108,48209,72_05_49,SLOVENIA,0,TOTALS,SLOVENIA,200,29,66,43.9,19,40,47.5,10,26,38.5,14,19,73.7,16,36,52,19,21,20,12,5,82,1
2109,48222,72_05_49,BULGARIA,0,TOTALS,BULGARIA,200,21,63,33.3,12,33,36.4,9,30,30.0,8,13,61.5,9,22,31,11,17,19,14,2,59,0
2110,48235,72_05_50,FRANCE,0,TOTALS,FRANCE,200,29,56,51.8,24,38,63.2,5,18,27.8,14,18,77.8,8,26,34,18,19,15,14,3,77,1
2111,48248,72_05_50,ISRAEL,0,TOTALS,ISRAEL,200,23,57,40.4,19,44,43.2,4,13,30.8,16,27,59.3,9,19,28,15,19,15,10,0,66,0
2112,48261,72_05_51,CROATIA,0,TOTALS,CROATIA,200,30,73,41.1,22,55,40.0,8,18,44.4,14,16,87.5,11,20,31,18,18,8,9,2,82,0
2113,48274,72_05_51,LITHUANIA,0,TOTALS,LITHUANIA,200,30,65,46.2,19,37,51.4,11,28,39.3,17,25,68.0,16,31,47,12,18,13,5,7,88,1
2114,48287,72_05_52,LATVIA,0,TOTALS,LATVIA,200,23,56,41.1,18,40,45.0,5,16,31.2,13,16,81.2,11,27,38,10,21,19,6,3,64,0
2115,48300,72_05_52,RUSSIA,0,TOTALS,RUSSIA,200,23,65,35.4,13,31,41.9,10,34,29.4,18,21,85.7,13,20,33,10,16,11,8,1,74,1
2116,48313,72_05_53,GERMANY,0,TOTALS,GERMANY,200,34,67,50.7,28,55,50.9,6,12,50.0,12,19,63.2,14,27,41,16,21,18,11,1,86,1
2117,48326,72_05_53,POLAND,0,TOTALS,POLAND,200,20,51,39.2,18,35,51.4,2,16,12.5,16,28,57.1,9,22,31,6,20,24,5,0,58,0
2118,48339,72_05_54,ITALY,0,TOTALS,ITALY,200,22,58,37.9,15,40,37.5,7,18,38.9,13,18,72.2,6,23,29,5,16,9,7,4,64,0
2119,48352,72_05_54,SERBIA & MONTENEGRO,0,TOTALS,SERBIA & MONTENEGRO,200,29,69,42.0,21,54,38.9,8,15,53.3,11,20,55.0,18,30,48,12,22,11,2,5,77,1
2120,48364,72_05_55,BELGIUM,0,TOTALS,BELGIUM,200,30,64,46.9,20,37,54.1,10,27,37.0,17,24,70.8,8,25,33,13,19,16,9,3,87,0
2121,48377,72_05_55,GREECE,0,TOTALS,GREECE,200,37,74,50.0,35,59,59.3,2,15,13.3,15,18,83.3,12,27,39,6,25,12,7,3,91,1
2122,48390,72_05_56,TURKEY,0,TOTALS,TURKEY,200,28,69,40.6,19,45,42.2,9,24,37.5,14,17,82.4,13,21,34,14,23,8,4,0,79,1
2123,48403,72_05_56,SPAIN,0,TOTALS,SPAIN,200,26,65,40.0,18,48,37.5,8,17,47.1,18,26,69.2,20,26,46,12,15,10,2,5,78,0
2124,48416,72_05_57,POLAND,0,TOTALS,POLAND,200,29,62,46.8,27,52,51.9,2,10,20.0,14,21,66.7,15,29,44,10,17,21,7,1,74,1
2125,48428,72_05_57,BELGIUM,0,TOTALS,BELGIUM,200,28,66,42.4,26,43,60.5,2,23,8.7,13,19,68.4,12,23,35,13,18,16,12,3,71,0
2126,48441,72_05_58,GERMANY,0,TOTALS,GERMANY,200,26,62,41.9,17,43,39.5,9,19,47.4,11,17,64.7,14,26,40,16,16,20,6,0,72,0
2127,48454,72_05_58,GREECE,0,TOTALS,GREECE,200,28,60,46.7,19,37,51.4,9,23,39.1,13,21,61.9,7,22,29,11,20,14,14,2,78,1
2128,48467,72_05_59,ISRAEL,0,TOTALS,ISRAEL,200,30,69,43.5,23,51,45.1,7,18,38.9,10,16,62.5,14,19,33,22,21,12,16,1,77,1
2129,48480,72_05_59,LATVIA,0,TOTALS,LATVIA,200,18,44,40.9,14,27,51.9,4,17,23.5,13,21,61.9,6,26,32,9,17,28,5,3,53,0
2130,48493,72_05_60,BULGARIA,0,TOTALS,BULGARIA,200,30,66,45.5,22,43,51.2,8,23,34.8,10,20,50.0,8,17,25,18,22,14,13,0,78,0
2131,48506,72_05_60,CROATIA,0,TOTALS,CROATIA,200,36,69,52.2,30,52,57.7,6,17,35.3,18,27,66.7,20,31,51,15,22,20,8,0,96,1
2132,48519,72_05_61,FRANCE,0,TOTALS,FRANCE,200,32,66,48.5,28,48,58.3,4,18,22.2,17,21,81.0,13,22,35,14,24,18,10,2,85,0
2133,48532,72_05_61,RUSSIA,0,TOTALS,RUSSIA,200,28,61,45.9,18,34,52.9,10,27,37.0,21,30,70.0,11,21,32,12,18,15,10,5,87,1
2134,48545,72_05_62,SLOVENIA,0,TOTALS,SLOVENIA,200,28,62,45.2,23,47,48.9,5,15,33.3,12,22,54.5,13,20,33,10,21,12,6,4,73,0
2135,48558,72_05_62,LITHUANIA,0,TOTALS,LITHUANIA,200,28,58,48.3,20,36,55.6,8,22,36.4,15,20,75.0,11,26,37,13,22,14,5,4,79,1
2136,48571,72_05_63,SPAIN,0,TOTALS,SPAIN,200,31,68,45.6,20,43,46.5,11,25,44.0,10,14,71.4,12,26,38,13,20,21,5,0,83,0
2137,48584,72_05_63,ITALY,0,TOTALS,ITALY,200,33,66,50.0,29,54,53.7,4,12,33.3,18,26,69.2,10,22,32,9,19,9,12,6,88,1
2138,48597,72_05_64,TURKEY,0,TOTALS,TURKEY,200,22,60,36.7,18,36,50.0,4,24,16.7,13,17,76.5,11,27,38,8,24,14,4,4,61,0
2139,48610,72_05_64,SERBIA & MONTENEGRO,0,TOTALS,SERBIA & MONTENEGRO,200,27,65,41.5,23,46,50.0,4,19,21.1,20,27,74.1,16,27,43,15,23,10,7,2,78,1
2140,48623,73_05_01,UKRAINE,0,TOTALS,UKRAINE,200,33,67,49.3,32,54,59.3,1,13,7.7,11,21,52.4,17,23,40,9,16,26,15,13,78,1
2141,48636,73_05_01,IRELAND,0,TOTALS,IRELAND,200,19,66,28.8,9,36,25.0,10,30,33.3,5,8,62.5,8,17,25,9,22,24,8,0,53,0
2142,48649,73_05_02,NETHERLANDS,0,TOTALS,NETHERLANDS,200,31,70,44.3,26,54,48.1,5,16,31.2,2,6,33.3,18,25,43,9,18,25,10,4,69,0
2143,48662,73_05_02,LUXEMBOURG,0,TOTALS,LUXEMBOURG,200,26,61,42.6,16,36,44.4,10,25,40.0,12,16,75.0,6,17,23,12,10,14,13,0,74,1
2144,48675,73_05_03,ENGLAND,0,TOTALS,ENGLAND,200,18,59,30.5,15,44,34.1,3,15,20.0,16,25,64.0,6,24,30,8,24,22,11,10,55,0
2145,48688,73_05_03,NETHERLANDS,0,TOTALS,NETHERLANDS,200,27,77,35.1,19,59,32.2,8,18,44.4,16,25,64.0,17,28,45,6,18,15,6,1,78,1
2146,48701,73_05_04,LUXEMBOURG,0,TOTALS,LUXEMBOURG,200,21,60,35.0,12,30,40.0,9,30,30.0,9,10,90.0,7,10,17,8,20,16,10,1,60,0
2147,48714,73_05_04,UKRAINE,0,TOTALS,UKRAINE,200,30,52,57.7,26,40,65.0,4,12,33.3,12,19,63.2,10,23,33,11,18,22,5,7,76,1
2148,48727,73_05_05,ESTONIA,0,TOTALS,ESTONIA,200,21,76,27.6,11,42,26.2,10,34,29.4,9,18,50.0,15,30,45,13,26,23,15,5,61,0
2149,48740,73_05_05,ROMANIA,0,TOTALS,ROMANIA,200,22,67,32.8,18,52,34.6,4,15,26.7,18,31,58.1,14,35,49,6,21,27,6,7,66,1
2150,48753,73_05_06,ICELAND,0,TOTALS,ICELAND,200,21,79,26.6,17,51,33.3,4,28,14.3,4,14,28.6,18,25,43,8,21,19,7,1,50,0
2151,48766,73_05_06,SWEDEN,0,TOTALS,SWEDEN,200,20,64,31.2,15,48,31.2,5,16,31.2,15,21,71.4,16,36,52,10,19,23,6,3,60,1
2152,48779,73_05_07,PORTUGAL,0,TOTALS,PORTUGAL,200,19,67,28.4,18,52,34.6,1,15,6.7,9,14,64.3,10,11,21,6,24,22,12,3,48,0
2153,48792,73_05_07,BOSNIA AND HERZEGOVINA,0,TOTALS,BOSNIA AND HERZEGOVINA,200,31,64,48.4,28,49,57.1,3,15,20.0,13,23,56.5,16,35,51,7,24,26,10,3,78,1
2154,48805,73_05_08,IRELAND,0,TOTALS,IRELAND,200,23,80,28.7,21,53,39.6,2,27,7.4,19,23,82.6,20,36,56,6,17,17,8,0,67,1
2155,48818,73_05_08,LUXEMBOURG,0,TOTALS,LUXEMBOURG,200,20,60,33.3,12,38,31.6,8,22,36.4,6,18,33.3,8,31,39,11,21,23,10,1,54,0
2156,48831,73_05_09,SLOVAK REPUBLIC,0,TOTALS,SLOVAK REPUBLIC,200,26,61,42.6,24,47,51.1,2,14,14.3,17,34,50.0,16,29,45,9,28,20,14,1,71,1
2157,48844,73_05_09,CZECH REPUBLIC,0,TOTALS,CZECH REPUBLIC,200,16,56,28.6,10,26,38.5,6,30,20.0,20,36,55.6,12,21,33,7,28,20,13,5,58,0
2158,48857,73_05_10,FINLAND,0,TOTALS,FINLAND,200,27,61,44.3,22,45,48.9,5,16,31.2,20,32,62.5,11,30,41,11,23,15,11,3,79,1
2159,48870,73_05_10,MKD,0,TOTALS,MKD,200,16,59,27.1,12,40,30.0,4,19,21.1,20,35,57.1,11,23,34,7,24,17,7,0,56,0
2160,48883,73_05_11,AUSTRIA,0,TOTALS,AUSTRIA,200,25,67,37.3,22,52,42.3,3,15,20.0,17,23,73.9,10,26,36,12,22,18,13,1,70,1
2161,48896,73_05_11,HUNGARY,0,TOTALS,HUNGARY,200,23,67,34.3,17,46,37.0,6,21,28.6,16,26,61.5,14,28,42,9,25,22,10,2,68,0
2162,48909,73_05_12,UKRAINE,0,TOTALS,UKRAINE,200,29,68,42.6,18,47,38.3,11,21,52.4,17,25,68.0,20,25,45,14,22,19,8,8,86,1
2163,48922,73_05_12,ENGLAND,0,TOTALS,ENGLAND,200,20,64,31.2,18,48,37.5,2,16,12.5,13,23,56.5,14,14,28,5,22,14,14,3,55,0
2164,48935,73_05_13,HUNGARY,0,TOTALS,HUNGARY,200,28,70,40.0,25,57,43.9,3,13,23.1,14,21,66.7,13,21,34,14,12,16,10,2,73,1
2165,48948,73_05_13,ESTONIA,0,TOTALS,ESTONIA,200,25,59,42.4,18,33,54.5,7,26,26.9,6,9,66.7,6,23,29,13,23,25,9,4,63,0
2166,48961,73_05_14,MKD,0,TOTALS,MKD,200,28,80,35.0,22,57,38.6,6,23,26.1,7,17,41.2,17,27,44,13,26,20,9,1,69,0
2167,48974,73_05_14,ICELAND,0,TOTALS,ICELAND,200,27,70,38.6,22,47,46.8,5,23,21.7,20,38,52.6,19,32,51,11,18,21,16,3,79,1
2168,48987,73_05_15,CZECH REPUBLIC,0,TOTALS,CZECH REPUBLIC,200,22,68,32.4,11,28,39.3,11,40,27.5,7,17,41.2,14,15,29,13,27,16,9,3,62,0
2169,49000,73_05_15,PORTUGAL,0,TOTALS,PORTUGAL,200,27,60,45.0,24,48,50.0,3,12,25.0,23,35,65.7,16,29,45,8,19,24,10,5,80,1
2170,49013,73_05_16,NETHERLANDS,0,TOTALS,NETHERLANDS,200,17,63,27.0,13,44,29.5,4,19,21.1,11,16,68.8,16,19,35,5,21,14,16,0,49,1
2171,49026,73_05_16,UKRAINE,0,TOTALS,UKRAINE,200,16,46,34.8,13,28,46.4,3,18,16.7,11,19,57.9,9,26,35,6,15,23,5,5,46,0
2172,49039,73_05_17,BOSNIA AND HERZEGOVINA,0,TOTALS,BOSNIA AND HERZEGOVINA,200,24,56,42.9,19,40,47.5,5,16,31.2,18,29,62.1,10,24,34,11,17,26,11,2,71,1
2173,49052,73_05_17,SLOVAK REPUBLIC,0,TOTALS,SLOVAK REPUBLIC,200,22,55,40.0,16,38,42.1,6,17,35.3,13,18,72.2,4,18,22,12,26,22,13,5,63,0
2174,49065,73_05_18,SWEDEN,0,TOTALS,SWEDEN,200,25,68,36.8,17,51,33.3,8,17,47.1,10,17,58.8,11,28,39,10,16,21,7,2,68,0
2175,49078,73_05_18,FINLAND,0,TOTALS,FINLAND,200,24,60,40.0,17,37,45.9,7,23,30.4,14,22,63.6,5,25,30,11,17,13,10,4,69,1
2176,49091,73_05_19,ROMANIA,0,TOTALS,ROMANIA,200,27,64,42.2,24,47,51.1,3,17,17.6,12,22,54.5,12,25,37,6,21,24,13,5,69,1
2177,49104,73_05_19,AUSTRIA,0,TOTALS,AUSTRIA,200,23,64,35.9,18,42,42.9,5,22,22.7,15,29,51.7,16,23,39,17,22,27,19,1,66,0
2178,49117,73_05_20,ENGLAND,0,TOTALS,ENGLAND,200,48,76,63.2,47,70,67.1,1,6,16.7,9,31,29.0,14,40,54,15,16,22,12,11,106,0
2179,49130,73_05_20,IRELAND,0,TOTALS,IRELAND,200,22,83,26.5,13,46,28.3,9,37,24.3,9,16,56.2,12,25,37,8,24,24,12,1,62,1
2180,49143,73_05_21,BOSNIA AND HERZEGOVINA,0,TOTALS,BOSNIA AND HERZEGOVINA,200,30,68,44.1,30,58,51.7,0,10,0.0,26,40,65.0,16,26,42,12,24,23,8,2,86,1
2181,49156,73_05_21,CZECH REPUBLIC,0,TOTALS,CZECH REPUBLIC,200,31,77,40.3,27,44,61.4,4,33,12.1,13,25,52.0,16,18,34,11,26,19,11,3,79,0
2182,49169,73_05_22,MKD,0,TOTALS,MKD,200,30,65,46.2,25,49,51.0,5,16,31.2,14,21,66.7,7,20,27,10,22,15,9,4,79,1
2183,49182,73_05_22,SWEDEN,0,TOTALS,SWEDEN,200,30,66,45.5,26,51,51.0,4,15,26.7,11,17,64.7,13,23,36,13,21,20,3,3,75,0
2184,49195,73_05_23,AUSTRIA,0,TOTALS,AUSTRIA,200,25,71,35.2,21,50,42.0,4,21,19.0,24,34,70.6,12,32,44,9,23,19,15,0,78,1
2185,49208,73_05_23,ESTONIA,0,TOTALS,ESTONIA,200,23,61,37.7,18,41,43.9,5,20,25.0,17,25,68.0,6,28,34,6,31,27,8,6,68,0
2186,49221,73_05_24,LUXEMBOURG,0,TOTALS,LUXEMBOURG,200,29,66,43.9,16,34,47.1,13,32,40.6,4,8,50.0,4,21,25,16,12,20,16,1,75,1
2187,49233,73_05_24,ENGLAND,0,TOTALS,ENGLAND,200,28,69,40.6,27,61,44.3,1,8,12.5,4,10,40.0,15,28,43,4,13,30,13,5,61,0
2188,49246,73_05_25,SLOVAK REPUBLIC,0,TOTALS,SLOVAK REPUBLIC,200,29,58,50.0,18,28,64.3,11,30,36.7,10,16,62.5,9,16,25,18,24,12,11,2,79,0
2189,49259,73_05_25,PORTUGAL,0,TOTALS,PORTUGAL,200,27,54,50.0,17,37,45.9,10,17,58.8,19,27,70.4,8,21,29,15,14,14,7,1,83,1
2190,49272,73_05_26,ICELAND,0,TOTALS,ICELAND,200,21,61,34.4,16,38,42.1,5,23,21.7,28,42,66.7,13,25,38,7,28,17,8,4,75,1
2191,49285,73_05_26,FINLAND,0,TOTALS,FINLAND,200,23,71,32.4,18,45,40.0,5,26,19.2,17,30,56.7,13,28,41,8,33,13,6,3,68,0
2192,49298,73_05_27,ROMANIA,0,TOTALS,ROMANIA,200,22,67,32.8,17,41,41.5,5,26,19.2,11,17,64.7,17,21,38,6,16,24,11,2,60,0
2193,49311,73_05_27,HUNGARY,0,TOTALS,HUNGARY,200,30,63,47.6,21,44,47.7,9,19,47.4,7,9,77.8,11,21,32,21,22,20,10,4,76,1
2194,49324,73_05_28,IRELAND,0,TOTALS,IRELAND,200,24,73,32.9,19,47,40.4,5,26,19.2,8,15,53.3,7,20,27,9,20,14,14,2,61,0
2195,49337,73_05_28,NETHERLANDS,0,TOTALS,NETHERLANDS,200,33,67,49.3,31,56,55.4,2,11,18.2,12,24,50.0,16,36,52,13,13,28,12,2,80,1
2196,49350,73_05_29,BOSNIA AND HERZEGOVINA,0,TOTALS,BOSNIA AND HERZEGOVINA,200,17,56,30.4,16,42,38.1,1,14,7.1,13,20,65.0,16,19,35,9,18,27,3,1,48,0
2197,49363,73_05_29,UKRAINE,0,TOTALS,UKRAINE,200,25,59,42.4,20,34,58.8,5,25,20.0,9,14,64.3,12,18,30,7,23,18,16,6,64,1
2198,49376,73_05_30,AUSTRIA,0,TOTALS,AUSTRIA,200,25,62,40.3,16,40,40.0,9,22,40.9,12,22,54.5,6,25,31,11,23,24,11,0,71,1
2199,49389,73_05_30,ICELAND,0,TOTALS,ICELAND,200,23,63,36.5,20,38,52.6,3,25,12.0,18,26,69.2,11,30,41,11,20,20,16,1,67,0
2200,49401,73_05_31,ENGLAND,0,TOTALS,ENGLAND,225,39,86,45.3,32,64,50.0,7,22,31.8,15,29,51.7,20,27,47,10,22,21,8,8,100,0
2201,49414,73_05_31,ESTONIA,0,TOTALS,ESTONIA,225,37,90,41.1,25,57,43.9,12,33,36.4,19,29,65.5,21,29,50,17,25,18,11,2,105,1
2202,49427,73_05_32,PORTUGAL,0,TOTALS,PORTUGAL,200,25,72,34.7,23,50,46.0,2,22,9.1,9,15,60.0,12,21,33,9,17,12,10,1,61,0
2203,49440,73_05_32,NETHERLANDS,0,TOTALS,NETHERLANDS,200,27,56,48.2,24,45,53.3,3,11,27.3,14,20,70.0,10,37,47,18,17,19,5,3,71,1
2204,49453,73_05_33,SLOVAK REPUBLIC,0,TOTALS,SLOVAK REPUBLIC,200,32,73,43.8,21,47,44.7,11,26,42.3,20,34,58.8,27,23,50,16,28,21,20,3,95,1
2205,49466,73_05_33,CZECH REPUBLIC,0,TOTALS,CZECH REPUBLIC,200,22,49,44.9,17,31,54.8,5,18,27.8,14,35,40.0,7,14,21,9,28,25,10,1,63,0
2206,49479,73_05_34,HUNGARY,0,TOTALS,HUNGARY,200,28,65,43.1,25,50,50.0,3,15,20.0,10,19,52.6,10,21,31,17,18,10,13,1,69,0
2207,49492,73_05_34,FINLAND,0,TOTALS,FINLAND,200,26,57,45.6,17,36,47.2,9,21,42.9,11,15,73.3,8,28,36,8,15,20,8,1,72,1
2208,49505,73_05_35,MKD,0,TOTALS,MKD,200,41,73,56.2,34,54,63.0,7,19,36.8,16,22,72.7,12,28,40,18,18,13,12,4,105,0
2209,49518,73_05_35,IRELAND,0,TOTALS,IRELAND,200,27,68,39.7,23,53,43.4,4,15,26.7,12,24,50.0,9,19,28,14,20,15,9,1,70,1
2210,49531,73_05_36,FINLAND,0,TOTALS,FINLAND,200,31,69,44.9,24,48,50.0,7,21,33.3,12,20,60.0,16,20,36,15,24,13,6,2,81,1
2211,49544,73_05_36,PORTUGAL,0,TOTALS,PORTUGAL,200,21,57,36.8,20,43,46.5,1,14,7.1,20,26,76.9,10,22,32,7,19,18,6,3,63,0
2212,49557,73_05_37,NETHERLANDS,0,TOTALS,NETHERLANDS,200,16,59,27.1,11,31,35.5,5,28,17.9,10,14,71.4,9,23,32,5,14,17,10,5,47,0
2213,49570,73_05_37,HUNGARY,0,TOTALS,HUNGARY,200,27,67,40.3,23,56,41.1,4,11,36.4,11,15,73.3,15,30,45,17,17,13,12,3,69,1
2214,49583,73_05_38,ESTONIA,0,TOTALS,ESTONIA,200,32,76,42.1,29,53,54.7,3,23,13.0,17,29,58.6,12,31,43,13,23,12,12,4,84,1
2215,49596,73_05_38,ROMANIA,0,TOTALS,ROMANIA,200,22,67,32.8,13,44,29.5,9,23,39.1,14,25,56.0,12,30,42,12,21,24,9,4,67,0
2216,49609,73_05_39,ICELAND,0,TOTALS,ICELAND,200,24,69,34.8,13,40,32.5,11,29,37.9,16,24,66.7,14,26,40,10,22,19,17,2,75,1
2217,49622,73_05_39,BOSNIA AND HERZEGOVINA,0,TOTALS,BOSNIA AND HERZEGOVINA,200,19,58,32.8,17,39,43.6,2,19,10.5,16,25,64.0,15,25,40,7,24,27,8,7,56,0
2218,49635,73_05_40,CZECH REPUBLIC,0,TOTALS,CZECH REPUBLIC,200,29,75,38.7,27,49,55.1,2,26,7.7,7,11,63.6,18,24,42,10,19,15,5,1,67,0
2219,49648,73_05_40,LUXEMBOURG,0,TOTALS,LUXEMBOURG,200,27,60,45.0,17,35,48.6,10,25,40.0,15,20,75.0,8,20,28,9,13,14,6,0,79,1
2220,49661,73_05_41,UKRAINE,0,TOTALS,UKRAINE,200,24,65,36.9,20,49,40.8,4,16,25.0,18,26,69.2,24,23,47,7,12,17,10,6,70,1
2221,49674,73_05_41,AUSTRIA,0,TOTALS,AUSTRIA,200,17,62,27.4,9,32,28.1,8,30,26.7,9,12,75.0,13,16,29,10,22,15,5,0,51,0
2222,49687,73_05_42,IRELAND,0,TOTALS,IRELAND,200,21,76,27.6,14,52,26.9,7,24,29.2,8,12,66.7,17,22,39,10,23,24,11,0,57,0
2223,49700,73_05_42,SWEDEN,0,TOTALS,SWEDEN,200,29,58,50.0,26,48,54.2,3,10,30.0,13,23,56.5,7,33,40,8,17,26,12,9,74,1
2224,49713,73_05_43,BOSNIA AND HERZEGOVINA,0,TOTALS,BOSNIA AND HERZEGOVINA,200,21,57,36.8,15,35,42.9,6,22,27.3,11,14,78.6,9,28,37,8,22,22,4,6,59,0
2225,49726,73_05_43,AUSTRIA,0,TOTALS,AUSTRIA,200,25,76,32.9,20,49,40.8,5,27,18.5,11,20,55.0,16,22,38,12,22,8,15,4,66,1
2226,49739,73_05_44,ICELAND,0,TOTALS,ICELAND,200,23,58,39.7,16,34,47.1,7,24,29.2,18,26,69.2,8,17,25,14,22,13,18,0,71,1
2227,49752,73_05_44,UKRAINE,0,TOTALS,UKRAINE,200,21,57,36.8,12,33,36.4,9,24,37.5,19,24,79.2,15,25,40,8,23,27,4,3,70,0
2228,49765,73_05_45,ROMANIA,0,TOTALS,ROMANIA,200,30,84,35.7,25,60,41.7,5,24,20.8,6,14,42.9,23,20,43,8,16,14,8,6,71,0
2229,49777,73_05_45,ENGLAND,0,TOTALS,ENGLAND,200,40,78,51.3,36,66,54.5,4,12,33.3,14,25,56.0,17,30,47,13,15,12,11,10,98,1
2230,49790,73_05_46,PORTUGAL,0,TOTALS,PORTUGAL,200,18,57,31.6,11,36,30.6,7,21,33.3,12,16,75.0,12,20,32,8,19,22,5,4,55,0
2231,49803,73_05_46,HUNGARY,0,TOTALS,HUNGARY,200,30,62,48.4,25,49,51.0,5,13,38.5,13,20,65.0,12,22,34,22,20,16,9,2,78,1
2232,49816,73_05_47,LUXEMBOURG,0,TOTALS,LUXEMBOURG,200,18,56,32.1,12,36,33.3,6,20,30.0,17,22,77.3,4,15,19,8,11,13,12,2,59,1
2233,49829,73_05_47,SLOVAK REPUBLIC,0,TOTALS,SLOVAK REPUBLIC,200,24,65,36.9,20,41,48.8,4,24,16.7,5,8,62.5,19,32,51,12,18,21,7,2,57,0
2234,49842,73_05_48,FINLAND,0,TOTALS,FINLAND,200,28,63,44.4,17,38,44.7,11,25,44.0,12,17,70.6,8,30,38,14,13,9,2,1,79,1
2235,49855,73_05_48,NETHERLANDS,0,TOTALS,NETHERLANDS,200,29,77,37.7,25,57,43.9,4,20,20.0,4,5,80.0,13,26,39,8,15,5,3,4,66,0
2236,49868,73_05_49,SWEDEN,0,TOTALS,SWEDEN,225,26,68,38.2,25,54,46.3,1,14,7.1,14,22,63.6,19,27,46,5,18,25,11,1,67,1
2237,49881,73_05_49,MKD,0,TOTALS,MKD,225,25,69,36.2,19,49,38.8,6,20,30.0,8,15,53.3,14,20,34,11,24,22,13,2,64,0
2238,49894,73_05_50,ESTONIA,0,TOTALS,ESTONIA,200,39,76,51.3,33,57,57.9,6,19,31.6,22,32,68.8,19,28,47,11,22,12,7,3,106,0
2239,49907,73_05_50,LUXEMBOURG,0,TOTALS,LUXEMBOURG,200,26,65,40.0,19,33,57.6,7,32,21.9,13,24,54.2,7,16,23,9,25,12,4,0,72,1
2240,49919,73_05_51,ENGLAND,0,TOTALS,ENGLAND,200,28,66,42.4,25,51,49.0,3,15,20.0,18,29,62.1,18,27,45,10,21,24,10,4,77,0
2241,49932,73_05_51,SLOVAK REPUBLIC,0,TOTALS,SLOVAK REPUBLIC,200,29,77,37.7,21,46,45.7,8,31,25.8,16,22,72.7,19,20,39,18,25,19,9,4,82,1
2242,49945,73_05_52,ROMANIA,0,TOTALS,ROMANIA,200,24,59,40.7,19,41,46.3,5,18,27.8,14,31,45.2,14,21,35,7,21,24,7,2,67,0
2243,49958,73_05_52,CZECH REPUBLIC,0,TOTALS,CZECH REPUBLIC,200,37,76,48.7,25,47,53.2,12,29,41.4,12,21,57.1,13,25,38,21,26,16,19,3,98,1
2244,49971,73_05_53,AUSTRIA,0,TOTALS,AUSTRIA,200,28,78,35.9,18,47,38.3,10,31,32.3,6,13,46.2,17,21,38,19,25,18,15,1,72,0
2245,49984,73_05_53,PORTUGAL,0,TOTALS,PORTUGAL,200,27,58,46.6,22,38,57.9,5,20,25.0,16,30,53.3,15,27,42,11,16,22,10,7,75,1
2246,49997,73_05_54,BOSNIA AND HERZEGOVINA,0,TOTALS,BOSNIA AND HERZEGOVINA,200,21,58,36.2,18,40,45.0,3,18,16.7,14,19,73.7,15,18,33,7,18,18,10,2,59,0
2247,50010,73_05_54,NETHERLANDS,0,TOTALS,NETHERLANDS,200,26,63,41.3,23,49,46.9,3,14,21.4,11,16,68.8,12,21,33,17,17,14,10,2,66,1
2248,50023,73_05_55,LUXEMBOURG,0,TOTALS,LUXEMBOURG,200,21,58,36.2,15,33,45.5,6,25,24.0,7,11,63.6,3,16,19,5,14,10,6,2,55,0
2249,50036,73_05_55,SWEDEN,0,TOTALS,SWEDEN,200,31,65,47.7,29,52,55.8,2,13,15.4,7,17,41.2,16,36,52,17,11,13,6,2,71,1
2250,50049,73_05_56,UKRAINE,0,TOTALS,UKRAINE,200,22,73,30.1,18,51,35.3,4,22,18.2,10,16,62.5,17,23,40,5,10,9,17,7,58,1
2251,50062,73_05_56,HUNGARY,0,TOTALS,HUNGARY,200,22,54,40.7,16,39,41.0,6,15,40.0,6,9,66.7,8,27,35,13,19,24,3,3,56,0
2252,50075,73_05_57,SLOVAK REPUBLIC,0,TOTALS,SLOVAK REPUBLIC,225,29,84,34.5,17,50,34.0,12,34,35.3,10,19,52.6,18,22,40,16,26,13,14,2,80,0
2253,50088,73_05_57,MKD,0,TOTALS,MKD,225,28,72,38.9,25,55,45.5,3,17,17.6,27,33,81.8,20,37,57,8,18,18,8,3,86,1
2254,50101,73_05_58,ICELAND,0,TOTALS,ICELAND,200,29,66,43.9,18,38,47.4,11,28,39.3,17,20,85.0,12,27,39,15,18,19,13,4,86,1
2255,50114,73_05_58,FINLAND,0,TOTALS,FINLAND,200,28,64,43.8,20,40,50.0,8,24,33.3,7,11,63.6,5,15,20,13,22,20,8,3,71,0
2256,50127,73_05_59,CZECH REPUBLIC,0,TOTALS,CZECH REPUBLIC,200,42,78,53.8,31,50,62.0,11,28,39.3,12,19,63.2,14,37,51,24,14,17,13,4,107,0
2257,50140,73_05_59,IRELAND,0,TOTALS,IRELAND,200,22,77,28.6,18,56,32.1,4,21,19.0,11,17,64.7,14,17,31,8,19,17,9,4,59,1
2258,50153,73_05_60,SWEDEN,0,TOTALS,SWEDEN,200,28,74,37.8,28,64,43.8,0,10,0.0,13,19,68.4,13,36,49,17,19,18,12,5,69,1
2259,50166,73_05_60,ESTONIA,0,TOTALS,ESTONIA,200,19,72,26.4,13,42,31.0,6,30,20.0,12,18,66.7,10,31,41,7,20,21,8,5,56,0
2260,50179,73_05_61,AUSTRIA,0,TOTALS,AUSTRIA,200,27,75,36.0,19,51,37.3,8,24,33.3,19,28,67.9,21,25,46,14,21,10,14,4,81,1
2261,50192,73_05_61,BOSNIA AND HERZEGOVINA,0,TOTALS,BOSNIA AND HERZEGOVINA,200,25,56,44.6,21,45,46.7,4,11,36.4,22,29,75.9,8,25,33,12,24,18,6,5,76,0
2262,50205,73_05_62,MKD,0,TOTALS,MKD,200,32,71,45.1,24,50,48.0,8,21,38.1,15,27,55.6,18,22,40,13,22,16,8,0,87,1
2263,50217,73_05_62,ENGLAND,0,TOTALS,ENGLAND,200,29,65,44.6,25,46,54.3,4,19,21.1,15,30,50.0,20,23,43,11,24,22,11,1,77,0
2264,50230,73_05_63,PORTUGAL,0,TOTALS,PORTUGAL,200,20,53,37.7,12,32,37.5,8,21,38.1,6,8,75.0,10,28,38,13,13,17,7,0,54,1
2265,50243,73_05_63,NETHERLANDS,0,TOTALS,NETHERLANDS,200,19,71,26.8,15,40,37.5,4,31,12.9,6,8,75.0,15,22,37,10,16,9,10,5,48,0
2266,50256,73_05_64,IRELAND,0,TOTALS,IRELAND,200,22,73,30.1,11,41,26.8,11,32,34.4,20,26,76.9,16,35,51,16,23,26,18,2,75,1
2267,50269,73_05_64,ROMANIA,0,TOTALS,ROMANIA,200,23,72,31.9,19,50,38.0,4,22,18.2,19,28,67.9,15,31,46,8,20,23,13,3,69,0
2268,50282,73_05_65,HUNGARY,0,TOTALS,HUNGARY,200,39,73,53.4,34,59,57.6,5,14,35.7,14,19,73.7,15,28,43,23,24,13,7,1,97,1
2269,50295,73_05_65,FINLAND,0,TOTALS,FINLAND,200,26,66,39.4,20,47,42.6,6,19,31.6,18,32,56.2,15,15,30,12,19,12,6,3,76,0
2270,50308,73_05_66,UKRAINE,0,TOTALS,UKRAINE,200,29,64,45.3,24,44,54.5,5,20,25.0,19,28,67.9,14,34,48,13,14,16,10,9,82,1
2271,50321,73_05_66,ICELAND,0,TOTALS,ICELAND,200,19,69,27.5,10,33,30.3,9,36,25.0,9,10,90.0,11,15,26,12,23,17,7,1,56,0
2272,50334,74_05_01,GIBRALTAR,0,TOTALS,GIBRALTAR,200,14,53,26.4,14,44,31.8,0,9,0.0,2,9,22.2,15,24,39,0,56,37,1,0,30,1
2273,50346,74_05_01,ANDORRA,0,TOTALS,ANDORRA,200,46,94,48.9,40,66,60.6,6,28,21.4,19,39,48.7,30,24,54,8,8,10,6,2,117,0
2274,50359,74_05_02,LUXEMBOURG,0,TOTALS,LUXEMBOURG,200,25,69,36.2,21,49,42.9,4,20,20.0,9,19,47.4,19,27,46,9,20,30,0,0,63,1
2275,50369,74_05_02,PRINCIPALITY OF MONACO,0,TOTALS,PRINCIPALITY OF MONACO,200,20,58,34.5,17,41,41.5,3,17,17.6,9,18,50.0,13,27,40,4,24,27,6,1,52,0
2276,50382,74_05_03,SCOTLAND,0,TOTALS,SCOTLAND,200,44,91,48.4,40,76,52.6,4,15,26.7,14,25,56.0,19,32,51,8,17,10,13,2,106,0
2277,50395,74_05_03,SAN MARINO,0,TOTALS,SAN MARINO,200,14,47,29.8,12,32,37.5,2,15,13.3,7,14,50.0,2,29,31,2,26,23,5,1,37,1
2278,50408,74_05_04,MALTA,0,TOTALS,MALTA,200,20,70,28.6,20,56,35.7,0,14,0.0,5,18,27.8,22,31,53,10,26,24,10,3,45,0
2279,50421,74_05_04,WALES,0,TOTALS,WALES,200,14,64,21.9,13,56,23.2,1,8,12.5,18,33,54.5,24,33,57,2,21,24,11,3,47,1
2280,50434,74_05_05,SAN MARINO,0,TOTALS,SAN MARINO,200,13,48,27.1,13,31,41.9,0,17,0.0,10,22,45.5,14,29,43,1,22,27,5,0,36,0
2281,50447,74_05_05,LUXEMBOURG,0,TOTALS,LUXEMBOURG,200,33,73,45.2,28,50,56.0,5,23,21.7,13,25,52.0,15,27,42,7,22,12,5,1,84,1
2282,50459,74_05_06,ANDORRA,0,TOTALS,ANDORRA,200,38,82,46.3,34,68,50.0,4,14,28.6,18,26,69.2,12,23,35,12,21,16,10,1,98,1
2283,50472,74_05_06,WALES,0,TOTALS,WALES,200,18,61,29.5,17,53,32.1,1,8,12.5,11,23,47.8,19,28,47,7,19,35,3,5,48,0
2284,50482,74_05_07,PRINCIPALITY OF MONACO,0,TOTALS,PRINCIPALITY OF MONACO,200,22,66,33.3,16,37,43.2,6,29,20.7,14,37,37.8,16,16,32,12,20,20,14,0,64,1
2285,50495,74_05_07,SCOTLAND,0,TOTALS,SCOTLAND,200,42,79,53.2,30,51,58.8,12,28,42.9,11,21,52.4,24,40,64,17,30,23,10,1,107,0
2286,50508,74_05_08,GIBRALTAR,0,TOTALS,GIBRALTAR,200,18,62,29.0,16,51,31.4,2,11,18.2,2,17,11.8,9,28,37,11,17,25,18,1,40,0
2287,50521,74_05_08,MALTA,0,TOTALS,MALTA,200,28,69,40.6,21,51,41.2,7,18,38.9,3,12,25.0,18,42,60,18,16,27,12,4,66,1
2288,50534,74_05_09,SAN MARINO,0,TOTALS,SAN MARINO,200,24,55,43.6,22,47,46.8,2,8,25.0,14,30,46.7,16,33,49,15,21,35,12,2,64,0
2289,50544,74_05_09,PRINCIPALITY OF MONACO,0,TOTALS,PRINCIPALITY OF MONACO,200,31,71,43.7,22,40,55.0,9,31,29.0,9,28,32.1,16,24,40,22,26,21,19,5,80,1
2290,50557,74_05_10,WALES,0,TOTALS,WALES,200,36,78,46.2,34,71,47.9,2,7,28.6,10,23,43.5,22,42,64,17,26,27,11,9,84,1
2291,50570,74_05_10,GIBRALTAR,0,TOTALS,GIBRALTAR,200,17,64,26.6,16,59,27.1,1,5,20.0,13,31,41.9,13,26,39,6,19,29,8,3,48,0
2292,50583,74_05_11,LUXEMBOURG,0,TOTALS,LUXEMBOURG,200,26,67,38.8,18,41,43.9,8,26,30.8,7,20,35.0,12,18,30,11,26,22,14,2,67,0
2293,50596,74_05_11,SCOTLAND,0,TOTALS,SCOTLAND,200,25,55,45.5,22,46,47.8,3,9,33.3,20,34,58.8,19,34,53,12,20,32,13,6,73,1
2294,50608,74_05_12,ANDORRA,0,TOTALS,ANDORRA,200,48,84,57.1,42,66,63.6,6,18,33.3,10,22,45.5,14,37,51,15,12,14,11,2,112,0
2295,50621,74_05_12,MALTA,0,TOTALS,MALTA,200,14,70,20.0,9,50,18.0,5,20,25.0,5,10,50.0,16,24,40,4,18,30,4,3,38,1
2296,50631,74_05_13,PRINCIPALITY OF MONACO,0,TOTALS,PRINCIPALITY OF MONACO,200,33,78,42.3,29,45,64.4,4,33,12.1,11,19,57.9,12,25,37,10,27,17,19,3,81,1
2297,50644,74_05_13,GIBRALTAR,0,TOTALS,GIBRALTAR,200,7,41,17.1,7,36,19.4,0,5,0.0,11,22,50.0,13,37,50,1,20,45,1,1,25,0
2298,50657,74_05_14,MALTA,0,TOTALS,MALTA,200,21,63,33.3,18,50,36.0,3,13,23.1,8,18,44.4,14,40,54,12,17,24,15,4,53,1
2299,50670,74_05_14,SAN MARINO,0,TOTALS,SAN MARINO,200,17,67,25.4,16,46,34.8,1,21,4.8,8,13,61.5,13,28,41,7,22,21,12,2,43,0
2300,50682,74_05_15,ANDORRA,0,TOTALS,ANDORRA,200,31,77,40.3,26,53,49.1,5,24,20.8,15,26,57.7,24,26,50,13,20,19,13,1,82,1
2301,50695,74_05_15,LUXEMBOURG,0,TOTALS,LUXEMBOURG,200,29,74,39.2,23,48,47.9,6,26,23.1,12,17,70.6,19,25,44,12,25,18,11,3,76,0
2302,50708,74_05_16,SCOTLAND,0,TOTALS,SCOTLAND,200,35,93,37.6,33,80,41.2,2,13,15.4,8,18,44.4,27,29,56,14,19,23,22,7,80,1
2303,50721,74_05_16,WALES,0,TOTALS,WALES,200,11,52,21.2,10,46,21.7,1,6,16.7,12,20,60.0,12,33,45,7,17,47,10,9,35,0
2304,50734,74_05_17,SAN MARINO,0,TOTALS,SAN MARINO,200,23,61,37.7,18,45,40.0,5,16,31.2,10,27,37.0,19,34,53,2,32,28,9,4,61,1
2305,50747,74_05_17,GIBRALTAR,0,TOTALS,GIBRALTAR,200,15,57,26.3,12,41,29.3,3,16,18.8,13,41,31.7,18,30,48,3,21,34,11,4,46,0
2306,50760,74_05_18,MALTA,0,TOTALS,MALTA,200,27,72,37.5,26,58,44.8,1,14,7.1,9,22,40.9,21,31,52,16,6,29,14,2,64,0
2307,50770,74_05_18,PRINCIPALITY OF MONACO,0,TOTALS,PRINCIPALITY OF MONACO,200,36,68,52.9,24,39,61.5,12,29,41.4,1,2,50.0,2,27,29,4,15,24,16,3,85,1
2308,50783,74_05_19,LUXEMBOURG,0,TOTALS,LUXEMBOURG,200,32,71,45.1,27,50,54.0,5,21,23.8,12,19,63.2,12,30,42,16,24,17,13,5,81,1
2309,50796,74_05_19,WALES,0,TOTALS,WALES,200,14,61,23.0,14,56,25.0,0,5,0.0,11,26,42.3,20,27,47,7,19,28,7,5,39,0
2310,50808,74_05_20,ANDORRA,0,TOTALS,ANDORRA,200,34,77,44.2,25,48,52.1,9,29,31.0,20,29,69.0,18,32,50,16,19,15,6,4,97,1
2311,50821,74_05_20,SCOTLAND,0,TOTALS,SCOTLAND,200,33,79,41.8,28,67,41.8,5,12,41.7,14,29,48.3,20,27,47,12,26,23,7,8,85,0
2312,54434,78_05_01,GREECE,0,TOTALS,GREECE,200,35,60,58.3,29,45,64.4,6,15,40.0,13,25,52.0,10,31,41,11,19,21,15,11,89,1
2313,54447,78_05_01,ICELAND,0,TOTALS,ICELAND,200,15,62,24.2,9,41,22.0,6,21,28.6,12,18,66.7,13,17,30,4,23,27,9,0,48,0
2314,54460,78_05_02,BELGIUM,0,TOTALS,BELGIUM,200,30,77,39.0,25,60,41.7,5,17,29.4,5,12,41.7,15,24,39,5,22,11,8,0,70,0
2315,54473,78_05_02,TURKEY,0,TOTALS,TURKEY,200,30,57,52.6,23,39,59.0,7,18,38.9,15,25,60.0,5,31,36,9,14,13,6,1,82,1
2316,54486,78_05_03,ITALY,0,TOTALS,ITALY,200,26,74,35.1,21,57,36.8,5,17,29.4,12,17,70.6,20,25,45,12,33,20,14,2,69,1
2317,54499,78_05_03,POLAND,0,TOTALS,POLAND,200,19,48,39.6,18,42,42.9,1,6,16.7,17,40,42.5,8,25,33,5,22,26,11,2,56,0
2318,54512,78_05_04,SLOVENIA,0,TOTALS,SLOVENIA,200,20,63,31.7,16,40,40.0,4,23,17.4,5,7,71.4,10,19,29,7,20,13,8,2,49,0
2319,54525,78_05_04,UKRAINE,0,TOTALS,UKRAINE,200,21,59,35.6,16,43,37.2,5,16,31.2,19,26,73.1,20,27,47,10,13,16,7,2,66,1
2320,54538,78_05_05,ISRAEL,0,TOTALS,ISRAEL,200,32,71,45.1,28,60,46.7,4,11,36.4,16,29,55.2,11,21,32,12,34,12,3,1,84,0
2321,54551,78_05_05,LITHUANIA,0,TOTALS,LITHUANIA,200,27,58,46.6,15,27,55.6,12,31,38.7,29,53,54.7,10,31,41,7,22,12,8,5,95,1
2322,54564,78_05_06,SERBIA & MONTENEGRO,0,TOTALS,SERBIA & MONTENEGRO,200,28,55,50.9,26,44,59.1,2,11,18.2,15,16,93.8,11,17,28,5,17,24,11,1,73,0
2323,54577,78_05_06,FRANCE,0,TOTALS,FRANCE,200,30,52,57.7,23,37,62.2,7,15,46.7,10,18,55.6,7,11,18,10,18,16,13,1,77,1
2324,54590,78_05_07,SPAIN,0,TOTALS,SPAIN,200,40,75,53.3,36,58,62.1,4,17,23.5,12,21,57.1,12,22,34,12,19,19,26,3,96,1
2325,54603,78_05_07,LATVIA,0,TOTALS,LATVIA,200,19,50,38.0,12,31,38.7,7,19,36.8,8,16,50.0,7,21,28,6,20,36,5,1,53,0
2326,54616,78_05_08,CROATIA,0,TOTALS,CROATIA,200,25,59,42.4,21,44,47.7,4,15,26.7,15,28,53.6,9,28,37,10,26,13,4,3,69,0
2327,54629,78_05_08,RUSSIA,0,TOTALS,RUSSIA,200,29,72,40.3,25,52,48.1,4,20,20.0,16,20,80.0,13,28,41,5,21,6,8,4,78,1
2328,54642,78_05_09,POLAND,0,TOTALS,POLAND,200,22,71,31.0,20,49,40.8,2,22,9.1,19,26,73.1,14,35,49,10,26,23,15,10,65,0
2329,54655,78_05_09,ISRAEL,0,TOTALS,ISRAEL,200,26,74,35.1,22,61,36.1,4,13,30.8,22,30,73.3,14,29,43,6,27,18,15,10,78,1
2330,54668,78_05_10,UKRAINE,0,TOTALS,UKRAINE,200,22,49,44.9,14,21,66.7,8,28,28.6,20,29,69.0,11,15,26,4,17,7,3,2,72,1
2331,54681,78_05_10,BELGIUM,0,TOTALS,BELGIUM,200,24,51,47.1,20,38,52.6,4,13,30.8,13,16,81.2,14,20,34,6,24,17,3,1,65,0
2332,54694,78_05_11,LATVIA,0,TOTALS,LATVIA,200,31,59,52.5,28,51,54.9,3,8,37.5,18,35,51.4,12,24,36,8,26,14,8,3,83,1
2333,54707,78_05_11,SERBIA & MONTENEGRO,0,TOTALS,SERBIA & MONTENEGRO,200,24,69,34.8,18,53,34.0,6,16,37.5,16,19,84.2,18,23,41,6,28,15,8,1,70,0
2334,54720,78_05_12,ICELAND,0,TOTALS,ICELAND,200,28,63,44.4,19,41,46.3,9,22,40.9,9,13,69.2,7,23,30,15,13,10,6,2,74,0
2335,54733,78_05_12,CROATIA,0,TOTALS,CROATIA,200,30,70,42.9,24,52,46.2,6,18,33.3,11,15,73.3,12,27,39,12,15,9,7,3,77,1
2336,54746,78_05_13,RUSSIA,0,TOTALS,RUSSIA,200,19,67,28.4,13,51,25.5,6,16,37.5,15,24,62.5,17,24,41,5,19,15,11,3,59,0
2337,54759,78_05_13,GREECE,0,TOTALS,GREECE,200,24,58,41.4,21,40,52.5,3,18,16.7,10,22,45.5,6,30,36,8,25,14,7,11,61,1
2338,54772,78_05_14,TURKEY,0,TOTALS,TURKEY,200,25,58,43.1,21,44,47.7,4,14,28.6,19,31,61.3,11,29,40,8,20,13,6,5,73,1
2339,54785,78_05_14,SLOVENIA,0,TOTALS,SLOVENIA,200,24,67,35.8,18,49,36.7,6,18,33.3,9,21,42.9,14,25,39,4,24,12,5,1,63,0
2340,54798,78_05_15,LITHUANIA,0,TOTALS,LITHUANIA,200,23,64,35.9,19,41,46.3,4,23,17.4,23,35,65.7,14,35,49,12,20,13,8,3,73,1
2341,54811,78_05_15,ITALY,0,TOTALS,ITALY,200,18,64,28.1,15,52,28.8,3,12,25.0,6,16,37.5,8,23,31,5,26,12,6,2,45,0
2342,54824,78_05_16,FRANCE,0,TOTALS,FRANCE,200,38,65,58.5,35,47,74.5,3,18,16.7,18,22,81.8,7,25,32,7,30,21,13,1,97,1
2343,54837,78_05_16,SPAIN,0,TOTALS,SPAIN,200,25,62,40.3,18,36,50.0,7,26,26.9,30,34,88.2,11,17,28,5,24,21,17,3,87,0
2344,54850,78_05_17,ICELAND,0,TOTALS,ICELAND,200,22,62,35.5,18,42,42.9,4,20,20.0,10,17,58.8,9,27,36,6,13,11,7,2,58,0
2345,54863,78_05_17,RUSSIA,0,TOTALS,RUSSIA,200,30,64,46.9,20,40,50.0,10,24,41.7,4,8,50.0,7,27,34,8,15,12,8,3,74,1
2346,54876,78_05_18,BELGIUM,0,TOTALS,BELGIUM,200,22,55,40.0,19,43,44.2,3,12,25.0,10,15,66.7,8,23,31,4,20,20,4,1,57,0
2347,54889,78_05_18,SLOVENIA,0,TOTALS,SLOVENIA,200,30,60,50.0,23,39,59.0,7,21,33.3,17,20,85.0,6,25,31,6,15,12,12,3,84,1
2348,54902,78_05_19,POLAND,0,TOTALS,POLAND,200,19,63,30.2,14,47,29.8,5,16,31.2,6,9,66.7,11,22,33,4,21,23,10,4,49,0
2349,54915,78_05_19,LITHUANIA,0,TOTALS,LITHUANIA,200,31,70,44.3,22,51,43.1,9,19,47.4,7,19,36.8,19,29,48,8,17,22,14,12,78,1
2350,54928,78_05_20,UKRAINE,0,TOTALS,UKRAINE,225,28,65,43.1,16,37,43.2,12,28,42.9,11,18,61.1,6,29,35,6,12,12,6,2,79,0
2351,54941,78_05_20,TURKEY,0,TOTALS,TURKEY,225,34,73,46.6,24,46,52.2,10,27,37.0,3,7,42.9,9,30,39,7,19,13,6,0,81,1
2352,54954,78_05_21,ISRAEL,0,TOTALS,ISRAEL,200,20,61,32.8,18,45,40.0,2,16,12.5,17,28,60.7,10,21,31,7,21,18,9,0,59,0
2353,54967,78_05_21,ITALY,0,TOTALS,ITALY,200,31,65,47.7,28,43,65.1,3,22,13.6,15,19,78.9,8,29,37,14,21,15,11,6,80,1
2354,54980,78_05_22,LATVIA,0,TOTALS,LATVIA,200,27,50,54.0,21,33,63.6,6,17,35.3,16,24,66.7,7,25,32,1,23,19,8,0,76,0
2355,54993,78_05_22,FRANCE,0,TOTALS,FRANCE,200,28,64,43.8,20,36,55.6,8,28,28.6,14,22,63.6,14,15,29,7,18,15,12,1,78,1
2356,55006,78_05_23,SERBIA & MONTENEGRO,0,TOTALS,SERBIA & MONTENEGRO,200,27,61,44.3,23,38,60.5,4,23,17.4,9,15,60.0,6,26,32,8,29,13,7,2,67,0
2357,55019,78_05_23,SPAIN,0,TOTALS,SPAIN,200,23,59,39.0,17,43,39.5,6,16,37.5,21,34,61.8,12,24,36,8,16,11,7,1,73,1
2358,55032,78_05_24,CROATIA,0,TOTALS,CROATIA,225,30,70,42.9,27,53,50.9,3,17,17.6,18,28,64.3,12,27,39,10,21,16,10,5,81,1
2359,55045,78_05_24,GREECE,0,TOTALS,GREECE,225,27,62,43.5,22,43,51.2,5,19,26.3,14,24,58.3,11,27,38,11,25,19,9,9,73,0
2360,55058,78_05_25,ISRAEL,0,TOTALS,ISRAEL,200,28,60,46.7,26,50,52.0,2,10,20.0,14,26,53.8,13,33,46,12,20,23,15,6,72,1
2361,55071,78_05_25,BELGIUM,0,TOTALS,BELGIUM,200,21,69,30.4,18,51,35.3,3,18,16.7,3,11,27.3,12,22,34,9,20,23,13,4,48,0
2362,55084,78_05_26,LITHUANIA,0,TOTALS,LITHUANIA,200,29,69,42.0,21,44,47.7,8,25,32.0,9,11,81.8,13,33,46,8,17,12,5,2,75,1
2363,55097,78_05_26,UKRAINE,0,TOTALS,UKRAINE,200,16,56,28.6,14,39,35.9,2,17,11.8,9,18,50.0,8,26,34,4,15,11,5,2,43,0
2364,55110,78_05_27,SERBIA & MONTENEGRO,0,TOTALS,SERBIA & MONTENEGRO,200,25,58,43.1,21,49,42.9,4,9,44.4,14,20,70.0,10,27,37,10,20,14,7,1,68,1
2365,55123,78_05_27,GREECE,0,TOTALS,GREECE,200,23,55,41.8,16,36,44.4,7,19,36.8,12,19,63.2,7,20,27,5,22,11,8,3,65,0
2366,55136,78_05_28,FRANCE,0,TOTALS,FRANCE,225,34,75,45.3,27,55,49.1,7,20,35.0,16,23,69.6,14,27,41,4,19,14,12,3,91,1
2367,55149,78_05_28,CROATIA,0,TOTALS,CROATIA,225,34,70,48.6,25,50,50.0,9,20,45.0,12,17,70.6,10,29,39,6,23,19,10,3,89,0
2368,55162,78_05_29,POLAND,0,TOTALS,POLAND,225,29,74,39.2,28,61,45.9,1,13,7.7,25,38,65.8,23,30,53,7,22,14,13,4,84,1
2369,55175,78_05_29,SLOVENIA,0,TOTALS,SLOVENIA,225,28,65,43.1,23,47,48.9,5,18,27.8,15,24,62.5,9,19,28,6,33,16,9,4,76,0
2370,55188,78_05_30,ITALY,0,TOTALS,ITALY,200,25,68,36.8,21,55,38.2,4,13,30.8,19,34,55.9,9,24,33,3,22,13,10,4,73,0
2371,55201,78_05_30,TURKEY,0,TOTALS,TURKEY,200,35,70,50.0,27,46,58.7,8,24,33.3,14,23,60.9,14,37,51,11,27,16,9,2,92,1
2372,55214,78_05_31,LATVIA,0,TOTALS,LATVIA,200,27,58,46.6,22,44,50.0,5,14,35.7,7,18,38.9,12,27,39,8,15,19,9,6,66,1
2373,55227,78_05_31,ICELAND,0,TOTALS,ICELAND,200,18,60,30.0,11,28,39.3,7,32,21.9,6,10,60.0,5,19,24,4,16,16,14,1,49,0
2374,55240,78_05_32,SPAIN,0,TOTALS,SPAIN,200,35,68,51.5,31,53,58.5,4,15,26.7,14,24,58.3,12,18,30,9,20,10,14,1,88,1
2375,55253,78_05_32,RUSSIA,0,TOTALS,RUSSIA,200,30,58,51.7,27,47,57.4,3,11,27.3,15,19,78.9,11,22,33,7,20,18,7,0,78,0
2376,55266,78_05_33,GREECE,0,TOTALS,GREECE,200,22,70,31.4,19,44,43.2,3,26,11.5,17,33,51.5,18,23,41,2,19,21,16,4,64,0
2377,55279,78_05_33,ISRAEL,0,TOTALS,ISRAEL,200,28,60,46.7,24,49,49.0,4,11,36.4,14,20,70.0,8,29,37,8,29,25,12,0,74,1
2378,55292,78_05_34,RUSSIA,0,TOTALS,RUSSIA,200,26,64,40.6,21,51,41.2,5,13,38.5,8,14,57.1,10,25,35,4,27,15,11,0,65,0
2379,55305,78_05_34,LITHUANIA,0,TOTALS,LITHUANIA,200,28,66,42.4,20,42,47.6,8,24,33.3,17,30,56.7,14,28,42,5,20,13,8,2,81,1
2380,55318,78_05_35,BELGIUM,0,TOTALS,BELGIUM,200,14,53,26.4,11,41,26.8,3,12,25.0,12,14,85.7,7,14,21,2,25,26,16,2,43,0
2381,55331,78_05_35,SERBIA & MONTENEGRO,0,TOTALS,SERBIA & MONTENEGRO,200,28,56,50.0,23,42,54.8,5,14,35.7,13,27,48.1,14,25,39,14,19,25,15,7,74,1
2382,55344,78_05_36,TURKEY,0,TOTALS,TURKEY,200,26,65,40.0,14,28,50.0,12,37,32.4,3,7,42.9,9,21,30,5,17,13,11,1,67,1
2383,55357,78_05_36,FRANCE,0,TOTALS,FRANCE,200,25,59,42.4,19,33,57.6,6,26,23.1,10,12,83.3,10,32,42,5,12,19,8,2,66,0
2384,55370,78_05_37,ICELAND,0,TOTALS,ICELAND,200,26,59,44.1,20,42,47.6,6,17,35.3,10,19,52.6,3,22,25,9,12,8,7,1,68,1
2385,55383,78_05_37,POLAND,0,TOTALS,POLAND,200,27,60,45.0,25,52,48.1,2,8,25.0,10,16,62.5,10,31,41,7,18,14,6,1,66,0
2386,55396,78_05_38,CROATIA,0,TOTALS,CROATIA,200,27,58,46.6,20,34,58.8,7,24,29.2,12,23,52.2,6,27,33,1,25,19,8,3,73,0
2387,55409,78_05_38,ITALY,0,TOTALS,ITALY,200,28,62,45.2,20,50,40.0,8,12,66.7,18,27,66.7,9,25,34,8,24,15,15,2,82,1
2388,55422,78_05_39,SLOVENIA,0,TOTALS,SLOVENIA,200,29,52,55.8,21,35,60.0,8,17,47.1,21,33,63.6,6,18,24,7,23,10,15,3,87,1
2389,55435,78_05_39,LATVIA,0,TOTALS,LATVIA,200,27,58,46.6,25,52,48.1,2,6,33.3,13,25,52.0,18,16,34,5,28,17,5,3,69,0
2390,55448,78_05_40,UKRAINE,0,TOTALS,UKRAINE,200,20,55,36.4,9,26,34.6,11,29,37.9,7,11,63.6,6,15,21,4,12,17,12,2,58,0
2391,55461,78_05_40,SPAIN,0,TOTALS,SPAIN,200,35,67,52.2,31,54,57.4,4,13,30.8,5,7,71.4,16,24,40,5,16,17,11,3,79,1
2392,55474,78_05_41,ISRAEL,0,TOTALS,ISRAEL,200,27,57,47.4,26,53,49.1,1,4,25.0,19,21,90.5,5,20,25,12,27,15,11,4,74,0
2393,55487,78_05_41,SERBIA & MONTENEGRO,0,TOTALS,SERBIA & MONTENEGRO,200,28,70,40.0,25,52,48.1,3,18,16.7,24,34,70.6,22,23,45,12,18,14,7,7,83,1
2394,55500,78_05_42,CROATIA,0,TOTALS,CROATIA,200,32,66,48.5,24,44,54.5,8,22,36.4,15,27,55.6,11,29,40,4,20,19,14,3,87,1
2395,55513,78_05_42,TURKEY,0,TOTALS,TURKEY,200,27,63,42.9,19,50,38.0,8,13,61.5,10,17,58.8,6,23,29,5,25,21,12,6,72,0
2396,55526,78_05_43,GREECE,0,TOTALS,GREECE,200,28,66,42.4,22,48,45.8,6,18,33.3,8,16,50.0,11,34,45,15,9,11,9,11,70,1
2397,55539,78_05_43,BELGIUM,0,TOTALS,BELGIUM,200,14,67,20.9,11,54,20.4,3,13,23.1,6,9,66.7,16,32,48,3,17,18,10,6,37,0
2398,55552,78_05_44,RUSSIA,0,TOTALS,RUSSIA,200,26,64,40.6,21,51,41.2,5,13,38.5,13,19,68.4,9,30,39,7,16,15,16,2,70,1
2399,55565,78_05_44,UKRAINE,0,TOTALS,UKRAINE,200,20,61,32.8,11,39,28.2,9,22,40.9,3,10,30.0,10,26,36,5,20,24,8,1,52,0
2400,55578,78_05_45,POLAND,0,TOTALS,POLAND,200,19,66,28.8,15,44,34.1,4,22,18.2,12,24,50.0,12,25,37,3,22,13,8,0,54,0
2401,55591,78_05_45,LATVIA,0,TOTALS,LATVIA,200,29,64,45.3,25,56,44.6,4,8,50.0,17,26,65.4,11,35,46,8,23,13,10,5,79,1
2402,55604,78_05_46,ITALY,0,TOTALS,ITALY,200,25,58,43.1,17,39,43.6,8,19,42.1,13,15,86.7,11,20,31,3,33,22,9,2,71,0
2403,55617,78_05_46,FRANCE,0,TOTALS,FRANCE,200,30,62,48.4,26,49,53.1,4,13,30.8,22,34,64.7,12,20,32,9,18,12,17,2,86,1
2404,55630,78_05_47,ICELAND,0,TOTALS,ICELAND,200,18,56,32.1,15,34,44.1,3,22,13.6,11,21,52.4,5,24,29,3,13,13,5,1,50,0
2405,55643,78_05_47,SLOVENIA,0,TOTALS,SLOVENIA,200,28,62,45.2,23,42,54.8,5,20,25.0,7,14,50.0,11,32,43,5,22,13,8,0,68,1
2406,55656,78_05_48,LITHUANIA,0,TOTALS,LITHUANIA,200,23,53,43.4,12,27,44.4,11,26,42.3,30,44,68.2,12,23,35,6,19,18,15,1,87,1
2407,55669,78_05_48,SPAIN,0,TOTALS,SPAIN,200,27,67,40.3,21,49,42.9,6,18,33.3,16,21,76.2,14,22,36,7,29,18,13,4,76,0
2408,55682,78_05_49,GREECE,0,TOTALS,GREECE,200,29,67,43.3,25,51,49.0,4,16,25.0,18,30,60.0,18,31,49,16,17,17,9,7,80,1
2409,55695,78_05_49,POLAND,0,TOTALS,POLAND,200,30,71,42.3,22,52,42.3,8,19,42.1,11,16,68.8,11,25,36,6,22,13,14,2,79,0
2410,55708,78_05_50,RUSSIA,0,TOTALS,RUSSIA,200,31,62,50.0,28,57,49.1,3,5,60.0,25,39,64.1,13,24,37,7,19,15,10,9,90,1
2411,55721,78_05_50,CROATIA,0,TOTALS,CROATIA,200,31,70,44.3,29,60,48.3,2,10,20.0,11,17,64.7,9,21,30,3,31,15,10,2,75,0
2412,55734,78_05_51,BELGIUM,0,TOTALS,BELGIUM,200,23,69,33.3,17,48,35.4,6,21,28.6,4,7,57.1,8,28,36,6,15,13,6,0,56,0
2413,55747,78_05_51,ICELAND,0,TOTALS,ICELAND,200,24,60,40.0,15,28,53.6,9,32,28.1,7,8,87.5,7,33,40,4,12,15,7,3,64,1
2414,55760,78_05_52,UKRAINE,0,TOTALS,UKRAINE,200,26,63,41.3,18,45,40.0,8,18,44.4,10,15,66.7,11,30,41,7,11,9,11,2,70,1
2415,55773,78_05_52,ITALY,0,TOTALS,ITALY,200,19,61,31.1,12,42,28.6,7,19,36.8,3,5,60.0,8,20,28,4,17,15,4,6,48,0
2416,55786,78_05_53,SERBIA & MONTENEGRO,0,TOTALS,SERBIA & MONTENEGRO,200,30,68,44.1,26,56,46.4,4,12,33.3,13,22,59.1,16,24,40,13,22,15,18,7,77,1
2417,55799,78_05_53,LATVIA,0,TOTALS,LATVIA,200,17,55,30.9,14,41,34.1,3,14,21.4,8,18,44.4,10,19,29,3,21,24,7,9,45,0
2418,55812,78_05_54,LITHUANIA,0,TOTALS,LITHUANIA,200,24,60,40.0,16,37,43.2,8,23,34.8,17,22,77.3,9,25,34,3,22,15,7,2,73,0
2419,55825,78_05_54,FRANCE,0,TOTALS,FRANCE,200,25,67,37.3,19,51,37.3,6,16,37.5,20,24,83.3,16,25,41,4,24,11,10,2,76,1
2420,55838,78_05_55,ISRAEL,0,TOTALS,ISRAEL,200,38,69,55.1,37,64,57.8,1,5,20.0,12,21,57.1,11,30,41,12,28,15,11,5,89,1
2421,55851,78_05_55,SLOVENIA,0,TOTALS,SLOVENIA,200,14,50,28.0,6,27,22.2,8,23,34.8,24,37,64.9,6,18,24,4,19,19,11,4,60,0
2422,55864,78_05_56,SPAIN,0,TOTALS,SPAIN,200,29,70,41.4,21,41,51.2,8,29,27.6,17,28,60.7,15,25,40,9,20,15,10,6,83,0
2423,55877,78_05_56,TURKEY,0,TOTALS,TURKEY,200,34,71,47.9,27,51,52.9,7,20,35.0,13,23,56.5,11,25,36,6,21,15,12,2,88,1
2424,55890,78_05_57,POLAND,0,TOTALS,POLAND,200,18,69,26.1,13,49,26.5,5,20,25.0,21,28,75.0,17,23,40,3,10,11,13,3,62,1
2425,55903,78_05_57,BELGIUM,0,TOTALS,BELGIUM,200,26,74,35.1,23,59,39.0,3,15,20.0,6,9,66.7,23,36,59,5,18,21,7,7,61,0
2426,55916,78_05_58,GREECE,0,TOTALS,GREECE,200,43,76,56.6,41,60,68.3,2,16,12.5,15,19,78.9,14,27,41,16,11,19,23,5,103,0
2427,55929,78_05_58,ICELAND,0,TOTALS,ICELAND,200,21,69,30.4,10,33,30.3,11,36,30.6,1,2,50.0,9,19,28,4,18,35,15,1,54,1
2428,55942,78_05_59,CROATIA,0,TOTALS,CROATIA,200,25,65,38.5,20,47,42.6,5,18,27.8,18,31,58.1,15,34,49,0,21,21,11,5,73,0
2429,55955,78_05_59,ITALY,0,TOTALS,ITALY,200,28,73,38.4,22,57,38.6,6,16,37.5,15,24,62.5,11,25,36,6,27,15,14,4,77,1
2430,55968,78_05_60,LATVIA,0,TOTALS,LATVIA,200,27,57,47.4,22,47,46.8,5,10,50.0,13,27,48.1,14,25,39,8,16,18,12,7,72,1
2431,55981,78_05_60,SLOVENIA,0,TOTALS,SLOVENIA,200,26,70,37.1,22,52,42.3,4,18,22.2,9,15,60.0,15,18,33,7,20,14,14,3,65,0
2432,55994,78_05_61,RUSSIA,0,TOTALS,RUSSIA,200,27,69,39.1,22,54,40.7,5,15,33.3,7,12,58.3,13,26,39,0,23,12,4,2,66,0
2433,56007,78_05_61,UKRAINE,0,TOTALS,UKRAINE,200,24,61,39.3,20,43,46.5,4,18,22.2,21,30,70.0,12,25,37,4,14,12,5,3,73,1
2434,56020,78_05_62,SERBIA & MONTENEGRO,0,TOTALS,SERBIA & MONTENEGRO,200,19,51,37.3,14,39,35.9,5,12,41.7,32,41,78.0,10,20,30,2,18,14,12,3,75,0
2435,56033,78_05_62,ISRAEL,0,TOTALS,ISRAEL,200,32,59,54.2,31,48,64.6,1,11,9.1,11,15,73.3,7,21,28,10,29,14,9,3,76,1
2436,56046,78_05_63,LITHUANIA,0,TOTALS,LITHUANIA,200,25,64,39.1,19,41,46.3,6,23,26.1,7,20,35.0,9,27,36,9,19,16,5,1,63,0
2437,56059,78_05_63,SPAIN,0,TOTALS,SPAIN,200,26,81,32.1,24,65,36.9,2,16,12.5,16,24,66.7,21,27,48,7,20,6,14,5,70,1
2438,56072,78_05_64,FRANCE,0,TOTALS,FRANCE,200,23,71,32.4,16,47,34.0,7,24,29.2,2,2,100.0,11,22,33,7,17,12,9,0,55,0
2439,56085,78_05_64,TURKEY,0,TOTALS,TURKEY,200,24,56,42.9,17,39,43.6,7,17,41.2,6,12,50.0,10,26,36,5,14,18,10,2,61,1
2440,56098,79_05_01,MKD,0,TOTALS,MKD,225,26,72,36.1,17,45,37.8,9,27,33.3,8,13,61.5,21,30,51,3,29,26,9,3,69,0
2441,56111,79_05_01,IRELAND,0,TOTALS,IRELAND,225,26,59,44.1,16,36,44.4,10,23,43.5,22,35,62.9,9,28,37,5,16,16,19,1,84,1
2442,56124,79_05_02,GERMANY,0,TOTALS,GERMANY,200,34,63,54.0,29,51,56.9,5,12,41.7,16,27,59.3,18,26,44,12,16,19,10,4,89,1
2443,56137,79_05_02,SLOVAK REPUBLIC,0,TOTALS,SLOVAK REPUBLIC,200,27,68,39.7,22,49,44.9,5,19,26.3,3,9,33.3,18,17,35,6,22,19,12,2,62,0
2444,56150,79_05_03,FINLAND,0,TOTALS,FINLAND,200,37,79,46.8,28,61,45.9,9,18,50.0,5,16,31.2,25,30,55,5,17,27,20,1,88,1
2445,56163,79_05_03,CZECH REPUBLIC,0,TOTALS,CZECH REPUBLIC,200,28,66,42.4,21,46,45.7,7,20,35.0,7,20,35.0,14,23,37,5,18,26,13,6,70,0
2446,56176,79_05_04,ESTONIA,0,TOTALS,ESTONIA,200,28,68,41.2,20,46,43.5,8,22,36.4,8,17,47.1,14,31,45,4,21,19,7,2,72,1
2447,56189,79_05_04,ENGLAND,0,TOTALS,ENGLAND,200,25,68,36.8,23,58,39.7,2,10,20.0,14,24,58.3,16,31,47,8,20,17,9,1,66,0
2448,56202,79_05_05,NETHERLANDS,0,TOTALS,NETHERLANDS,200,19,57,33.3,15,44,34.1,4,13,30.8,11,27,40.7,18,34,52,7,25,28,8,3,53,0
2449,56215,79_05_05,FINLAND,0,TOTALS,FINLAND,200,26,65,40.0,18,42,42.9,8,23,34.8,13,32,40.6,11,25,36,3,21,17,15,0,73,1
2450,56228,79_05_06,CYPRUS,0,TOTALS,CYPRUS,200,30,91,33.0,26,63,41.3,4,28,14.3,9,22,40.9,22,22,44,1,28,12,24,2,73,0
2451,56240,79_05_06,ESTONIA,0,TOTALS,ESTONIA,200,29,65,44.6,26,46,56.5,3,19,15.8,22,32,68.8,17,44,61,13,23,31,8,2,83,1
2452,56253,79_05_07,CZECH REPUBLIC,0,TOTALS,CZECH REPUBLIC,200,9,49,18.4,8,26,30.8,1,23,4.3,13,23,56.5,9,27,36,1,29,35,11,4,32,0
2453,56266,79_05_07,GERMANY,0,TOTALS,GERMANY,200,27,76,35.5,22,60,36.7,5,16,31.2,19,30,63.3,28,37,65,6,20,24,23,2,78,1
2454,56279,79_05_08,ENGLAND,0,TOTALS,ENGLAND,200,32,72,44.4,26,52,50.0,6,20,30.0,10,21,47.6,19,23,42,3,27,22,10,0,80,1
2455,56292,79_05_08,MKD,0,TOTALS,MKD,200,30,69,43.5,24,42,57.1,6,27,22.2,10,24,41.7,20,25,45,6,21,25,14,2,76,0
2456,56305,79_05_09,SLOVAK REPUBLIC,0,TOTALS,SLOVAK REPUBLIC,200,30,78,38.5,24,48,50.0,6,30,20.0,14,30,46.7,21,35,56,5,22,17,12,3,80,1
2457,56318,79_05_09,CZECH REPUBLIC,0,TOTALS,CZECH REPUBLIC,200,27,73,37.0,19,45,42.2,8,28,28.6,14,24,58.3,17,33,50,6,30,22,7,2,76,0
2458,56331,79_05_10,IRELAND,0,TOTALS,IRELAND,200,22,69,31.9,13,38,34.2,9,31,29.0,11,15,73.3,9,14,23,5,14,14,11,5,64,0
2459,56344,79_05_10,ENGLAND,0,TOTALS,ENGLAND,200,38,71,53.5,35,60,58.3,3,11,27.3,8,13,61.5,19,39,58,11,20,23,8,1,87,1
2460,56357,79_05_11,GERMANY,0,TOTALS,GERMANY,200,29,74,39.2,26,55,47.3,3,19,15.8,25,39,64.1,26,22,48,9,9,26,33,7,86,1
2461,56370,79_05_11,NETHERLANDS,0,TOTALS,NETHERLANDS,200,15,48,31.2,14,37,37.8,1,11,9.1,3,6,50.0,10,25,35,1,27,46,10,3,34,0
2462,56382,79_05_12,MKD,0,TOTALS,MKD,200,20,55,36.4,14,33,42.4,6,22,27.3,20,35,57.1,19,40,59,3,12,27,5,7,66,0
2463,56395,79_05_12,CYPRUS,0,TOTALS,CYPRUS,200,27,73,37.0,20,48,41.7,7,25,28.0,7,12,58.3,9,21,30,5,27,9,17,1,68,1
2464,56408,79_05_13,AUSTRIA,0,TOTALS,AUSTRIA,200,25,70,35.7,16,43,37.2,9,27,33.3,6,14,42.9,17,27,44,5,36,24,12,0,65,0
2465,56421,79_05_13,ROMANIA,0,TOTALS,ROMANIA,200,23,53,43.4,22,45,48.9,1,8,12.5,24,53,45.3,18,35,53,5,16,25,12,5,71,1
2466,56433,79_05_14,GEORGIA,0,TOTALS,GEORGIA,200,30,64,46.9,26,44,59.1,4,20,20.0,18,27,66.7,18,47,65,5,19,36,13,6,82,1
2467,56446,79_05_14,BULGARIA,0,TOTALS,BULGARIA,200,20,82,24.4,16,62,25.8,4,20,20.0,12,23,52.2,19,20,39,10,28,21,26,1,56,0
2468,56459,79_05_15,BOSNIA AND HERZEGOVINA,0,TOTALS,BOSNIA AND HERZEGOVINA,200,18,52,34.6,16,44,36.4,2,8,25.0,14,22,63.6,12,29,41,4,29,38,13,1,52,0
2469,56472,79_05_15,PORTUGAL,0,TOTALS,PORTUGAL,200,27,60,45.0,22,39,56.4,5,21,23.8,11,28,39.3,14,27,41,4,21,29,19,3,70,1
2470,56485,79_05_16,SWEDEN,0,TOTALS,SWEDEN,200,23,72,31.9,21,51,41.2,2,21,9.5,5,20,25.0,19,32,51,4,13,15,12,1,53,0
2471,56498,79_05_16,HUNGARY,0,TOTALS,HUNGARY,200,27,70,38.6,25,61,41.0,2,9,22.2,5,9,55.6,12,38,50,7,17,19,10,5,61,1
2472,56511,79_05_17,ROMANIA,0,TOTALS,ROMANIA,200,22,66,33.3,20,55,36.4,2,11,18.2,16,27,59.3,13,20,33,1,18,27,15,1,62,0
2473,56524,79_05_17,BOSNIA AND HERZEGOVINA,0,TOTALS,BOSNIA AND HERZEGOVINA,200,40,83,48.2,38,71,53.5,2,12,16.7,9,20,45.0,29,38,67,7,22,26,23,0,91,1
2474,56537,79_05_18,ESTONIA,0,TOTALS,ESTONIA,200,34,66,51.5,23,46,50.0,11,20,55.0,14,26,53.8,8,32,40,10,19,13,11,1,93,1
2475,56550,79_05_18,MKD,0,TOTALS,MKD,200,24,64,37.5,19,43,44.2,5,21,23.8,13,19,68.4,10,30,40,7,23,22,4,6,66,0
2476,56563,79_05_19,PORTUGAL,0,TOTALS,PORTUGAL,200,30,66,45.5,24,46,52.2,6,20,30.0,8,18,44.4,17,31,48,4,12,21,14,6,74,1
2477,56576,79_05_19,AUSTRIA,0,TOTALS,AUSTRIA,200,17,58,29.3,15,50,30.0,2,8,25.0,8,11,72.7,10,24,34,5,17,26,7,3,44,0
2478,56589,79_05_20,HUNGARY,0,TOTALS,HUNGARY,200,20,60,33.3,17,43,39.5,3,17,17.6,11,20,55.0,10,30,40,5,16,14,6,2,54,0
2479,56601,79_05_20,GEORGIA,0,TOTALS,GEORGIA,200,28,71,39.4,16,39,41.0,12,32,37.5,9,14,64.3,14,33,47,10,19,10,10,2,77,1
2480,56614,79_05_21,BULGARIA,0,TOTALS,BULGARIA,200,29,81,35.8,27,65,41.5,2,16,12.5,12,19,63.2,26,27,53,8,20,17,14,0,72,1
2481,56627,79_05_21,SWEDEN,0,TOTALS,SWEDEN,200,26,67,38.8,22,53,41.5,4,14,28.6,7,13,53.8,17,28,45,7,20,25,9,4,63,0
2482,56640,79_05_22,FINLAND,0,TOTALS,FINLAND,200,16,54,29.6,10,38,26.3,6,16,37.5,12,22,54.5,11,23,34,2,25,27,12,0,50,0
2483,56653,79_05_22,GERMANY,0,TOTALS,GERMANY,200,34,64,53.1,31,50,62.0,3,14,21.4,12,29,41.4,16,32,48,9,25,19,14,6,83,1
2484,56666,79_05_23,NETHERLANDS,0,TOTALS,NETHERLANDS,200,20,53,37.7,16,40,40.0,4,13,30.8,19,27,70.4,15,34,49,4,24,34,11,0,63,0
2485,56679,79_05_23,SLOVAK REPUBLIC,0,TOTALS,SLOVAK REPUBLIC,200,20,76,26.3,14,45,31.1,6,31,19.4,23,37,62.2,27,23,50,1,21,19,17,4,69,1
2486,56692,79_05_24,CYPRUS,0,TOTALS,CYPRUS,200,31,77,40.3,24,54,44.4,7,23,30.4,3,8,37.5,17,25,42,6,16,12,19,0,72,1
2487,56705,79_05_24,IRELAND,0,TOTALS,IRELAND,200,19,62,30.6,14,38,36.8,5,24,20.8,4,8,50.0,15,31,46,4,13,28,1,4,47,0
2488,56718,79_05_25,AUSTRIA,0,TOTALS,AUSTRIA,200,20,75,26.7,16,47,34.0,4,28,14.3,11,18,61.1,16,24,40,2,28,16,15,3,55,0
2489,56731,79_05_25,BOSNIA AND HERZEGOVINA,0,TOTALS,BOSNIA AND HERZEGOVINA,200,26,57,45.6,21,44,47.7,5,13,38.5,26,40,65.0,19,40,59,7,21,30,9,5,83,1
2490,56744,79_05_26,SWEDEN,0,TOTALS,SWEDEN,200,21,65,32.3,17,48,35.4,4,17,23.5,9,12,75.0,14,30,44,5,14,25,10,4,55,0
2491,56756,79_05_26,GEORGIA,0,TOTALS,GEORGIA,200,28,83,33.7,24,58,41.4,4,25,16.0,10,12,83.3,26,32,58,5,14,22,9,7,70,1
2492,56769,79_05_27,CZECH REPUBLIC,0,TOTALS,CZECH REPUBLIC,200,21,79,26.6,13,43,30.2,8,36,22.2,13,42,31.0,29,26,55,1,23,22,22,2,63,1
2493,56782,79_05_27,NETHERLANDS,0,TOTALS,NETHERLANDS,200,18,57,31.6,12,41,29.3,6,16,37.5,11,25,44.0,20,44,64,7,35,40,9,5,53,0
2494,56795,79_05_28,ENGLAND,0,TOTALS,ENGLAND,200,25,54,46.3,25,48,52.1,0,6,0.0,19,32,59.4,17,39,56,10,16,23,2,3,69,1
2495,56808,79_05_28,CYPRUS,0,TOTALS,CYPRUS,200,21,66,31.8,11,41,26.8,10,25,40.0,10,13,76.9,6,20,26,1,24,10,11,0,62,0
2496,56821,79_05_29,PORTUGAL,0,TOTALS,PORTUGAL,200,34,80,42.5,28,59,47.5,6,21,28.6,7,11,63.6,20,24,44,7,20,18,16,5,81,1
2497,56834,79_05_29,ROMANIA,0,TOTALS,ROMANIA,200,20,54,37.0,15,45,33.3,5,9,55.6,11,24,45.8,14,25,39,3,12,26,11,3,56,0
2498,56847,79_05_30,BULGARIA,0,TOTALS,BULGARIA,200,21,76,27.6,17,51,33.3,4,25,16.0,18,31,58.1,26,34,60,6,22,18,13,0,64,1
2499,56860,79_05_30,HUNGARY,0,TOTALS,HUNGARY,200,16,58,27.6,14,38,36.8,2,20,10.0,10,14,71.4,10,36,46,1,32,22,8,5,44,0
2500,56873,79_05_31,SLOVAK REPUBLIC,0,TOTALS,SLOVAK REPUBLIC,200,41,78,52.6,35,62,56.5,6,16,37.5,11,21,52.4,19,28,47,9,22,15,7,2,99,1
2501,56886,79_05_31,FINLAND,0,TOTALS,FINLAND,200,24,66,36.4,18,46,39.1,6,20,30.0,17,28,60.7,18,23,41,6,18,22,5,3,71,0
2502,56899,79_05_32,IRELAND,0,TOTALS,IRELAND,200,29,54,53.7,19,35,54.3,10,19,52.6,6,17,35.3,11,37,48,7,21,31,8,5,74,1
2503,56912,79_05_32,ESTONIA,0,TOTALS,ESTONIA,200,23,84,27.4,16,52,30.8,7,32,21.9,16,20,80.0,23,20,43,7,18,15,17,5,69,0
2504,56925,79_05_33,PORTUGAL,0,TOTALS,PORTUGAL,200,20,68,29.4,15,48,31.2,5,20,25.0,9,20,45.0,20,27,47,5,20,10,7,6,54,0
2505,56938,79_05_33,ENGLAND,0,TOTALS,ENGLAND,200,25,61,41.0,20,52,38.5,5,9,55.6,13,17,76.5,13,34,47,4,21,14,2,2,68,1
2506,56951,79_05_34,IRELAND,0,TOTALS,IRELAND,200,21,63,33.3,11,37,29.7,10,26,38.5,6,18,33.3,12,24,36,5,16,17,11,4,58,1
2507,56964,79_05_34,NETHERLANDS,0,TOTALS,NETHERLANDS,200,20,59,33.9,15,41,36.6,5,18,27.8,5,6,83.3,15,36,51,2,19,28,7,2,50,0
2508,56977,79_05_35,BOSNIA AND HERZEGOVINA,0,TOTALS,BOSNIA AND HERZEGOVINA,200,30,75,40.0,22,52,42.3,8,23,34.8,12,23,52.2,24,34,58,5,27,21,4,5,80,0
2509,56990,79_05_35,ESTONIA,0,TOTALS,ESTONIA,200,30,78,38.5,20,44,45.5,10,34,29.4,20,27,74.1,18,25,43,9,18,9,9,4,90,1
2510,57003,79_05_36,CZECH REPUBLIC,0,TOTALS,CZECH REPUBLIC,200,24,76,31.6,14,44,31.8,10,32,31.2,15,29,51.7,17,37,54,4,24,23,12,6,73,1
2511,57016,79_05_36,CYPRUS,0,TOTALS,CYPRUS,200,24,74,32.4,24,61,39.3,0,13,0.0,13,24,54.2,18,43,61,7,23,26,15,1,61,0
2512,57029,79_05_37,BULGARIA,0,TOTALS,BULGARIA,200,23,74,31.1,17,51,33.3,6,23,26.1,6,16,37.5,18,32,50,10,23,20,18,2,58,0
2513,57042,79_05_37,GERMANY,0,TOTALS,GERMANY,200,26,67,38.8,25,59,42.4,1,8,12.5,10,21,47.6,16,36,52,8,25,23,14,7,63,1
2514,57055,79_05_38,AUSTRIA,0,TOTALS,AUSTRIA,200,24,62,38.7,18,48,37.5,6,14,42.9,9,16,56.2,16,18,34,4,26,27,10,1,63,0
2515,57068,79_05_38,HUNGARY,0,TOTALS,HUNGARY,200,24,55,43.6,21,46,45.7,3,9,33.3,19,32,59.4,16,25,41,5,17,23,15,6,70,1
2516,57080,79_05_39,GEORGIA,0,TOTALS,GEORGIA,200,32,62,51.6,27,47,57.4,5,15,33.3,22,30,73.3,17,33,50,19,21,24,14,7,91,1
2517,57093,79_05_39,SLOVAK REPUBLIC,0,TOTALS,SLOVAK REPUBLIC,200,25,82,30.5,23,64,35.9,2,18,11.1,14,26,53.8,29,16,45,2,23,17,16,2,66,0
2518,57106,79_05_40,SWEDEN,0,TOTALS,SWEDEN,200,33,70,47.1,27,54,50.0,6,16,37.5,4,10,40.0,14,31,45,2,10,19,11,2,76,1
2519,57119,79_05_40,MKD,0,TOTALS,MKD,200,21,54,38.9,14,31,45.2,7,23,30.4,3,8,37.5,6,27,33,3,15,25,9,3,52,0
2520,57132,79_05_41,SLOVAK REPUBLIC,0,TOTALS,SLOVAK REPUBLIC,200,28,69,40.6,22,49,44.9,6,20,30.0,7,12,58.3,15,23,38,5,16,12,12,5,69,0
2521,57145,79_05_41,BOSNIA AND HERZEGOVINA,0,TOTALS,BOSNIA AND HERZEGOVINA,200,28,62,45.2,22,47,46.8,6,15,40.0,9,13,69.2,13,29,42,7,14,18,9,4,71,1
2522,57158,79_05_42,FINLAND,0,TOTALS,FINLAND,200,20,59,33.9,20,47,42.6,0,12,0.0,20,27,74.1,21,39,60,8,24,31,8,3,60,1
2523,57171,79_05_42,AUSTRIA,0,TOTALS,AUSTRIA,200,21,70,30.0,17,47,36.2,4,23,17.4,12,18,66.7,14,21,35,1,25,17,14,2,58,0
2524,57184,79_05_43,GERMANY,0,TOTALS,GERMANY,200,34,67,50.7,29,58,50.0,5,9,55.6,8,17,47.1,15,23,38,9,21,18,19,3,81,1
2525,57197,79_05_43,PORTUGAL,0,TOTALS,PORTUGAL,200,23,56,41.1,18,42,42.9,5,14,35.7,14,22,63.6,13,23,36,4,17,23,10,5,65,0
2526,57210,79_05_44,ROMANIA,0,TOTALS,ROMANIA,200,31,71,43.7,30,62,48.4,1,9,11.1,29,42,69.0,19,36,55,9,23,27,17,3,92,1
2527,57223,79_05_44,CZECH REPUBLIC,0,TOTALS,CZECH REPUBLIC,200,27,78,34.6,26,61,42.6,1,17,5.9,16,26,61.5,21,27,48,9,33,27,18,1,71,0
2528,57236,79_05_45,ENGLAND,0,TOTALS,ENGLAND,200,28,70,40.0,26,59,44.1,2,11,18.2,13,18,72.2,17,35,52,7,24,21,8,4,71,0
2529,57249,79_05_45,BULGARIA,0,TOTALS,BULGARIA,200,27,70,38.6,18,44,40.9,9,26,34.6,13,32,40.6,17,26,43,13,20,15,14,3,76,1
2530,57262,79_05_46,HUNGARY,0,TOTALS,HUNGARY,200,27,65,41.5,23,53,43.4,4,12,33.3,9,17,52.9,12,29,41,6,16,15,13,4,67,1
2531,57275,79_05_46,IRELAND,0,TOTALS,IRELAND,200,19,63,30.2,15,43,34.9,4,20,20.0,11,13,84.6,15,31,46,3,15,24,6,3,53,0
2532,57288,79_05_47,ESTONIA,0,TOTALS,ESTONIA,200,24,63,38.1,16,39,41.0,8,24,33.3,15,26,57.7,16,18,34,3,28,20,9,1,71,0
2533,57300,79_05_47,GEORGIA,0,TOTALS,GEORGIA,200,26,61,42.6,20,39,51.3,6,22,27.3,24,32,75.0,17,27,44,10,20,20,12,4,82,1
2534,57313,79_05_48,CYPRUS,0,TOTALS,CYPRUS,200,33,70,47.1,26,51,51.0,7,19,36.8,1,6,16.7,6,27,33,6,21,12,15,0,74,0
2535,57326,79_05_48,SWEDEN,0,TOTALS,SWEDEN,200,31,75,41.3,25,55,45.5,6,20,30.0,11,20,55.0,20,32,52,5,14,18,6,6,79,1
2536,57339,79_05_49,SLOVAK REPUBLIC,0,TOTALS,SLOVAK REPUBLIC,200,30,64,46.9,23,45,51.1,7,19,36.8,13,19,68.4,10,34,44,4,24,16,8,5,80,1
2537,57352,79_05_49,ESTONIA,0,TOTALS,ESTONIA,200,24,70,34.3,19,52,36.5,5,18,27.8,20,30,66.7,18,26,44,4,20,13,7,2,73,0
2538,57365,79_05_50,IRELAND,0,TOTALS,IRELAND,200,20,62,32.3,19,50,38.0,1,12,8.3,11,14,78.6,12,20,32,5,10,23,14,4,52,0
2539,57378,79_05_50,FINLAND,0,TOTALS,FINLAND,200,34,72,47.2,29,51,56.9,5,21,23.8,5,10,50.0,19,31,50,10,15,21,15,3,78,1
2540,57391,79_05_51,GERMANY,0,TOTALS,GERMANY,200,34,68,50.0,27,48,56.2,7,20,35.0,25,33,75.8,15,27,42,8,12,11,17,3,100,0
2541,57404,79_05_51,ENGLAND,0,TOTALS,ENGLAND,200,17,51,33.3,13,39,33.3,4,12,33.3,2,7,28.6,9,20,29,1,24,32,5,2,40,1
2542,57417,79_05_52,MKD,0,TOTALS,MKD,200,29,59,49.2,22,37,59.5,7,22,31.8,9,18,50.0,18,43,61,8,17,35,9,10,74,1
2543,57430,79_05_52,CYPRUS,0,TOTALS,CYPRUS,200,27,84,32.1,25,64,39.1,2,20,10.0,6,14,42.9,19,18,37,3,18,15,23,0,62,0
2544,57443,79_05_53,PORTUGAL,0,TOTALS,PORTUGAL,200,35,71,49.3,33,53,62.3,2,18,11.1,11,15,73.3,12,38,50,9,21,15,10,5,83,1
2545,57456,79_05_53,BULGARIA,0,TOTALS,BULGARIA,200,21,73,28.8,18,48,37.5,3,25,12.0,9,21,42.9,17,26,43,8,21,16,8,4,54,0
2546,57469,79_05_54,NETHERLANDS,0,TOTALS,NETHERLANDS,200,16,72,22.2,15,56,26.8,1,16,6.2,16,28,57.1,32,34,66,2,26,30,5,3,49,0
2547,57482,79_05_54,HUNGARY,0,TOTALS,HUNGARY,200,27,68,39.7,19,52,36.5,8,16,50.0,21,32,65.6,10,32,42,6,25,12,15,11,83,1
2548,57495,79_05_55,BOSNIA AND HERZEGOVINA,0,TOTALS,BOSNIA AND HERZEGOVINA,200,32,67,47.8,30,57,52.6,2,10,20.0,18,30,60.0,18,23,41,4,21,17,12,4,84,1
2549,57507,79_05_55,GEORGIA,0,TOTALS,GEORGIA,200,30,68,44.1,24,46,52.2,6,22,27.3,13,21,61.9,15,24,39,8,23,15,9,7,79,0
2550,57520,79_05_56,SWEDEN,0,TOTALS,SWEDEN,200,30,83,36.1,24,59,40.7,6,24,25.0,2,4,50.0,25,38,63,13,8,15,4,5,68,1
2551,57533,79_05_56,ROMANIA,0,TOTALS,ROMANIA,200,25,86,29.1,23,69,33.3,2,17,11.8,2,10,20.0,27,27,54,3,12,10,9,6,54,0
2552,57546,79_05_57,FINLAND,0,TOTALS,FINLAND,200,23,75,30.7,17,48,35.4,6,27,22.2,13,20,65.0,20,23,43,5,18,16,7,2,65,0
2553,57559,79_05_57,NETHERLANDS,0,TOTALS,NETHERLANDS,200,34,72,47.2,29,54,53.7,5,18,27.8,8,13,61.5,18,35,53,12,14,20,9,2,81,1
2554,57572,79_05_58,ROMANIA,0,TOTALS,ROMANIA,200,32,79,40.5,30,71,42.3,2,8,25.0,11,18,61.1,22,27,49,3,10,9,7,1,77,1
2555,57585,79_05_58,MKD,0,TOTALS,MKD,200,29,65,44.6,19,34,55.9,10,31,32.3,6,7,85.7,10,30,40,6,17,15,5,5,74,0
2556,57598,79_05_59,AUSTRIA,0,TOTALS,AUSTRIA,200,24,81,29.6,19,55,34.5,5,26,19.2,6,12,50.0,27,23,50,1,25,17,16,5,59,0
2557,57611,79_05_59,IRELAND,0,TOTALS,IRELAND,200,19,54,35.2,11,29,37.9,8,25,32.0,15,28,53.6,16,34,50,5,17,23,12,5,61,1
2558,57624,79_05_60,CZECH REPUBLIC,0,TOTALS,CZECH REPUBLIC,200,27,79,34.2,22,55,40.0,5,24,20.8,10,13,76.9,19,29,48,7,26,11,8,5,69,0
2559,57637,79_05_60,SWEDEN,0,TOTALS,SWEDEN,200,24,71,33.8,16,50,32.0,8,21,38.1,19,27,70.4,20,34,54,2,16,14,3,4,75,1
2560,57650,79_05_61,NETHERLANDS,0,TOTALS,NETHERLANDS,200,20,48,41.7,18,38,47.4,2,10,20.0,24,30,80.0,10,35,45,5,18,24,5,2,66,0
2561,57663,79_05_61,AUSTRIA,0,TOTALS,AUSTRIA,200,23,67,34.3,17,40,42.5,6,27,22.2,16,20,80.0,11,20,31,1,23,11,15,2,68,1
2562,57676,79_05_62,ENGLAND,0,TOTALS,ENGLAND,200,34,61,55.7,33,57,57.9,1,4,25.0,13,23,56.5,11,32,43,9,21,17,4,4,82,0
2563,57689,79_05_62,ESTONIA,0,TOTALS,ESTONIA,200,31,72,43.1,19,42,45.2,12,30,40.0,12,21,57.1,15,21,36,8,18,10,10,4,86,1
2564,57702,79_05_63,CYPRUS,0,TOTALS,CYPRUS,200,26,74,35.1,22,56,39.3,4,18,22.2,6,12,50.0,11,24,35,7,16,7,12,0,62,0
2565,57715,79_05_63,ROMANIA,0,TOTALS,ROMANIA,200,25,70,35.7,16,51,31.4,9,19,47.4,10,19,52.6,25,40,65,4,13,21,2,7,69,1
2566,57728,79_05_64,BULGARIA,0,TOTALS,BULGARIA,200,24,74,32.4,20,49,40.8,4,25,16.0,19,24,79.2,14,25,39,4,25,16,15,1,71,0
2567,57741,79_05_64,SLOVAK REPUBLIC,0,TOTALS,SLOVAK REPUBLIC,200,33,70,47.1,28,52,53.8,5,18,27.8,19,32,59.4,17,40,57,6,20,21,10,1,90,1
2568,57754,79_05_65,HUNGARY,0,TOTALS,HUNGARY,200,30,67,44.8,28,62,45.2,2,5,40.0,19,36,52.8,22,33,55,8,19,15,13,6,81,1
2569,57767,79_05_65,FINLAND,0,TOTALS,FINLAND,200,23,73,31.5,16,51,31.4,7,22,31.8,8,19,42.1,22,27,49,3,26,18,9,1,61,0
2570,57780,79_05_66,GERMANY,0,TOTALS,GERMANY,200,30,76,39.5,26,64,40.6,4,12,33.3,15,20,75.0,24,19,43,4,14,13,18,2,79,1
2571,57792,79_05_66,GEORGIA,0,TOTALS,GEORGIA,200,25,60,41.7,18,35,51.4,7,25,28.0,7,12,58.3,16,20,36,6,16,24,8,8,64,0
2572,57805,79_05_67,MKD,0,TOTALS,MKD,200,22,64,34.4,19,40,47.5,3,24,12.5,16,21,76.2,13,23,36,3,24,29,16,3,63,0
2573,57818,79_05_67,CZECH REPUBLIC,0,TOTALS,CZECH REPUBLIC,200,30,67,44.8,27,55,49.1,3,12,25.0,13,27,48.1,20,31,51,10,16,29,17,5,76,1
2574,57831,79_05_68,PORTUGAL,0,TOTALS,PORTUGAL,200,23,58,39.7,23,53,43.4,0,5,0.0,20,37,54.1,13,23,36,3,16,14,11,8,66,1
2575,57844,79_05_68,BOSNIA AND HERZEGOVINA,0,TOTALS,BOSNIA AND HERZEGOVINA,200,24,69,34.8,21,57,36.8,3,12,25.0,8,15,53.3,24,27,51,5,24,22,12,2,59,0
2576,57857,79_05_69,CYPRUS,0,TOTALS,CYPRUS,200,23,62,37.1,17,39,43.6,6,23,26.1,13,25,52.0,10,19,29,6,13,9,19,1,65,1
2577,57870,79_05_69,NETHERLANDS,0,TOTALS,NETHERLANDS,200,20,55,36.4,12,35,34.3,8,20,40.0,5,6,83.3,15,37,52,4,17,31,8,0,53,0
2578,57883,79_05_70,MKD,0,TOTALS,MKD,200,20,45,44.4,17,35,48.6,3,10,30.0,7,13,53.8,10,23,33,6,14,40,14,11,50,0
2579,57896,79_05_70,AUSTRIA,0,TOTALS,AUSTRIA,200,31,83,37.3,29,79,36.7,2,4,50.0,13,21,61.9,33,19,52,4,19,22,27,1,77,1
2580,57909,79_05_71,ENGLAND,0,TOTALS,ENGLAND,200,35,61,57.4,35,60,58.3,0,1,0.0,13,17,76.5,11,27,38,10,14,16,8,1,83,1
2581,57922,79_05_71,BULGARIA,0,TOTALS,BULGARIA,200,32,78,41.0,26,47,55.3,6,31,19.4,8,11,72.7,17,16,33,4,19,12,9,3,78,0
2582,57935,79_05_72,CZECH REPUBLIC,0,TOTALS,CZECH REPUBLIC,200,25,63,39.7,24,49,49.0,1,14,7.1,8,13,61.5,9,28,37,8,15,29,20,5,59,1
2583,57948,79_05_72,IRELAND,0,TOTALS,IRELAND,200,22,59,37.3,15,37,40.5,7,22,31.8,3,8,37.5,12,30,42,8,12,36,16,2,54,0
2584,57961,79_05_73,ESTONIA,0,TOTALS,ESTONIA,200,23,64,35.9,15,43,34.9,8,21,38.1,13,18,72.2,17,32,49,5,15,16,12,5,67,1
2585,57974,79_05_73,SLOVAK REPUBLIC,0,TOTALS,SLOVAK REPUBLIC,200,18,67,26.9,14,49,28.6,4,18,22.2,5,12,41.7,21,24,45,3,15,18,8,5,45,0
2586,57987,79_05_74,ROMANIA,0,TOTALS,ROMANIA,200,26,71,36.6,24,61,39.3,2,10,20.0,5,8,62.5,15,25,40,3,15,16,7,5,59,0
2587,58000,79_05_74,FINLAND,0,TOTALS,FINLAND,200,28,68,41.2,24,52,46.2,4,16,25.0,7,11,63.6,16,31,47,9,17,20,5,1,67,1
2588,58012,79_05_75,GEORGIA,0,TOTALS,GEORGIA,200,35,70,50.0,32,50,64.0,3,20,15.0,4,8,50.0,7,24,31,14,20,19,20,8,77,1
2589,58025,79_05_75,BOSNIA AND HERZEGOVINA,0,TOTALS,BOSNIA AND HERZEGOVINA,200,25,65,38.5,20,53,37.7,5,12,41.7,12,22,54.5,21,30,51,7,12,31,10,2,67,0
2590,58038,79_05_76,SWEDEN,0,TOTALS,SWEDEN,225,37,87,42.5,29,64,45.3,8,23,34.8,11,18,61.1,24,19,43,6,9,15,15,0,93,1
2591,58051,79_05_76,HUNGARY,0,TOTALS,HUNGARY,225,41,75,54.7,34,59,57.6,7,16,43.8,3,7,42.9,16,29,45,9,21,25,9,6,92,0
2592,58064,79_05_77,GERMANY,0,TOTALS,GERMANY,200,30,68,44.1,28,59,47.5,2,9,22.2,15,18,83.3,18,25,43,10,28,16,10,4,77,1
2593,58077,79_05_77,PORTUGAL,0,TOTALS,PORTUGAL,200,22,49,44.9,17,36,47.2,5,13,38.5,14,25,56.0,7,21,28,3,20,18,10,5,63,0
2594,61389,82_05_01,NEW ZEALAND,0,TOTALS,NEW ZEALAND,200,23,70,32.9,11,37,29.7,12,33,36.4,11,13,84.6,15,15,30,15,19,10,11,2,69,0
2595,61400,82_05_01,AUSTRALIA,0,TOTALS,AUSTRALIA,200,29,64,45.3,17,30,56.7,12,34,35.3,12,16,75.0,12,27,39,17,17,15,7,5,82,1
2596,61412,82_05_02,AUSTRALIA,0,TOTALS,AUSTRALIA,200,29,58,50.0,22,42,52.4,7,16,43.8,17,27,63.0,8,26,34,14,22,19,8,4,82,1
2597,61424,82_05_02,NEW ZEALAND,0,TOTALS,NEW ZEALAND,200,22,68,32.4,9,35,25.7,13,33,39.4,14,21,66.7,18,21,39,15,29,18,12,1,71,0
2598,61437,82_05_03,NEW ZEALAND,0,TOTALS,NEW ZEALAND,200,30,67,44.8,20,39,51.3,10,28,35.7,10,13,76.9,9,25,34,18,23,18,11,5,80,0
2599,61450,82_05_03,AUSTRALIA,0,TOTALS,AUSTRALIA,200,32,67,47.8,24,47,51.1,8,20,40.0,19,24,79.2,9,23,32,14,21,14,8,2,91,1
2600,61463,84_06_01,VENEZUELA,0,TOTALS,VENEZUELA,200,29,78,37.2,23,51,45.1,6,27,22.2,8,14,57.1,14,20,34,15,24,23,11,3,72,0
2601,61476,84_06_01,LEBANON,0,TOTALS,LEBANON,200,29,63,46.0,24,46,52.2,5,17,29.4,19,26,73.1,9,28,37,8,19,26,8,5,82,1
2602,61489,84_06_02,GERMANY,0,TOTALS,GERMANY,200,28,60,46.7,23,47,48.9,5,13,38.5,20,27,74.1,14,29,43,9,20,11,7,4,81,1
2603,61502,84_06_02,JAPAN,0,TOTALS,JAPAN,200,25,55,45.5,20,34,58.8,5,21,23.8,15,19,78.9,3,21,24,10,26,10,4,2,70,0
2604,61515,84_06_03,BRAZIL,0,TOTALS,BRAZIL,200,26,63,41.3,20,44,45.5,6,19,31.6,19,27,70.4,11,25,36,10,24,18,13,5,77,0
2605,61528,84_06_03,AUSTRALIA,0,TOTALS,AUSTRALIA,200,28,59,47.5,19,34,55.9,9,25,36.0,18,27,66.7,7,24,31,12,21,19,7,2,83,1
2606,61541,84_06_04,PUERTO RICO,0,TOTALS,PUERTO RICO,200,38,70,54.3,28,54,51.9,10,16,62.5,14,18,77.8,9,18,27,15,26,15,6,2,100,0
2607,61554,84_06_04,USA,0,TOTALS,USA,200,39,72,54.2,30,45,66.7,9,27,33.3,24,34,70.6,18,18,36,20,21,14,14,9,111,1
2608,61567,84_06_05,SERBIA & MONTENEGRO,0,TOTALS,SERBIA & MONTENEGRO,200,25,57,43.9,19,38,50.0,6,19,31.6,19,26,73.1,13,22,35,7,22,17,2,4,75,0
2609,61580,84_06_05,NIGERIA,0,TOTALS,NIGERIA,200,29,69,42.0,21,53,39.6,8,16,50.0,16,25,64.0,12,16,28,10,29,11,11,3,82,1
2610,61593,84_06_06,ANGOLA,0,TOTALS,ANGOLA,200,29,68,42.6,17,36,47.2,12,32,37.5,13,15,86.7,9,28,37,16,21,10,9,1,83,1
2611,61606,84_06_06,PANAMA,0,TOTALS,PANAMA,200,26,68,38.2,20,47,42.6,6,21,28.6,12,24,50.0,18,22,40,9,19,18,7,2,70,0
2612,61619,84_06_07,GREECE,0,TOTALS,GREECE,200,28,60,46.7,22,39,56.4,6,21,28.6,22,24,91.7,11,13,24,12,17,17,14,2,84,1
2613,61632,84_06_07,QATAR,0,TOTALS,QATAR,200,25,45,55.6,17,27,63.0,8,18,44.4,6,13,46.2,9,21,30,7,24,35,4,1,64,0
2614,61645,84_06_08,SLOVENIA,0,TOTALS,SLOVENIA,200,33,66,50.0,21,44,47.7,12,22,54.5,18,30,60.0,14,25,39,22,23,16,8,3,96,1
2615,61658,84_06_08,SENEGAL,0,TOTALS,SENEGAL,200,29,63,46.0,25,52,48.1,4,11,36.4,17,27,63.0,10,23,33,9,21,17,11,4,79,0
2616,61671,84_06_09,ARGENTINA,0,TOTALS,ARGENTINA,200,25,58,43.1,17,35,48.6,8,23,34.8,22,26,84.6,14,23,37,14,19,13,9,3,80,1
2617,61684,84_06_09,FRANCE,0,TOTALS,FRANCE,200,25,59,42.4,20,44,45.5,5,15,33.3,15,26,57.7,11,20,31,15,19,11,9,1,70,0
2618,61697,84_06_10,SPAIN,0,TOTALS,SPAIN,200,31,59,52.5,23,35,65.7,8,24,33.3,16,30,53.3,6,27,33,10,16,11,12,2,86,1
2619,61710,84_06_10,NEW ZEALAND,0,TOTALS,NEW ZEALAND,200,26,64,40.6,17,37,45.9,9,27,33.3,9,12,75.0,9,25,34,18,29,14,9,1,70,0
2620,61723,84_06_11,TURKEY,0,TOTALS,TURKEY,200,26,62,41.9,18,39,46.2,8,23,34.8,16,27,59.3,5,19,24,13,24,11,6,3,76,1
2621,61736,84_06_11,LITHUANIA,0,TOTALS,LITHUANIA,200,24,57,42.1,18,42,42.9,6,15,40.0,20,32,62.5,13,27,40,8,26,14,3,3,74,0
2622,61749,84_06_12,CHINA,0,TOTALS,CHINA,200,21,53,39.6,17,42,40.5,4,11,36.4,23,26,88.5,11,22,33,9,20,15,5,4,69,0
2623,61762,84_06_12,ITALY,0,TOTALS,ITALY,200,28,62,45.2,15,37,40.5,13,25,52.0,15,19,78.9,13,19,32,22,24,8,9,0,84,1
2624,61775,84_06_13,NIGERIA,0,TOTALS,NIGERIA,200,30,71,42.3,24,52,46.2,6,19,31.6,11,18,61.1,9,16,25,12,20,12,14,1,77,0
2625,61788,84_06_13,VENEZUELA,0,TOTALS,VENEZUELA,200,28,53,52.8,16,31,51.6,12,22,54.5,16,25,64.0,8,27,35,15,17,23,8,4,84,1
2626,61801,84_06_14,JAPAN,0,TOTALS,JAPAN,200,23,58,39.7,15,36,41.7,8,22,36.4,8,15,53.3,7,21,28,7,16,14,4,1,62,0
2627,61814,84_06_14,ANGOLA,0,TOTALS,ANGOLA,200,31,71,43.7,19,47,40.4,12,24,50.0,13,17,76.5,19,31,50,11,18,13,8,6,87,1
2628,61827,84_06_15,QATAR,0,TOTALS,QATAR,200,24,57,42.1,14,31,45.2,10,26,38.5,8,14,57.1,12,20,32,18,18,29,7,1,66,0
2629,61840,84_06_15,BRAZIL,0,TOTALS,BRAZIL,200,39,69,56.5,33,49,67.3,6,20,30.0,13,18,72.2,11,20,31,18,16,15,17,2,97,1
2630,61853,84_06_16,SENEGAL,0,TOTALS,SENEGAL,200,26,70,37.1,15,43,34.9,11,27,40.7,16,22,72.7,15,27,42,20,32,17,7,1,79,0
2631,61866,84_06_16,PUERTO RICO,0,TOTALS,PUERTO RICO,200,25,54,46.3,13,32,40.6,12,22,54.5,26,36,72.2,7,28,35,12,22,16,7,1,88,1
2632,61879,84_06_17,LEBANON,0,TOTALS,LEBANON,200,27,72,37.5,18,43,41.9,9,29,31.0,9,17,52.9,11,19,30,6,22,21,8,2,72,1
2633,61892,84_06_17,ARGENTINA,0,TOTALS,ARGENTINA,200,38,70,54.3,27,39,69.2,11,31,35.5,20,32,62.5,13,29,42,28,19,15,8,3,107,0
2634,61905,84_06_18,NEW ZEALAND,0,TOTALS,NEW ZEALAND,200,19,50,38.0,12,29,41.4,7,21,33.3,11,21,52.4,5,19,24,10,17,11,6,2,56,0
2635,61918,84_06_18,GERMANY,0,TOTALS,GERMANY,200,27,64,42.2,11,30,36.7,16,34,47.1,10,13,76.9,14,30,44,22,20,12,4,0,80,1
2636,61931,84_06_19,AUSTRALIA,0,TOTALS,AUSTRALIA,200,22,53,41.5,11,26,42.3,11,27,40.7,13,19,68.4,4,25,29,11,28,15,6,0,68,0
2637,61944,84_06_19,TURKEY,0,TOTALS,TURKEY,200,27,66,40.9,20,41,48.8,7,25,28.0,15,26,57.7,14,26,40,13,26,16,6,2,76,1
2638,61957,84_06_20,ITALY,0,TOTALS,ITALY,200,29,61,47.5,20,36,55.6,9,25,36.0,13,19,68.4,5,27,32,11,21,11,4,3,80,1
2639,61970,84_06_20,SLOVENIA,0,TOTALS,SLOVENIA,200,31,64,48.4,23,41,56.1,8,23,34.8,6,12,50.0,7,29,36,16,23,15,6,3,76,0
2640,61983,84_06_21,FRANCE,0,TOTALS,FRANCE,200,21,60,35.0,19,47,40.4,2,13,15.4,21,30,70.0,7,26,33,9,24,13,11,3,65,1
2641,61996,84_06_21,SERBIA & MONTENEGRO,0,TOTALS,SERBIA & MONTENEGRO,200,20,49,40.8,16,33,48.5,4,16,25.0,17,26,65.4,4,27,31,6,27,18,7,4,61,0
2642,62009,84_06_22,PANAMA,0,TOTALS,PANAMA,200,22,64,34.4,21,50,42.0,1,14,7.1,12,17,70.6,8,26,34,5,25,23,7,3,57,1
2643,62022,84_06_22,SPAIN,0,TOTALS,SPAIN,200,37,79,46.8,26,50,52.0,11,29,37.9,16,25,64.0,14,32,46,22,20,9,12,3,101,0
2644,62035,84_06_23,LITHUANIA,0,TOTALS,LITHUANIA,225,27,71,38.0,21,40,52.5,6,31,19.4,16,22,72.7,17,29,46,20,31,25,7,1,76,0
2645,62048,84_06_23,GREECE,0,TOTALS,GREECE,225,28,58,48.3,24,41,58.5,4,17,23.5,21,41,51.2,9,20,29,13,26,18,16,2,81,1
2646,62061,84_06_24,USA,0,TOTALS,USA,200,41,85,48.2,35,65,53.8,6,20,30.0,33,40,82.5,20,25,45,23,20,8,18,1,121,0
2647,62074,84_06_24,CHINA,0,TOTALS,CHINA,200,29,66,43.9,16,35,45.7,13,31,41.9,19,25,76.0,13,24,37,17,28,24,3,5,90,1
2648,62087,84_06_25,ARGENTINA,0,TOTALS,ARGENTINA,200,38,68,55.9,29,46,63.0,9,22,40.9,11,15,73.3,7,31,38,20,19,10,9,3,96,1
2649,62100,84_06_25,VENEZUELA,0,TOTALS,VENEZUELA,200,19,70,27.1,18,53,34.0,1,17,5.9,15,23,65.2,21,21,42,3,14,18,4,2,54,0
2650,62113,84_06_26,ANGOLA,0,TOTALS,ANGOLA,200,35,68,51.5,23,36,63.9,12,32,37.5,13,21,61.9,14,23,37,20,30,14,5,0,95,1
2651,62126,84_06_26,NEW ZEALAND,0,TOTALS,NEW ZEALAND,200,24,57,42.1,17,30,56.7,7,27,25.9,18,31,58.1,11,19,30,13,22,20,7,2,73,0
2652,62139,84_06_27,SERBIA & MONTENEGRO,0,TOTALS,SERBIA & MONTENEGRO,200,40,64,62.5,28,44,63.6,12,20,60.0,12,17,70.6,13,24,37,25,19,12,6,5,104,0
2653,62152,84_06_27,LEBANON,0,TOTALS,LEBANON,200,19,60,31.7,14,39,35.9,5,21,23.8,14,19,73.7,12,15,27,10,19,16,4,1,57,1
2654,62165,84_06_28,GERMANY,0,TOTALS,GERMANY,200,23,52,44.2,13,23,56.5,10,29,34.5,15,19,78.9,6,16,22,13,24,18,6,1,71,0
2655,62178,84_06_28,SPAIN,0,TOTALS,SPAIN,200,28,48,58.3,17,30,56.7,11,18,61.1,25,34,73.5,3,23,26,14,19,13,10,0,92,1
2656,62191,84_06_29,FRANCE,0,TOTALS,FRANCE,200,21,60,35.0,11,30,36.7,10,30,33.3,12,23,52.2,13,33,46,13,19,17,5,2,64,1
2657,62204,84_06_29,NIGERIA,0,TOTALS,NIGERIA,200,18,67,26.9,16,49,32.7,2,18,11.1,15,26,57.7,16,25,41,6,19,11,7,2,53,0
2658,62217,84_06_30,JAPAN,0,TOTALS,JAPAN,200,27,60,45.0,18,35,51.4,9,25,36.0,15,23,65.2,5,24,29,16,25,14,16,1,78,1
2659,62230,84_06_30,PANAMA,0,TOTALS,PANAMA,200,22,57,38.6,20,47,42.6,2,10,20.0,15,32,46.9,15,26,41,9,22,27,8,3,61,0
2660,62243,84_06_31,LITHUANIA,0,TOTALS,LITHUANIA,200,39,76,51.3,30,54,55.6,9,22,40.9,19,30,63.3,16,25,41,28,15,17,19,7,106,0
2661,62256,84_06_31,QATAR,0,TOTALS,QATAR,200,21,58,36.2,9,31,29.0,12,27,44.4,11,16,68.8,8,24,32,14,24,32,10,1,65,1
2662,62269,84_06_32,CHINA,0,TOTALS,CHINA,225,30,67,44.8,23,46,50.0,7,21,33.3,20,27,74.1,9,35,44,13,28,16,3,4,87,0
2663,62282,84_06_32,PUERTO RICO,0,TOTALS,PUERTO RICO,225,30,67,44.8,18,43,41.9,12,24,50.0,18,29,62.1,9,30,39,15,24,11,5,2,90,1
2664,62295,84_06_33,GREECE,0,TOTALS,GREECE,200,23,53,43.4,17,31,54.8,6,22,27.3,20,23,87.0,6,17,23,7,17,19,12,3,72,1
2665,62308,84_06_33,AUSTRALIA,0,TOTALS,AUSTRALIA,200,25,50,50.0,16,29,55.2,9,21,42.9,10,16,62.5,7,22,29,17,24,24,10,0,69,0
2666,62321,84_06_34,ITALY,0,TOTALS,ITALY,200,22,66,33.3,14,34,41.2,8,32,25.0,12,19,63.2,20,21,41,16,18,13,12,3,64,1
2667,62334,84_06_34,SENEGAL,0,TOTALS,SENEGAL,200,21,54,38.9,17,40,42.5,4,14,28.6,10,16,62.5,14,27,41,7,18,22,9,4,56,0
2668,62347,84_06_35,TURKEY,0,TOTALS,TURKEY,200,26,59,44.1,16,35,45.7,10,24,41.7,11,17,64.7,3,28,31,15,31,21,5,3,73,1
2669,62360,84_06_35,BRAZIL,0,TOTALS,BRAZIL,200,23,62,37.1,21,45,46.7,2,17,11.8,23,37,62.2,11,20,31,11,21,12,7,1,71,0
2670,62373,84_06_36,SLOVENIA,0,TOTALS,SLOVENIA,200,33,69,47.8,27,54,50.0,6,15,40.0,23,27,85.2,14,26,40,10,27,25,8,1,95,1
2671,62386,84_06_36,USA,0,TOTALS,USA,200,40,71,56.3,30,51,58.8,10,20,50.0,24,36,66.7,8,21,29,21,25,12,17,3,114,0
2672,62399,84_06_37,NIGERIA,0,TOTALS,NIGERIA,200,24,68,35.3,21,47,44.7,3,21,14.3,13,22,59.1,15,23,38,3,16,16,10,0,64,0
2673,62412,84_06_37,ARGENTINA,0,TOTALS,ARGENTINA,200,38,68,55.9,23,36,63.9,15,32,46.9,7,11,63.6,9,28,37,25,17,15,7,3,98,1
2674,62425,84_06_38,SPAIN,0,TOTALS,SPAIN,200,32,54,59.3,23,36,63.9,9,18,50.0,20,24,83.3,5,21,26,17,15,14,7,3,93,1
2675,62438,84_06_38,ANGOLA,0,TOTALS,ANGOLA,200,32,70,45.7,21,41,51.2,11,29,37.9,8,12,66.7,15,19,34,16,24,12,7,1,83,0
2676,62451,84_06_39,AUSTRALIA,0,TOTALS,AUSTRALIA,200,18,51,35.3,7,25,28.0,11,26,42.3,10,18,55.6,5,21,26,13,21,28,7,1,57,0
2677,62464,84_06_39,LITHUANIA,0,TOTALS,LITHUANIA,200,30,62,48.4,25,44,56.8,5,18,27.8,13,22,59.1,12,28,40,13,22,20,11,3,78,1
2678,62477,84_06_40,SENEGAL,0,TOTALS,SENEGAL,200,31,67,46.3,27,57,47.4,4,10,40.0,17,22,77.3,16,22,38,12,23,16,7,1,83,1
2679,62490,84_06_40,CHINA,0,TOTALS,CHINA,200,32,66,48.5,20,33,60.6,12,33,36.4,24,27,88.9,12,21,33,15,19,12,3,6,100,0
2680,62503,84_06_41,VENEZUELA,0,TOTALS,VENEZUELA,200,25,65,38.5,21,54,38.9,4,11,36.4,11,18,61.1,11,26,37,12,19,20,4,6,65,0
2681,62516,84_06_41,SERBIA & MONTENEGRO,0,TOTALS,SERBIA & MONTENEGRO,200,37,75,49.3,27,54,50.0,10,21,47.6,6,10,60.0,9,27,36,18,21,11,11,9,90,1
2682,62529,84_06_42,PANAMA,0,TOTALS,PANAMA,200,25,64,39.1,18,41,43.9,7,23,30.4,6,16,37.5,11,19,30,12,22,10,7,2,63,0
2683,62542,84_06_42,GERMANY,0,TOTALS,GERMANY,200,28,53,52.8,19,26,73.1,9,27,33.3,16,24,66.7,7,34,41,16,21,17,5,1,81,1
2684,62555,84_06_43,QATAR,0,TOTALS,QATAR,200,28,74,37.8,20,47,42.6,8,27,29.6,5,6,83.3,15,20,35,14,18,12,10,5,69,0
2685,62568,84_06_43,TURKEY,0,TOTALS,TURKEY,200,28,61,45.9,21,40,52.5,7,21,33.3,13,18,72.2,11,28,39,14,12,15,8,5,76,1
2686,62581,84_06_44,PUERTO RICO,0,TOTALS,PUERTO RICO,200,29,62,46.8,18,42,42.9,11,20,55.0,13,21,61.9,10,22,32,12,20,16,9,2,82,0
2687,62594,84_06_44,SLOVENIA,0,TOTALS,SLOVENIA,200,31,67,46.3,18,43,41.9,13,24,54.2,15,18,83.3,13,28,41,14,23,18,7,3,90,1
2688,62607,84_06_45,LEBANON,0,TOTALS,LEBANON,200,25,55,45.5,19,34,55.9,6,21,28.6,18,20,90.0,9,23,32,9,16,21,8,3,74,1
2689,62620,84_06_45,FRANCE,0,TOTALS,FRANCE,200,27,73,37.0,24,47,51.1,3,26,11.5,16,22,72.7,20,18,38,10,20,13,16,2,73,0
2690,62633,84_06_46,NEW ZEALAND,0,TOTALS,NEW ZEALAND,200,18,61,29.5,10,28,35.7,8,33,24.2,16,24,66.7,15,26,41,10,25,21,10,1,60,1
2691,62646,84_06_46,JAPAN,0,TOTALS,JAPAN,200,19,53,35.8,12,30,40.0,7,23,30.4,12,16,75.0,6,21,27,9,22,18,7,3,57,0
2692,62659,84_06_47,BRAZIL,0,TOTALS,BRAZIL,200,29,58,50.0,17,35,48.6,12,23,52.2,10,23,43.5,7,16,23,19,30,22,5,0,80,0
2693,62672,84_06_47,GREECE,0,TOTALS,GREECE,200,27,51,52.9,19,34,55.9,8,17,47.1,29,34,85.3,7,18,25,14,24,22,14,1,91,1
2694,62685,84_06_48,USA,0,TOTALS,USA,200,34,60,56.7,27,46,58.7,7,14,50.0,19,34,55.9,8,18,26,14,19,9,8,4,94,1
2695,62698,84_06_48,ITALY,0,TOTALS,ITALY,200,31,63,49.2,24,42,57.1,7,21,33.3,16,19,84.2,10,21,31,12,29,15,5,0,85,0
2696,62711,84_06_49,SERBIA & MONTENEGRO,0,TOTALS,SERBIA & MONTENEGRO,200,28,62,45.2,22,50,44.0,6,12,50.0,17,18,94.4,5,25,30,12,20,10,8,5,79,0
2697,62724,84_06_49,ARGENTINA,0,TOTALS,ARGENTINA,200,28,69,40.6,16,43,37.2,12,26,46.2,15,16,93.8,12,27,39,24,17,11,8,2,83,1
2698,62737,84_06_50,ANGOLA,0,TOTALS,ANGOLA,275,32,77,41.6,23,44,52.3,9,33,27.3,30,38,78.9,10,32,42,11,27,14,12,3,103,0
2699,62750,84_06_50,GERMANY,0,TOTALS,GERMANY,275,38,90,42.2,29,57,50.9,9,33,27.3,23,26,88.5,19,35,54,13,29,17,7,4,108,1
2700,62763,84_06_51,AUSTRALIA,0,TOTALS,AUSTRALIA,200,36,66,54.5,23,37,62.2,13,29,44.8,8,13,61.5,9,30,39,23,7,15,17,4,93,1
2701,62776,84_06_51,QATAR,0,TOTALS,QATAR,200,18,59,30.5,10,28,35.7,8,31,25.8,2,6,33.3,10,20,30,12,17,25,8,0,46,0
2702,62789,84_06_52,SLOVENIA,0,TOTALS,SLOVENIA,200,29,67,43.3,22,51,43.1,7,16,43.8,12,18,66.7,19,22,41,15,21,10,9,4,77,0
2703,62802,84_06_52,CHINA,0,TOTALS,CHINA,200,28,59,47.5,21,43,48.8,7,16,43.8,15,19,78.9,11,22,33,16,20,13,4,4,78,1
2704,62815,84_06_53,LEBANON,0,TOTALS,LEBANON,200,27,71,38.0,17,35,48.6,10,36,27.8,8,10,80.0,11,21,32,13,18,12,5,2,72,0
2705,62828,84_06_53,NIGERIA,0,TOTALS,NIGERIA,200,38,75,50.7,28,50,56.0,10,25,40.0,9,17,52.9,16,29,45,21,12,8,5,5,95,1
2706,62841,84_06_54,NEW ZEALAND,0,TOTALS,NEW ZEALAND,200,29,56,51.8,17,22,77.3,12,34,35.3,16,20,80.0,3,21,24,22,26,14,10,0,86,1
2707,62854,84_06_54,PANAMA,0,TOTALS,PANAMA,200,25,62,40.3,20,43,46.5,5,19,26.3,20,30,66.7,17,20,37,7,18,18,4,0,75,0
2708,62867,84_06_55,LITHUANIA,0,TOTALS,LITHUANIA,200,28,54,51.9,19,29,65.5,9,25,36.0,14,19,73.7,8,27,35,19,26,26,3,3,79,1
2709,62880,84_06_55,BRAZIL,0,TOTALS,BRAZIL,200,26,73,35.6,22,48,45.8,4,25,16.0,18,29,62.1,14,16,30,12,22,8,9,2,74,0
2710,62893,84_06_56,ITALY,0,TOTALS,ITALY,200,24,64,37.5,18,39,46.2,6,25,24.0,19,27,70.4,12,24,36,13,32,9,4,4,73,1
2711,62906,84_06_56,PUERTO RICO,0,TOTALS,PUERTO RICO,200,21,49,42.9,17,35,48.6,4,14,28.6,26,34,76.5,7,28,35,7,24,14,5,3,72,0
2712,62919,84_06_57,FRANCE,0,TOTALS,FRANCE,200,27,63,42.9,24,41,58.5,3,22,13.6,24,31,77.4,15,27,42,11,18,8,5,5,81,1
2713,62932,84_06_57,VENEZUELA,0,TOTALS,VENEZUELA,200,24,67,35.8,20,50,40.0,4,17,23.5,9,18,50.0,16,22,38,10,23,8,6,0,61,0
2714,62945,84_06_58,JAPAN,0,TOTALS,JAPAN,200,21,62,33.9,13,36,36.1,8,26,30.8,5,9,55.6,7,18,25,10,26,19,4,0,55,1
2715,62958,84_06_58,SPAIN,0,TOTALS,SPAIN,200,38,64,59.4,32,51,62.7,6,13,46.2,22,31,71.0,11,36,47,15,14,14,9,4,104,0
2716,62971,84_06_59,GREECE,0,TOTALS,GREECE,200,28,52,53.8,24,38,63.2,4,14,28.6,16,25,64.0,7,16,23,11,19,16,8,4,76,1
2717,62984,84_06_59,TURKEY,0,TOTALS,TURKEY,200,26,53,49.1,18,30,60.0,8,23,34.8,9,13,69.2,6,18,24,10,24,20,7,2,69,0
2718,62997,84_06_60,USA,0,TOTALS,USA,200,37,73,50.7,27,45,60.0,10,28,35.7,19,27,70.4,15,38,53,19,9,11,8,4,103,0
2719,63010,84_06_60,SENEGAL,0,TOTALS,SENEGAL,200,24,69,34.8,20,54,37.0,4,15,26.7,6,8,75.0,6,26,32,13,20,12,5,3,58,1
2720,63023,84_06_61,ARGENTINA,0,TOTALS,ARGENTINA,200,28,63,44.4,27,45,60.0,1,18,5.6,22,29,75.9,17,29,46,14,15,17,7,2,79,1
2721,63036,84_06_61,NEW ZEALAND,0,TOTALS,NEW ZEALAND,200,24,61,39.3,18,31,58.1,6,30,20.0,8,12,66.7,9,22,31,13,23,19,9,0,62,0
2722,63049,84_06_62,ITALY,0,TOTALS,ITALY,200,26,59,44.1,16,38,42.1,10,21,47.6,6,19,31.6,10,25,35,14,26,17,11,2,68,0
2723,63062,84_06_62,LITHUANIA,0,TOTALS,LITHUANIA,200,24,54,44.4,20,42,47.6,4,12,33.3,19,30,63.3,11,29,40,5,18,13,9,1,71,1
2724,63075,84_06_63,TURKEY,0,TOTALS,TURKEY,200,32,59,54.2,25,43,58.1,7,16,43.8,19,22,86.4,6,22,28,12,25,14,6,5,90,1
2725,63088,84_06_63,SLOVENIA,0,TOTALS,SLOVENIA,200,29,62,46.8,24,48,50.0,5,14,35.7,21,35,60.0,15,23,38,12,23,14,6,2,84,0
2726,63101,84_06_64,SPAIN,0,TOTALS,SPAIN,200,27,58,46.6,21,38,55.3,6,20,30.0,27,36,75.0,12,30,42,12,16,21,6,5,87,1
2727,63114,84_06_64,SERBIA & MONTENEGRO,0,TOTALS,SERBIA & MONTENEGRO,200,29,76,38.2,23,55,41.8,6,21,28.6,11,12,91.7,16,19,35,9,29,12,10,3,75,0
2728,63127,84_06_65,GERMANY,0,TOTALS,GERMANY,200,26,60,43.3,17,33,51.5,9,27,33.3,17,20,85.0,10,24,34,16,26,16,3,2,78,1
2729,63140,84_06_65,NIGERIA,0,TOTALS,NIGERIA,200,27,61,44.3,23,48,47.9,4,13,30.8,19,32,59.4,12,25,37,8,26,12,7,3,77,0
2730,63153,84_06_66,USA,0,TOTALS,USA,200,41,76,53.9,27,49,55.1,14,27,51.9,17,23,73.9,11,27,38,24,19,8,11,5,113,0
2731,63166,84_06_66,AUSTRALIA,0,TOTALS,AUSTRALIA,200,26,64,40.6,20,39,51.3,6,25,24.0,15,20,75.0,13,26,39,15,26,24,5,2,73,1
2732,63179,84_06_67,FRANCE,0,TOTALS,FRANCE,200,25,54,46.3,19,36,52.8,6,18,33.3,12,17,70.6,10,30,40,9,13,16,2,2,68,1
2733,63192,84_06_67,ANGOLA,0,TOTALS,ANGOLA,200,24,65,36.9,18,47,38.3,6,18,33.3,8,13,61.5,11,21,32,12,20,11,9,4,62,0
2734,63205,84_06_68,GREECE,0,TOTALS,GREECE,200,38,74,51.4,30,58,51.7,8,16,50.0,11,17,64.7,15,17,32,15,15,3,13,2,95,1
2735,63218,84_06_68,CHINA,0,TOTALS,CHINA,200,25,48,52.1,19,29,65.5,6,19,31.6,8,11,72.7,5,22,27,10,19,24,0,3,64,0
2736,63231,84_06_69,SPAIN,0,TOTALS,SPAIN,200,31,73,42.5,26,47,55.3,5,26,19.2,22,28,78.6,14,23,37,12,16,11,17,4,89,1
2737,63244,84_06_69,LITHUANIA,0,TOTALS,LITHUANIA,200,29,62,46.8,23,40,57.5,6,22,27.3,3,9,33.3,11,28,39,16,21,28,3,1,67,0
2738,63257,84_06_70,ARGENTINA,0,TOTALS,ARGENTINA,200,30,61,49.2,22,38,57.9,8,23,34.8,15,18,83.3,10,29,39,14,16,11,7,1,83,1
2739,63270,84_06_70,TURKEY,0,TOTALS,TURKEY,200,22,59,37.3,16,40,40.0,6,19,31.6,8,19,42.1,14,21,35,13,19,16,5,5,58,0
2740,63283,84_06_71,GREECE,0,TOTALS,GREECE,200,23,54,42.6,16,30,53.3,7,24,29.2,20,31,64.5,8,30,38,10,19,8,6,3,73,1
2741,63296,84_06_71,FRANCE,0,TOTALS,FRANCE,200,21,60,35.0,14,42,33.3,7,18,38.9,7,14,50.0,12,28,40,13,21,16,5,7,56,0
2742,63309,84_06_72,USA,0,TOTALS,USA,200,32,85,37.6,22,45,48.9,10,40,25.0,11,15,73.3,22,26,48,15,23,13,10,7,85,1
2743,63322,84_06_72,GERMANY,0,TOTALS,GERMANY,200,21,54,38.9,18,41,43.9,3,13,23.1,20,21,95.2,6,28,34,6,17,24,2,4,65,0
2744,63335,84_06_73,LITHUANIA,0,TOTALS,LITHUANIA,225,24,53,45.3,18,33,54.5,6,20,30.0,30,42,71.4,9,31,40,14,32,28,12,4,84,0
2745,63348,84_06_73,TURKEY,0,TOTALS,TURKEY,225,31,68,45.6,21,41,51.2,10,27,37.0,23,38,60.5,15,24,39,13,32,19,14,4,95,1
2746,63361,84_06_74,FRANCE,0,TOTALS,FRANCE,200,26,60,43.3,18,41,43.9,8,19,42.1,15,22,68.2,12,30,42,8,19,21,6,5,75,1
2747,63374,84_06_74,GERMANY,0,TOTALS,GERMANY,200,28,65,43.1,22,50,44.0,6,15,40.0,11,15,73.3,9,25,34,12,17,12,4,2,73,0
2748,63387,84_06_75,GREECE,0,TOTALS,GREECE,200,35,56,62.5,27,38,71.1,8,18,44.4,23,33,69.7,4,24,28,19,25,12,4,1,101,0
2749,63400,84_06_75,USA,0,TOTALS,USA,200,33,66,50.0,24,38,63.2,9,28,32.1,20,34,58.8,16,18,34,17,26,10,4,7,95,1
2750,63413,84_06_76,SPAIN,0,TOTALS,SPAIN,200,22,50,44.0,16,30,53.3,6,20,30.0,25,33,75.8,6,30,36,11,22,18,6,3,75,1
2751,63426,84_06_76,ARGENTINA,0,TOTALS,ARGENTINA,200,24,67,35.8,11,34,32.4,13,33,39.4,13,19,68.4,14,23,37,11,29,14,6,1,74,0
2752,63439,84_06_77,TURKEY,0,TOTALS,TURKEY,200,15,62,24.2,9,42,21.4,6,20,30.0,20,30,66.7,18,27,45,4,33,17,9,2,56,0
2753,63452,84_06_77,FRANCE,0,TOTALS,FRANCE,200,21,52,40.4,18,41,43.9,3,11,27.3,19,37,51.4,10,34,44,9,23,17,6,6,64,1
2754,63465,84_06_78,USA,0,TOTALS,USA,200,37,72,51.4,30,54,55.6,7,18,38.9,15,30,50.0,8,33,41,16,17,12,7,4,96,1
2755,63478,84_06_78,ARGENTINA,0,TOTALS,ARGENTINA,200,34,75,45.3,30,54,55.6,4,21,19.0,9,16,56.2,11,30,41,13,29,15,3,1,81,0
2756,63491,84_06_79,LITHUANIA,0,TOTALS,LITHUANIA,200,32,60,53.3,27,43,62.8,5,17,29.4,8,16,50.0,6,25,31,15,22,17,14,0,77,1
2757,63504,84_06_79,GERMANY,0,TOTALS,GERMANY,200,20,55,36.4,13,31,41.9,7,24,29.2,15,21,71.4,10,24,34,7,16,25,7,0,62,0
2758,63517,84_06_80,GREECE,0,TOTALS,GREECE,200,18,55,32.7,13,34,38.2,5,21,23.8,6,12,50.0,11,23,34,9,19,18,4,4,47,0
2759,63530,84_06_80,SPAIN,0,TOTALS,SPAIN,200,26,61,42.6,14,31,45.2,12,30,40.0,6,11,54.5,15,27,42,16,12,18,9,2,70,1
2760,65129,86_06_01,AUSTRALIA,0,TOTALS,AUSTRALIA,200,23,58,39.7,15,31,48.4,8,27,29.6,6,8,75.0,8,20,28,13,24,24,13,0,60,0
2761,65141,86_06_01,GREECE,0,TOTALS,GREECE,200,23,49,46.9,17,29,58.6,6,20,30.0,16,20,80.0,3,22,25,14,20,23,16,2,68,1
2762,65154,86_06_02,CHINA,0,TOTALS,CHINA,200,21,53,39.6,12,33,36.4,9,20,45.0,22,31,71.0,6,27,33,10,17,16,7,4,73,0
2763,65167,86_06_02,GERMANY,0,TOTALS,GERMANY,200,29,62,46.8,21,41,51.2,8,21,38.1,16,19,84.2,6,28,34,12,25,13,11,3,82,1
2764,65180,86_06_03,GREECE,0,TOTALS,GREECE,200,25,47,53.2,20,34,58.8,5,13,38.5,13,19,68.4,6,16,22,10,24,18,13,0,68,0
2765,65193,86_06_03,FRANCE,0,TOTALS,FRANCE,200,24,47,51.1,22,38,57.9,2,9,22.2,22,28,78.6,18,26,44,12,24,18,11,1,72,1
2766,65206,86_06_04,GERMANY,0,TOTALS,GERMANY,200,27,64,42.2,19,40,47.5,8,24,33.3,14,21,66.7,13,32,45,14,28,20,7,2,76,1
2767,65219,86_06_04,BRAZIL,0,TOTALS,BRAZIL,200,23,69,33.3,18,48,37.5,5,21,23.8,24,28,85.7,9,24,33,10,20,10,15,3,75,0
2768,65232,86_06_05,FRANCE,0,TOTALS,FRANCE,200,25,59,42.4,17,37,45.9,8,22,36.4,13,20,65.0,12,21,33,13,20,16,11,4,71,0
2769,65245,86_06_05,AUSTRALIA,0,TOTALS,AUSTRALIA,200,29,58,50.0,20,37,54.1,9,21,42.9,10,17,58.8,8,23,31,15,23,12,12,2,77,1
2770,65258,86_06_06,BRAZIL,0,TOTALS,BRAZIL,200,34,72,47.2,28,52,53.8,6,20,30.0,14,18,77.8,12,16,28,14,23,8,14,1,88,1
2771,65271,86_06_06,CHINA,0,TOTALS,CHINA,200,27,54,50.0,18,32,56.2,9,22,40.9,15,21,71.4,11,26,37,20,21,22,5,3,78,0
2772,65284,86_06_07,FRANCE,0,TOTALS,FRANCE,200,28,54,51.9,16,30,53.3,12,24,50.0,18,27,66.7,8,26,34,14,17,18,7,4,86,1
2773,65297,86_06_07,BRAZIL,0,TOTALS,BRAZIL,200,28,61,45.9,24,48,50.0,4,13,30.8,14,22,63.6,8,13,21,11,21,14,10,1,74,0
2774,65310,86_06_08,AUSTRALIA,0,TOTALS,AUSTRALIA,200,23,68,33.8,19,44,43.2,4,24,16.7,11,20,55.0,12,18,30,13,18,4,14,1,61,0
2775,65322,86_06_08,CHINA,0,TOTALS,CHINA,200,22,50,44.0,15,28,53.6,7,22,31.8,12,14,85.7,7,33,40,16,20,18,2,4,63,1
2776,65335,86_06_09,GREECE,0,TOTALS,GREECE,200,32,49,65.3,24,34,70.6,8,15,53.3,12,19,63.2,7,27,34,13,21,17,12,0,84,1
2777,65348,86_06_09,GERMANY,0,TOTALS,GERMANY,200,15,45,33.3,10,28,35.7,5,17,29.4,12,20,60.0,5,11,16,9,23,14,8,2,47,0
2778,65725,88_06_01,SOUTH AFRICA,0,TOTALS,SOUTH AFRICA,200,20,58,34.5,18,40,45.0,2,18,11.1,4,18,22.2,11,34,45,11,18,25,11,1,46,0
2779,65738,88_06_01,REPUBLIC OF CONGO,0,TOTALS,REPUBLIC OF CONGO,200,30,77,39.0,25,64,39.1,5,13,38.5,6,15,40.0,17,33,50,17,13,16,11,6,71,1
2780,65751,88_06_02,KENYA,0,TOTALS,KENYA,200,25,63,39.7,18,48,37.5,7,15,46.7,15,29,51.7,11,33,44,9,27,31,11,1,72,1
2781,65764,88_06_02,NIGERIA,0,TOTALS,NIGERIA,200,40,103,38.8,34,77,44.2,6,26,23.1,17,36,47.2,41,34,75,23,30,22,16,5,103,0
2782,65777,88_06_03,KENYA,0,TOTALS,KENYA,200,12,62,19.4,9,36,25.0,3,26,11.5,15,32,46.9,16,28,44,4,27,30,15,0,42,0
2783,65787,88_06_03,ANGOLA,0,TOTALS,ANGOLA,200,29,64,45.3,23,44,52.3,6,20,30.0,22,31,71.0,13,44,57,9,28,26,16,1,86,1
2784,65800,88_06_04,MOZAMBIQUE,0,TOTALS,MOZAMBIQUE,200,13,61,21.3,11,41,26.8,2,20,10.0,6,21,28.6,13,22,35,5,16,27,19,1,34,0
2785,65813,88_06_04,MALI,0,TOTALS,MALI,200,27,63,42.9,21,44,47.7,6,19,31.6,13,20,65.0,18,42,60,14,20,34,15,4,73,1
2786,65825,88_06_05,GUINEA,0,TOTALS,GUINEA,200,19,65,29.2,15,54,27.8,4,11,36.4,9,17,52.9,13,19,32,8,16,35,16,3,51,0
2787,65838,88_06_05,NIGERIA,0,TOTALS,NIGERIA,200,32,62,51.6,23,46,50.0,9,16,56.2,12,19,63.2,14,31,45,17,20,31,18,8,85,1
2788,65851,88_06_06,COTE D'IVOIRE,0,TOTALS,COTE D'IVOIRE,200,27,66,40.9,23,52,44.2,4,14,28.6,25,39,64.1,19,42,61,9,24,28,17,3,83,1
2789,65864,88_06_06,KENYA,0,TOTALS,KENYA,200,16,68,23.5,10,39,25.6,6,29,20.7,15,31,48.4,16,21,37,7,30,33,12,3,53,0
2790,65877,88_06_07,REPUBLIC OF CONGO,0,TOTALS,REPUBLIC OF CONGO,200,24,58,41.4,21,47,44.7,3,11,27.3,15,40,37.5,16,34,50,12,23,29,17,9,66,1
2791,65890,88_06_07,MOZAMBIQUE,0,TOTALS,MOZAMBIQUE,200,14,57,24.6,9,41,22.0,5,16,31.2,11,22,50.0,14,30,44,7,28,34,12,1,44,0
2792,65900,88_06_08,ANGOLA,0,TOTALS,ANGOLA,200,17,65,26.2,16,46,34.8,1,19,5.3,13,26,50.0,22,32,54,2,28,30,5,1,48,0
2793,65913,88_06_08,NIGERIA,0,TOTALS,NIGERIA,200,20,78,25.6,19,59,32.2,1,19,5.3,23,40,57.5,31,29,60,10,24,18,23,4,64,1
2794,65926,88_06_09,MALI,0,TOTALS,MALI,200,21,68,30.9,17,44,38.6,4,24,16.7,14,23,60.9,19,29,48,11,14,15,13,7,60,1
2795,65939,88_06_09,SOUTH AFRICA,0,TOTALS,SOUTH AFRICA,200,16,64,25.0,14,50,28.0,2,14,14.3,9,12,75.0,16,31,47,4,22,22,10,6,43,0
2796,65951,88_06_10,GUINEA,0,TOTALS,GUINEA,200,18,68,26.5,14,46,30.4,4,22,18.2,7,16,43.8,18,29,47,10,30,25,19,1,47,0
2797,65961,88_06_10,ANGOLA,0,TOTALS,ANGOLA,200,14,54,25.9,13,44,29.5,1,10,10.0,22,28,78.6,14,33,47,6,16,28,15,1,51,1
2798,65974,88_06_11,NIGERIA,0,TOTALS,NIGERIA,200,36,84,42.9,29,61,47.5,7,23,30.4,13,30,43.3,30,37,67,18,18,15,13,5,92,1
2799,65987,88_06_11,COTE D'IVOIRE,0,TOTALS,COTE D'IVOIRE,200,20,77,26.0,13,49,26.5,7,28,25.0,7,15,46.7,21,26,47,4,24,21,7,3,54,0
2800,66000,88_06_12,MOZAMBIQUE,0,TOTALS,MOZAMBIQUE,200,22,69,31.9,20,47,42.6,2,22,9.1,14,31,45.2,20,33,53,12,24,22,13,2,60,0
2801,66013,88_06_12,SOUTH AFRICA,0,TOTALS,SOUTH AFRICA,200,22,54,40.7,17,41,41.5,5,13,38.5,17,34,50.0,8,34,42,13,23,24,16,6,66,1
2802,66025,88_06_13,GUINEA,0,TOTALS,GUINEA,200,30,89,33.7,27,72,37.5,3,17,17.6,21,47,44.7,31,34,65,13,30,25,16,4,84,1
2803,66038,88_06_13,KENYA,0,TOTALS,KENYA,200,19,64,29.7,17,45,37.8,2,19,10.5,24,40,60.0,18,41,59,13,37,36,12,1,64,0
2804,66048,88_06_14,ANGOLA,0,TOTALS,ANGOLA,200,24,54,44.4,17,32,53.1,7,22,31.8,17,30,56.7,14,34,48,8,13,16,7,2,72,1
2805,66061,88_06_14,COTE D'IVOIRE,0,TOTALS,COTE D'IVOIRE,200,16,63,25.4,8,32,25.0,8,31,25.8,9,12,75.0,10,24,34,7,21,15,7,3,49,0
2806,66074,88_06_15,MALI,0,TOTALS,MALI,200,23,78,29.5,20,58,34.5,3,20,15.0,4,5,80.0,20,27,47,16,29,19,16,3,53,1
2807,66087,88_06_15,REPUBLIC OF CONGO,0,TOTALS,REPUBLIC OF CONGO,200,15,55,27.3,13,42,31.0,2,13,15.4,18,34,52.9,20,36,56,8,8,26,12,6,50,0
2808,66100,88_06_16,COTE D'IVOIRE,0,TOTALS,COTE D'IVOIRE,200,21,57,36.8,16,44,36.4,5,13,38.5,13,21,61.9,13,35,48,8,24,31,7,5,60,0
2809,66112,88_06_16,GUINEA,0,TOTALS,GUINEA,200,23,66,34.8,19,46,41.3,4,20,20.0,16,31,51.6,13,27,40,12,21,14,19,0,66,1
2810,66125,88_06_17,MOZAMBIQUE,0,TOTALS,MOZAMBIQUE,200,16,60,26.7,15,48,31.2,1,12,8.3,15,34,44.1,21,36,57,10,17,24,1,2,48,0
2811,66138,88_06_17,COTE D'IVOIRE,0,TOTALS,COTE D'IVOIRE,200,25,63,39.7,21,44,47.7,4,19,21.1,8,16,50.0,8,27,35,11,29,15,11,2,62,1
2812,66151,88_06_18,SOUTH AFRICA,0,TOTALS,SOUTH AFRICA,200,20,69,29.0,20,60,33.3,0,9,0.0,5,18,27.8,17,32,49,10,28,24,12,1,45,0
2813,66163,88_06_18,GUINEA,0,TOTALS,GUINEA,200,22,65,33.8,17,48,35.4,5,17,29.4,13,35,37.1,20,38,58,12,15,22,12,8,62,1
2814,66173,88_06_19,ANGOLA,0,TOTALS,ANGOLA,200,17,59,28.8,10,40,25.0,7,19,36.8,19,29,65.5,17,17,34,10,23,15,8,0,60,0
2815,66186,88_06_19,MALI,0,TOTALS,MALI,200,20,50,40.0,12,33,36.4,8,17,47.1,20,32,62.5,15,29,44,17,25,20,7,7,68,1
2816,66199,88_06_20,REPUBLIC OF CONGO,0,TOTALS,REPUBLIC OF CONGO,200,19,74,25.7,16,53,30.2,3,21,14.3,16,24,66.7,16,29,45,5,26,17,3,4,57,0
2817,66212,88_06_20,NIGERIA,0,TOTALS,NIGERIA,200,29,75,38.7,22,50,44.0,7,25,28.0,22,37,59.5,24,42,66,18,21,13,7,5,87,1
2818,66222,88_06_21,ANGOLA,0,TOTALS,ANGOLA,200,29,71,40.8,20,47,42.6,9,24,37.5,7,12,58.3,17,23,40,16,31,13,6,0,74,1
2819,66235,88_06_21,REPUBLIC OF CONGO,0,TOTALS,REPUBLIC OF CONGO,200,22,52,42.3,21,46,45.7,1,6,16.7,25,43,58.1,14,25,39,13,16,17,6,4,70,0
2820,66248,88_06_22,MALI,0,TOTALS,MALI,200,14,69,20.3,11,47,23.4,3,22,13.6,10,17,58.8,14,34,48,10,27,16,11,3,41,0
2821,66261,88_06_22,NIGERIA,0,TOTALS,NIGERIA,200,25,59,42.4,19,40,47.5,6,19,31.6,13,31,41.9,12,40,52,14,23,23,7,1,69,1
2822,66274,89_06_01,DEM.REP. OF CONGO,0,TOTALS,DEM.REP. OF CONGO,200,25,80,31.2,22,59,37.3,3,21,14.3,16,29,55.2,12,17,29,20,26,22,6,4,69,0
2823,66287,89_06_01,REPUBLIC OF CONGO,0,TOTALS,REPUBLIC OF CONGO,200,35,89,39.3,29,60,48.3,6,29,20.7,18,27,66.7,18,30,48,20,20,29,12,4,94,1
2824,66635,92_06_01,ARGENTINA,0,TOTALS,ARGENTINA,200,39,67,58.2,29,43,67.4,10,24,41.7,15,20,75.0,5,22,27,16,30,8,17,0,103,0
2825,66648,92_06_01,COLOMBIA,0,TOTALS,COLOMBIA,200,25,68,36.8,22,56,39.3,3,12,25.0,16,34,47.1,14,16,30,8,20,12,11,0,69,1
2826,66661,92_06_02,VENEZUELA,0,TOTALS,VENEZUELA,200,24,49,49.0,20,32,62.5,4,17,23.5,35,46,76.1,13,22,35,12,18,14,18,0,87,1
2827,66672,92_06_02,CHILE,0,TOTALS,CHILE,200,14,62,22.6,10,43,23.3,4,19,21.1,13,19,68.4,7,7,14,7,31,14,17,0,45,0
2828,66685,92_06_03,COLOMBIA,0,TOTALS,COLOMBIA,200,23,54,42.6,18,35,51.4,5,19,26.3,13,21,61.9,4,18,22,6,22,11,13,1,64,0
2829,66698,92_06_03,URUGUAY,0,TOTALS,URUGUAY,200,24,59,40.7,16,34,47.1,8,25,32.0,17,25,68.0,6,20,26,7,23,15,25,2,73,1
2830,66710,92_06_04,CHILE,0,TOTALS,CHILE,200,18,47,38.3,15,30,50.0,3,17,17.6,18,30,60.0,2,11,13,7,25,18,19,0,57,0
2831,66723,92_06_04,BRAZIL,0,TOTALS,BRAZIL,200,32,61,52.5,27,46,58.7,5,15,33.3,16,22,72.7,5,19,24,18,29,17,20,0,85,1
2832,66736,92_06_05,ARGENTINA,0,TOTALS,ARGENTINA,200,30,59,50.8,22,33,66.7,8,26,30.8,21,30,70.0,6,19,25,13,28,12,15,0,89,1
2833,66749,92_06_05,URUGUAY,0,TOTALS,URUGUAY,200,24,61,39.3,17,36,47.2,7,25,28.0,24,40,60.0,5,12,17,5,28,5,13,0,79,0
2834,66762,92_06_06,VENEZUELA,0,TOTALS,VENEZUELA,200,25,59,42.4,20,39,51.3,5,20,25.0,28,40,70.0,7,14,21,13,28,10,15,0,83,1
2835,66775,92_06_06,BRAZIL,0,TOTALS,BRAZIL,200,30,62,48.4,24,45,53.3,6,17,35.3,16,29,55.2,4,18,22,16,33,11,12,0,82,0
2836,66787,92_06_07,CHILE,0,TOTALS,CHILE,200,32,76,42.1,26,57,45.6,6,19,31.6,13,17,76.5,7,15,22,12,32,10,17,0,83,0
2837,66800,92_06_07,COLOMBIA,0,TOTALS,COLOMBIA,200,28,55,50.9,23,41,56.1,5,14,35.7,26,43,60.5,2,21,23,12,23,5,11,0,87,1
2838,66813,92_06_08,ARGENTINA,0,TOTALS,ARGENTINA,200,20,54,37.0,15,32,46.9,5,22,22.7,27,41,65.9,6,19,25,11,32,7,13,0,72,0
2839,66826,92_06_08,BRAZIL,0,TOTALS,BRAZIL,200,24,57,42.1,24,42,57.1,0,15,0.0,26,41,63.4,10,16,26,8,28,6,16,0,74,1
2840,66839,92_06_09,VENEZUELA,0,TOTALS,VENEZUELA,200,26,59,44.1,16,27,59.3,10,32,31.2,17,22,77.3,9,15,24,3,25,12,9,0,79,0
2841,66852,92_06_09,URUGUAY,0,TOTALS,URUGUAY,200,26,54,48.1,12,27,44.4,14,27,51.9,19,22,86.4,2,17,19,10,28,8,21,0,85,1
2842,66865,92_06_10,ARGENTINA,0,TOTALS,ARGENTINA,200,34,66,51.5,23,42,54.8,11,24,45.8,16,21,76.2,4,13,17,2,27,4,10,1,95,1
2843,66878,92_06_10,VENEZUELA,0,TOTALS,VENEZUELA,200,26,68,38.2,22,49,44.9,4,19,21.1,22,29,75.9,5,22,27,15,24,8,16,5,78,0
2844,66891,92_06_11,BRAZIL,0,TOTALS,BRAZIL,200,32,55,58.2,24,35,68.6,8,20,40.0,20,29,69.0,5,19,24,13,25,8,16,0,92,1
2845,66904,92_06_11,URUGUAY,0,TOTALS,URUGUAY,200,21,57,36.8,17,30,56.7,4,27,14.8,15,26,57.7,4,11,15,5,25,9,12,0,61,0
2846,67318,94_06_01,DOMINICAN REPUBLIC,0,TOTALS,DOMINICAN REPUBLIC,200,25,68,36.8,22,56,39.3,3,12,25.0,7,16,43.8,13,22,35,12,17,23,8,2,60,0
2847,67331,94_06_01,VIRGIN ISLANDS,0,TOTALS,VIRGIN ISLANDS,200,35,63,55.6,24,41,58.5,11,22,50.0,10,19,52.6,8,28,36,19,19,23,13,3,91,1
2848,67342,94_06_02,JAMAICA,0,TOTALS,JAMAICA,200,26,81,32.1,22,59,37.3,4,22,18.2,13,21,61.9,18,21,39,9,25,15,8,4,69,0
2849,67354,94_06_02,MEXICO,0,TOTALS,MEXICO,200,27,59,45.8,16,32,50.0,11,27,40.7,20,34,58.8,7,30,37,21,23,18,5,6,85,1
2850,67367,94_06_03,CUBA,0,TOTALS,CUBA,200,24,61,39.3,19,46,41.3,5,15,33.3,21,30,70.0,12,22,34,12,25,24,11,0,74,0
2851,67380,94_06_03,PUERTO RICO,0,TOTALS,PUERTO RICO,200,27,56,48.2,20,34,58.8,7,22,31.8,25,36,69.4,8,27,35,15,24,23,11,4,86,1
2852,67393,94_06_04,PANAMA,0,TOTALS,PANAMA,200,39,78,50.0,34,58,58.6,5,20,25.0,22,32,68.8,16,44,60,28,17,9,7,6,105,0
2853,67405,94_06_04,COSTA RICA,0,TOTALS,COSTA RICA,200,24,80,30.0,14,55,25.5,10,25,40.0,13,17,76.5,9,26,35,16,21,11,6,5,71,1
2854,67415,94_06_05,MEXICO,0,TOTALS,MEXICO,200,27,51,52.9,20,34,58.8,7,17,41.2,26,34,76.5,4,19,23,15,24,19,9,5,87,1
2855,67427,94_06_05,CUBA,0,TOTALS,CUBA,200,26,64,40.6,23,52,44.2,3,12,25.0,17,28,60.7,15,19,34,15,33,17,13,0,72,0
2856,67438,94_06_06,COSTA RICA,0,TOTALS,COSTA RICA,200,32,78,41.0,21,52,40.4,11,26,42.3,10,14,71.4,13,24,37,15,20,18,5,1,85,1
2857,67451,94_06_06,DOMINICAN REPUBLIC,0,TOTALS,DOMINICAN REPUBLIC,200,44,83,53.0,40,68,58.8,4,15,26.7,16,27,59.3,12,32,44,28,16,10,12,6,108,0
2858,67463,94_06_07,PUERTO RICO,0,TOTALS,PUERTO RICO,200,23,65,35.4,11,30,36.7,12,35,34.3,25,34,73.5,13,20,33,18,19,14,7,1,83,1
2859,67473,94_06_07,JAMAICA,0,TOTALS,JAMAICA,200,28,65,43.1,20,43,46.5,8,22,36.4,18,21,85.7,9,27,36,14,27,17,9,5,82,0
2860,67482,94_06_08,VIRGIN ISLANDS,0,TOTALS,VIRGIN ISLANDS,200,26,66,39.4,24,55,43.6,2,11,18.2,23,35,65.7,8,21,29,8,25,13,10,5,77,0
2861,67494,94_06_08,PANAMA,0,TOTALS,PANAMA,200,26,69,37.7,18,50,36.0,8,19,42.1,24,32,75.0,24,27,51,20,26,19,10,6,84,1
2862,67505,94_06_09,CUBA,0,TOTALS,CUBA,200,35,69,50.7,29,50,58.0,6,19,31.6,21,28,75.0,11,23,34,19,19,10,8,0,97,1
2863,67516,94_06_09,JAMAICA,0,TOTALS,JAMAICA,200,32,64,50.0,24,43,55.8,8,21,38.1,10,19,52.6,6,25,31,14,26,15,7,5,82,0
2864,67527,94_06_10,VIRGIN ISLANDS,0,TOTALS,VIRGIN ISLANDS,200,35,75,46.7,30,53,56.6,5,22,22.7,19,25,76.0,16,33,49,21,13,16,11,9,94,1
2865,67538,94_06_10,COSTA RICA,0,TOTALS,COSTA RICA,200,19,63,30.2,11,42,26.2,8,21,38.1,15,18,83.3,5,20,25,10,18,17,8,1,61,0
2866,67549,94_06_11,MEXICO,0,TOTALS,MEXICO,200,24,46,52.2,14,28,50.0,10,18,55.6,23,33,69.7,5,28,33,19,26,24,4,3,81,0
2867,67562,94_06_11,PUERTO RICO,0,TOTALS,PUERTO RICO,200,31,75,41.3,21,46,45.7,10,29,34.5,19,23,82.6,10,19,29,10,27,9,9,0,91,1
2868,67573,94_06_12,PANAMA,0,TOTALS,PANAMA,200,32,64,50.0,26,49,53.1,6,15,40.0,15,22,68.2,11,29,40,20,16,18,6,4,85,1
2869,67584,94_06_12,DOMINICAN REPUBLIC,0,TOTALS,DOMINICAN REPUBLIC,200,34,81,42.0,27,65,41.5,7,16,43.8,6,11,54.5,14,19,33,18,23,13,8,2,81,0
2870,67595,94_06_13,DOMINICAN REPUBLIC,0,TOTALS,DOMINICAN REPUBLIC,200,32,72,44.4,27,51,52.9,5,21,23.8,25,34,73.5,15,27,42,20,9,13,10,4,94,1
2871,67605,94_06_13,JAMAICA,0,TOTALS,JAMAICA,200,36,75,48.0,23,43,53.5,13,32,40.6,5,12,41.7,11,26,37,13,22,20,10,0,90,0
2872,67618,94_06_14,CUBA,0,TOTALS,CUBA,200,42,73,57.5,31,54,57.4,11,19,57.9,7,9,77.8,11,31,42,26,19,13,12,6,102,0
2873,67628,94_06_14,COSTA RICA,0,TOTALS,COSTA RICA,200,18,72,25.0,11,51,21.6,7,21,33.3,16,25,64.0,16,18,34,9,13,18,7,1,59,1
2874,67640,94_06_15,PUERTO RICO,0,TOTALS,PUERTO RICO,200,30,61,49.2,21,43,48.8,9,18,50.0,15,23,65.2,8,24,32,15,21,13,8,4,84,0
2875,67649,94_06_15,VIRGIN ISLANDS,0,TOTALS,VIRGIN ISLANDS,200,30,65,46.2,24,48,50.0,6,17,35.3,19,27,70.4,10,25,35,15,21,16,5,2,85,1
2876,67662,94_06_16,PANAMA,0,TOTALS,PANAMA,200,27,66,40.9,23,55,41.8,4,11,36.4,23,31,74.2,13,33,46,18,15,7,6,5,81,1
2877,67672,94_06_16,MEXICO,0,TOTALS,MEXICO,200,25,71,35.2,19,48,39.6,6,23,26.1,10,16,62.5,13,23,36,17,24,12,2,6,66,0
2878,67684,94_06_17,JAMAICA,0,TOTALS,JAMAICA,200,38,77,49.4,27,47,57.4,11,30,36.7,13,20,65.0,19,29,48,23,25,13,17,5,100,0
2879,67694,94_06_17,COSTA RICA,0,TOTALS,COSTA RICA,200,14,57,24.6,7,37,18.9,7,20,35.0,22,29,75.9,13,20,33,11,17,23,5,0,57,1
2880,67705,94_06_18,DOMINICAN REPUBLIC,0,TOTALS,DOMINICAN REPUBLIC,200,32,60,53.3,28,49,57.1,4,11,36.4,16,26,61.5,9,21,30,15,14,15,9,5,84,1
2881,67717,94_06_18,CUBA,0,TOTALS,CUBA,200,33,69,47.8,29,57,50.9,4,12,33.3,8,13,61.5,10,19,29,24,22,17,9,0,78,0
2882,67727,94_06_19,PUERTO RICO,0,TOTALS,PUERTO RICO,200,33,63,52.4,20,37,54.1,13,26,50.0,14,19,73.7,9,19,28,21,22,8,9,4,93,1
2883,67738,94_06_19,MEXICO,0,TOTALS,MEXICO,200,30,57,52.6,21,40,52.5,9,17,52.9,14,17,82.4,7,19,26,17,19,13,4,1,83,0
2884,67747,94_06_20,VIRGIN ISLANDS,0,TOTALS,VIRGIN ISLANDS,200,21,63,33.3,15,45,33.3,6,18,33.3,11,20,55.0,10,20,30,11,15,13,11,5,59,0
2885,67760,94_06_20,PANAMA,0,TOTALS,PANAMA,200,30,65,46.2,25,54,46.3,5,11,45.5,8,15,53.3,13,29,42,18,20,18,6,5,73,1
2886,68243,96_06_01,ANTIGUA,0,TOTALS,ANTIGUA,200,24,52,46.2,16,33,48.5,8,19,42.1,14,25,56.0,5,8,13,5,30,22,10,1,70,1
2887,68254,96_06_01,ST.VINCENT AND THE GRENADINES,0,TOTALS,ST.VINCENT AND THE GRENADINES,200,17,47,36.2,13,29,44.8,4,18,22.2,23,41,56.1,7,12,19,4,22,16,6,1,61,0
2888,68267,96_06_02,BARBADOS,0,TOTALS,BARBADOS,200,20,52,38.5,14,36,38.9,6,16,37.5,24,34,70.6,13,10,23,3,27,7,5,1,70,0
2889,68280,96_06_02,VIRGIN ISLANDS,0,TOTALS,VIRGIN ISLANDS,200,33,52,63.5,31,46,67.4,2,6,33.3,24,31,77.4,9,22,31,15,25,10,6,2,92,1
2890,68291,96_06_03,CUBA,0,TOTALS,CUBA,200,24,40,60.0,18,30,60.0,6,10,60.0,25,31,80.6,6,13,19,6,27,15,2,1,79,1
2891,68304,96_06_03,BAHAMAS,0,TOTALS,BAHAMAS,200,23,43,53.5,17,29,58.6,6,14,42.9,21,29,72.4,2,3,5,5,25,13,5,0,73,0
2892,68317,96_06_04,JAMAICA,0,TOTALS,JAMAICA,200,50,85,58.8,41,67,61.2,9,18,50.0,5,11,45.5,11,14,25,12,17,8,11,5,114,0
2893,68330,96_06_04,ST. KITTS,0,TOTALS,ST. KITTS,200,19,39,48.7,14,28,50.0,5,11,45.5,13,22,59.1,3,13,16,2,13,21,3,0,56,1
2894,68340,96_06_05,ST.VINCENT AND THE GRENADINES,0,TOTALS,ST.VINCENT AND THE GRENADINES,200,17,46,37.0,15,35,42.9,2,11,18.2,26,37,70.3,7,18,25,10,18,15,2,2,62,0
2895,68352,96_06_05,BAHAMAS,0,TOTALS,BAHAMAS,200,28,59,47.5,20,37,54.1,8,22,36.4,11,22,50.0,8,12,20,11,29,17,5,3,75,1
2896,68365,96_06_06,ST. KITTS,0,TOTALS,ST. KITTS,200,22,51,43.1,22,41,53.7,0,10,0.0,8,12,66.7,5,14,19,6,21,18,4,3,52,0
2897,68377,96_06_06,BARBADOS,0,TOTALS,BARBADOS,200,35,66,53.0,31,49,63.3,4,17,23.5,20,29,69.0,15,27,42,11,14,11,10,6,94,1
2898,68388,96_06_07,CUBA,0,TOTALS,CUBA,200,28,51,54.9,25,40,62.5,3,11,27.3,19,32,59.4,15,9,24,6,22,24,12,2,78,1
2899,68398,96_06_07,ANTIGUA,0,TOTALS,ANTIGUA,200,21,45,46.7,15,28,53.6,6,17,35.3,15,25,60.0,14,11,25,4,24,29,5,1,63,0
2900,68406,96_06_08,VIRGIN ISLANDS,0,TOTALS,VIRGIN ISLANDS,200,22,41,53.7,18,33,54.5,4,8,50.0,30,48,62.5,5,21,26,6,24,15,5,4,78,1
2901,68419,96_06_08,JAMAICA,0,TOTALS,JAMAICA,200,28,64,43.8,21,43,48.8,7,21,33.3,12,24,50.0,12,10,22,6,33,12,5,2,75,0
2902,68431,96_06_09,CUBA,0,TOTALS,CUBA,200,28,54,51.9,23,42,54.8,5,12,41.7,26,35,74.3,7,16,23,7,26,16,12,1,87,1
2903,68442,96_06_09,ST.VINCENT AND THE GRENADINES,0,TOTALS,ST.VINCENT AND THE GRENADINES,200,27,56,48.2,25,40,62.5,2,16,12.5,15,23,65.2,7,17,24,9,24,24,5,0,71,0
2904,68455,96_06_10,ST. KITTS,0,TOTALS,ST. KITTS,200,22,50,44.0,20,42,47.6,2,8,25.0,17,31,54.8,6,18,24,6,20,22,4,2,63,0
2905,68468,96_06_10,VIRGIN ISLANDS,0,TOTALS,VIRGIN ISLANDS,200,29,63,46.0,22,42,52.4,7,21,33.3,28,35,80.0,15,22,37,14,24,10,14,3,93,1
2906,68479,96_06_11,ANTIGUA,0,TOTALS,ANTIGUA,200,26,58,44.8,21,36,58.3,5,22,22.7,10,18,55.6,14,11,25,9,17,11,5,0,67,0
2907,68492,96_06_11,BAHAMAS,0,TOTALS,BAHAMAS,200,31,57,54.4,22,38,57.9,9,19,47.4,12,19,63.2,17,16,33,12,19,11,3,2,83,1
2908,68504,96_06_12,JAMAICA,0,TOTALS,JAMAICA,200,22,56,39.3,14,28,50.0,8,28,28.6,18,27,66.7,12,21,33,9,25,20,3,1,70,1
2909,68515,96_06_12,BARBADOS,0,TOTALS,BARBADOS,200,18,51,35.3,13,28,46.4,5,23,21.7,25,34,73.5,5,17,22,2,26,23,5,2,66,0
2910,68528,96_06_13,ANTIGUA,0,TOTALS,ANTIGUA,200,36,75,48.0,28,53,52.8,8,22,36.4,22,40,55.0,13,25,38,17,16,8,7,0,102,0
2911,68540,96_06_13,ST. KITTS,0,TOTALS,ST. KITTS,200,30,65,46.2,23,44,52.3,7,21,33.3,9,20,45.0,12,23,35,14,26,12,4,2,76,1
2912,68551,96_06_14,BARBADOS,0,TOTALS,BARBADOS,200,30,55,54.5,25,39,64.1,5,16,31.2,22,32,68.8,7,13,20,10,19,20,5,1,87,1
2913,68560,96_06_14,ST.VINCENT AND THE GRENADINES,0,TOTALS,ST.VINCENT AND THE GRENADINES,200,32,62,51.6,26,46,56.5,6,16,37.5,10,17,58.8,10,20,30,11,21,24,9,1,80,0
2914,68571,96_06_15,CUBA,0,TOTALS,CUBA,200,28,55,50.9,21,36,58.3,7,19,36.8,20,28,71.4,6,13,19,8,27,17,7,2,83,0
2915,68583,96_06_15,JAMAICA,0,TOTALS,JAMAICA,200,33,59,55.9,23,39,59.0,10,20,50.0,18,21,85.7,9,16,25,15,22,22,6,3,94,1
2916,68595,96_06_16,VIRGIN ISLANDS,0,TOTALS,VIRGIN ISLANDS,200,38,60,63.3,34,51,66.7,4,9,44.4,17,22,77.3,5,15,20,16,15,14,1,3,97,1
2917,68608,96_06_16,BAHAMAS,0,TOTALS,BAHAMAS,200,24,57,42.1,15,38,39.5,9,19,47.4,21,30,70.0,8,6,14,5,25,10,4,0,78,0
2918,68618,96_06_17,ST. KITTS,0,TOTALS,ST. KITTS,200,29,64,45.3,28,58,48.3,1,6,16.7,10,25,40.0,9,20,29,7,27,10,4,2,69,0
2919,68627,96_06_17,ST.VINCENT AND THE GRENADINES,0,TOTALS,ST.VINCENT AND THE GRENADINES,200,31,68,45.6,27,51,52.9,4,17,23.5,18,34,52.9,13,27,40,12,21,9,4,1,84,1
2920,68637,96_06_18,ANTIGUA,0,TOTALS,ANTIGUA,200,29,72,40.3,23,46,50.0,6,26,23.1,7,15,46.7,11,25,36,6,19,12,5,2,71,0
2921,68649,96_06_18,BARBADOS,0,TOTALS,BARBADOS,200,24,59,40.7,15,34,44.1,9,25,36.0,20,29,69.0,9,25,34,8,12,16,3,1,77,1
2922,68659,96_06_19,CUBA,0,TOTALS,CUBA,200,26,45,57.8,23,37,62.2,3,8,37.5,21,32,65.6,7,17,24,9,22,14,3,3,76,1
2923,68671,96_06_19,BAHAMAS,0,TOTALS,BAHAMAS,200,22,58,37.9,19,41,46.3,3,17,17.6,18,26,69.2,11,10,21,6,23,12,5,0,65,0
2924,68682,96_06_20,JAMAICA,0,TOTALS,JAMAICA,200,27,51,52.9,19,36,52.8,8,15,53.3,14,20,70.0,12,17,29,5,19,10,5,0,76,1
2925,68692,96_06_20,VIRGIN ISLANDS,0,TOTALS,VIRGIN ISLANDS,200,20,55,36.4,13,36,36.1,7,19,36.8,12,21,57.1,12,11,23,9,15,14,2,4,59,0
2926,68930,99_06_01,PANAMA,0,TOTALS,PANAMA,200,30,68,44.1,28,52,53.8,2,16,12.5,22,30,73.3,8,28,36,6,17,18,14,6,84,1
2927,68942,99_06_01,DOMINICAN REPUBLIC,0,TOTALS,DOMINICAN REPUBLIC,200,28,76,36.8,22,56,39.3,6,20,30.0,12,29,41.4,8,12,20,4,23,12,27,2,74,0
2928,68955,99_06_02,MEXICO,0,TOTALS,MEXICO,200,28,72,38.9,22,44,50.0,6,28,21.4,16,24,66.7,5,18,23,6,21,20,14,3,78,1
2929,68968,99_06_02,PUERTO RICO,0,TOTALS,PUERTO RICO,200,35,80,43.8,29,64,45.3,6,16,37.5,24,31,77.4,8,21,29,8,23,9,16,2,100,0
2930,68981,99_06_03,COLOMBIA,0,TOTALS,COLOMBIA,200,25,68,36.8,20,53,37.7,5,15,33.3,28,46,60.9,7,11,18,4,23,17,23,0,83,0
2931,68994,99_06_03,CUBA,0,TOTALS,CUBA,200,30,71,42.3,27,57,47.4,3,14,21.4,26,34,76.5,8,24,32,4,33,19,14,1,89,1
2932,69007,99_06_04,PANAMA,0,TOTALS,PANAMA,200,31,71,43.7,25,56,44.6,6,15,40.0,25,38,65.8,6,18,24,7,22,13,16,2,93,1
2933,69020,99_06_04,MEXICO,0,TOTALS,MEXICO,200,24,68,35.3,17,46,37.0,7,22,31.8,26,34,76.5,0,24,24,3,25,18,11,0,81,0
2934,69033,99_06_05,PUERTO RICO,0,TOTALS,PUERTO RICO,200,26,59,44.1,21,43,48.8,5,16,31.2,23,37,62.2,4,12,16,5,26,11,22,4,80,1
2935,69046,99_06_05,CUBA,0,TOTALS,CUBA,200,26,69,37.7,20,52,38.5,6,17,35.3,18,32,56.2,12,18,30,2,32,18,9,0,76,0
2936,69058,99_06_06,DOMINICAN REPUBLIC,0,TOTALS,DOMINICAN REPUBLIC,200,35,76,46.1,29,57,50.9,6,19,31.6,17,25,68.0,6,14,20,8,21,13,20,6,93,1
2937,69071,99_06_06,COLOMBIA,0,TOTALS,COLOMBIA,200,24,67,35.8,18,47,38.3,6,20,30.0,18,30,60.0,6,21,27,0,22,23,14,1,72,0
2938,69084,99_06_07,PUERTO RICO,0,TOTALS,PUERTO RICO,225,33,85,38.8,26,62,41.9,7,23,30.4,29,37,78.4,8,17,25,2,30,10,15,3,102,0
2939,69097,99_06_07,PANAMA,0,TOTALS,PANAMA,225,33,77,42.9,27,58,46.6,6,19,31.6,25,40,62.5,8,20,28,8,23,12,12,4,97,1
2940,69110,99_06_08,CUBA,0,TOTALS,CUBA,200,32,68,47.1,23,47,48.9,9,21,42.9,13,20,65.0,5,13,18,5,19,11,18,1,86,1
2941,69122,99_06_08,DOMINICAN REPUBLIC,0,TOTALS,DOMINICAN REPUBLIC,200,30,79,38.0,22,56,39.3,8,23,34.8,17,23,73.9,7,12,19,5,18,13,18,3,85,0
2942,69135,99_06_09,COLOMBIA,0,TOTALS,COLOMBIA,200,30,82,36.6,25,60,41.7,5,22,22.7,18,25,72.0,7,18,25,2,18,6,21,0,83,0
2943,69148,99_06_09,MEXICO,0,TOTALS,MEXICO,200,32,67,47.8,24,42,57.1,8,25,32.0,14,20,70.0,3,24,27,5,18,13,12,2,86,1
2944,69161,99_06_10,CUBA,0,TOTALS,CUBA,225,39,78,50.0,33,61,54.1,6,17,35.3,26,34,76.5,4,14,18,3,30,16,17,2,110,0
2945,69174,99_06_10,PANAMA,0,TOTALS,PANAMA,225,37,76,48.7,25,55,45.5,12,21,57.1,27,35,77.1,8,10,18,8,30,15,14,3,113,1
2946,69187,99_06_11,MEXICO,0,TOTALS,MEXICO,200,36,73,49.3,23,50,46.0,13,23,56.5,11,13,84.6,5,18,23,4,19,17,14,2,96,1
2947,69199,99_06_11,DOMINICAN REPUBLIC,0,TOTALS,DOMINICAN REPUBLIC,200,35,88,39.8,29,69,42.0,6,19,31.6,27,38,71.1,14,22,36,11,12,9,18,4,103,0
2948,69212,99_06_12,PUERTO RICO,0,TOTALS,PUERTO RICO,200,38,82,46.3,25,53,47.2,13,29,44.8,17,23,73.9,10,28,38,5,15,10,15,6,106,0
2949,69225,99_06_12,COLOMBIA,0,TOTALS,COLOMBIA,200,30,81,37.0,27,53,50.9,3,28,10.7,9,18,50.0,2,19,21,1,18,9,8,3,72,1
2950,69237,99_06_13,DOMINICAN REPUBLIC,0,TOTALS,DOMINICAN REPUBLIC,200,31,73,42.5,28,58,48.3,3,15,20.0,20,24,83.3,6,22,28,7,16,15,17,3,85,0
2951,69250,99_06_13,PUERTO RICO,0,TOTALS,PUERTO RICO,200,32,83,38.6,27,65,41.5,5,18,27.8,19,23,82.6,7,19,26,11,18,18,28,5,88,1
2952,69263,99_06_14,CUBA,0,TOTALS,CUBA,200,35,73,47.9,30,61,49.2,5,12,41.7,16,27,59.3,5,10,15,8,25,13,22,0,91,1
2953,69276,99_06_14,MEXICO,0,TOTALS,MEXICO,200,28,56,50.0,26,45,57.8,2,11,18.2,19,29,65.5,2,21,23,4,19,22,16,2,77,0
2954,69289,99_06_15,PANAMA,0,TOTALS,PANAMA,200,30,77,39.0,20,52,38.5,10,25,40.0,14,25,56.0,9,19,28,10,24,9,18,1,84,1
2955,69302,99_06_15,COLOMBIA,0,TOTALS,COLOMBIA,200,24,64,37.5,19,44,43.2,5,20,25.0,26,36,72.2,2,24,26,0,20,13,11,5,79,0
2956,69315,99_06_16,PUERTO RICO,0,TOTALS,PUERTO RICO,200,32,72,44.4,26,54,48.1,6,18,33.3,16,28,57.1,11,10,21,18,12,14,20,2,86,1
2957,69327,99_06_16,DOMINICAN REPUBLIC,0,TOTALS,DOMINICAN REPUBLIC,200,34,77,44.2,31,63,49.2,3,14,21.4,6,10,60.0,13,17,30,9,17,17,12,4,77,0
2958,69340,99_06_17,PANAMA,0,TOTALS,PANAMA,200,28,65,43.1,22,54,40.7,6,11,54.5,33,51,64.7,11,20,31,12,19,13,11,3,95,1
2959,69353,99_06_17,CUBA,0,TOTALS,CUBA,200,30,80,37.5,24,58,41.4,6,22,27.3,13,24,54.2,6,14,20,5,34,11,20,0,79,0
2960,69365,99_06_18,DOMINICAN REPUBLIC,0,TOTALS,DOMINICAN REPUBLIC,200,37,68,54.4,30,53,56.6,7,15,46.7,14,22,63.6,3,19,22,8,18,21,18,2,95,1
2961,69378,99_06_18,CUBA,0,TOTALS,CUBA,200,28,73,38.4,23,54,42.6,5,19,26.3,10,19,52.6,6,13,19,4,12,19,22,4,71,0
2962,69391,99_06_19,PUERTO RICO,0,TOTALS,PUERTO RICO,200,32,81,39.5,25,61,41.0,7,20,35.0,19,27,70.4,10,15,25,12,23,8,12,1,90,1
2963,69404,99_06_19,PANAMA,0,TOTALS,PANAMA,200,31,70,44.3,23,50,46.0,8,20,40.0,17,27,63.0,6,21,27,7,24,10,15,1,87,0
2964,69797,101_06_01,ARGENTINA,0,TOTALS,ARGENTINA,200,37,69,53.6,29,51,56.9,8,18,44.4,17,26,65.4,10,46,56,26,22,28,9,3,99,1
2965,69810,101_06_01,BAHAMAS,0,TOTALS,BAHAMAS,200,23,84,27.4,19,50,38.0,4,34,11.8,9,20,45.0,18,24,42,11,22,23,14,1,59,0
2966,69822,101_06_02,CANADA,0,TOTALS,CANADA,200,34,68,50.0,22,42,52.4,12,26,46.2,10,19,52.6,8,34,42,23,15,16,6,7,90,1
2967,69834,101_06_02,PUERTO RICO,0,TOTALS,PUERTO RICO,200,30,78,38.5,24,53,45.3,6,25,24.0,7,12,58.3,12,24,36,11,20,13,6,3,73,0
2968,69847,101_06_03,USA,0,TOTALS,USA,200,37,78,47.4,30,53,56.6,7,25,28.0,30,40,75.0,24,26,50,22,23,14,18,4,111,0
2969,69860,101_06_03,URUGUAY,0,TOTALS,URUGUAY,200,24,62,38.7,20,44,45.5,4,18,22.2,12,19,63.2,10,17,27,19,32,24,8,3,64,1
2970,69872,101_06_04,PUERTO RICO,0,TOTALS,PUERTO RICO,200,28,66,42.4,22,49,44.9,6,17,35.3,15,23,65.2,11,33,44,11,24,18,2,4,77,0
2971,69883,101_06_04,ARGENTINA,0,TOTALS,ARGENTINA,200,26,64,40.6,20,43,46.5,6,21,28.6,21,27,77.8,6,28,34,17,23,11,10,4,79,1
2972,69894,101_06_05,BAHAMAS,0,TOTALS,BAHAMAS,200,26,85,30.6,23,69,33.3,3,16,18.8,15,25,60.0,28,26,54,10,16,15,8,2,70,0
2973,69905,101_06_05,CANADA,0,TOTALS,CANADA,200,31,73,42.5,24,46,52.2,7,27,25.9,8,14,57.1,14,30,44,17,21,17,3,10,77,1
2974,69916,101_06_06,URUGUAY,0,TOTALS,URUGUAY,200,25,64,39.1,17,36,47.2,8,28,28.6,8,12,66.7,11,13,24,15,24,19,11,3,66,0
2975,69928,101_06_06,BRAZIL,0,TOTALS,BRAZIL,200,24,51,47.1,14,31,45.2,10,20,50.0,13,27,48.1,16,21,37,15,23,29,10,6,71,1
2976,69941,101_06_07,ARGENTINA,0,TOTALS,ARGENTINA,200,30,65,46.2,19,39,48.7,11,26,42.3,19,24,79.2,8,25,33,25,27,18,11,5,90,1
2977,69954,101_06_07,CANADA,0,TOTALS,CANADA,200,26,67,38.8,19,46,41.3,7,21,33.3,20,29,69.0,11,26,37,8,23,17,12,5,79,0
2978,69966,101_06_08,PUERTO RICO,0,TOTALS,PUERTO RICO,200,26,59,44.1,15,32,46.9,11,27,40.7,16,30,53.3,9,19,28,12,19,17,9,11,79,1
2979,69978,101_06_08,BAHAMAS,0,TOTALS,BAHAMAS,200,29,75,38.7,22,55,40.0,7,20,35.0,12,23,52.2,23,25,48,19,23,18,9,4,77,0
2980,69991,101_06_09,USA,0,TOTALS,USA,200,31,75,41.3,29,64,45.3,2,11,18.2,26,38,68.4,19,29,48,19,27,19,11,6,90,1
2981,70004,101_06_09,BRAZIL,0,TOTALS,BRAZIL,200,21,67,31.3,17,40,42.5,4,27,14.8,20,35,57.1,14,23,37,11,31,23,9,6,66,0
2982,70016,101_06_10,URUGUAY,0,TOTALS,URUGUAY,200,24,55,43.6,15,35,42.9,9,20,45.0,22,34,64.7,7,23,30,19,15,18,18,2,79,1
2983,70028,101_06_10,BAHAMAS,0,TOTALS,BAHAMAS,200,26,74,35.1,24,55,43.6,2,19,10.5,6,12,50.0,18,24,42,8,28,26,9,2,60,0
2984,70041,101_06_11,ARGENTINA,0,TOTALS,ARGENTINA,200,28,50,56.0,22,36,61.1,6,14,42.9,28,42,66.7,9,32,41,18,34,31,8,4,90,1
2985,70053,101_06_11,BRAZIL,0,TOTALS,BRAZIL,200,26,82,31.7,25,62,40.3,1,20,5.0,20,36,55.6,26,15,41,11,35,20,15,3,73,0
2986,70066,101_06_12,USA,0,TOTALS,USA,200,36,85,42.4,31,69,44.9,5,16,31.2,15,22,68.2,22,40,62,19,23,19,10,7,92,1
2987,70077,101_06_12,CANADA,0,TOTALS,CANADA,200,24,81,29.6,21,62,33.9,3,19,15.8,15,25,60.0,15,22,37,8,19,17,11,3,66,0
2988,70089,101_06_13,URUGUAY,0,TOTALS,URUGUAY,225,29,61,47.5,21,34,61.8,8,27,29.6,26,39,66.7,12,23,35,17,36,21,9,3,92,0
2989,70101,101_06_13,PUERTO RICO,0,TOTALS,PUERTO RICO,225,26,51,51.0,18,33,54.5,8,18,44.4,35,50,70.0,5,23,28,15,31,19,8,2,95,1
2990,70113,101_06_14,BRAZIL,0,TOTALS,BRAZIL,200,31,82,37.8,22,56,39.3,9,26,34.6,8,14,57.1,27,23,50,18,13,15,14,9,79,1
2991,70125,101_06_14,CANADA,0,TOTALS,CANADA,200,28,76,36.8,23,54,42.6,5,22,22.7,9,11,81.8,20,22,42,9,13,19,8,6,70,0
2992,70138,101_06_15,ARGENTINA,0,TOTALS,ARGENTINA,200,25,63,39.7,18,41,43.9,7,22,31.8,25,30,83.3,8,13,21,10,31,19,10,4,82,1
2993,70150,101_06_15,USA,0,TOTALS,USA,200,35,72,48.6,28,58,48.3,7,14,50.0,27,34,79.4,16,25,41,22,24,17,9,2,104,0
2994,70527,103_06_01,URUGUAY,0,TOTALS,URUGUAY,200,15,58,25.9,12,37,32.4,3,21,14.3,23,38,60.5,21,28,49,11,24,22,17,9,56,1
2995,70540,103_06_01,CHILE,0,TOTALS,CHILE,200,16,54,29.6,16,42,38.1,0,12,0.0,15,32,46.9,12,28,40,11,27,23,13,4,47,0
2996,70553,103_06_02,ARGENTINA,0,TOTALS,ARGENTINA,200,23,49,46.9,22,40,55.0,1,9,11.1,20,38,52.6,13,30,43,11,23,17,8,4,67,1
2997,70566,103_06_02,VENEZUELA,0,TOTALS,VENEZUELA,200,18,59,30.5,12,43,27.9,6,16,37.5,18,30,60.0,11,19,30,11,28,9,11,0,60,0
2998,70579,103_06_03,BRAZIL,0,TOTALS,BRAZIL,200,33,67,49.3,28,49,57.1,5,18,27.8,12,22,54.5,16,31,47,18,23,29,13,1,83,1
2999,70592,103_06_03,CHILE,0,TOTALS,CHILE,200,27,72,37.5,22,49,44.9,5,23,21.7,15,23,65.2,13,16,29,12,18,15,21,2,74,0
3000,70605,103_06_04,PARAGUAY,0,TOTALS,PARAGUAY,200,13,58,22.4,8,28,28.6,5,30,16.7,13,26,50.0,7,22,29,3,24,14,6,2,44,0
3001,70618,103_06_04,ARGENTINA,0,TOTALS,ARGENTINA,200,26,60,43.3,22,43,51.2,4,17,23.5,22,35,62.9,16,37,53,16,23,15,5,2,78,1
3002,70631,103_06_05,URUGUAY,0,TOTALS,URUGUAY,200,19,56,33.9,14,36,38.9,5,20,25.0,21,35,60.0,16,24,40,13,26,27,20,3,64,0
3003,70644,103_06_05,BRAZIL,0,TOTALS,BRAZIL,200,26,52,50.0,23,41,56.1,3,11,27.3,15,32,46.9,11,25,36,22,25,28,15,1,70,1
3004,70657,103_06_06,VENEZUELA,0,TOTALS,VENEZUELA,200,26,60,43.3,22,42,52.4,4,18,22.2,20,36,55.6,20,40,60,19,25,16,3,1,76,1
3005,70670,103_06_06,PARAGUAY,0,TOTALS,PARAGUAY,200,15,62,24.2,9,36,25.0,6,26,23.1,11,24,45.8,5,16,21,10,27,7,6,4,47,0
3006,70683,103_06_07,CHILE,0,TOTALS,CHILE,200,37,75,49.3,35,64,54.7,2,11,18.2,13,26,50.0,20,35,55,12,22,15,18,1,89,1
3007,70696,103_06_07,PARAGUAY,0,TOTALS,PARAGUAY,200,21,65,32.3,16,37,43.2,5,28,17.9,11,23,47.8,10,25,35,13,22,17,10,2,58,0
3008,70709,103_06_08,BRAZIL,0,TOTALS,BRAZIL,200,29,60,48.3,28,53,52.8,1,7,14.3,23,36,63.9,15,32,47,14,21,20,15,1,82,1
3009,70722,103_06_08,VENEZUELA,0,TOTALS,VENEZUELA,200,17,59,28.8,14,39,35.9,3,20,15.0,17,29,58.6,8,20,28,6,27,19,13,8,54,0
3010,70735,103_06_09,ARGENTINA,0,TOTALS,ARGENTINA,200,23,56,41.1,17,36,47.2,6,20,30.0,27,45,60.0,12,24,36,13,33,15,9,5,79,1
3011,70748,103_06_09,URUGUAY,0,TOTALS,URUGUAY,200,22,63,34.9,19,48,39.6,3,15,20.0,26,43,60.5,16,28,44,6,32,16,9,3,73,0
3012,70761,103_06_10,VENEZUELA,0,TOTALS,VENEZUELA,200,18,60,30.0,14,34,41.2,4,26,15.4,9,16,56.2,9,27,36,10,28,14,13,2,49,0
3013,70774,103_06_10,URUGUAY,0,TOTALS,URUGUAY,200,17,51,33.3,12,34,35.3,5,17,29.4,19,29,65.5,12,30,42,7,18,20,8,3,58,1
3014,70787,103_06_11,BRAZIL,0,TOTALS,BRAZIL,200,31,71,43.7,28,58,48.3,3,13,23.1,23,34,67.6,18,36,54,14,28,20,7,3,88,1
3015,70800,103_06_11,ARGENTINA,0,TOTALS,ARGENTINA,200,26,65,40.0,23,50,46.0,3,15,20.0,30,41,73.2,7,25,32,15,24,11,14,6,85,0
3016,71307,105_06_01,ANDORRA,0,TOTALS,ANDORRA,200,28,60,46.7,22,45,48.9,6,15,40.0,25,38,65.8,14,21,35,4,11,14,8,0,87,1
3017,71318,105_06_01,MALTA,0,TOTALS,MALTA,200,26,56,46.4,15,35,42.9,11,21,52.4,10,17,58.8,5,18,23,4,33,21,5,5,73,0
3018,71329,105_06_02,MOLDOVA,0,TOTALS,MOLDOVA,200,35,74,47.3,22,41,53.7,13,33,39.4,17,28,60.7,14,27,41,6,25,12,10,2,100,0
3019,71342,105_06_02,GIBRALTAR,0,TOTALS,GIBRALTAR,200,17,59,28.8,16,49,32.7,1,10,10.0,19,26,73.1,9,23,32,1,21,21,3,0,54,1
3020,71355,105_06_03,ALBANIA,0,TOTALS,ALBANIA,200,30,56,53.6,16,27,59.3,14,29,48.3,10,18,55.6,9,24,33,7,26,17,7,5,84,1
3021,71368,105_06_03,SAN MARINO,0,TOTALS,SAN MARINO,200,23,61,37.7,16,39,41.0,7,22,31.8,23,25,92.0,10,15,25,4,22,15,5,0,76,0
3022,71381,105_06_04,AZERBAIJAN,0,TOTALS,AZERBAIJAN,200,31,76,40.8,16,34,47.1,15,42,35.7,5,10,50.0,14,13,27,5,20,10,4,4,82,1
3023,71394,105_06_04,WALES,0,TOTALS,WALES,200,22,58,37.9,19,46,41.3,3,12,25.0,15,21,71.4,13,24,37,4,13,12,4,0,62,0
3024,71405,105_06_05,MALTA,0,TOTALS,MALTA,200,24,57,42.1,17,38,44.7,7,19,36.8,11,19,57.9,8,23,31,13,24,19,7,0,66,0
3025,71416,105_06_05,MOLDOVA,0,TOTALS,MOLDOVA,200,24,62,38.7,19,42,45.2,5,20,25.0,25,30,83.3,13,22,35,7,18,17,9,2,78,1
3026,71429,105_06_06,GIBRALTAR,0,TOTALS,GIBRALTAR,200,23,58,39.7,17,41,41.5,6,17,35.3,15,23,65.2,9,22,31,11,17,19,9,4,67,0
3027,71442,105_06_06,ANDORRA,0,TOTALS,ANDORRA,200,25,62,40.3,19,43,44.2,6,19,31.6,12,21,57.1,12,25,37,8,19,18,11,2,68,1
3028,71455,105_06_07,SAN MARINO,0,TOTALS,SAN MARINO,200,25,61,41.0,12,32,37.5,13,29,44.8,11,13,84.6,11,17,28,15,16,14,2,0,74,0
3029,71468,105_06_07,AZERBAIJAN,0,TOTALS,AZERBAIJAN,200,34,61,55.7,20,33,60.6,14,28,50.0,4,9,44.4,6,20,26,14,19,11,5,3,86,1
3030,71481,105_06_08,WALES,0,TOTALS,WALES,200,23,53,43.4,21,43,48.8,2,10,20.0,25,32,78.1,8,25,33,10,26,22,6,3,73,0
3031,71494,105_06_08,ALBANIA,0,TOTALS,ALBANIA,200,33,73,45.2,27,44,61.4,6,29,20.7,19,32,59.4,15,21,36,16,26,14,9,3,91,1
3032,71507,105_06_09,SAN MARINO,0,TOTALS,SAN MARINO,200,19,50,38.0,5,22,22.7,14,28,50.0,21,25,84.0,6,16,22,11,25,17,7,1,73,1
3033,71520,105_06_09,WALES,0,TOTALS,WALES,200,19,46,41.3,16,32,50.0,3,14,21.4,20,30,66.7,6,23,29,8,27,15,8,0,61,0
3034,71533,105_06_10,GIBRALTAR,0,TOTALS,GIBRALTAR,200,23,49,46.9,19,37,51.4,4,12,33.3,13,27,48.1,8,23,31,14,17,12,4,2,63,0
3035,71544,105_06_10,MALTA,0,TOTALS,MALTA,200,27,67,40.3,19,43,44.2,8,24,33.3,8,18,44.4,13,21,34,15,22,9,5,2,70,1
3036,71557,105_06_11,AZERBAIJAN,0,TOTALS,AZERBAIJAN,200,23,73,31.5,14,34,41.2,9,39,23.1,4,12,33.3,15,26,41,9,21,18,5,2,59,0
3037,71570,105_06_11,ALBANIA,0,TOTALS,ALBANIA,200,32,65,49.2,25,45,55.6,7,20,35.0,16,22,72.7,9,28,37,16,21,13,14,1,87,1
3038,71583,105_06_12,ANDORRA,0,TOTALS,ANDORRA,200,26,67,38.8,17,45,37.8,9,22,40.9,12,21,57.1,12,16,28,8,20,17,11,2,73,0
3039,71594,105_06_12,MOLDOVA,0,TOTALS,MOLDOVA,200,35,68,51.5,28,43,65.1,7,25,28.0,10,19,52.6,16,29,45,10,23,20,7,0,87,1
3040,71605,105_06_13,MALTA,0,TOTALS,MALTA,200,22,59,37.3,13,39,33.3,9,20,45.0,8,14,57.1,6,15,21,12,28,12,2,1,61,0
3041,71618,105_06_13,WALES,0,TOTALS,WALES,200,22,43,51.2,21,38,55.3,1,5,20.0,26,40,65.0,6,28,34,12,19,18,5,1,71,1
3042,71631,105_06_14,GIBRALTAR,0,TOTALS,GIBRALTAR,200,19,47,40.4,17,36,47.2,2,11,18.2,14,17,82.4,5,21,26,8,20,19,5,1,54,0
3043,71644,105_06_14,SAN MARINO,0,TOTALS,SAN MARINO,200,26,67,38.8,18,35,51.4,8,32,25.0,14,20,70.0,10,22,32,14,22,11,14,2,74,1
3044,71657,105_06_15,ANDORRA,0,TOTALS,ANDORRA,200,30,74,40.5,21,50,42.0,9,24,37.5,32,46,69.6,8,12,20,11,31,17,16,0,101,0
3045,71670,105_06_15,ALBANIA,0,TOTALS,ALBANIA,200,36,68,52.9,29,46,63.0,7,22,31.8,32,48,66.7,21,37,58,17,32,32,12,4,111,1
3046,71681,105_06_16,MOLDOVA,0,TOTALS,MOLDOVA,200,24,59,40.7,15,34,44.1,9,25,36.0,13,21,61.9,9,20,29,5,13,12,4,0,70,0
3047,71694,105_06_16,AZERBAIJAN,0,TOTALS,AZERBAIJAN,200,31,69,44.9,21,44,47.7,10,25,40.0,9,10,90.0,10,24,34,14,21,7,9,5,81,1
3048,71705,105_06_17,MALTA,0,TOTALS,MALTA,200,21,62,33.9,15,39,38.5,6,23,26.1,7,11,63.6,6,30,36,11,28,12,6,3,55,0
3049,71718,105_06_17,GIBRALTAR,0,TOTALS,GIBRALTAR,200,22,54,40.7,19,47,40.4,3,7,42.9,13,27,48.1,6,31,37,12,11,12,2,5,60,1
3050,71731,105_06_18,WALES,0,TOTALS,WALES,200,27,54,50.0,24,40,60.0,3,14,21.4,9,20,45.0,5,26,31,6,20,13,3,3,66,0
3051,71744,105_06_18,SAN MARINO,0,TOTALS,SAN MARINO,200,26,63,41.3,19,36,52.8,7,27,25.9,12,16,75.0,10,18,28,8,18,9,4,1,71,1
3052,71755,105_06_19,MOLDOVA,0,TOTALS,MOLDOVA,225,33,74,44.6,27,53,50.9,6,21,28.6,13,13,100.0,11,31,42,12,26,26,5,4,85,0
3053,71768,105_06_19,ANDORRA,0,TOTALS,ANDORRA,225,30,70,42.9,18,45,40.0,12,25,48.0,22,29,75.9,7,24,31,11,19,15,16,0,94,1
3054,71781,105_06_20,AZERBAIJAN,0,TOTALS,AZERBAIJAN,200,25,63,39.7,21,38,55.3,4,25,16.0,12,16,75.0,11,32,43,9,19,17,4,5,66,1
3055,71794,105_06_20,ALBANIA,0,TOTALS,ALBANIA,200,21,67,31.3,18,43,41.9,3,24,12.5,12,22,54.5,8,24,32,6,22,14,11,2,57,0
3056,72177,107_06_01,ISRAEL,0,TOTALS,ISRAEL,200,26,55,47.3,24,46,52.2,2,9,22.2,12,14,85.7,9,20,29,7,21,13,15,1,66,1
3057,72190,107_06_01,ITALY,0,TOTALS,ITALY,200,20,51,39.2,10,24,41.7,10,27,37.0,14,17,82.4,10,19,29,12,19,20,7,2,64,0
3058,72203,107_06_02,RUSSIA,0,TOTALS,RUSSIA,200,21,52,40.4,11,25,44.0,10,27,37.0,11,19,57.9,7,12,19,16,22,21,6,3,63,0
3059,72216,107_06_02,FRANCE,0,TOTALS,FRANCE,200,34,55,61.8,24,37,64.9,10,18,55.6,14,19,73.7,7,27,34,18,21,13,16,2,92,1
3060,72229,107_06_03,SERBIA & MONTENEGRO,0,TOTALS,SERBIA & MONTENEGRO,200,29,70,41.4,22,44,50.0,7,26,26.9,7,8,87.5,11,28,39,15,23,14,9,2,72,1
3061,72242,107_06_03,LATVIA,0,TOTALS,LATVIA,200,22,56,39.3,18,36,50.0,4,20,20.0,13,18,72.2,6,25,31,13,16,17,6,5,61,0
3062,72255,107_06_04,SPAIN,0,TOTALS,SPAIN,200,29,69,42.0,25,54,46.3,4,15,26.7,11,19,57.9,22,19,41,9,19,16,11,7,73,0
3063,72268,107_06_04,BULGARIA,0,TOTALS,BULGARIA,200,29,64,45.3,22,45,48.9,7,19,36.8,10,19,52.6,13,21,34,11,20,17,11,4,75,1
3064,72281,107_06_05,CROATIA,0,TOTALS,CROATIA,200,25,64,39.1,19,41,46.3,6,23,26.1,8,14,57.1,15,20,35,10,12,13,8,3,64,1
3065,72294,107_06_05,BELARUS,0,TOTALS,BELARUS,200,24,61,39.3,18,38,47.4,6,23,26.1,4,7,57.1,17,26,43,11,17,21,8,2,58,0
3066,72307,107_06_06,LITHUANIA,0,TOTALS,LITHUANIA,200,26,69,37.7,21,42,50.0,5,27,18.5,14,23,60.9,12,25,37,10,21,12,5,4,71,0
3067,72320,107_06_06,GREECE,0,TOTALS,GREECE,200,30,60,50.0,24,38,63.2,6,22,27.3,15,22,68.2,7,32,39,10,21,14,4,1,81,1
3068,72331,107_06_07,SLOVENIA,0,TOTALS,SLOVENIA,200,35,71,49.3,24,49,49.0,11,22,50.0,11,16,68.8,13,25,38,17,22,15,14,2,92,1
3069,72344,107_06_07,HUNGARY,0,TOTALS,HUNGARY,200,23,58,39.7,21,46,45.7,2,12,16.7,12,23,52.2,12,24,36,6,17,24,8,2,60,0
3070,72357,107_06_08,TURKEY,0,TOTALS,TURKEY,200,34,67,50.7,25,44,56.8,9,23,39.1,6,16,37.5,12,30,42,18,15,12,14,6,83,1
3071,72370,107_06_08,GERMANY,0,TOTALS,GERMANY,200,19,63,30.2,16,47,34.0,3,16,18.8,4,8,50.0,15,22,37,10,18,22,4,1,45,0
3072,72383,107_06_09,BELARUS,0,TOTALS,BELARUS,200,22,51,43.1,15,34,44.1,7,17,41.2,6,14,42.9,6,21,27,9,21,20,6,4,57,0
3073,72396,107_06_09,SERBIA & MONTENEGRO,0,TOTALS,SERBIA & MONTENEGRO,200,30,64,46.9,22,40,55.0,8,24,33.3,13,17,76.5,14,25,39,19,20,12,8,0,81,1
3074,72409,107_06_10,BULGARIA,0,TOTALS,BULGARIA,200,34,70,48.6,25,39,64.1,9,31,29.0,9,20,45.0,19,15,34,18,28,22,8,0,86,0
3075,72422,107_06_10,LITHUANIA,0,TOTALS,LITHUANIA,200,35,61,57.4,32,50,64.0,3,11,27.3,25,30,83.3,10,18,28,15,20,15,12,3,98,1
3076,72435,107_06_11,HUNGARY,0,TOTALS,HUNGARY,200,25,54,46.3,16,34,47.1,9,20,45.0,9,10,90.0,5,26,31,9,25,21,8,6,68,0
3077,72448,107_06_11,ISRAEL,0,TOTALS,ISRAEL,200,27,63,42.9,24,50,48.0,3,13,23.1,15,25,60.0,17,23,40,11,18,14,10,0,72,1
3078,72461,107_06_12,GERMANY,0,TOTALS,GERMANY,200,20,56,35.7,17,41,41.5,3,15,20.0,8,12,66.7,8,20,28,11,19,24,11,2,51,0
3079,72474,107_06_12,RUSSIA,0,TOTALS,RUSSIA,200,30,57,52.6,20,34,58.8,10,23,43.5,11,18,61.1,9,30,39,19,17,21,20,5,81,1
3080,72487,107_06_13,LATVIA,0,TOTALS,LATVIA,200,29,62,46.8,21,44,47.7,8,18,44.4,13,20,65.0,11,22,33,18,20,21,12,4,79,0
3081,72500,107_06_13,CROATIA,0,TOTALS,CROATIA,200,38,66,57.6,25,44,56.8,13,22,59.1,6,13,46.2,10,26,36,17,25,22,7,4,95,1
3082,72513,107_06_14,GREECE,0,TOTALS,GREECE,200,24,65,36.9,17,48,35.4,7,17,41.2,14,19,73.7,10,16,26,9,31,11,14,1,69,0
3083,72526,107_06_14,SPAIN,0,TOTALS,SPAIN,200,23,52,44.2,18,32,56.2,5,20,25.0,23,36,63.9,21,30,51,13,24,28,7,7,74,1
3084,72539,107_06_15,ITALY,0,TOTALS,ITALY,200,29,63,46.0,24,45,53.3,5,18,27.8,11,22,50.0,15,20,35,9,25,16,7,0,74,1
3085,72550,107_06_15,SLOVENIA,0,TOTALS,SLOVENIA,200,22,57,38.6,19,40,47.5,3,17,17.6,23,32,71.9,13,18,31,6,25,18,8,0,70,0
3086,72563,107_06_16,FRANCE,0,TOTALS,FRANCE,200,21,50,42.0,18,36,50.0,3,14,21.4,15,24,62.5,7,25,32,10,23,18,10,4,60,0
3087,72576,107_06_16,TURKEY,0,TOTALS,TURKEY,200,26,63,41.3,21,48,43.8,5,15,33.3,9,13,69.2,16,25,41,11,22,17,13,1,66,1
3088,72589,107_06_17,LATVIA,0,TOTALS,LATVIA,200,25,60,41.7,17,40,42.5,8,20,40.0,19,28,67.9,13,19,32,14,26,16,11,0,77,0
3089,72602,107_06_17,BELARUS,0,TOTALS,BELARUS,200,28,53,52.8,21,39,53.8,7,14,50.0,21,28,75.0,12,20,32,16,19,15,14,2,84,1
3090,72615,107_06_18,GREECE,0,TOTALS,GREECE,200,25,58,43.1,18,32,56.2,7,26,26.9,21,34,61.8,8,30,38,12,25,13,10,3,78,1
3091,72628,107_06_18,BULGARIA,0,TOTALS,BULGARIA,200,27,63,42.9,16,37,43.2,11,26,42.3,12,25,48.0,12,33,45,15,29,16,6,2,77,0
3092,72641,107_06_19,CROATIA,0,TOTALS,CROATIA,200,30,69,43.5,26,50,52.0,4,19,21.1,8,9,88.9,10,26,36,9,17,8,7,5,72,0
3093,72654,107_06_19,SERBIA & MONTENEGRO,0,TOTALS,SERBIA & MONTENEGRO,200,29,65,44.6,21,40,52.5,8,25,32.0,12,17,70.6,13,27,40,13,17,9,7,4,78,1
3094,72667,107_06_20,SPAIN,0,TOTALS,SPAIN,200,32,71,45.1,23,41,56.1,9,30,30.0,15,24,62.5,19,31,50,13,22,16,1,3,88,0
3095,72680,107_06_20,LITHUANIA,0,TOTALS,LITHUANIA,200,34,70,48.6,26,46,56.5,8,24,33.3,16,24,66.7,8,24,32,13,25,4,7,2,92,1
3096,72691,107_06_21,SLOVENIA,0,TOTALS,SLOVENIA,200,23,55,41.8,18,35,51.4,5,20,25.0,22,27,81.5,12,35,47,11,22,16,4,4,73,1
3097,72704,107_06_21,ISRAEL,0,TOTALS,ISRAEL,200,26,69,37.7,21,56,37.5,5,13,38.5,11,20,55.0,12,21,33,10,28,7,12,1,68,0
3098,72717,107_06_22,FRANCE,0,TOTALS,FRANCE,200,33,63,52.4,20,32,62.5,13,31,41.9,20,27,74.1,10,20,30,13,19,13,16,0,99,1
3099,72730,107_06_22,GERMANY,0,TOTALS,GERMANY,200,25,52,48.1,21,38,55.3,4,14,28.6,12,18,66.7,9,23,32,10,27,24,7,1,66,0
3100,72743,107_06_23,ITALY,0,TOTALS,ITALY,200,26,79,32.9,18,49,36.7,8,30,26.7,14,24,58.3,21,31,52,13,18,16,24,4,74,1
3101,72756,107_06_23,HUNGARY,0,TOTALS,HUNGARY,200,14,52,26.9,11,40,27.5,3,12,25.0,10,19,52.6,10,34,44,8,18,34,10,5,41,0
3102,72769,107_06_24,TURKEY,0,TOTALS,TURKEY,200,22,57,38.6,16,36,44.4,6,21,28.6,10,12,83.3,13,22,35,15,27,15,6,4,60,0
3103,72782,107_06_24,RUSSIA,0,TOTALS,RUSSIA,200,21,53,39.6,18,38,47.4,3,15,20.0,18,35,51.4,16,20,36,10,19,13,9,1,63,1
3104,72795,107_06_25,ISRAEL,0,TOTALS,ISRAEL,200,24,57,42.1,20,44,45.5,4,13,30.8,15,23,65.2,15,26,41,13,17,14,9,1,67,1
3105,72808,107_06_25,GERMANY,0,TOTALS,GERMANY,200,25,60,41.7,17,34,50.0,8,26,30.8,6,7,85.7,9,20,29,14,24,13,7,2,64,0
3106,72821,107_06_26,CROATIA,0,TOTALS,CROATIA,200,29,49,59.2,16,26,61.5,13,23,56.5,16,24,66.7,7,26,33,14,21,15,5,2,87,1
3107,72834,107_06_26,GREECE,0,TOTALS,GREECE,200,26,59,44.1,20,34,58.8,6,25,24.0,14,17,82.4,9,18,27,11,21,9,8,3,72,0
3108,72847,107_06_27,BELARUS,0,TOTALS,BELARUS,200,21,55,38.2,17,38,44.7,4,17,23.5,4,13,30.8,11,26,37,11,20,24,3,0,50,0
3109,72860,107_06_27,SPAIN,0,TOTALS,SPAIN,200,32,71,45.1,29,54,53.7,3,17,17.6,11,17,64.7,15,25,40,13,14,9,12,7,78,1
3110,72873,107_06_28,SERBIA & MONTENEGRO,0,TOTALS,SERBIA & MONTENEGRO,200,40,63,63.5,31,42,73.8,9,21,42.9,12,18,66.7,9,28,37,21,21,16,9,3,101,0
3111,72886,107_06_28,LITHUANIA,0,TOTALS,LITHUANIA,200,24,61,39.3,21,40,52.5,3,21,14.3,17,24,70.8,13,14,27,8,18,15,8,1,68,1
3112,72899,107_06_29,HUNGARY,0,TOTALS,HUNGARY,200,15,54,27.8,9,39,23.1,6,15,40.0,0,0,0.0,12,18,30,6,13,25,4,2,36,0
3113,72912,107_06_29,RUSSIA,0,TOTALS,RUSSIA,200,32,63,50.8,26,41,63.4,6,22,27.3,12,15,80.0,13,26,39,17,11,15,15,7,82,1
3114,72923,107_06_30,SLOVENIA,0,TOTALS,SLOVENIA,200,23,53,43.4,17,38,44.7,6,15,40.0,15,18,83.3,10,24,34,7,14,22,10,6,67,1
3115,72936,107_06_30,FRANCE,0,TOTALS,FRANCE,200,26,64,40.6,21,43,48.8,5,21,23.8,8,14,57.1,14,22,36,11,19,21,11,2,65,0
3116,72949,107_06_31,LATVIA,0,TOTALS,LATVIA,200,37,66,56.1,30,50,60.0,7,16,43.8,9,12,75.0,14,16,30,15,27,23,7,0,90,1
3117,72962,107_06_31,BULGARIA,0,TOTALS,BULGARIA,200,31,58,53.4,20,31,64.5,11,27,40.7,16,29,55.2,13,15,28,19,20,18,10,2,89,0
3118,72975,107_06_32,ITALY,0,TOTALS,ITALY,200,17,52,32.7,14,29,48.3,3,23,13.0,16,19,84.2,7,18,25,8,15,18,11,1,53,0
3119,72988,107_06_32,TURKEY,0,TOTALS,TURKEY,200,30,63,47.6,23,40,57.5,7,23,30.4,8,20,40.0,21,30,51,11,26,19,10,2,75,1
3120,73001,107_06_33,RUSSIA,0,TOTALS,RUSSIA,200,32,64,50.0,25,42,59.5,7,22,31.8,15,17,88.2,10,30,40,22,10,5,5,3,86,1
3121,73014,107_06_33,BELARUS,0,TOTALS,BELARUS,200,20,62,32.3,11,39,28.2,9,23,39.1,3,4,75.0,13,20,33,11,13,13,4,0,52,0
3122,73027,107_06_34,LITHUANIA,0,TOTALS,LITHUANIA,250,37,78,47.4,31,58,53.4,6,20,30.0,14,32,43.8,16,35,51,14,32,21,10,3,94,1
3123,73038,107_06_34,SLOVENIA,0,TOTALS,SLOVENIA,250,30,82,36.6,21,55,38.2,9,27,33.3,31,37,83.8,16,30,46,13,29,13,13,1,100,0
3124,73051,107_06_35,GERMANY,0,TOTALS,GERMANY,200,29,64,45.3,18,38,47.4,11,26,42.3,17,24,70.8,8,26,34,15,27,10,9,2,86,1
3125,73064,107_06_35,LATVIA,0,TOTALS,LATVIA,200,24,67,35.8,21,44,47.7,3,23,13.0,25,28,89.3,19,29,48,10,19,14,6,2,76,0
3126,73077,107_06_36,GREECE,0,TOTALS,GREECE,200,27,63,42.9,20,42,47.6,7,21,33.3,9,13,69.2,7,26,33,14,23,13,8,3,70,0
3127,73090,107_06_36,ITALY,0,TOTALS,ITALY,200,22,62,35.5,12,32,37.5,10,30,33.3,22,26,84.6,13,30,43,13,22,15,6,3,76,1
3128,73103,107_06_37,SPAIN,0,TOTALS,SPAIN,200,35,77,45.5,29,60,48.3,6,17,35.3,13,19,68.4,21,33,54,18,8,14,11,6,89,1
3129,73116,107_06_37,HUNGARY,0,TOTALS,HUNGARY,200,22,65,33.8,15,43,34.9,7,22,31.8,5,10,50.0,12,24,36,13,22,20,9,6,56,0
3130,73129,107_06_38,FRANCE,0,TOTALS,FRANCE,200,18,63,28.6,11,40,27.5,7,23,30.4,15,18,83.3,16,19,35,6,19,8,6,3,58,0
3131,73142,107_06_38,SERBIA & MONTENEGRO,0,TOTALS,SERBIA & MONTENEGRO,200,25,56,44.6,20,41,48.8,5,15,33.3,5,9,55.6,9,31,40,12,19,14,2,3,60,1
3132,73155,107_06_39,BULGARIA,0,TOTALS,BULGARIA,200,26,55,47.3,19,35,54.3,7,20,35.0,18,25,72.0,14,27,41,18,14,20,6,6,77,1
3133,73168,107_06_39,ISRAEL,0,TOTALS,ISRAEL,200,25,64,39.1,20,52,38.5,5,12,41.7,9,13,69.2,13,18,31,11,19,16,13,1,64,0
3134,73181,107_06_40,TURKEY,0,TOTALS,TURKEY,200,34,63,54.0,24,37,64.9,10,26,38.5,13,19,68.4,13,21,34,18,24,9,7,1,91,1
3135,73194,107_06_40,CROATIA,0,TOTALS,CROATIA,200,27,49,55.1,23,35,65.7,4,14,28.6,14,22,63.6,4,19,23,10,21,15,6,1,72,0
3136,73207,107_06_41,BELARUS,0,TOTALS,BELARUS,200,29,56,51.8,24,43,55.8,5,13,38.5,8,12,66.7,7,29,36,17,18,13,5,3,71,1
3137,73220,107_06_41,HUNGARY,0,TOTALS,HUNGARY,200,22,64,34.4,18,39,46.2,4,25,16.0,7,14,50.0,13,19,32,9,12,8,4,2,55,0
3138,73233,107_06_42,FRANCE,0,TOTALS,FRANCE,200,27,69,39.1,23,50,46.0,4,19,21.1,21,33,63.6,15,37,52,12,17,16,10,6,79,1
3139,73246,107_06_42,LITHUANIA,0,TOTALS,LITHUANIA,200,29,74,39.2,17,47,36.2,12,27,44.4,7,14,50.0,16,32,48,16,24,17,11,5,77,0
3140,73259,107_06_43,GERMANY,0,TOTALS,GERMANY,200,25,59,42.4,15,34,44.1,10,25,40.0,6,12,50.0,9,18,27,9,17,10,7,3,66,0
3141,73272,107_06_43,BULGARIA,0,TOTALS,BULGARIA,200,30,65,46.2,19,34,55.9,11,31,35.5,8,14,57.1,20,27,47,16,13,13,6,2,79,1
3142,73285,107_06_44,SERBIA & MONTENEGRO,0,TOTALS,SERBIA & MONTENEGRO,225,35,75,46.7,28,51,54.9,7,24,29.2,8,11,72.7,11,25,36,18,19,11,12,2,85,1
3143,73296,107_06_44,SLOVENIA,0,TOTALS,SLOVENIA,225,29,57,50.9,21,40,52.5,8,17,47.1,12,17,70.6,2,31,33,14,19,19,6,0,78,0
3144,73309,107_06_45,LATVIA,0,TOTALS,LATVIA,200,24,47,51.1,13,21,61.9,11,26,42.3,14,23,60.9,7,23,30,15,25,24,4,4,73,0
3145,73322,107_06_45,ISRAEL,0,TOTALS,ISRAEL,200,37,70,52.9,31,53,58.5,6,17,35.3,15,24,62.5,12,19,31,17,21,7,16,1,95,1
3146,73335,107_06_46,CROATIA,0,TOTALS,CROATIA,200,25,64,39.1,20,40,50.0,5,24,20.8,19,26,73.1,10,23,33,11,28,9,2,5,74,0
3147,73348,107_06_46,ITALY,0,TOTALS,ITALY,200,27,60,45.0,17,33,51.5,10,27,37.0,22,25,88.0,11,31,42,14,29,8,2,3,86,1
3148,73361,107_06_47,RUSSIA,0,TOTALS,RUSSIA,200,28,52,53.8,25,38,65.8,3,14,21.4,18,23,78.3,9,19,28,12,23,16,16,3,77,1
3149,73374,107_06_47,SPAIN,0,TOTALS,SPAIN,200,19,45,42.2,13,32,40.6,6,13,46.2,17,23,73.9,9,17,26,9,19,23,8,1,61,0
3150,73387,107_06_48,TURKEY,0,TOTALS,TURKEY,200,27,60,45.0,18,31,58.1,9,29,31.0,15,33,45.5,14,29,43,13,26,15,9,3,78,0
3151,73400,107_06_48,GREECE,0,TOTALS,GREECE,200,27,61,44.3,17,35,48.6,10,26,38.5,16,24,66.7,8,26,34,12,26,12,10,0,80,1
3152,73413,107_06_49,BELARUS,0,TOTALS,BELARUS,200,24,69,34.8,15,43,34.9,9,26,34.6,2,4,50.0,12,27,39,11,17,15,11,4,59,0
3153,73426,107_06_49,LATVIA,0,TOTALS,LATVIA,200,23,60,38.3,16,36,44.4,7,24,29.2,10,13,76.9,12,33,45,11,12,19,10,4,63,1
3154,73439,107_06_50,FRANCE,0,TOTALS,FRANCE,200,26,63,41.3,17,41,41.5,9,22,40.9,15,20,75.0,6,23,29,12,16,15,17,0,76,1
3155,73452,107_06_50,GREECE,0,TOTALS,GREECE,200,21,48,43.8,20,39,51.3,1,9,11.1,7,14,50.0,8,33,41,12,18,30,8,1,50,0
3156,73465,107_06_51,HUNGARY,0,TOTALS,HUNGARY,200,22,54,40.7,11,30,36.7,11,24,45.8,15,22,68.2,7,28,35,14,18,17,7,4,70,1
3157,73478,107_06_51,GERMANY,0,TOTALS,GERMANY,200,23,66,34.8,19,45,42.2,4,21,19.0,13,17,76.5,15,26,41,8,23,16,10,1,63,0
3158,73491,107_06_52,LITHUANIA,0,TOTALS,LITHUANIA,200,24,69,34.8,21,47,44.7,3,22,13.6,11,17,64.7,12,25,37,13,20,17,9,2,62,0
3159,73504,107_06_52,CROATIA,0,TOTALS,CROATIA,200,30,61,49.2,19,40,47.5,11,21,52.4,10,21,47.6,9,34,43,18,20,20,8,3,81,1
3160,73517,107_06_53,RUSSIA,0,TOTALS,RUSSIA,200,22,46,47.8,11,20,55.0,11,26,42.3,11,15,73.3,8,27,35,15,15,14,6,3,66,1
3161,73530,107_06_53,ISRAEL,0,TOTALS,ISRAEL,200,23,58,39.7,17,44,38.6,6,14,42.9,9,15,60.0,13,18,31,13,19,9,3,2,61,0
3162,73543,107_06_54,SERBIA & MONTENEGRO,0,TOTALS,SERBIA & MONTENEGRO,250,30,77,39.0,23,51,45.1,7,26,26.9,22,30,73.3,15,36,51,12,33,15,9,1,89,1
3163,73556,107_06_54,ITALY,0,TOTALS,ITALY,250,22,60,36.7,13,30,43.3,9,30,30.0,30,40,75.0,7,34,41,14,29,16,9,1,83,0
3164,73567,107_06_55,SPAIN,0,TOTALS,SPAIN,200,30,67,44.8,28,55,50.9,2,12,16.7,10,15,66.7,15,15,30,14,16,14,12,3,72,0
3165,73580,107_06_55,BULGARIA,0,TOTALS,BULGARIA,200,30,58,51.7,20,37,54.1,10,21,47.6,10,13,76.9,14,24,38,13,19,18,6,5,80,1
3166,73591,107_06_56,SLOVENIA,0,TOTALS,SLOVENIA,200,20,60,33.3,15,38,39.5,5,22,22.7,17,26,65.4,9,20,29,8,23,15,6,1,62,0
3167,73604,107_06_56,TURKEY,0,TOTALS,TURKEY,200,36,67,53.7,28,50,56.0,8,17,47.1,16,24,66.7,13,34,47,18,24,14,9,6,96,1
3168,73617,107_06_57,BELARUS,0,TOTALS,BELARUS,200,22,63,34.9,14,39,35.9,8,24,33.3,7,13,53.8,9,23,32,14,14,13,10,1,59,0
3169,73630,107_06_57,GERMANY,0,TOTALS,GERMANY,200,31,67,46.3,22,48,45.8,9,19,47.4,10,13,76.9,14,33,47,13,21,17,9,1,81,1
3170,73643,107_06_58,LATVIA,0,TOTALS,LATVIA,200,39,81,48.1,35,60,58.3,4,21,19.0,19,22,86.4,22,36,58,18,17,19,15,5,101,0
3171,73656,107_06_58,HUNGARY,0,TOTALS,HUNGARY,200,26,80,32.5,20,56,35.7,6,24,25.0,11,18,61.1,20,22,42,12,23,19,12,3,69,1
3172,73669,107_06_59,GREECE,0,TOTALS,GREECE,200,27,61,44.3,16,34,47.1,11,27,40.7,13,13,100.0,11,22,33,15,18,20,11,1,78,0
3173,73682,107_06_59,LITHUANIA,0,TOTALS,LITHUANIA,200,31,65,47.7,22,37,59.5,9,28,32.1,11,22,50.0,16,22,38,13,15,14,11,6,82,1
3174,73695,107_06_60,ISRAEL,0,TOTALS,ISRAEL,200,31,70,44.3,26,50,52.0,5,20,25.0,7,9,77.8,14,18,32,11,25,16,13,1,74,0
3175,73706,107_06_60,SPAIN,0,TOTALS,SPAIN,200,26,52,50.0,19,33,57.6,7,19,36.8,23,34,67.6,15,26,41,19,16,22,10,1,82,1
3176,73719,107_06_61,FRANCE,0,TOTALS,FRANCE,200,24,66,36.4,17,42,40.5,7,24,29.2,3,11,27.3,12,23,35,9,12,14,13,2,58,0
3177,73732,107_06_61,CROATIA,0,TOTALS,CROATIA,200,26,62,41.9,22,52,42.3,4,10,40.0,7,10,70.0,15,33,48,9,17,20,9,1,63,1
3178,73745,107_06_62,RUSSIA,0,TOTALS,RUSSIA,250,32,73,43.8,25,52,48.1,7,21,33.3,13,22,59.1,17,22,39,15,30,21,14,1,84,0
3179,73758,107_06_62,BULGARIA,0,TOTALS,BULGARIA,250,26,52,50.0,17,31,54.8,9,21,42.9,27,37,73.0,8,27,35,12,23,23,7,4,88,1
3180,73771,107_06_63,ITALY,0,TOTALS,ITALY,200,26,59,44.1,18,35,51.4,8,24,33.3,15,21,71.4,9,15,24,13,19,12,8,1,75,0
3181,73782,107_06_63,SLOVENIA,0,TOTALS,SLOVENIA,200,34,58,58.6,28,44,63.6,6,14,42.9,9,13,69.2,11,26,37,11,23,17,8,1,83,1
3182,73795,107_06_64,SERBIA & MONTENEGRO,0,TOTALS,SERBIA & MONTENEGRO,200,26,53,49.1,22,37,59.5,4,16,25.0,8,10,80.0,7,33,40,15,19,21,5,3,64,1
3183,73808,107_06_64,TURKEY,0,TOTALS,TURKEY,200,21,61,34.4,14,36,38.9,7,25,28.0,9,20,45.0,11,21,32,11,18,14,10,4,58,0
3184,73821,108_06_01,SWITZERLAND,0,TOTALS,SWITZERLAND,200,31,71,43.7,24,50,48.0,7,21,33.3,16,21,76.2,7,15,22,6,21,14,10,1,85,0
3185,73834,108_06_01,MKD,0,TOTALS,MKD,200,40,69,58.0,33,47,70.2,7,22,31.8,12,16,75.0,10,27,37,13,17,16,8,1,99,1
3186,73847,108_06_02,ICELAND,0,TOTALS,ICELAND,200,19,56,33.9,14,37,37.8,5,19,26.3,15,20,75.0,6,13,19,9,17,18,2,2,58,0
3187,73860,108_06_02,NETHERLANDS,0,TOTALS,NETHERLANDS,200,42,78,53.8,36,61,59.0,6,17,35.3,9,15,60.0,16,28,44,13,21,10,7,2,99,1
3188,73873,108_06_03,SLOVAK REPUBLIC,0,TOTALS,SLOVAK REPUBLIC,200,27,68,39.7,20,44,45.5,7,24,29.2,7,9,77.8,5,14,19,12,31,13,11,2,68,0
3189,73886,108_06_03,CZECH REPUBLIC,0,TOTALS,CZECH REPUBLIC,200,21,56,37.5,18,41,43.9,3,15,20.0,24,33,72.7,12,24,36,5,19,24,7,7,69,1
3190,73899,108_06_04,SWEDEN,0,TOTALS,SWEDEN,200,24,50,48.0,19,36,52.8,5,14,35.7,19,30,63.3,8,16,24,5,25,17,5,1,72,0
3191,73912,108_06_04,UKRAINE,0,TOTALS,UKRAINE,200,27,48,56.2,23,36,63.9,4,12,33.3,28,35,80.0,9,18,27,10,22,18,7,7,86,1
3192,73925,108_06_05,BELGIUM,0,TOTALS,BELGIUM,200,25,52,48.1,19,34,55.9,6,18,33.3,23,28,82.1,7,17,24,11,29,13,6,1,79,0
3193,73938,108_06_05,POLAND,0,TOTALS,POLAND,200,30,60,50.0,23,38,60.5,7,22,31.8,23,31,74.2,11,21,32,14,23,16,4,2,90,1
3194,73951,108_06_06,FINLAND,0,TOTALS,FINLAND,200,32,66,48.5,26,43,60.5,6,23,26.1,17,26,65.4,12,15,27,13,25,13,11,1,87,1
3195,73964,108_06_06,GEORGIA,0,TOTALS,GEORGIA,200,25,51,49.0,14,23,60.9,11,28,39.3,20,29,69.0,3,22,25,16,24,21,10,1,81,0
3196,73977,108_06_07,IRELAND,0,TOTALS,IRELAND,225,23,60,38.3,17,36,47.2,6,24,25.0,19,33,57.6,14,21,35,9,19,14,8,0,71,1
3197,73990,108_06_07,GREAT BRITAIN,0,TOTALS,GREAT BRITAIN,225,26,65,40.0,19,39,48.7,7,26,26.9,11,16,68.8,16,26,42,7,20,22,7,2,70,0
3198,74003,108_06_08,PORTUGAL,0,TOTALS,PORTUGAL,200,28,65,43.1,20,35,57.1,8,30,26.7,17,27,63.0,13,34,47,19,22,14,6,4,81,1
3199,74016,108_06_08,AUSTRIA,0,TOTALS,AUSTRIA,200,26,62,41.9,16,32,50.0,10,30,33.3,18,26,69.2,8,29,37,13,22,14,4,1,80,0
3200,74029,108_06_09,GEORGIA,0,TOTALS,GEORGIA,200,33,71,46.5,25,35,71.4,8,36,22.2,15,20,75.0,9,19,28,17,20,15,11,5,89,1
3201,74042,108_06_09,ICELAND,0,TOTALS,ICELAND,200,30,58,51.7,22,39,56.4,8,19,42.1,12,17,70.6,9,28,37,16,22,21,4,2,80,0
3202,74055,108_06_10,CZECH REPUBLIC,0,TOTALS,CZECH REPUBLIC,200,28,70,40.0,16,36,44.4,12,34,35.3,6,17,35.3,11,21,32,13,19,9,5,5,74,0
3203,74068,108_06_10,SWITZERLAND,0,TOTALS,SWITZERLAND,200,25,66,37.9,15,40,37.5,10,26,38.5,17,23,73.9,11,26,37,7,14,8,4,5,77,1
3204,74081,108_06_11,AUSTRIA,0,TOTALS,AUSTRIA,200,25,71,35.2,14,36,38.9,11,35,31.4,16,20,80.0,11,22,33,9,19,11,9,2,77,1
3205,74094,108_06_11,SWEDEN,0,TOTALS,SWEDEN,200,27,58,46.6,21,33,63.6,6,25,24.0,8,8,100.0,5,31,36,11,25,22,6,3,68,0
3206,74107,108_06_12,GREAT BRITAIN,0,TOTALS,GREAT BRITAIN,200,15,55,27.3,11,37,29.7,4,18,22.2,5,8,62.5,7,13,20,6,11,20,3,1,39,0
3207,74120,108_06_12,BELGIUM,0,TOTALS,BELGIUM,200,34,64,53.1,22,36,61.1,12,28,42.9,6,10,60.0,13,23,36,16,18,16,8,4,86,1
3208,74133,108_06_13,UKRAINE,0,TOTALS,UKRAINE,200,24,51,47.1,17,35,48.6,7,16,43.8,12,17,70.6,9,30,39,7,23,25,6,5,67,1
3209,74146,108_06_13,PORTUGAL,0,TOTALS,PORTUGAL,200,23,63,36.5,18,44,40.9,5,19,26.3,9,15,60.0,7,18,25,9,17,14,13,1,60,0
3210,74159,108_06_14,MKD,0,TOTALS,MKD,200,33,59,55.9,27,42,64.3,6,17,35.3,19,30,63.3,12,26,38,16,13,17,6,2,91,1
3211,74172,108_06_14,SLOVAK REPUBLIC,0,TOTALS,SLOVAK REPUBLIC,200,30,75,40.0,26,58,44.8,4,17,23.5,5,5,100.0,15,16,31,7,24,13,5,1,69,0
3212,74185,108_06_15,NETHERLANDS,0,TOTALS,NETHERLANDS,200,28,62,45.2,22,46,47.8,6,16,37.5,13,15,86.7,16,16,32,9,21,25,9,3,75,0
3213,74198,108_06_15,FINLAND,0,TOTALS,FINLAND,200,29,64,45.3,19,37,51.4,10,27,37.0,17,23,73.9,13,15,28,9,16,14,18,3,85,1
3214,74211,108_06_16,POLAND,0,TOTALS,POLAND,200,29,63,46.0,23,44,52.3,6,19,31.6,15,19,78.9,13,26,39,15,26,19,6,4,79,1
3215,74224,108_06_16,IRELAND,0,TOTALS,IRELAND,200,22,58,37.9,15,40,37.5,7,18,38.9,21,26,80.8,4,16,20,13,21,14,5,2,72,0
3216,74237,108_06_17,SWITZERLAND,0,TOTALS,SWITZERLAND,200,21,54,38.9,17,41,41.5,4,13,30.8,16,26,61.5,12,14,26,2,23,25,8,3,62,0
3217,74250,108_06_17,SLOVAK REPUBLIC,0,TOTALS,SLOVAK REPUBLIC,200,26,59,44.1,17,36,47.2,9,23,39.1,13,19,68.4,8,10,18,16,23,21,10,2,74,1
3218,74263,108_06_18,UKRAINE,0,TOTALS,UKRAINE,200,22,58,37.9,16,30,53.3,6,28,21.4,17,20,85.0,15,31,46,8,22,18,4,7,67,0
3219,74276,108_06_18,AUSTRIA,0,TOTALS,AUSTRIA,200,24,62,38.7,21,44,47.7,3,18,16.7,18,23,78.3,7,20,27,10,21,6,7,3,69,1
3220,74289,108_06_19,IRELAND,0,TOTALS,IRELAND,200,16,61,26.2,12,37,32.4,4,24,16.7,6,9,66.7,9,14,23,5,17,20,9,3,42,0
3221,74302,108_06_19,BELGIUM,0,TOTALS,BELGIUM,200,24,59,40.7,21,46,45.7,3,13,23.1,6,10,60.0,10,29,39,9,13,23,8,7,57,1
3222,74315,108_06_20,GEORGIA,0,TOTALS,GEORGIA,200,38,70,54.3,30,46,65.2,8,24,33.3,22,32,68.8,12,27,39,12,19,6,14,1,106,0
3223,74328,108_06_20,NETHERLANDS,0,TOTALS,NETHERLANDS,200,23,65,35.4,15,42,35.7,8,23,34.8,10,12,83.3,9,25,34,9,29,18,2,5,64,1
3224,74341,108_06_21,POLAND,0,TOTALS,POLAND,200,29,75,38.7,20,44,45.5,9,31,29.0,7,13,53.8,9,25,34,14,20,17,5,2,74,1
3225,74354,108_06_21,GREAT BRITAIN,0,TOTALS,GREAT BRITAIN,200,25,70,35.7,19,53,35.8,6,17,35.3,13,24,54.2,19,23,42,5,20,16,6,5,69,0
3226,74367,108_06_22,PORTUGAL,0,TOTALS,PORTUGAL,200,18,62,29.0,13,36,36.1,5,26,19.2,17,28,60.7,9,25,34,11,25,18,10,3,58,0
3227,74380,108_06_22,SWEDEN,0,TOTALS,SWEDEN,200,28,63,44.4,25,50,50.0,3,13,23.1,13,23,56.5,9,37,46,13,26,17,10,4,72,1
3228,74393,108_06_23,CZECH REPUBLIC,0,TOTALS,CZECH REPUBLIC,200,33,68,48.5,22,40,55.0,11,28,39.3,15,22,68.2,11,30,41,15,25,15,12,2,92,1
3229,74406,108_06_23,MKD,0,TOTALS,MKD,200,25,65,38.5,17,44,38.6,8,21,38.1,16,29,55.2,13,21,34,5,19,16,9,5,74,0
3230,74419,108_06_24,ICELAND,0,TOTALS,ICELAND,200,22,62,35.5,18,45,40.0,4,17,23.5,13,15,86.7,9,28,37,11,25,28,4,1,61,1
3231,74432,108_06_24,FINLAND,0,TOTALS,FINLAND,200,34,79,43.0,27,57,47.4,7,22,31.8,25,33,75.8,17,31,48,16,18,10,15,2,100,0
3232,74445,108_06_25,NETHERLANDS,0,TOTALS,NETHERLANDS,200,29,68,42.6,22,43,51.2,7,25,28.0,15,24,62.5,13,26,39,15,20,16,5,2,80,1
3233,74458,108_06_25,SWITZERLAND,0,TOTALS,SWITZERLAND,200,30,61,49.2,28,49,57.1,2,12,16.7,7,14,50.0,5,25,30,8,26,16,9,3,69,0
3234,74471,108_06_26,FINLAND,0,TOTALS,FINLAND,200,27,74,36.5,20,50,40.0,7,24,29.2,16,21,76.2,13,20,33,10,23,15,15,3,77,1
3235,74484,108_06_26,MKD,0,TOTALS,MKD,200,24,62,38.7,15,35,42.9,9,27,33.3,11,16,68.8,11,29,40,10,22,28,6,8,68,0
3236,74497,108_06_27,ICELAND,0,TOTALS,ICELAND,200,25,61,41.0,19,39,48.7,6,22,27.3,15,21,71.4,8,18,26,8,16,17,7,0,71,1
3237,74510,108_06_27,SLOVAK REPUBLIC,0,TOTALS,SLOVAK REPUBLIC,200,28,61,45.9,23,41,56.1,5,20,25.0,7,12,58.3,14,26,40,10,27,22,6,1,68,0
3238,74523,108_06_28,GEORGIA,0,TOTALS,GEORGIA,200,32,56,57.1,16,30,53.3,16,26,61.5,18,25,72.0,5,17,22,12,19,19,3,1,98,1
3239,74536,108_06_28,CZECH REPUBLIC,0,TOTALS,CZECH REPUBLIC,200,35,75,46.7,23,48,47.9,12,27,44.4,6,10,60.0,15,12,27,4,23,16,9,1,88,0
3240,74549,108_06_29,BELGIUM,0,TOTALS,BELGIUM,200,19,68,27.9,14,33,42.4,5,35,14.3,6,8,75.0,12,25,37,7,25,19,5,3,49,0
3241,74562,108_06_29,AUSTRIA,0,TOTALS,AUSTRIA,200,25,69,36.2,18,41,43.9,7,28,25.0,16,22,72.7,14,31,45,16,12,14,8,0,73,1
3242,74575,108_06_30,IRELAND,0,TOTALS,IRELAND,200,26,58,44.8,18,40,45.0,8,18,44.4,11,20,55.0,5,12,17,10,21,15,6,2,71,0
3243,74588,108_06_30,PORTUGAL,0,TOTALS,PORTUGAL,200,31,65,47.7,22,41,53.7,9,24,37.5,17,22,77.3,8,27,35,24,21,15,5,3,88,1
3244,74601,108_06_31,GREAT BRITAIN,0,TOTALS,GREAT BRITAIN,200,21,71,29.6,19,55,34.5,2,16,12.5,8,12,66.7,9,17,26,5,26,20,18,1,52,1
3245,74614,108_06_31,SWEDEN,0,TOTALS,SWEDEN,200,38,68,55.9,22,35,62.9,16,33,48.5,21,23,91.3,10,34,44,20,13,25,9,3,113,0
3246,74627,108_06_32,POLAND,0,TOTALS,POLAND,200,22,56,39.3,18,44,40.9,4,12,33.3,19,28,67.9,10,16,26,9,24,12,10,1,67,1
3247,74640,108_06_32,UKRAINE,0,TOTALS,UKRAINE,200,21,50,42.0,14,32,43.8,7,18,38.9,16,22,72.7,8,19,27,11,26,20,6,5,65,0
3248,74653,108_06_33,SLOVAK REPUBLIC,0,TOTALS,SLOVAK REPUBLIC,225,29,70,41.4,21,49,42.9,8,21,38.1,5,7,71.4,10,29,39,14,24,23,10,5,71,0
3249,74666,108_06_33,IRELAND,0,TOTALS,IRELAND,225,27,73,37.0,23,59,39.0,4,14,28.6,21,26,80.8,13,22,35,9,13,20,10,1,79,1
3250,74679,108_06_34,MKD,0,TOTALS,MKD,200,29,64,45.3,19,36,52.8,10,28,35.7,19,27,70.4,12,32,44,11,24,24,5,4,87,1
3251,74692,108_06_34,BELGIUM,0,TOTALS,BELGIUM,200,23,69,33.3,16,50,32.0,7,19,36.8,19,25,76.0,8,24,32,10,26,13,10,3,72,0
3252,74705,108_06_35,SWITZERLAND,0,TOTALS,SWITZERLAND,225,24,71,33.8,14,41,34.1,10,30,33.3,21,32,65.6,15,22,37,11,23,15,8,2,79,1
3253,74718,108_06_35,GREAT BRITAIN,0,TOTALS,GREAT BRITAIN,225,28,73,38.4,25,51,49.0,3,22,13.6,17,20,85.0,21,25,46,9,29,16,8,2,76,0
3254,74731,108_06_36,CZECH REPUBLIC,0,TOTALS,CZECH REPUBLIC,200,27,66,40.9,17,41,41.5,10,25,40.0,13,20,65.0,14,18,32,7,22,8,7,1,77,1
3255,74744,108_06_36,POLAND,0,TOTALS,POLAND,200,28,59,47.5,25,43,58.1,3,16,18.8,10,18,55.6,9,23,32,8,23,11,1,1,69,0
3256,74757,108_06_37,SWEDEN,0,TOTALS,SWEDEN,200,24,71,33.8,22,53,41.5,2,18,11.1,12,17,70.6,13,19,32,7,18,16,10,2,62,0
3257,74770,108_06_37,NETHERLANDS,0,TOTALS,NETHERLANDS,200,36,72,50.0,26,47,55.3,10,25,40.0,11,14,78.6,18,28,46,14,18,23,8,2,93,1
3258,74783,108_06_38,UKRAINE,0,TOTALS,UKRAINE,200,24,52,46.2,18,35,51.4,6,17,35.3,17,24,70.8,6,22,28,12,24,21,3,3,71,0
3259,74796,108_06_38,GEORGIA,0,TOTALS,GEORGIA,200,30,65,46.2,24,38,63.2,6,27,22.2,19,24,79.2,8,19,27,14,22,13,9,1,85,1
3260,74809,108_06_39,AUSTRIA,0,TOTALS,AUSTRIA,200,23,51,45.1,20,37,54.1,3,14,21.4,13,17,76.5,3,17,20,12,19,24,7,0,62,0
3261,74822,108_06_39,FINLAND,0,TOTALS,FINLAND,200,34,64,53.1,23,34,67.6,11,30,36.7,16,19,84.2,12,22,34,17,19,15,15,0,95,1
3262,74835,108_06_40,PORTUGAL,0,TOTALS,PORTUGAL,200,33,75,44.0,26,45,57.8,7,30,23.3,13,20,65.0,16,19,35,14,18,9,12,2,86,1
3263,74848,108_06_40,ICELAND,0,TOTALS,ICELAND,200,23,45,51.1,17,30,56.7,6,15,40.0,9,12,75.0,0,25,25,13,20,21,4,1,61,0
3264,74861,108_06_41,GREAT BRITAIN,0,TOTALS,GREAT BRITAIN,200,28,63,44.4,23,50,46.0,5,13,38.5,11,18,61.1,7,30,37,10,25,11,5,1,72,0
3265,74874,108_06_41,NETHERLANDS,0,TOTALS,NETHERLANDS,200,32,71,45.1,27,51,52.9,5,20,25.0,14,27,51.9,15,27,42,6,19,12,5,2,83,1
3266,74887,108_06_42,POLAND,0,TOTALS,POLAND,200,34,69,49.3,26,47,55.3,8,22,36.4,9,13,69.2,5,19,24,12,24,11,3,1,85,1
3267,74900,108_06_42,GEORGIA,0,TOTALS,GEORGIA,200,27,56,48.2,21,43,48.8,6,13,46.2,13,18,72.2,5,23,28,11,21,19,5,1,73,0
3268,74913,108_06_43,IRELAND,0,TOTALS,IRELAND,225,33,74,44.6,29,57,50.9,4,17,23.5,19,26,73.1,6,30,36,5,23,12,8,1,89,0
3269,74926,108_06_43,ICELAND,0,TOTALS,ICELAND,225,35,69,50.7,25,47,53.2,10,22,45.5,19,26,73.1,4,34,38,12,22,16,6,1,99,1
3270,74939,108_06_44,BELGIUM,0,TOTALS,BELGIUM,200,21,64,32.8,19,51,37.3,2,13,15.4,11,15,73.3,9,20,29,8,26,21,8,3,55,0
3271,74952,108_06_44,FINLAND,0,TOTALS,FINLAND,200,24,53,45.3,20,42,47.6,4,11,36.4,27,33,81.8,4,28,32,7,18,20,8,1,79,1
3272,74965,108_06_45,SWITZERLAND,0,TOTALS,SWITZERLAND,200,27,65,41.5,24,48,50.0,3,17,17.6,12,17,70.6,10,22,32,8,16,15,8,3,69,0
3273,74978,108_06_45,SWEDEN,0,TOTALS,SWEDEN,200,35,75,46.7,28,59,47.5,7,16,43.8,6,11,54.5,19,28,47,18,13,17,8,6,83,1
3274,74991,108_06_46,SLOVAK REPUBLIC,0,TOTALS,SLOVAK REPUBLIC,200,26,70,37.1,20,40,50.0,6,30,20.0,13,20,65.0,24,16,40,8,30,14,7,1,71,0
3275,75004,108_06_46,PORTUGAL,0,TOTALS,PORTUGAL,200,21,46,45.7,12,24,50.0,9,22,40.9,23,31,74.2,7,21,28,14,23,14,8,2,74,1
3276,75017,108_06_47,CZECH REPUBLIC,0,TOTALS,CZECH REPUBLIC,200,13,64,20.3,8,42,19.0,5,22,22.7,7,16,43.8,13,18,31,3,23,14,12,3,38,0
3277,75030,108_06_47,UKRAINE,0,TOTALS,UKRAINE,200,20,50,40.0,16,37,43.2,4,13,30.8,13,22,59.1,8,36,44,11,16,23,7,6,57,1
3278,75043,108_06_48,IRELAND,0,TOTALS,IRELAND,200,24,61,39.3,17,33,51.5,7,28,25.0,13,22,59.1,5,21,26,12,18,15,11,0,68,0
3279,75056,108_06_48,GREAT BRITAIN,0,TOTALS,GREAT BRITAIN,200,34,62,54.8,27,44,61.4,7,18,38.9,12,15,80.0,7,33,40,12,17,18,11,4,87,1
3280,75069,108_06_49,UKRAINE,0,TOTALS,UKRAINE,200,20,52,38.5,15,35,42.9,5,17,29.4,10,14,71.4,5,18,23,8,9,20,8,8,55,0
3281,75082,108_06_49,BELGIUM,0,TOTALS,BELGIUM,200,26,61,42.6,21,53,39.6,5,8,62.5,8,12,66.7,10,26,36,10,19,18,12,0,65,1
3282,75095,108_06_50,SLOVAK REPUBLIC,0,TOTALS,SLOVAK REPUBLIC,200,33,62,53.2,23,40,57.5,10,22,45.5,18,24,75.0,6,26,32,14,28,13,8,1,94,1
3283,75108,108_06_50,SWITZERLAND,0,TOTALS,SWITZERLAND,200,31,68,45.6,27,49,55.1,4,19,21.1,17,26,65.4,8,24,32,10,24,16,5,4,83,0
3284,75121,108_06_51,CZECH REPUBLIC,0,TOTALS,CZECH REPUBLIC,200,37,73,50.7,25,44,56.8,12,29,41.4,9,12,75.0,8,23,31,15,27,16,7,5,95,1
3285,75134,108_06_51,AUSTRIA,0,TOTALS,AUSTRIA,200,22,60,36.7,15,38,39.5,7,22,31.8,26,28,92.9,6,26,32,11,18,18,9,1,77,0
3286,75147,108_06_52,PORTUGAL,0,TOTALS,PORTUGAL,200,32,63,50.8,20,37,54.1,12,26,46.2,8,14,57.1,10,24,34,20,22,14,9,7,84,1
3287,75160,108_06_52,SWEDEN,0,TOTALS,SWEDEN,200,24,59,40.7,18,37,48.6,6,22,27.3,15,23,65.2,13,18,31,10,19,16,8,2,69,0
3288,75173,108_06_53,POLAND,0,TOTALS,POLAND,200,31,68,45.6,23,47,48.9,8,21,38.1,2,4,50.0,10,18,28,9,18,11,3,4,72,0
3289,75186,108_06_53,MKD,0,TOTALS,MKD,200,28,66,42.4,19,45,42.2,9,21,42.9,12,16,75.0,7,22,29,13,12,13,6,6,77,1
3290,75199,108_06_54,ICELAND,0,TOTALS,ICELAND,200,34,65,52.3,28,46,60.9,6,19,31.6,13,20,65.0,4,20,24,13,14,16,7,0,87,0
3291,75212,108_06_54,NETHERLANDS,0,TOTALS,NETHERLANDS,200,39,72,54.2,27,44,61.4,12,28,42.9,8,13,61.5,11,23,34,17,21,19,6,0,98,1
3292,75225,108_06_55,GEORGIA,0,TOTALS,GEORGIA,200,25,57,43.9,16,30,53.3,9,27,33.3,15,23,65.2,4,24,28,16,21,12,8,2,74,1
3293,75238,108_06_55,FINLAND,0,TOTALS,FINLAND,200,20,56,35.7,14,32,43.8,6,24,25.0,17,21,81.0,6,21,27,5,27,19,6,1,63,0
3294,75251,108_06_56,IRELAND,0,TOTALS,IRELAND,200,26,63,41.3,24,50,48.0,2,13,15.4,8,12,66.7,10,24,34,8,11,19,10,1,62,0
3295,75264,108_06_56,SWITZERLAND,0,TOTALS,SWITZERLAND,200,29,66,43.9,22,46,47.8,7,20,35.0,7,11,63.6,12,28,40,12,12,16,8,4,72,1
3296,75277,108_06_57,UKRAINE,0,TOTALS,UKRAINE,200,27,56,48.2,20,36,55.6,7,20,35.0,12,15,80.0,7,24,31,9,12,14,8,7,73,1
3297,75290,108_06_57,AUSTRIA,0,TOTALS,AUSTRIA,200,27,62,43.5,23,43,53.5,4,19,21.1,10,15,66.7,9,17,26,6,13,16,9,2,68,0
3298,75303,108_06_58,GREAT BRITAIN,0,TOTALS,GREAT BRITAIN,200,25,57,43.9,23,43,53.5,2,14,14.3,18,24,75.0,4,21,25,4,9,10,5,1,70,0
3299,75316,108_06_58,SLOVAK REPUBLIC,0,TOTALS,SLOVAK REPUBLIC,200,33,67,49.3,23,41,56.1,10,26,38.5,7,8,87.5,7,26,33,10,20,15,7,2,83,1
3300,75329,108_06_59,SWEDEN,0,TOTALS,SWEDEN,200,38,75,50.7,33,55,60.0,5,20,25.0,20,27,74.1,16,31,47,23,9,26,11,1,101,0
3301,75342,108_06_59,ICELAND,0,TOTALS,ICELAND,200,27,73,37.0,21,48,43.8,6,25,24.0,5,5,100.0,5,13,18,9,18,26,15,1,65,1
3302,75355,108_06_60,BELGIUM,0,TOTALS,BELGIUM,200,23,58,39.7,17,39,43.6,6,19,31.6,14,28,50.0,10,23,33,15,19,18,6,4,66,0
3303,75368,108_06_60,CZECH REPUBLIC,0,TOTALS,CZECH REPUBLIC,200,29,69,42.0,20,45,44.4,9,24,37.5,13,18,72.2,11,24,35,17,24,15,10,3,80,1
3304,75381,108_06_61,PORTUGAL,0,TOTALS,PORTUGAL,200,22,56,39.3,13,36,36.1,9,20,45.0,13,15,86.7,9,17,26,13,17,20,7,0,66,0
3305,75394,108_06_61,NETHERLANDS,0,TOTALS,NETHERLANDS,200,32,60,53.3,26,47,55.3,6,13,46.2,9,12,75.0,8,23,31,18,20,18,8,2,79,1
3306,75407,108_06_62,POLAND,0,TOTALS,POLAND,200,29,64,45.3,25,47,53.2,4,17,23.5,13,22,59.1,3,25,28,17,27,13,7,2,75,0
3307,75420,108_06_62,FINLAND,0,TOTALS,FINLAND,200,30,68,44.1,23,53,43.4,7,15,46.7,24,34,70.6,12,28,40,12,21,11,7,1,91,1
3308,75433,108_06_63,MKD,0,TOTALS,MKD,200,33,63,52.4,20,31,64.5,13,32,40.6,9,13,69.2,12,21,33,18,18,22,8,1,88,0
3309,75446,108_06_63,GEORGIA,0,TOTALS,GEORGIA,200,40,70,57.1,32,45,71.1,8,25,32.0,8,12,66.7,7,19,26,22,14,13,12,0,96,1
3310,78129,111_06_01,UKRAINE,0,TOTALS,UKRAINE,200,25,61,41.0,16,37,43.2,9,24,37.5,15,20,75.0,13,25,38,12,18,20,5,2,74,0
3311,78142,111_06_01,TURKEY,0,TOTALS,TURKEY,200,34,73,46.6,25,52,48.1,9,21,42.9,10,14,71.4,13,25,38,14,16,13,13,4,87,1
3312,78155,111_06_02,GERMANY,0,TOTALS,GERMANY,200,24,62,38.7,17,42,40.5,7,20,35.0,3,6,50.0,12,29,41,11,24,18,6,5,58,0
3313,78168,111_06_02,ITALY,0,TOTALS,ITALY,200,22,59,37.3,17,41,41.5,5,18,27.8,13,22,59.1,9,26,35,8,19,12,9,2,62,1
3314,78181,111_06_03,LATVIA,0,TOTALS,LATVIA,200,23,74,31.1,17,53,32.1,6,21,28.6,15,17,88.2,13,24,37,6,26,12,9,4,67,0
3315,78194,111_06_03,LITHUANIA,0,TOTALS,LITHUANIA,200,33,72,45.8,29,50,58.0,4,22,18.2,15,29,51.7,21,37,58,15,16,16,7,6,85,1
3316,78207,111_06_04,ISRAEL,0,TOTALS,ISRAEL,225,29,62,46.8,25,45,55.6,4,17,23.5,20,32,62.5,11,27,38,10,28,13,4,3,82,1
3317,78220,111_06_04,BULGARIA,0,TOTALS,BULGARIA,225,25,74,33.8,17,44,38.6,8,30,26.7,23,35,65.7,23,27,50,7,28,13,5,2,81,0
3318,78233,111_06_05,GREECE,0,TOTALS,GREECE,200,19,53,35.8,9,35,25.7,10,18,55.6,10,16,62.5,10,18,28,7,22,17,7,4,58,0
3319,78246,111_06_05,SERBIA & MONTENEGRO,0,TOTALS,SERBIA & MONTENEGRO,200,31,56,55.4,26,40,65.0,5,16,31.2,16,22,72.7,10,25,35,15,20,12,9,2,83,1
3320,78259,111_06_06,ICELAND,0,TOTALS,ICELAND,200,18,55,32.7,12,32,37.5,6,23,26.1,13,23,56.5,6,25,31,8,18,17,6,0,55,0
3321,78272,111_06_06,SPAIN,0,TOTALS,SPAIN,200,39,75,52.0,31,51,60.8,8,24,33.3,12,18,66.7,9,34,43,16,19,10,15,4,98,1
3322,78285,111_06_07,RUSSIA,0,TOTALS,RUSSIA,200,30,59,50.8,20,39,51.3,10,20,50.0,13,17,76.5,6,36,42,12,19,13,8,15,83,1
3323,78298,111_06_07,SLOVENIA,0,TOTALS,SLOVENIA,200,17,63,27.0,10,43,23.3,7,20,35.0,12,16,75.0,11,23,34,7,18,13,3,1,53,0
3324,78311,111_06_08,FRANCE,0,TOTALS,FRANCE,200,39,65,60.0,35,52,67.3,4,13,30.8,8,16,50.0,7,35,42,14,16,9,9,3,90,1
3325,78324,111_06_08,CROATIA,0,TOTALS,CROATIA,200,19,58,32.8,14,32,43.8,5,26,19.2,13,20,65.0,9,21,30,8,19,11,5,1,56,0
3326,78337,111_06_09,LITHUANIA,0,TOTALS,LITHUANIA,200,37,76,48.7,30,59,50.8,7,17,41.2,20,31,64.5,19,35,54,23,29,16,7,3,101,0
3327,78350,111_06_09,UKRAINE,0,TOTALS,UKRAINE,200,20,61,32.8,17,42,40.5,3,19,15.8,24,39,61.5,11,18,29,6,27,11,12,1,67,1
3328,78363,111_06_10,BULGARIA,0,TOTALS,BULGARIA,200,29,69,42.0,18,44,40.9,11,25,44.0,17,23,73.9,13,23,36,13,22,13,14,0,86,1
3329,78376,111_06_10,GERMANY,0,TOTALS,GERMANY,200,29,61,47.5,26,44,59.1,3,17,17.6,10,15,66.7,12,31,43,8,22,22,4,4,71,0
3330,78389,111_06_11,TURKEY,0,TOTALS,TURKEY,200,21,60,35.0,16,32,50.0,5,28,17.9,24,32,75.0,6,24,30,11,16,13,16,3,71,1
3331,78402,111_06_11,LATVIA,0,TOTALS,LATVIA,200,24,66,36.4,18,41,43.9,6,25,24.0,13,19,68.4,14,31,45,9,25,26,5,3,67,0
3332,78415,111_06_12,ITALY,0,TOTALS,ITALY,200,29,58,50.0,21,40,52.5,8,18,44.4,29,37,78.4,11,33,44,8,23,14,7,2,95,1
3333,78428,111_06_12,ISRAEL,0,TOTALS,ISRAEL,200,22,62,35.5,19,48,39.6,3,14,21.4,16,21,76.2,10,20,30,11,32,16,7,2,63,0
3334,78441,111_06_13,SLOVENIA,0,TOTALS,SLOVENIA,200,20,50,40.0,18,40,45.0,2,10,20.0,9,18,50.0,11,22,33,8,20,19,6,1,51,0
3335,78454,111_06_13,GREECE,0,TOTALS,GREECE,200,25,67,37.3,22,48,45.8,3,19,15.8,13,21,61.9,23,21,44,12,18,15,9,4,66,1
3336,78467,111_06_14,CROATIA,0,TOTALS,CROATIA,200,33,82,40.2,22,58,37.9,11,24,45.8,12,18,66.7,30,34,64,11,20,17,9,6,89,1
3337,78480,111_06_14,ICELAND,0,TOTALS,ICELAND,200,21,67,31.3,18,46,39.1,3,21,14.3,10,17,58.8,14,24,38,6,20,19,10,1,55,0
3338,78493,111_06_15,SERBIA & MONTENEGRO,0,TOTALS,SERBIA & MONTENEGRO,200,30,60,50.0,28,53,52.8,2,7,28.6,16,26,61.5,14,21,35,18,22,23,15,0,78,1
3339,78506,111_06_15,RUSSIA,0,TOTALS,RUSSIA,200,22,50,44.0,17,33,51.5,5,17,29.4,14,21,66.7,9,20,29,7,24,31,13,6,63,0
3340,78519,111_06_16,SPAIN,0,TOTALS,SPAIN,200,35,63,55.6,28,45,62.2,7,18,38.9,17,25,68.0,7,24,31,11,22,15,11,4,94,1
3341,78532,111_06_16,FRANCE,0,TOTALS,FRANCE,200,32,75,42.7,27,58,46.6,5,17,29.4,16,23,69.6,21,23,44,12,26,17,6,4,85,0
3342,78545,111_06_17,LITHUANIA,0,TOTALS,LITHUANIA,200,23,52,44.2,17,37,45.9,6,15,40.0,18,29,62.1,10,33,43,14,19,17,3,5,70,1
3343,78557,111_06_17,TURKEY,0,TOTALS,TURKEY,200,18,61,29.5,14,45,31.1,4,16,25.0,15,23,65.2,14,24,38,10,24,14,12,4,55,0
3344,78570,111_06_18,BULGARIA,0,TOTALS,BULGARIA,225,28,62,45.2,18,32,56.2,10,30,33.3,26,32,81.2,10,30,40,10,23,17,10,1,92,1
3345,78583,111_06_18,ITALY,0,TOTALS,ITALY,225,29,77,37.7,22,48,45.8,7,29,24.1,16,19,84.2,19,27,46,10,28,13,10,2,81,0
3346,78596,111_06_19,UKRAINE,0,TOTALS,UKRAINE,200,31,59,52.5,25,41,61.0,6,18,33.3,25,35,71.4,7,16,23,11,19,23,15,4,93,1
3347,78609,111_06_19,LATVIA,0,TOTALS,LATVIA,200,40,72,55.6,29,52,55.8,11,20,55.0,10,13,76.9,17,22,39,14,28,33,10,2,101,0
3348,78622,111_06_20,GERMANY,0,TOTALS,GERMANY,200,28,65,43.1,23,51,45.1,5,14,35.7,15,24,62.5,12,38,50,11,21,28,7,5,76,0
3349,78635,111_06_20,ISRAEL,0,TOTALS,ISRAEL,200,27,68,39.7,21,52,40.4,6,16,37.5,19,23,82.6,5,27,32,15,24,15,13,6,79,1
3350,78648,111_06_21,GREECE,0,TOTALS,GREECE,200,25,61,41.0,17,39,43.6,8,22,36.4,18,27,66.7,11,22,33,20,29,11,7,2,76,1
3351,78661,111_06_21,RUSSIA,0,TOTALS,RUSSIA,200,25,55,45.5,19,36,52.8,6,19,31.6,15,29,51.7,11,22,33,13,29,16,3,3,71,0
3352,78674,111_06_22,CROATIA,0,TOTALS,CROATIA,200,26,61,42.6,19,36,52.8,7,25,28.0,8,9,88.9,11,19,30,14,22,16,10,3,67,0
3353,78687,111_06_22,SPAIN,0,TOTALS,SPAIN,200,28,57,49.1,24,42,57.1,4,15,26.7,13,21,61.9,11,24,35,12,12,20,11,3,73,1
3354,78700,111_06_23,SLOVENIA,0,TOTALS,SLOVENIA,200,23,71,32.4,16,47,34.0,7,24,29.2,6,7,85.7,11,10,21,12,24,18,11,4,59,0
3355,78713,111_06_23,SERBIA & MONTENEGRO,0,TOTALS,SERBIA & MONTENEGRO,200,35,61,57.4,32,52,61.5,3,9,33.3,17,25,68.0,17,34,51,19,14,26,11,4,90,1
3356,78726,111_06_24,ICELAND,0,TOTALS,ICELAND,200,27,66,40.9,17,33,51.5,10,33,30.3,9,10,90.0,11,31,42,14,20,21,5,3,73,1
3357,78739,111_06_24,FRANCE,0,TOTALS,FRANCE,200,23,66,34.8,22,54,40.7,1,12,8.3,14,24,58.3,16,27,43,3,19,18,9,3,61,0
3358,78752,111_06_25,SLOVENIA,0,TOTALS,SLOVENIA,200,24,57,42.1,16,41,39.0,8,16,50.0,13,24,54.2,12,26,38,8,19,13,3,3,69,1
3359,78765,111_06_25,ISRAEL,0,TOTALS,ISRAEL,200,24,55,43.6,23,45,51.1,1,10,10.0,9,17,52.9,6,25,31,7,23,11,3,2,58,0
3360,78778,111_06_26,TURKEY,0,TOTALS,TURKEY,200,23,69,33.3,19,42,45.2,4,27,14.8,9,11,81.8,21,20,41,8,30,14,8,2,59,0
3361,78791,111_06_26,SPAIN,0,TOTALS,SPAIN,200,27,63,42.9,21,45,46.7,6,18,33.3,21,37,56.8,27,24,51,16,12,16,5,6,81,1
3362,78804,111_06_27,UKRAINE,0,TOTALS,UKRAINE,200,24,66,36.4,19,43,44.2,5,23,21.7,15,27,55.6,13,27,40,10,17,15,13,1,68,0
3363,78817,111_06_27,CROATIA,0,TOTALS,CROATIA,200,27,65,41.5,22,47,46.8,5,18,27.8,11,18,61.1,11,33,44,10,22,20,7,2,70,1
3364,78830,111_06_28,LITHUANIA,0,TOTALS,LITHUANIA,200,29,67,43.3,15,35,42.9,14,32,43.8,8,14,57.1,17,22,39,14,19,15,7,5,80,1
3365,78843,111_06_28,FRANCE,0,TOTALS,FRANCE,200,28,73,38.4,26,63,41.3,2,10,20.0,15,24,62.5,23,24,47,13,18,16,11,2,73,0
3366,78856,111_06_29,GREECE,0,TOTALS,GREECE,200,22,48,45.8,17,35,48.6,5,13,38.5,24,38,63.2,10,26,36,14,18,12,6,4,73,1
3367,78869,111_06_29,ITALY,0,TOTALS,ITALY,200,27,65,41.5,19,40,47.5,8,25,32.0,8,16,50.0,15,23,38,11,27,10,5,0,70,0
3368,78882,111_06_30,LATVIA,0,TOTALS,LATVIA,200,33,72,45.8,23,45,51.1,10,27,37.0,22,33,66.7,11,31,42,21,20,14,14,3,98,1
3369,78895,111_06_30,ICELAND,0,TOTALS,ICELAND,200,30,64,46.9,24,42,57.1,6,22,27.3,12,13,92.3,3,30,33,19,24,25,6,2,78,0
3370,78908,111_06_31,RUSSIA,0,TOTALS,RUSSIA,200,28,60,46.7,22,40,55.0,6,20,30.0,18,31,58.1,11,25,36,14,16,20,8,4,80,1
3371,78921,111_06_31,GERMANY,0,TOTALS,GERMANY,200,32,71,45.1,25,51,49.0,7,20,35.0,5,12,41.7,15,26,41,15,28,21,8,4,76,0
3372,78934,111_06_32,SERBIA & MONTENEGRO,0,TOTALS,SERBIA & MONTENEGRO,200,38,65,58.5,31,51,60.8,7,14,50.0,10,17,58.8,15,26,41,20,23,24,10,1,93,1
3373,78947,111_06_32,BULGARIA,0,TOTALS,BULGARIA,200,30,56,53.6,22,36,61.1,8,20,40.0,14,23,60.9,5,17,22,11,18,22,11,1,82,0
3374,78960,111_06_33,ISRAEL,0,TOTALS,ISRAEL,200,34,67,50.7,30,50,60.0,4,17,23.5,16,30,53.3,9,26,35,17,25,12,9,4,88,1
3375,78973,111_06_33,LATVIA,0,TOTALS,LATVIA,200,28,65,43.1,21,46,45.7,7,19,36.8,19,28,67.9,15,29,44,11,26,17,4,1,82,0
3376,78986,111_06_34,ITALY,0,TOTALS,ITALY,200,28,64,43.8,19,47,40.4,9,17,52.9,6,10,60.0,9,14,23,12,29,13,6,5,71,0
3377,78999,111_06_34,LITHUANIA,0,TOTALS,LITHUANIA,200,30,62,48.4,23,45,51.1,7,17,41.2,21,35,60.0,24,27,51,12,16,15,7,5,88,1
3378,79012,111_06_35,ICELAND,0,TOTALS,ICELAND,200,32,62,51.6,23,36,63.9,9,26,34.6,10,14,71.4,9,24,33,17,14,20,7,2,83,1
3379,79025,111_06_35,SLOVENIA,0,TOTALS,SLOVENIA,200,27,66,40.9,23,49,46.9,4,17,23.5,7,13,53.8,15,21,36,10,21,20,11,0,65,0
3380,79038,111_06_36,BULGARIA,0,TOTALS,BULGARIA,200,23,52,44.2,16,32,50.0,7,20,35.0,7,15,46.7,3,15,18,10,13,27,15,3,60,0
3381,79051,111_06_36,TURKEY,0,TOTALS,TURKEY,200,32,64,50.0,28,49,57.1,4,15,26.7,10,12,83.3,18,30,48,17,18,30,18,2,78,1
3382,79064,111_06_37,GERMANY,0,TOTALS,GERMANY,200,21,60,35.0,19,46,41.3,2,14,14.3,14,15,93.3,13,28,41,6,21,23,5,5,58,0
3383,79077,111_06_37,UKRAINE,0,TOTALS,UKRAINE,200,24,65,36.9,20,45,44.4,4,20,20.0,20,27,74.1,14,22,36,7,17,11,12,1,72,1
3384,79090,111_06_38,FRANCE,0,TOTALS,FRANCE,200,30,73,41.1,26,59,44.1,4,14,28.6,22,29,75.9,29,36,65,13,19,18,10,5,86,1
3385,79103,111_06_38,GREECE,0,TOTALS,GREECE,200,16,56,28.6,13,33,39.4,3,23,13.0,8,19,42.1,9,16,25,7,22,17,12,3,43,0
3386,79116,111_06_39,CROATIA,0,TOTALS,CROATIA,200,24,63,38.1,15,36,41.7,9,27,33.3,14,25,56.0,12,28,40,10,25,8,2,0,71,0
3387,79129,111_06_39,RUSSIA,0,TOTALS,RUSSIA,200,28,62,45.2,21,42,50.0,7,20,35.0,11,24,45.8,12,28,40,15,22,6,3,4,74,1
3388,79142,111_06_40,SPAIN,0,TOTALS,SPAIN,200,25,55,45.5,21,41,51.2,4,14,28.6,27,38,71.1,6,26,32,11,26,13,9,5,81,1
3389,79155,111_06_40,SERBIA & MONTENEGRO,0,TOTALS,SERBIA & MONTENEGRO,200,27,64,42.2,23,46,50.0,4,18,22.2,19,26,73.1,12,26,38,16,32,15,2,2,77,0
3390,79168,111_06_41,LATVIA,0,TOTALS,LATVIA,200,27,58,46.6,16,37,43.2,11,21,52.4,11,15,73.3,14,25,39,12,17,18,4,7,76,1
3391,79181,111_06_41,SLOVENIA,0,TOTALS,SLOVENIA,200,24,60,40.0,22,46,47.8,2,14,14.3,16,19,84.2,12,19,31,9,19,13,11,4,66,0
3392,79194,111_06_42,ITALY,0,TOTALS,ITALY,200,30,75,40.0,23,53,43.4,7,22,31.8,5,8,62.5,15,16,31,11,21,13,9,0,72,0
3393,79207,111_06_42,FRANCE,0,TOTALS,FRANCE,200,33,65,50.8,30,52,57.7,3,13,23.1,13,21,61.9,19,32,51,14,17,22,6,5,82,1
3394,79220,111_06_43,ISRAEL,0,TOTALS,ISRAEL,200,37,72,51.4,36,58,62.1,1,14,7.1,11,18,61.1,7,36,43,9,26,18,14,5,86,1
3395,79233,111_06_43,ICELAND,0,TOTALS,ICELAND,200,22,59,37.3,13,30,43.3,9,29,31.0,14,31,45.2,7,29,36,11,17,22,10,1,67,0
3396,79246,111_06_44,BULGARIA,0,TOTALS,BULGARIA,200,18,61,29.5,14,37,37.8,4,24,16.7,9,10,90.0,11,28,39,7,26,25,8,0,49,0
3397,79259,111_06_44,SPAIN,0,TOTALS,SPAIN,200,35,73,47.9,31,52,59.6,4,21,19.0,15,23,65.2,13,32,45,15,14,12,12,6,89,1
3398,79272,111_06_45,UKRAINE,0,TOTALS,UKRAINE,200,29,64,45.3,23,41,56.1,6,23,26.1,14,21,66.7,8,20,28,13,21,19,17,3,78,0
3399,79285,111_06_45,RUSSIA,0,TOTALS,RUSSIA,200,37,60,61.7,30,46,65.2,7,14,50.0,14,29,48.3,9,31,40,14,19,27,11,4,95,1
3400,79298,111_06_46,TURKEY,0,TOTALS,TURKEY,200,20,58,34.5,9,31,29.0,11,27,40.7,12,18,66.7,8,26,34,11,23,10,7,2,63,1
3401,79311,111_06_46,SERBIA & MONTENEGRO,0,TOTALS,SERBIA & MONTENEGRO,200,21,57,36.8,15,42,35.7,6,15,40.0,10,21,47.6,9,30,39,11,16,16,3,3,58,0
3402,79324,111_06_47,GERMANY,0,TOTALS,GERMANY,200,21,59,35.6,17,39,43.6,4,20,20.0,6,10,60.0,11,22,33,8,22,14,8,2,52,0
3403,79337,111_06_47,CROATIA,0,TOTALS,CROATIA,200,19,54,35.2,11,27,40.7,8,27,29.6,18,24,75.0,18,28,46,12,16,14,4,1,64,1
3404,79350,111_06_48,LITHUANIA,0,TOTALS,LITHUANIA,200,30,72,41.7,19,43,44.2,11,29,37.9,13,25,52.0,19,25,44,21,21,10,7,3,84,1
3405,79363,111_06_48,GREECE,0,TOTALS,GREECE,200,23,55,41.8,20,41,48.8,3,14,21.4,16,27,59.3,11,29,40,9,23,14,7,7,65,0
3406,79376,111_06_49,ICELAND,0,TOTALS,ICELAND,200,18,62,29.0,13,30,43.3,5,32,15.6,22,26,84.6,10,26,36,9,24,18,7,2,63,0
3407,79389,111_06_49,GERMANY,0,TOTALS,GERMANY,200,33,75,44.0,29,56,51.8,4,19,21.1,22,27,81.5,18,36,54,11,29,17,12,2,92,1
3408,79402,111_06_50,ITALY,0,TOTALS,ITALY,200,25,57,43.9,14,31,45.2,11,26,42.3,24,31,77.4,8,13,21,15,30,15,9,1,85,1
3409,79415,111_06_50,SERBIA & MONTENEGRO,0,TOTALS,SERBIA & MONTENEGRO,200,33,54,61.1,27,44,61.4,6,10,60.0,29,36,80.6,10,23,33,18,28,18,7,0,101,0
3410,79428,111_06_51,SLOVENIA,0,TOTALS,SLOVENIA,200,20,52,38.5,17,42,40.5,3,10,30.0,8,18,44.4,6,28,34,2,20,16,12,5,51,1
3411,79441,111_06_51,UKRAINE,0,TOTALS,UKRAINE,200,18,59,30.5,11,36,30.6,7,23,30.4,7,14,50.0,18,26,44,7,20,22,5,1,50,0
3412,79454,111_06_52,GREECE,0,TOTALS,GREECE,200,29,63,46.0,24,45,53.3,5,18,27.8,8,13,61.5,20,22,42,17,17,16,7,1,71,1
3413,79467,111_06_52,BULGARIA,0,TOTALS,BULGARIA,200,22,46,47.8,13,20,65.0,9,26,34.6,16,22,72.7,7,17,24,16,18,16,13,2,69,0
3414,79480,111_06_53,ISRAEL,0,TOTALS,ISRAEL,200,36,80,45.0,33,65,50.8,3,15,20.0,7,10,70.0,11,20,31,13,22,7,18,3,82,0
3415,79493,111_06_53,CROATIA,0,TOTALS,CROATIA,200,36,69,52.2,31,50,62.0,5,19,26.3,16,25,64.0,15,34,49,18,12,20,2,4,93,1
3416,79506,111_06_54,LITHUANIA,0,TOTALS,LITHUANIA,200,27,53,50.9,16,33,48.5,11,20,55.0,22,32,68.8,9,37,46,21,24,17,2,8,87,1
3417,79519,111_06_54,TURKEY,0,TOTALS,TURKEY,200,31,79,39.2,24,58,41.4,7,21,33.3,11,21,52.4,15,20,35,14,24,6,13,1,80,0
3418,79532,111_06_55,LATVIA,0,TOTALS,LATVIA,200,30,77,39.0,25,54,46.3,5,23,21.7,20,25,80.0,18,21,39,12,21,17,12,2,85,0
3419,79545,111_06_55,RUSSIA,0,TOTALS,RUSSIA,200,29,55,52.7,20,36,55.6,9,19,47.4,20,29,69.0,8,26,34,13,23,21,5,9,87,1
3420,79558,111_06_56,FRANCE,0,TOTALS,FRANCE,200,30,66,45.5,23,44,52.3,7,22,31.8,13,23,56.5,14,37,51,10,29,20,4,2,80,1
3421,79571,111_06_56,SPAIN,0,TOTALS,SPAIN,200,21,65,32.3,15,37,40.5,6,28,21.4,19,33,57.6,14,24,38,11,22,11,11,3,67,0
3422,79584,111_06_57,ICELAND,0,TOTALS,ICELAND,200,39,61,63.9,27,40,67.5,12,21,57.1,12,16,75.0,9,26,35,19,26,24,5,1,102,0
3423,79597,111_06_57,UKRAINE,0,TOTALS,UKRAINE,200,29,76,38.2,23,51,45.1,6,25,24.0,22,30,73.3,11,15,26,10,21,13,13,4,86,1
3424,79610,111_06_58,GERMANY,0,TOTALS,GERMANY,200,29,52,55.8,23,35,65.7,6,17,35.3,14,25,56.0,7,27,34,11,19,15,11,4,78,1
3425,79623,111_06_58,SLOVENIA,0,TOTALS,SLOVENIA,200,26,61,42.6,21,44,47.7,5,17,29.4,6,15,40.0,13,19,32,9,23,17,10,1,63,0
3426,79636,111_06_59,ISRAEL,0,TOTALS,ISRAEL,200,37,82,45.1,34,66,51.5,3,16,18.8,25,36,69.4,18,23,41,13,35,17,13,3,102,0
3427,79649,111_06_59,LATVIA,0,TOTALS,LATVIA,200,26,67,38.8,20,41,48.8,6,26,23.1,36,55,65.5,20,29,49,7,24,27,10,4,94,1
3428,79662,111_06_60,BULGARIA,0,TOTALS,BULGARIA,200,30,76,39.5,27,56,48.2,3,20,15.0,13,16,81.2,18,31,49,13,21,16,10,2,76,0
3429,79675,111_06_60,ITALY,0,TOTALS,ITALY,200,28,71,39.4,18,46,39.1,10,25,40.0,11,16,68.8,12,30,42,11,21,17,7,1,77,1
3430,79688,111_06_61,CROATIA,0,TOTALS,CROATIA,200,31,76,40.8,23,50,46.0,8,26,30.8,12,22,54.5,18,26,44,13,23,9,6,2,82,0
3431,79701,111_06_61,RUSSIA,0,TOTALS,RUSSIA,200,31,67,46.3,21,47,44.7,10,20,50.0,13,18,72.2,10,26,36,12,15,11,4,0,85,1
3432,79714,111_06_62,GREECE,0,TOTALS,GREECE,200,22,57,38.6,20,44,45.5,2,13,15.4,3,5,60.0,8,24,32,11,23,25,12,2,49,0
3433,79727,111_06_62,SERBIA & MONTENEGRO,0,TOTALS,SERBIA & MONTENEGRO,200,26,56,46.4,20,39,51.3,6,17,35.3,17,28,60.7,14,28,42,15,14,20,12,3,75,1
3434,79740,111_06_63,TURKEY,0,TOTALS,TURKEY,200,28,72,38.9,18,42,42.9,10,30,33.3,17,22,77.3,15,17,32,18,29,8,7,2,83,0
3435,79753,111_06_63,SPAIN,0,TOTALS,SPAIN,200,32,58,55.2,28,45,62.2,4,13,30.8,24,38,63.2,14,32,46,13,22,15,5,6,92,1
3436,79766,111_06_64,LITHUANIA,0,TOTALS,LITHUANIA,200,28,71,39.4,19,49,38.8,9,22,40.9,7,12,58.3,14,20,34,17,13,13,9,5,72,0
3437,79779,111_06_64,FRANCE,0,TOTALS,FRANCE,200,30,74,40.5,27,57,47.4,3,17,17.6,14,19,73.7,22,31,53,12,15,14,8,8,77,1
3438,79792,112_06_01,IRELAND,0,TOTALS,IRELAND,225,26,81,32.1,20,50,40.0,6,31,19.4,24,40,60.0,23,26,49,5,25,20,21,2,82,1
3439,79804,112_06_01,MOLDOVA,0,TOTALS,MOLDOVA,225,27,69,39.1,24,56,42.9,3,13,23.1,18,28,64.3,19,40,59,6,26,32,15,1,75,0
3440,79817,112_06_02,CZECH REPUBLIC,0,TOTALS,CZECH REPUBLIC,200,21,52,40.4,18,37,48.6,3,15,20.0,17,36,47.2,12,37,49,8,20,33,12,8,62,1
3441,79830,112_06_02,NORWAY,0,TOTALS,NORWAY,200,23,74,31.1,17,47,36.2,6,27,22.2,7,14,50.0,17,27,44,4,27,24,18,0,59,0
3442,79843,112_06_03,SLOVAK REPUBLIC,0,TOTALS,SLOVAK REPUBLIC,200,13,54,24.1,11,34,32.4,2,20,10.0,11,17,64.7,9,28,37,4,22,16,3,3,39,0
3443,79856,112_06_03,POLAND,0,TOTALS,POLAND,200,25,70,35.7,16,39,41.0,9,31,29.0,15,22,68.2,17,31,48,2,19,12,10,0,74,1
3444,79869,112_06_04,SWEDEN,0,TOTALS,SWEDEN,200,28,58,48.3,18,38,47.4,10,20,50.0,19,25,76.0,6,24,30,12,15,19,11,6,85,1
3445,79882,112_06_04,BELGIUM,0,TOTALS,BELGIUM,200,27,72,37.5,19,48,39.6,8,24,33.3,6,10,60.0,18,29,47,14,22,23,6,3,68,0
3446,79895,112_06_05,ROMANIA,0,TOTALS,ROMANIA,200,32,63,50.8,24,41,58.5,8,22,36.4,13,20,65.0,11,30,41,11,24,21,10,2,85,1
3447,79908,112_06_05,SCOTLAND,0,TOTALS,SCOTLAND,200,14,50,28.0,14,39,35.9,0,11,0.0,18,27,66.7,8,22,30,2,23,18,10,2,46,0
3448,79921,112_06_06,ESTONIA,0,TOTALS,ESTONIA,200,22,56,39.3,14,35,40.0,8,21,38.1,17,30,56.7,14,29,43,5,22,23,12,0,69,1
3449,79934,112_06_06,HUNGARY,0,TOTALS,HUNGARY,200,21,54,38.9,12,33,36.4,9,21,42.9,16,28,57.1,7,26,33,5,30,19,17,0,67,0
3450,79947,112_06_07,AUSTRIA,0,TOTALS,AUSTRIA,200,23,65,35.4,19,46,41.3,4,19,21.1,13,24,54.2,16,26,42,4,22,13,12,1,63,1
3451,79960,112_06_07,SLOVAK REPUBLIC,0,TOTALS,SLOVAK REPUBLIC,200,22,60,36.7,18,44,40.9,4,16,25.0,12,21,57.1,15,31,46,1,21,18,10,2,60,0
3452,79973,112_06_08,BOSNIA AND HERZEGOVINA,0,TOTALS,BOSNIA AND HERZEGOVINA,200,26,66,39.4,18,43,41.9,8,23,34.8,22,29,75.9,13,35,48,1,29,15,8,2,82,1
3453,79986,112_06_08,ESTONIA,0,TOTALS,ESTONIA,200,26,61,42.6,18,39,46.2,8,22,36.4,16,30,53.3,7,26,33,2,27,10,5,1,76,0
3454,79999,112_06_09,NETHERLANDS,0,TOTALS,NETHERLANDS,200,22,66,33.3,18,52,34.6,4,14,28.6,12,21,57.1,16,22,38,4,21,14,9,1,60,0
3455,80012,112_06_09,SWEDEN,0,TOTALS,SWEDEN,200,25,61,41.0,21,42,50.0,4,19,21.1,12,24,50.0,14,29,43,7,20,17,10,1,66,1
3456,80025,112_06_10,HUNGARY,0,TOTALS,HUNGARY,200,17,52,32.7,8,30,26.7,9,22,40.9,8,14,57.1,6,26,32,4,23,16,8,4,51,0
3457,80038,112_06_10,ROMANIA,0,TOTALS,ROMANIA,200,27,61,44.3,25,48,52.1,2,13,15.4,9,29,31.0,19,30,49,16,17,15,10,2,65,1
3458,80051,112_06_11,BELGIUM,0,TOTALS,BELGIUM,200,26,62,41.9,20,42,47.6,6,20,30.0,9,17,52.9,17,27,44,6,21,25,8,2,67,1
3459,80064,112_06_11,CZECH REPUBLIC,0,TOTALS,CZECH REPUBLIC,200,23,56,41.1,19,35,54.3,4,21,19.0,13,21,61.9,10,22,32,5,19,16,10,2,63,0
3460,80077,112_06_12,POLAND,0,TOTALS,POLAND,200,33,65,50.8,24,39,61.5,9,26,34.6,12,18,66.7,18,26,44,11,16,18,2,1,87,1
3461,80090,112_06_12,IRELAND,0,TOTALS,IRELAND,200,25,67,37.3,15,34,44.1,10,33,30.3,12,16,75.0,15,20,35,5,23,14,8,0,72,0
3462,80103,112_06_13,PORTUGAL,0,TOTALS,PORTUGAL,200,25,65,38.5,20,49,40.8,5,16,31.2,18,27,66.7,20,39,59,7,17,24,13,5,73,1
3463,80115,112_06_13,LUXEMBOURG,0,TOTALS,LUXEMBOURG,200,17,64,26.6,11,41,26.8,6,23,26.1,11,16,68.8,10,25,35,1,25,19,10,2,51,0
3464,80128,112_06_14,SCOTLAND,0,TOTALS,SCOTLAND,200,15,52,28.8,13,42,31.0,2,10,20.0,14,28,50.0,10,32,42,2,25,24,5,5,46,0
3465,80141,112_06_14,HUNGARY,0,TOTALS,HUNGARY,200,28,65,43.1,22,45,48.9,6,20,30.0,14,30,46.7,12,29,41,9,26,13,13,7,76,1
3466,80154,112_06_15,ENGLAND,0,TOTALS,ENGLAND,200,19,58,32.8,12,39,30.8,7,19,36.8,23,33,69.7,19,32,51,4,20,23,7,4,68,1
3467,80166,112_06_15,FINLAND,0,TOTALS,FINLAND,200,21,65,32.3,12,38,31.6,9,27,33.3,6,13,46.2,13,22,35,3,28,17,9,2,57,0
3468,80179,112_06_16,CZECH REPUBLIC,0,TOTALS,CZECH REPUBLIC,200,25,49,51.0,21,39,53.8,4,10,40.0,13,17,76.5,6,25,31,1,21,20,5,4,67,0
3469,80192,112_06_16,NETHERLANDS,0,TOTALS,NETHERLANDS,200,29,72,40.3,21,55,38.2,8,17,47.1,12,24,50.0,22,20,42,7,23,11,12,2,78,1
3470,80204,112_06_17,MOLDOVA,0,TOTALS,MOLDOVA,200,20,60,33.3,16,45,35.6,4,15,26.7,8,17,47.1,17,24,41,8,21,24,9,0,52,0
3471,80217,112_06_17,POLAND,0,TOTALS,POLAND,200,24,57,42.1,16,28,57.1,8,29,27.6,15,21,71.4,10,26,36,13,17,16,10,3,71,1
3472,80230,112_06_18,ROMANIA,0,TOTALS,ROMANIA,200,25,57,43.9,17,40,42.5,8,17,47.1,20,34,58.8,15,30,45,11,24,15,6,4,78,1
3473,80243,112_06_18,BOSNIA AND HERZEGOVINA,0,TOTALS,BOSNIA AND HERZEGOVINA,200,22,65,33.8,17,39,43.6,5,26,19.2,20,28,71.4,16,24,40,6,27,13,13,4,69,0
3474,80256,112_06_19,IRELAND,0,TOTALS,IRELAND,200,26,76,34.2,16,42,38.1,10,34,29.4,8,9,88.9,16,28,44,16,20,15,11,0,70,0
3475,80269,112_06_19,AUSTRIA,0,TOTALS,AUSTRIA,200,31,68,45.6,24,44,54.5,7,24,29.2,9,19,47.4,12,33,45,12,7,16,8,8,78,1
3476,80282,112_06_20,NORWAY,0,TOTALS,NORWAY,200,15,51,29.4,11,32,34.4,4,19,21.1,8,21,38.1,8,18,26,0,13,20,13,3,42,0
3477,80295,112_06_20,BELGIUM,0,TOTALS,BELGIUM,200,37,79,46.8,32,57,56.1,5,22,22.7,1,2,50.0,24,36,60,1,18,19,6,1,80,1
3478,80308,112_06_21,SWEDEN,0,TOTALS,SWEDEN,200,24,56,42.9,21,43,48.8,3,13,23.1,18,30,60.0,10,29,39,4,22,20,9,3,69,1
3479,80321,112_06_21,CZECH REPUBLIC,0,TOTALS,CZECH REPUBLIC,200,22,60,36.7,22,45,48.9,0,15,0.0,15,24,62.5,12,25,37,5,29,21,7,2,59,0
3480,80334,112_06_22,BOSNIA AND HERZEGOVINA,0,TOTALS,BOSNIA AND HERZEGOVINA,200,27,57,47.4,21,34,61.8,6,23,26.1,21,37,56.8,12,29,41,4,23,19,18,2,81,1
3481,80347,112_06_22,SCOTLAND,0,TOTALS,SCOTLAND,200,19,60,31.7,16,33,48.5,3,27,11.1,12,19,63.2,15,27,42,0,28,30,5,2,53,0
3482,80359,112_06_23,LUXEMBOURG,0,TOTALS,LUXEMBOURG,200,20,66,30.3,13,40,32.5,7,26,26.9,7,12,58.3,6,17,23,8,22,12,7,1,54,0
3483,80372,112_06_23,ENGLAND,0,TOTALS,ENGLAND,200,30,57,52.6,28,50,56.0,2,7,28.6,9,25,36.0,16,42,58,17,17,26,5,8,71,1
3484,80385,112_06_24,AUSTRIA,0,TOTALS,AUSTRIA,225,23,72,31.9,15,38,39.5,8,34,23.5,16,22,72.7,15,27,42,1,21,17,15,2,70,1
3485,80397,112_06_24,MOLDOVA,0,TOTALS,MOLDOVA,225,22,73,30.1,16,44,36.4,6,29,20.7,13,18,72.2,23,33,56,6,26,26,14,2,63,0
3486,80410,112_06_25,NETHERLANDS,0,TOTALS,NETHERLANDS,200,28,55,50.9,25,48,52.1,3,7,42.9,8,18,44.4,11,33,44,6,11,24,4,2,67,1
3487,80423,112_06_25,NORWAY,0,TOTALS,NORWAY,200,20,61,32.8,18,42,42.9,2,19,10.5,8,11,72.7,9,20,29,3,19,16,12,0,50,0
3488,80436,112_06_26,ESTONIA,0,TOTALS,ESTONIA,200,21,55,38.2,17,37,45.9,4,18,22.2,17,21,81.0,10,26,36,8,20,19,9,0,63,1
3489,80449,112_06_26,ROMANIA,0,TOTALS,ROMANIA,200,23,62,37.1,20,37,54.1,3,25,12.0,10,18,55.6,15,25,40,9,21,19,5,4,59,0
3490,80461,112_06_27,FINLAND,0,TOTALS,FINLAND,200,26,80,32.5,14,48,29.2,12,32,37.5,8,15,53.3,17,26,43,11,25,10,6,2,72,0
3491,80474,112_06_27,PORTUGAL,0,TOTALS,PORTUGAL,200,26,64,40.6,16,39,41.0,10,25,40.0,17,27,63.0,13,36,49,14,19,14,5,8,79,1
3492,80487,112_06_28,SLOVAK REPUBLIC,0,TOTALS,SLOVAK REPUBLIC,200,33,74,44.6,27,51,52.9,6,23,26.1,16,21,76.2,20,34,54,4,19,17,6,3,88,1
3493,80500,112_06_28,IRELAND,0,TOTALS,IRELAND,200,20,60,33.3,16,37,43.2,4,23,17.4,19,28,67.9,9,21,30,3,19,18,5,0,63,0
3494,80513,112_06_29,POLAND,0,TOTALS,POLAND,200,28,65,43.1,21,40,52.5,7,25,28.0,7,16,43.8,13,28,41,6,13,18,19,4,70,1
3495,80526,112_06_29,AUSTRIA,0,TOTALS,AUSTRIA,200,18,62,29.0,13,35,37.1,5,27,18.5,8,10,80.0,17,29,46,1,16,27,10,1,49,0
3496,80539,112_06_30,BELGIUM,0,TOTALS,BELGIUM,200,30,67,44.8,25,42,59.5,5,25,20.0,10,14,71.4,16,29,45,18,15,13,12,3,75,1
3497,80552,112_06_30,NETHERLANDS,0,TOTALS,NETHERLANDS,200,18,57,31.6,14,42,33.3,4,15,26.7,10,15,66.7,11,23,34,7,13,14,8,0,50,0
3498,80564,112_06_31,MOLDOVA,0,TOTALS,MOLDOVA,200,23,58,39.7,22,46,47.8,1,12,8.3,18,22,81.8,12,22,34,10,21,22,12,0,65,0
3499,80577,112_06_31,SLOVAK REPUBLIC,0,TOTALS,SLOVAK REPUBLIC,200,29,67,43.3,19,43,44.2,10,24,41.7,14,23,60.9,19,24,43,7,22,22,11,2,82,1
3500,80590,112_06_32,NORWAY,0,TOTALS,NORWAY,200,31,60,51.7,24,39,61.5,7,21,33.3,19,22,86.4,11,27,38,8,14,16,17,3,88,1
3501,80603,112_06_32,SWEDEN,0,TOTALS,SWEDEN,200,28,61,45.9,24,44,54.5,4,17,23.5,10,16,62.5,7,15,22,7,16,19,8,0,70,0
3502,80616,112_06_33,PORTUGAL,0,TOTALS,PORTUGAL,200,25,68,36.8,20,44,45.5,5,24,20.8,6,8,75.0,12,25,37,7,21,19,8,4,61,0
3503,80629,112_06_33,ENGLAND,0,TOTALS,ENGLAND,200,26,64,40.6,24,50,48.0,2,14,14.3,14,27,51.9,19,29,48,7,15,20,6,3,68,1
3504,80642,112_06_34,HUNGARY,0,TOTALS,HUNGARY,200,29,59,49.2,22,40,55.0,7,19,36.8,15,17,88.2,5,22,27,14,20,12,9,4,80,1
3505,80655,112_06_34,BOSNIA AND HERZEGOVINA,0,TOTALS,BOSNIA AND HERZEGOVINA,200,25,61,41.0,14,32,43.8,11,29,37.9,16,24,66.7,16,21,37,18,19,16,5,4,77,0
3506,80667,112_06_35,FINLAND,0,TOTALS,FINLAND,200,29,66,43.9,22,42,52.4,7,24,29.2,11,18,61.1,18,26,44,19,14,8,7,0,76,1
3507,80679,112_06_35,LUXEMBOURG,0,TOTALS,LUXEMBOURG,200,25,58,43.1,14,31,45.2,11,27,40.7,3,8,37.5,9,19,28,8,21,14,3,1,64,0
3508,80692,112_06_36,SCOTLAND,0,TOTALS,SCOTLAND,200,21,65,32.3,17,39,43.6,4,26,15.4,16,23,69.6,20,23,43,9,20,28,10,2,62,0
3509,80705,112_06_36,ESTONIA,0,TOTALS,ESTONIA,200,28,62,45.2,21,38,55.3,7,24,29.2,13,16,81.2,10,26,36,18,24,22,11,4,76,1
3510,80718,112_06_37,HUNGARY,0,TOTALS,HUNGARY,200,29,65,44.6,22,37,59.5,7,28,25.0,14,20,70.0,13,27,40,16,21,15,9,0,79,1
3511,80731,112_06_37,IRELAND,0,TOTALS,IRELAND,200,28,63,44.4,18,38,47.4,10,25,40.0,12,19,63.2,8,22,30,14,22,19,7,1,78,0
3512,80744,112_06_38,PORTUGAL,0,TOTALS,PORTUGAL,200,23,63,36.5,16,36,44.4,7,27,25.9,10,18,55.6,16,27,43,11,20,24,8,2,63,0
3513,80757,112_06_38,ESTONIA,0,TOTALS,ESTONIA,200,25,60,41.7,21,41,51.2,4,19,21.1,18,23,78.3,9,27,36,12,20,19,10,1,72,1
3514,80770,112_06_39,SLOVAK REPUBLIC,0,TOTALS,SLOVAK REPUBLIC,200,15,58,25.9,11,39,28.2,4,19,21.1,14,20,70.0,17,35,52,8,27,27,9,7,48,0
3515,80782,112_06_39,FINLAND,0,TOTALS,FINLAND,200,20,67,29.9,17,45,37.8,3,22,13.6,21,29,72.4,15,25,40,7,20,14,7,2,64,1
3516,80795,112_06_40,AUSTRIA,0,TOTALS,AUSTRIA,200,31,67,46.3,17,34,50.0,14,33,42.4,5,6,83.3,9,22,31,13,18,19,6,0,81,0
3517,80808,112_06_40,SWEDEN,0,TOTALS,SWEDEN,200,34,61,55.7,28,47,59.6,6,14,42.9,13,20,65.0,4,27,31,11,14,14,13,3,87,1
3518,80821,112_06_41,NETHERLANDS,0,TOTALS,NETHERLANDS,225,27,88,30.7,22,67,32.8,5,21,23.8,8,12,66.7,23,29,52,13,20,9,10,1,67,0
3519,80834,112_06_41,CZECH REPUBLIC,0,TOTALS,CZECH REPUBLIC,225,28,71,39.4,24,57,42.1,4,14,28.6,14,17,82.4,15,39,54,12,17,16,0,3,74,1
3520,80847,112_06_42,ENGLAND,0,TOTALS,ENGLAND,200,21,67,31.3,15,46,32.6,6,21,28.6,10,31,32.3,21,25,46,9,30,21,13,5,58,0
3521,80860,112_06_42,ROMANIA,0,TOTALS,ROMANIA,200,23,59,39.0,17,45,37.8,6,14,42.9,24,42,57.1,18,35,53,15,21,20,11,9,76,1
3522,80873,112_06_43,BOSNIA AND HERZEGOVINA,0,TOTALS,BOSNIA AND HERZEGOVINA,200,27,55,49.1,23,42,54.8,4,13,30.8,20,26,76.9,10,27,37,15,22,25,15,1,78,1
3523,80886,112_06_43,NORWAY,0,TOTALS,NORWAY,200,26,79,32.9,19,50,38.0,7,29,24.1,9,19,47.4,23,20,43,7,23,20,17,2,68,0
3524,80899,112_06_44,POLAND,0,TOTALS,POLAND,200,33,67,49.3,26,48,54.2,7,19,36.8,9,13,69.2,10,22,32,16,19,13,16,1,82,1
3525,80912,112_06_44,BELGIUM,0,TOTALS,BELGIUM,200,27,53,50.9,20,32,62.5,7,21,33.3,7,11,63.6,6,25,31,11,18,22,5,1,68,0
3526,80925,112_06_45,SWEDEN,0,TOTALS,SWEDEN,200,26,66,39.4,17,39,43.6,9,27,33.3,4,11,36.4,4,25,29,10,13,9,6,0,65,0
3527,80938,112_06_45,ENGLAND,0,TOTALS,ENGLAND,200,31,62,50.0,29,52,55.8,2,10,20.0,11,16,68.8,8,40,48,10,18,14,6,1,75,1
3528,80951,112_06_46,IRELAND,0,TOTALS,IRELAND,200,19,69,27.5,11,39,28.2,8,30,26.7,14,20,70.0,15,27,42,9,23,15,6,2,60,0
3529,80963,112_06_46,LUXEMBOURG,0,TOTALS,LUXEMBOURG,200,28,66,42.4,23,47,48.9,5,19,26.3,15,23,65.2,13,33,46,16,14,14,7,0,76,1
3530,80976,112_06_47,BELGIUM,0,TOTALS,BELGIUM,225,30,85,35.3,20,51,39.2,10,34,29.4,13,18,72.2,22,25,47,6,25,14,11,3,83,0
3531,80989,112_06_47,PORTUGAL,0,TOTALS,PORTUGAL,225,31,60,51.7,23,42,54.8,8,18,44.4,22,30,73.3,9,32,41,8,14,18,5,6,92,1
3532,81001,112_06_48,FINLAND,0,TOTALS,FINLAND,200,28,64,43.8,22,44,50.0,6,20,30.0,23,30,76.7,14,35,49,13,16,17,4,3,85,1
3533,81014,112_06_48,SCOTLAND,0,TOTALS,SCOTLAND,200,25,69,36.2,21,55,38.2,4,14,28.6,8,15,53.3,10,17,27,10,23,17,8,4,62,0
3534,81027,112_06_49,ROMANIA,0,TOTALS,ROMANIA,200,31,76,40.8,26,52,50.0,5,24,20.8,12,20,60.0,30,30,60,17,12,16,7,6,79,1
3535,81040,112_06_49,AUSTRIA,0,TOTALS,AUSTRIA,200,24,67,35.8,16,41,39.0,8,26,30.8,3,8,37.5,14,19,33,7,16,14,9,0,59,0
3536,81053,112_06_50,CZECH REPUBLIC,0,TOTALS,CZECH REPUBLIC,200,24,58,41.4,22,46,47.8,2,12,16.7,13,25,52.0,12,31,43,12,14,18,13,6,63,1
3537,81065,112_06_50,MOLDOVA,0,TOTALS,MOLDOVA,200,17,60,28.3,12,39,30.8,5,21,23.8,4,9,44.4,11,26,37,10,26,23,6,4,43,0
3538,81078,112_06_51,ESTONIA,0,TOTALS,ESTONIA,200,28,60,46.7,23,41,56.1,5,19,26.3,14,21,66.7,7,28,35,14,23,14,7,0,75,1
3539,81091,112_06_51,POLAND,0,TOTALS,POLAND,200,20,61,32.8,13,26,50.0,7,35,20.0,21,24,87.5,15,27,42,9,20,14,5,0,68,0
3540,81104,112_06_52,ENGLAND,0,TOTALS,ENGLAND,200,36,79,45.6,35,70,50.0,1,9,11.1,12,20,60.0,28,33,61,9,15,19,6,0,85,1
3541,81117,112_06_52,AUSTRIA,0,TOTALS,AUSTRIA,200,31,66,47.0,22,39,56.4,9,27,33.3,9,15,60.0,5,17,22,14,23,11,10,2,80,0
3542,81129,112_06_53,LUXEMBOURG,0,TOTALS,LUXEMBOURG,200,28,65,43.1,14,32,43.8,14,33,42.4,5,6,83.3,8,17,25,11,15,11,3,1,75,0
3543,81142,112_06_53,HUNGARY,0,TOTALS,HUNGARY,200,34,71,47.9,32,53,60.4,2,18,11.1,7,10,70.0,14,27,41,15,12,10,5,5,77,1
3544,81155,112_06_54,PORTUGAL,0,TOTALS,PORTUGAL,200,29,61,47.5,19,37,51.4,10,24,41.7,12,14,85.7,6,28,34,13,11,12,7,4,80,1
3545,81168,112_06_54,POLAND,0,TOTALS,POLAND,200,26,59,44.1,18,35,51.4,8,24,33.3,8,10,80.0,7,26,33,15,16,13,6,0,68,0
3546,81181,112_06_55,SCOTLAND,0,TOTALS,SCOTLAND,200,27,60,45.0,22,39,56.4,5,21,23.8,13,19,68.4,13,19,32,13,23,23,6,4,72,0
3547,81194,112_06_55,SLOVAK REPUBLIC,0,TOTALS,SLOVAK REPUBLIC,200,30,64,46.9,24,48,50.0,6,16,37.5,19,37,51.4,21,21,42,14,20,18,19,6,85,1
3548,81207,112_06_56,SWEDEN,0,TOTALS,SWEDEN,200,22,66,33.3,16,42,38.1,6,24,25.0,14,25,56.0,15,23,38,4,18,13,12,3,64,0
3549,81220,112_06_56,ROMANIA,0,TOTALS,ROMANIA,200,25,58,43.1,21,40,52.5,4,18,22.2,13,18,72.2,13,33,46,14,19,19,7,4,67,1
3550,81232,112_06_57,MOLDOVA,0,TOTALS,MOLDOVA,200,19,55,34.5,16,36,44.4,3,19,15.8,4,8,50.0,9,27,36,6,19,27,12,1,45,0
3551,81245,112_06_57,NETHERLANDS,0,TOTALS,NETHERLANDS,200,23,64,35.9,19,49,38.8,4,15,26.7,9,19,47.4,17,26,43,12,11,21,12,1,59,1
3552,81258,112_06_58,BELGIUM,0,TOTALS,BELGIUM,200,26,57,45.6,21,37,56.8,5,20,25.0,11,18,61.1,10,26,36,9,22,23,7,2,68,1
3553,81271,112_06_58,ESTONIA,0,TOTALS,ESTONIA,200,26,64,40.6,24,48,50.0,2,16,12.5,9,19,47.4,12,25,37,5,18,13,12,0,63,0
3554,81284,112_06_59,SCOTLAND,0,TOTALS,SCOTLAND,200,21,55,38.2,18,35,51.4,3,20,15.0,5,12,41.7,8,26,34,6,17,18,9,0,50,0
3555,81296,112_06_59,MOLDOVA,0,TOTALS,MOLDOVA,200,23,55,41.8,16,28,57.1,7,27,25.9,13,20,65.0,9,31,40,8,15,18,8,2,66,1
3556,81308,112_06_60,MOLDOVA,0,TOTALS,MOLDOVA,200,28,55,50.9,25,41,61.0,3,14,21.4,5,13,38.5,9,36,45,17,16,29,13,4,64,1
3557,81321,112_06_60,IRELAND,0,TOTALS,IRELAND,200,18,69,26.1,12,34,35.3,6,35,17.1,6,8,75.0,16,21,37,10,18,25,10,1,48,0
3558,81334,112_06_61,SWEDEN,0,TOTALS,SWEDEN,200,23,62,37.1,17,35,48.6,6,27,22.2,18,25,72.0,13,31,44,14,7,15,8,0,70,1
3559,81347,112_06_61,BELGIUM,0,TOTALS,BELGIUM,200,29,68,42.6,24,45,53.3,5,23,21.7,4,7,57.1,9,30,39,10,18,14,13,1,67,0
3560,81360,112_06_62,NORWAY,0,TOTALS,NORWAY,200,35,68,51.5,27,46,58.7,8,22,36.4,13,23,56.5,12,21,33,20,15,10,11,0,91,1
3561,81372,112_06_62,LUXEMBOURG,0,TOTALS,LUXEMBOURG,200,27,58,46.6,23,40,57.5,4,18,22.2,16,21,76.2,8,20,28,14,16,20,6,2,74,0
3562,81385,112_06_63,AUSTRIA,0,TOTALS,AUSTRIA,200,30,68,44.1,27,53,50.9,3,15,20.0,12,16,75.0,9,20,29,10,14,13,15,0,75,0
3563,81398,112_06_63,POLAND,0,TOTALS,POLAND,200,28,63,44.4,16,33,48.5,12,30,40.0,13,16,81.2,17,29,46,10,16,25,9,2,81,1
3564,81411,112_06_64,SLOVAK REPUBLIC,0,TOTALS,SLOVAK REPUBLIC,200,24,70,34.3,18,46,39.1,6,24,25.0,15,20,75.0,16,21,37,14,23,16,11,0,69,0
3565,81424,112_06_64,NETHERLANDS,0,TOTALS,NETHERLANDS,200,27,57,47.4,23,48,47.9,4,9,44.4,15,22,68.2,13,31,44,18,16,21,7,2,73,1
3566,81437,112_06_65,ROMANIA,0,TOTALS,ROMANIA,200,25,65,38.5,17,45,37.8,8,20,40.0,19,25,76.0,22,40,62,13,18,17,6,6,77,1
3567,81450,112_06_65,PORTUGAL,0,TOTALS,PORTUGAL,200,19,71,26.8,14,49,28.6,5,22,22.7,11,19,57.9,16,21,37,5,19,12,13,7,54,0
3568,81463,112_06_66,BOSNIA AND HERZEGOVINA,0,TOTALS,BOSNIA AND HERZEGOVINA,200,27,59,45.8,24,44,54.5,3,15,20.0,17,22,77.3,17,17,34,14,13,11,9,5,74,1
3569,81476,112_06_66,HUNGARY,0,TOTALS,HUNGARY,200,25,52,48.1,19,34,55.9,6,18,33.3,1,2,50.0,10,17,27,12,21,22,8,3,57,0
3570,81488,112_06_67,FINLAND,0,TOTALS,FINLAND,200,23,55,41.8,16,34,47.1,7,21,33.3,15,28,53.6,9,26,35,10,25,18,13,0,68,0
3571,81501,112_06_67,CZECH REPUBLIC,0,TOTALS,CZECH REPUBLIC,200,28,58,48.3,22,41,53.7,6,17,35.3,16,29,55.2,10,26,36,14,22,18,8,2,78,1
3572,81514,112_06_68,ENGLAND,0,TOTALS,ENGLAND,200,26,65,40.0,22,46,47.8,4,19,21.1,9,14,64.3,14,30,44,7,27,22,5,5,65,0
3573,81527,112_06_68,ESTONIA,0,TOTALS,ESTONIA,200,31,67,46.3,23,48,47.9,8,19,42.1,25,34,73.5,8,27,35,14,16,9,11,2,95,1
3574,81540,112_06_69,IRELAND,0,TOTALS,IRELAND,225,29,91,31.9,15,37,40.5,14,54,25.9,4,12,33.3,18,32,50,17,22,16,8,3,76,0
3575,81553,112_06_69,SCOTLAND,0,TOTALS,SCOTLAND,225,30,73,41.1,28,58,48.3,2,15,13.3,18,32,56.2,17,46,63,18,11,23,8,3,80,1
3576,81565,112_06_70,LUXEMBOURG,0,TOTALS,LUXEMBOURG,200,19,57,33.3,15,41,36.6,4,16,25.0,17,21,81.0,11,18,29,9,18,16,8,0,59,0
3577,81578,112_06_70,SLOVAK REPUBLIC,0,TOTALS,SLOVAK REPUBLIC,200,26,60,43.3,21,42,50.0,5,18,27.8,11,21,52.4,17,28,45,15,19,18,8,6,68,1
3578,81591,112_06_71,BELGIUM,0,TOTALS,BELGIUM,200,23,65,35.4,20,46,43.5,3,19,15.8,8,13,61.5,14,32,46,11,17,21,8,4,57,0
3579,81604,112_06_71,AUSTRIA,0,TOTALS,AUSTRIA,200,24,66,36.4,18,43,41.9,6,23,26.1,12,19,63.2,14,31,45,10,12,14,13,5,66,1
3580,81617,112_06_72,NORWAY,0,TOTALS,NORWAY,200,25,57,43.9,15,31,48.4,10,26,38.5,8,11,72.7,8,21,29,13,9,13,8,1,68,1
3581,81630,112_06_72,NETHERLANDS,0,TOTALS,NETHERLANDS,200,27,61,44.3,24,49,49.0,3,12,25.0,8,8,100.0,13,25,38,14,10,15,6,3,65,0
3582,81643,112_06_73,SWEDEN,0,TOTALS,SWEDEN,200,35,72,48.6,29,53,54.7,6,19,31.6,18,20,90.0,16,27,43,16,17,14,11,2,94,1
3583,81656,112_06_73,POLAND,0,TOTALS,POLAND,200,33,63,52.4,23,41,56.1,10,22,45.5,7,16,43.8,9,24,33,15,19,19,8,3,83,0
3584,81669,112_06_74,HUNGARY,0,TOTALS,HUNGARY,200,28,61,45.9,22,38,57.9,6,23,26.1,12,25,48.0,18,22,40,15,17,17,11,4,74,1
3585,81681,112_06_74,FINLAND,0,TOTALS,FINLAND,200,24,60,40.0,14,31,45.2,10,29,34.5,11,16,68.8,17,25,42,17,19,18,7,0,69,0
3586,81694,112_06_75,PORTUGAL,0,TOTALS,PORTUGAL,200,26,57,45.6,19,35,54.3,7,22,31.8,17,26,65.4,5,30,35,6,21,17,7,3,76,1
3587,81707,112_06_75,ENGLAND,0,TOTALS,ENGLAND,200,29,66,43.9,27,58,46.6,2,8,25.0,14,25,56.0,12,27,39,4,19,13,4,1,74,0
3588,81720,112_06_76,BOSNIA AND HERZEGOVINA,0,TOTALS,BOSNIA AND HERZEGOVINA,200,26,50,52.0,22,34,64.7,4,16,25.0,16,30,53.3,9,25,34,8,31,25,9,3,72,1
3589,81733,112_06_76,CZECH REPUBLIC,0,TOTALS,CZECH REPUBLIC,200,19,54,35.2,13,38,34.2,6,16,37.5,19,34,55.9,13,17,30,2,22,18,11,2,63,0
3590,81746,112_06_77,ROMANIA,0,TOTALS,ROMANIA,200,26,69,37.7,17,41,41.5,9,28,32.1,6,7,85.7,20,26,46,18,19,11,8,4,67,1
3591,81759,112_06_77,ESTONIA,0,TOTALS,ESTONIA,200,18,52,34.6,11,33,33.3,7,19,36.8,11,19,57.9,9,22,31,8,13,14,3,2,54,0
3592,84790,115_06_01,TURKEY,0,TOTALS,TURKEY,200,38,69,55.1,31,45,68.9,7,24,29.2,6,10,60.0,6,31,37,10,20,13,12,0,89,1
3593,84803,115_06_01,ITALY,0,TOTALS,ITALY,200,28,69,40.6,18,38,47.4,10,31,32.3,11,22,50.0,17,29,46,7,17,18,6,2,77,0
3594,84816,115_06_02,LITHUANIA,0,TOTALS,LITHUANIA,200,34,71,47.9,24,44,54.5,10,27,37.0,16,28,57.1,15,28,43,8,21,15,17,0,94,1
3595,84829,115_06_02,CROATIA,0,TOTALS,CROATIA,200,25,62,40.3,17,44,38.6,8,18,44.4,15,18,83.3,10,29,39,12,27,23,6,4,73,0
3596,84842,115_06_03,PORTUGAL,0,TOTALS,PORTUGAL,200,15,74,20.3,13,60,21.7,2,14,14.3,8,18,44.4,18,25,43,4,23,21,11,4,40,0
3597,84855,115_06_03,LATVIA,0,TOTALS,LATVIA,200,29,69,42.0,23,48,47.9,6,21,28.6,25,33,75.8,21,43,64,11,21,18,10,15,89,1
3598,84868,115_06_04,FRANCE,0,TOTALS,FRANCE,200,30,66,45.5,27,51,52.9,3,15,20.0,4,13,30.8,11,28,39,14,18,16,15,2,67,1
3599,84880,115_06_04,UKRAINE,0,TOTALS,UKRAINE,200,13,49,26.5,8,28,28.6,5,21,23.8,13,21,61.9,11,27,38,1,15,27,10,3,44,0
3600,84893,115_06_05,GERMANY,0,TOTALS,GERMANY,200,30,66,45.5,24,49,49.0,6,17,35.3,16,27,59.3,18,32,50,6,26,20,13,2,82,1
3601,84906,115_06_05,SLOVENIA,0,TOTALS,SLOVENIA,200,26,61,42.6,23,44,52.3,3,17,17.6,15,29,51.7,12,25,37,12,25,18,11,1,70,0
3602,84919,115_06_06,ICELAND,0,TOTALS,ICELAND,200,18,53,34.0,15,34,44.1,3,19,15.8,14,23,60.9,11,34,45,3,17,30,6,3,53,0
3603,84932,115_06_06,ISRAEL,0,TOTALS,ISRAEL,200,26,81,32.1,21,60,35.0,5,21,23.8,8,14,57.1,24,30,54,7,25,20,18,0,65,1
3604,84945,115_06_07,SPAIN,0,TOTALS,SPAIN,200,37,76,48.7,33,61,54.1,4,15,26.7,13,20,65.0,17,35,52,15,20,17,14,3,91,1
3605,84958,115_06_07,RUSSIA,0,TOTALS,RUSSIA,200,31,79,39.2,25,56,44.6,6,23,26.1,8,18,44.4,18,24,42,6,22,18,12,2,76,0
3606,84971,115_06_08,GREECE,0,TOTALS,GREECE,200,27,74,36.5,18,46,39.1,9,28,32.1,23,33,69.7,21,17,38,6,29,11,10,2,86,0
3607,84984,115_06_08,SERBIA & MONTENEGRO,0,TOTALS,SERBIA & MONTENEGRO,200,31,57,54.4,27,49,55.1,4,8,50.0,31,42,73.8,13,31,44,15,26,17,6,6,97,1
3608,84997,115_06_09,LATVIA,0,TOTALS,LATVIA,200,22,65,33.8,18,42,42.9,4,23,17.4,13,29,44.8,21,34,55,6,18,21,11,4,61,0
3609,85010,115_06_09,TURKEY,0,TOTALS,TURKEY,200,27,74,36.5,21,51,41.2,6,23,26.1,9,14,64.3,16,28,44,10,28,16,11,3,69,1
3610,85022,115_06_10,UKRAINE,0,TOTALS,UKRAINE,200,28,69,40.6,23,47,48.9,5,22,22.7,15,22,68.2,19,29,48,8,12,10,7,1,76,1
3611,85035,115_06_10,ICELAND,0,TOTALS,ICELAND,200,24,66,36.4,11,27,40.7,13,39,33.3,3,7,42.9,14,24,38,6,18,13,5,4,64,0
3612,85048,115_06_11,RUSSIA,0,TOTALS,RUSSIA,200,24,61,39.3,20,37,54.1,4,24,16.7,19,33,57.6,15,28,43,7,25,19,16,4,71,1
3613,85061,115_06_11,GERMANY,0,TOTALS,GERMANY,200,25,60,41.7,19,35,54.3,6,25,24.0,12,25,48.0,12,26,38,6,26,25,11,1,68,0
3614,85074,115_06_12,SERBIA & MONTENEGRO,0,TOTALS,SERBIA & MONTENEGRO,200,27,59,45.8,24,44,54.5,3,15,20.0,21,32,65.6,10,23,33,5,27,16,11,6,78,1
3615,85087,115_06_12,LITHUANIA,0,TOTALS,LITHUANIA,200,24,62,38.7,17,41,41.5,7,21,33.3,15,32,46.9,18,28,46,1,29,25,8,2,70,0
3616,85100,115_06_13,ITALY,0,TOTALS,ITALY,200,29,66,43.9,24,45,53.3,5,21,23.8,13,26,50.0,16,36,52,11,19,19,10,8,76,1
3617,85113,115_06_13,PORTUGAL,0,TOTALS,PORTUGAL,200,21,80,26.2,18,63,28.6,3,17,17.6,16,24,66.7,26,28,54,7,20,15,11,0,61,0
3618,85126,115_06_14,CROATIA,0,TOTALS,CROATIA,200,28,63,44.4,15,34,44.1,13,29,44.8,11,17,64.7,13,29,42,10,26,17,5,0,80,1
3619,85139,115_06_14,GREECE,0,TOTALS,GREECE,200,23,58,39.7,19,37,51.4,4,21,19.0,21,34,61.8,10,23,33,9,22,13,11,4,71,0
3620,85152,115_06_15,SLOVENIA,0,TOTALS,SLOVENIA,200,28,70,40.0,21,56,37.5,7,14,50.0,10,15,66.7,15,24,39,6,25,14,9,0,73,0
3621,85165,115_06_15,SPAIN,0,TOTALS,SPAIN,200,27,62,43.5,21,38,55.3,6,24,25.0,20,32,62.5,13,30,43,11,17,16,9,6,80,1
3622,85178,115_06_16,ISRAEL,0,TOTALS,ISRAEL,200,22,56,39.3,17,39,43.6,5,17,29.4,7,17,41.2,8,20,28,5,31,21,7,1,56,0
3623,85191,115_06_16,FRANCE,0,TOTALS,FRANCE,200,23,49,46.9,15,29,51.7,8,20,40.0,24,42,57.1,13,28,41,12,18,24,10,4,78,1
3624,85204,115_06_17,LATVIA,0,TOTALS,LATVIA,200,25,63,39.7,18,41,43.9,7,22,31.8,10,22,45.5,15,24,39,5,23,18,8,3,67,0
3625,85217,115_06_17,ITALY,0,TOTALS,ITALY,200,25,61,41.0,18,41,43.9,7,20,35.0,20,29,69.0,15,29,44,4,21,16,14,4,77,1
3626,85230,115_06_18,SERBIA & MONTENEGRO,0,TOTALS,SERBIA & MONTENEGRO,200,26,57,45.6,23,45,51.1,3,12,25.0,14,22,63.6,10,26,36,7,28,22,6,3,69,0
3627,85243,115_06_18,CROATIA,0,TOTALS,CROATIA,200,28,63,44.4,25,53,47.2,3,10,30.0,18,33,54.5,12,25,37,11,25,14,10,2,77,1
3628,85256,115_06_19,SLOVENIA,0,TOTALS,SLOVENIA,200,18,49,36.7,16,39,41.0,2,10,20.0,19,30,63.3,9,24,33,5,28,21,7,7,57,0
3629,85269,115_06_19,RUSSIA,0,TOTALS,RUSSIA,200,24,66,36.4,21,51,41.2,3,15,20.0,22,32,68.8,23,27,50,9,26,18,15,1,73,1
3630,85282,115_06_20,ISRAEL,0,TOTALS,ISRAEL,225,26,70,37.1,19,48,39.6,7,22,31.8,18,24,75.0,7,23,30,8,30,22,20,0,77,1
3631,85294,115_06_20,UKRAINE,0,TOTALS,UKRAINE,225,23,56,41.1,17,39,43.6,6,17,35.3,18,37,48.6,14,40,54,3,21,34,9,6,70,0
3632,85307,115_06_21,TURKEY,0,TOTALS,TURKEY,200,25,62,40.3,22,43,51.2,3,19,15.8,14,29,48.3,13,31,44,8,13,16,10,9,67,1
3633,85320,115_06_21,PORTUGAL,0,TOTALS,PORTUGAL,200,26,77,33.8,24,59,40.7,2,18,11.1,7,7,100.0,19,30,49,6,18,19,10,2,61,0
3634,85333,115_06_22,LITHUANIA,0,TOTALS,LITHUANIA,200,20,70,28.6,17,44,38.6,3,26,11.5,22,42,52.4,23,33,56,5,33,16,10,1,65,0
3635,85346,115_06_22,GREECE,0,TOTALS,GREECE,200,23,63,36.5,14,32,43.8,9,31,29.0,25,36,69.4,9,38,47,10,32,15,13,9,80,1
3636,85359,115_06_23,SPAIN,0,TOTALS,SPAIN,200,35,84,41.7,27,56,48.2,8,28,28.6,12,21,57.1,21,30,51,7,24,4,9,2,90,1
3637,85372,115_06_23,GERMANY,0,TOTALS,GERMANY,200,21,58,36.2,15,34,44.1,6,24,25.0,15,29,51.7,15,33,48,1,23,18,2,3,63,0
3638,85385,115_06_24,FRANCE,0,TOTALS,FRANCE,200,46,84,54.8,42,72,58.3,4,12,33.3,19,36,52.8,28,36,64,20,14,13,12,0,115,0
3639,85398,115_06_24,ICELAND,0,TOTALS,ICELAND,200,25,65,38.5,15,33,45.5,10,32,31.2,5,16,31.2,8,19,27,5,28,20,9,0,65,1
3640,85411,115_06_25,LATVIA,0,TOTALS,LATVIA,200,35,72,48.6,32,58,55.2,3,14,21.4,21,32,65.6,22,39,61,14,23,27,15,9,94,1
3641,85424,115_06_25,ICELAND,0,TOTALS,ICELAND,200,21,69,30.4,20,53,37.7,1,16,6.2,13,23,56.5,15,23,38,9,26,27,14,5,56,0
3642,85437,115_06_26,TURKEY,0,TOTALS,TURKEY,200,32,58,55.2,26,35,74.3,6,23,26.1,18,28,64.3,9,42,51,18,22,21,7,4,88,1
3643,85450,115_06_26,ISRAEL,0,TOTALS,ISRAEL,200,24,77,31.2,22,57,38.6,2,20,10.0,15,24,62.5,14,22,36,4,23,14,11,2,65,0
3644,85463,115_06_27,SLOVENIA,0,TOTALS,SLOVENIA,200,20,53,37.7,18,44,40.9,2,9,22.2,19,29,65.5,14,24,38,6,19,25,10,1,61,0
3645,85476,115_06_27,GREECE,0,TOTALS,GREECE,200,29,67,43.3,23,48,47.9,6,19,31.6,15,19,78.9,14,23,37,12,26,16,18,10,79,1
3646,85489,115_06_28,RUSSIA,0,TOTALS,RUSSIA,200,33,73,45.2,25,48,52.1,8,25,32.0,8,14,57.1,15,27,42,12,24,16,12,3,82,1
3647,85502,115_06_28,CROATIA,0,TOTALS,CROATIA,200,24,63,38.1,23,51,45.1,1,12,8.3,17,34,50.0,19,27,46,4,20,18,11,1,66,0
3648,85515,115_06_29,PORTUGAL,0,TOTALS,PORTUGAL,200,29,77,37.7,24,55,43.6,5,22,22.7,8,13,61.5,9,17,26,6,25,12,18,1,71,0
3649,85527,115_06_29,UKRAINE,0,TOTALS,UKRAINE,200,31,53,58.5,25,39,64.1,6,14,42.9,22,29,75.9,9,41,50,11,17,27,6,6,90,1
3650,85540,115_06_30,ITALY,0,TOTALS,ITALY,200,25,62,40.3,14,36,38.9,11,26,42.3,5,22,22.7,7,30,37,7,27,14,11,2,66,1
3651,85553,115_06_30,FRANCE,0,TOTALS,FRANCE,200,21,56,37.5,13,36,36.1,8,20,40.0,15,31,48.4,10,36,46,9,23,16,7,1,65,0
3652,85566,115_06_31,GERMANY,0,TOTALS,GERMANY,200,25,64,39.1,22,53,41.5,3,11,27.3,14,20,70.0,8,30,38,7,25,30,14,1,67,0
3653,85579,115_06_31,LITHUANIA,0,TOTALS,LITHUANIA,200,31,69,44.9,25,41,61.0,6,28,21.4,19,32,59.4,13,33,46,11,22,25,18,2,87,1
3654,85592,115_06_32,SPAIN,0,TOTALS,SPAIN,200,31,78,39.7,26,58,44.8,5,20,25.0,28,38,73.7,20,30,50,16,27,9,9,3,95,1
3655,85605,115_06_32,SERBIA & MONTENEGRO,0,TOTALS,SERBIA & MONTENEGRO,200,28,73,38.4,22,52,42.3,6,21,28.6,17,24,70.8,18,31,49,10,32,17,8,5,79,0
3656,85618,115_06_33,GREECE,0,TOTALS,GREECE,200,25,62,40.3,21,46,45.7,4,16,25.0,11,17,64.7,13,27,40,11,21,19,17,1,65,1
3657,85631,115_06_33,LATVIA,0,TOTALS,LATVIA,200,20,61,32.8,17,40,42.5,3,21,14.3,15,25,60.0,18,25,43,10,22,20,10,5,58,0
3658,85644,115_06_34,CROATIA,0,TOTALS,CROATIA,200,21,64,32.8,12,35,34.3,9,29,31.0,16,20,80.0,15,43,58,10,19,22,7,6,67,1
3659,85657,115_06_34,TURKEY,0,TOTALS,TURKEY,200,21,67,31.3,14,38,36.8,7,29,24.1,9,11,81.8,4,29,33,9,21,13,15,2,58,0
3660,85670,115_06_35,LITHUANIA,0,TOTALS,LITHUANIA,200,25,60,41.7,18,38,47.4,7,22,31.8,32,44,72.7,17,30,47,10,28,29,15,3,89,1
3661,85683,115_06_35,PORTUGAL,0,TOTALS,PORTUGAL,200,27,69,39.1,21,52,40.4,6,17,35.3,19,26,73.1,14,22,36,9,31,25,16,1,79,0
3662,85696,115_06_36,SERBIA & MONTENEGRO,0,TOTALS,SERBIA & MONTENEGRO,200,25,65,38.5,19,42,45.2,6,23,26.1,22,30,73.3,22,28,50,6,21,14,2,2,78,1
3663,85709,115_06_36,ITALY,0,TOTALS,ITALY,200,26,62,41.9,21,45,46.7,5,17,29.4,12,21,57.1,11,22,33,8,24,12,11,5,69,0
3664,85722,115_06_37,ICELAND,0,TOTALS,ICELAND,200,19,63,30.2,13,46,28.3,6,17,35.3,12,21,57.1,13,22,35,2,21,27,10,3,56,0
3665,85735,115_06_37,SLOVENIA,0,TOTALS,SLOVENIA,200,33,70,47.1,26,60,43.3,7,10,70.0,12,18,66.7,18,35,53,10,25,21,17,3,85,1
3666,85748,115_06_38,ISRAEL,0,TOTALS,ISRAEL,200,28,74,37.8,23,61,37.7,5,13,38.5,19,27,70.4,10,18,28,5,37,15,16,2,80,1
3667,85761,115_06_38,RUSSIA,0,TOTALS,RUSSIA,200,31,61,50.8,22,37,59.5,9,24,37.5,31,46,67.4,17,40,57,22,25,28,13,7,102,0
3668,85773,115_06_39,UKRAINE,0,TOTALS,UKRAINE,200,24,62,38.7,17,43,39.5,7,19,36.8,23,25,92.0,11,30,41,8,12,16,7,8,78,1
3669,85786,115_06_39,GERMANY,0,TOTALS,GERMANY,200,24,77,31.2,16,53,30.2,8,24,33.3,3,7,42.9,23,24,47,7,24,21,11,1,59,0
3670,85799,115_06_40,FRANCE,0,TOTALS,FRANCE,200,24,65,36.9,19,45,42.2,5,20,25.0,10,20,50.0,16,24,40,15,21,19,9,2,63,0
3671,85812,115_06_40,SPAIN,0,TOTALS,SPAIN,200,32,68,47.1,22,46,47.8,10,22,45.5,11,22,50.0,18,31,49,12,19,18,13,3,85,1
3672,85825,115_06_41,CROATIA,0,TOTALS,CROATIA,200,27,56,48.2,21,41,51.2,6,15,40.0,21,30,70.0,11,34,45,14,25,29,11,8,81,1
3673,85838,115_06_41,ISRAEL,0,TOTALS,ISRAEL,200,20,62,32.3,19,53,35.8,1,9,11.1,16,27,59.3,11,23,34,2,26,22,20,2,57,0
3674,85851,115_06_42,GREECE,0,TOTALS,GREECE,200,38,78,48.7,34,55,61.8,4,23,17.4,15,25,60.0,18,39,57,20,24,19,11,7,95,1
3675,85864,115_06_42,ICELAND,0,TOTALS,ICELAND,200,23,70,32.9,19,53,35.8,4,17,23.5,18,29,62.1,14,27,41,7,20,21,11,3,68,0
3676,85877,115_06_43,PORTUGAL,0,TOTALS,PORTUGAL,200,30,72,41.7,26,51,51.0,4,21,19.0,12,19,63.2,15,24,39,12,19,19,15,0,76,1
3677,85890,115_06_43,GERMANY,0,TOTALS,GERMANY,200,23,55,41.8,19,39,48.7,4,16,25.0,15,25,60.0,10,31,41,11,23,30,11,1,65,0
3678,85903,115_06_44,TURKEY,0,TOTALS,TURKEY,200,34,75,45.3,30,54,55.6,4,21,19.0,7,14,50.0,6,31,37,10,20,11,7,2,79,0
3679,85916,115_06_44,RUSSIA,0,TOTALS,RUSSIA,200,30,66,45.5,22,39,56.4,8,27,29.6,13,24,54.2,11,36,47,15,19,17,5,1,81,1
3680,85929,115_06_45,LITHUANIA,0,TOTALS,LITHUANIA,200,29,71,40.8,18,38,47.4,11,33,33.3,8,16,50.0,12,33,45,16,15,16,10,3,77,1
3681,85941,115_06_45,UKRAINE,0,TOTALS,UKRAINE,200,24,73,32.9,18,50,36.0,6,23,26.1,4,7,57.1,16,33,49,7,11,20,5,4,58,0
3682,85954,115_06_46,SERBIA & MONTENEGRO,0,TOTALS,SERBIA & MONTENEGRO,200,27,54,50.0,20,34,58.8,7,20,35.0,37,44,84.1,14,29,43,16,22,23,11,4,98,1
3683,85967,115_06_46,FRANCE,0,TOTALS,FRANCE,200,22,53,41.5,19,38,50.0,3,15,20.0,21,32,65.6,8,17,25,9,33,22,18,1,68,0
3684,85980,115_06_47,LATVIA,0,TOTALS,LATVIA,200,30,68,44.1,24,45,53.3,6,23,26.1,11,18,61.1,17,26,43,13,20,10,7,4,77,1
3685,85993,115_06_47,SLOVENIA,0,TOTALS,SLOVENIA,200,24,59,40.7,22,50,44.0,2,9,22.2,13,22,59.1,13,26,39,8,20,13,6,2,63,0
3686,86006,115_06_48,ITALY,0,TOTALS,ITALY,200,26,68,38.2,22,41,53.7,4,27,14.8,16,23,69.6,18,28,46,5,19,20,7,2,72,0
3687,86019,115_06_48,SPAIN,0,TOTALS,SPAIN,200,27,67,40.3,19,42,45.2,8,25,32.0,17,20,85.0,12,26,38,11,19,16,12,1,79,1
3688,86032,115_06_49,SLOVENIA,0,TOTALS,SLOVENIA,200,29,65,44.6,24,44,54.5,5,21,23.8,22,31,71.0,11,31,42,8,25,12,9,3,85,1
3689,86045,115_06_49,GERMANY,0,TOTALS,GERMANY,200,28,66,42.4,25,45,55.6,3,21,14.3,12,21,57.1,10,30,40,9,24,17,8,4,71,0
3690,86058,115_06_50,TURKEY,0,TOTALS,TURKEY,200,26,65,40.0,13,28,46.4,13,37,35.1,2,4,50.0,7,22,29,5,21,14,9,2,67,0
3691,86071,115_06_50,FRANCE,0,TOTALS,FRANCE,200,31,58,53.4,24,43,55.8,7,15,46.7,16,25,64.0,11,31,42,11,11,17,9,1,85,1
3692,86084,115_06_51,ICELAND,0,TOTALS,ICELAND,200,25,70,35.7,20,43,46.5,5,27,18.5,15,32,46.9,14,23,37,5,30,25,19,0,70,0
3693,86097,115_06_51,PORTUGAL,0,TOTALS,PORTUGAL,200,28,55,50.9,26,49,53.1,2,6,33.3,26,37,70.3,8,36,44,9,31,31,13,3,84,1
3694,86110,115_06_52,ISRAEL,0,TOTALS,ISRAEL,200,18,72,25.0,14,48,29.2,4,24,16.7,14,19,73.7,17,18,35,2,26,13,16,0,54,0
3695,86123,115_06_52,ITALY,0,TOTALS,ITALY,200,23,50,46.0,15,33,45.5,8,17,47.1,15,30,50.0,15,37,52,11,19,23,3,8,69,1
3696,86136,115_06_53,GREECE,0,TOTALS,GREECE,200,26,69,37.7,16,44,36.4,10,25,40.0,11,16,68.8,17,29,46,9,17,23,19,4,73,1
3697,86148,115_06_53,UKRAINE,0,TOTALS,UKRAINE,200,21,60,35.0,16,50,32.0,5,10,50.0,12,15,80.0,12,26,38,6,13,26,13,4,59,0
3698,86161,115_06_54,RUSSIA,0,TOTALS,RUSSIA,200,31,60,51.7,27,49,55.1,4,11,36.4,16,34,47.1,13,31,44,12,23,22,13,4,82,1
3699,86174,115_06_54,SERBIA & MONTENEGRO,0,TOTALS,SERBIA & MONTENEGRO,200,29,82,35.4,28,58,48.3,1,24,4.2,15,23,65.2,26,25,51,10,30,20,12,4,74,0
3700,86187,115_06_55,LATVIA,0,TOTALS,LATVIA,200,30,60,50.0,23,45,51.1,7,15,46.7,16,28,57.1,9,27,36,6,21,23,9,2,83,0
3701,86200,115_06_55,LITHUANIA,0,TOTALS,LITHUANIA,200,36,69,52.2,31,52,59.6,5,17,29.4,16,24,66.7,12,21,33,9,21,16,15,5,93,1
3702,86213,115_06_56,CROATIA,0,TOTALS,CROATIA,200,32,73,43.8,24,47,51.1,8,26,30.8,10,17,58.8,16,24,40,15,28,22,10,2,82,1
3703,86226,115_06_56,SPAIN,0,TOTALS,SPAIN,200,39,71,54.9,28,44,63.6,11,27,40.7,17,31,54.8,14,28,42,25,19,15,16,2,106,0
3704,86239,115_06_57,GERMANY,0,TOTALS,GERMANY,200,39,63,61.9,37,58,63.8,2,5,40.0,23,32,71.9,16,37,53,12,16,29,13,9,103,0
3705,86252,115_06_57,ICELAND,0,TOTALS,ICELAND,200,27,79,34.2,14,40,35.0,13,39,33.3,12,15,80.0,15,11,26,9,23,20,17,0,79,1
3706,86265,115_06_58,SLOVENIA,0,TOTALS,SLOVENIA,200,28,66,42.4,28,54,51.9,0,12,0.0,22,27,81.5,17,31,48,7,18,16,8,1,78,1
3707,86278,115_06_58,PORTUGAL,0,TOTALS,PORTUGAL,200,25,57,43.9,23,44,52.3,2,13,15.4,7,17,41.2,8,21,29,6,22,17,10,1,59,0
3708,86291,115_06_59,TURKEY,0,TOTALS,TURKEY,200,24,54,44.4,16,29,55.2,8,25,32.0,8,10,80.0,9,34,43,12,17,31,12,4,64,0
3709,86304,115_06_59,ISRAEL,0,TOTALS,ISRAEL,200,28,67,41.8,26,57,45.6,2,10,20.0,8,16,50.0,9,23,32,7,18,17,16,0,66,1
3710,86316,115_06_60,UKRAINE,0,TOTALS,UKRAINE,200,22,71,31.0,18,55,32.7,4,16,25.0,11,16,68.8,19,31,50,3,16,15,4,2,59,0
3711,86329,115_06_60,LATVIA,0,TOTALS,LATVIA,200,30,73,41.1,22,52,42.3,8,21,38.1,5,14,35.7,17,34,51,8,16,11,8,4,73,1
3712,86342,115_06_61,FRANCE,0,TOTALS,FRANCE,200,25,58,43.1,22,44,50.0,3,14,21.4,14,23,60.9,18,22,40,9,22,20,11,3,67,1
3713,86355,115_06_61,ITALY,0,TOTALS,ITALY,200,22,53,41.5,15,32,46.9,7,21,33.3,6,15,40.0,11,18,29,6,18,21,8,2,57,0
3714,86368,115_06_62,GREECE,0,TOTALS,GREECE,200,27,62,43.5,22,38,57.9,5,24,20.8,20,28,71.4,8,22,30,8,28,8,17,0,79,1
3715,86381,115_06_62,LITHUANIA,0,TOTALS,LITHUANIA,200,25,62,40.3,18,33,54.5,7,29,24.1,19,32,59.4,19,31,50,13,28,23,4,3,76,0
3716,86394,115_06_63,SERBIA & MONTENEGRO,0,TOTALS,SERBIA & MONTENEGRO,200,31,73,42.5,27,60,45.0,4,13,30.8,19,29,65.5,20,28,48,11,24,14,10,1,85,1
3717,86407,115_06_63,CROATIA,0,TOTALS,CROATIA,200,22,50,44.0,20,43,46.5,2,7,28.6,23,30,76.7,6,27,33,9,29,15,7,3,69,0
3718,86420,115_06_64,RUSSIA,0,TOTALS,RUSSIA,250,40,79,50.6,27,44,61.4,13,35,37.1,13,25,52.0,13,33,46,16,25,22,5,0,106,0
3719,86433,115_06_64,SPAIN,0,TOTALS,SPAIN,250,42,88,47.7,36,67,53.7,6,21,28.6,20,30,66.7,15,34,49,17,23,14,14,1,110,1
3720,86446,116_06_01,CZECH REPUBLIC,0,TOTALS,CZECH REPUBLIC,200,36,88,40.9,34,81,42.0,2,7,28.6,31,48,64.6,39,41,80,12,10,32,18,4,105,0
3721,86459,116_06_01,LUXEMBOURG,0,TOTALS,LUXEMBOURG,200,26,72,36.1,23,52,44.2,3,20,15.0,4,8,50.0,7,19,26,8,32,33,25,1,59,1
3722,86472,116_06_02,BULGARIA,0,TOTALS,BULGARIA,225,24,67,35.8,16,43,37.2,8,24,33.3,19,28,67.9,17,27,44,13,18,23,20,3,75,1
3723,86485,116_06_02,BELGIUM,0,TOTALS,BELGIUM,225,28,66,42.4,26,53,49.1,2,13,15.4,8,11,72.7,11,30,41,8,23,29,15,4,66,0
3724,86498,116_06_03,ESTONIA,0,TOTALS,ESTONIA,200,28,82,34.1,20,51,39.2,8,31,25.8,13,21,61.9,23,26,49,12,34,19,10,3,77,0
3725,86511,116_06_03,GEORGIA,0,TOTALS,GEORGIA,200,27,61,44.3,26,53,49.1,1,8,12.5,35,56,62.5,17,36,53,11,22,17,15,9,90,1
3726,86524,116_06_04,AUSTRIA,0,TOTALS,AUSTRIA,200,33,80,41.2,29,65,44.6,4,15,26.7,8,21,38.1,26,28,54,8,18,20,18,8,78,1
3727,86535,116_06_04,NORWAY,0,TOTALS,NORWAY,200,22,60,36.7,18,43,41.9,4,17,23.5,10,16,62.5,14,26,40,4,18,28,9,0,58,0
3728,86548,116_06_05,HUNGARY,0,TOTALS,HUNGARY,200,26,62,41.9,24,43,55.8,2,19,10.5,8,15,53.3,12,30,42,11,18,29,11,2,62,0
3729,86561,116_06_05,BULGARIA,0,TOTALS,BULGARIA,200,31,74,41.9,22,46,47.8,9,28,32.1,10,19,52.6,19,26,45,12,19,21,17,4,81,1
3730,86574,116_06_06,BELGIUM,0,TOTALS,BELGIUM,200,25,62,40.3,17,39,43.6,8,23,34.8,10,18,55.6,8,30,38,19,22,13,7,2,68,1
3731,86587,116_06_06,CZECH REPUBLIC,0,TOTALS,CZECH REPUBLIC,200,23,71,32.4,16,46,34.8,7,25,28.0,12,20,60.0,19,31,50,8,21,15,6,4,65,0
3732,86600,116_06_07,SWEDEN,0,TOTALS,SWEDEN,200,32,72,44.4,24,55,43.6,8,17,47.1,8,21,38.1,15,43,58,12,11,15,7,5,80,1
3733,86613,116_06_07,ESTONIA,0,TOTALS,ESTONIA,200,20,71,28.2,12,45,26.7,8,26,30.8,5,14,35.7,13,32,45,5,18,11,10,5,53,0
3734,86626,116_06_08,GEORGIA,0,TOTALS,GEORGIA,200,21,60,35.0,18,39,46.2,3,21,14.3,17,34,50.0,21,38,59,10,20,27,10,3,62,1
3735,86639,116_06_08,AUSTRIA,0,TOTALS,AUSTRIA,200,20,68,29.4,16,51,31.4,4,17,23.5,17,22,77.3,14,27,41,9,29,18,14,1,61,0
3736,86652,116_06_09,LUXEMBOURG,0,TOTALS,LUXEMBOURG,200,22,58,37.9,16,35,45.7,6,23,26.1,8,14,57.1,7,19,26,10,15,21,14,4,58,0
3737,86665,116_06_09,BELGIUM,0,TOTALS,BELGIUM,200,31,66,47.0,25,51,49.0,6,15,40.0,13,18,72.2,17,30,47,19,11,24,13,2,81,1
3738,86678,116_06_10,FINLAND,0,TOTALS,FINLAND,200,21,63,33.3,14,34,41.2,7,29,24.1,13,28,46.4,22,32,54,11,12,19,7,0,62,1
3739,86691,116_06_10,SLOVAK REPUBLIC,0,TOTALS,SLOVAK REPUBLIC,200,22,69,31.9,19,56,33.9,3,13,23.1,5,8,62.5,14,29,43,5,20,17,9,2,52,0
3740,86704,116_06_11,CZECH REPUBLIC,0,TOTALS,CZECH REPUBLIC,200,37,71,52.1,27,47,57.4,10,24,41.7,8,12,66.7,15,23,38,19,9,13,14,2,92,1
3741,86717,116_06_11,HUNGARY,0,TOTALS,HUNGARY,200,25,67,37.3,17,40,42.5,8,27,29.6,7,8,87.5,19,20,39,14,16,21,6,3,65,0
3742,86729,116_06_12,IRELAND,0,TOTALS,IRELAND,200,23,77,29.9,14,51,27.5,9,26,34.6,5,15,33.3,21,25,46,8,13,16,16,0,60,0
3743,86742,116_06_12,POLAND,0,TOTALS,POLAND,200,28,63,44.4,24,49,49.0,4,14,28.6,1,8,12.5,13,38,51,18,19,27,9,8,61,1
3744,86755,116_06_13,NORWAY,0,TOTALS,NORWAY,225,22,69,31.9,10,36,27.8,12,33,36.4,15,26,57.7,16,24,40,6,26,18,10,1,71,0
3745,86768,116_06_13,GEORGIA,0,TOTALS,GEORGIA,225,22,63,34.9,13,31,41.9,9,32,28.1,22,34,64.7,24,34,58,8,23,27,4,9,75,1
3746,86781,116_06_14,ROMANIA,0,TOTALS,ROMANIA,200,20,62,32.3,17,39,43.6,3,23,13.0,3,5,60.0,11,19,30,9,18,31,12,3,46,0
3747,86794,116_06_14,ENGLAND,0,TOTALS,ENGLAND,200,31,70,44.3,25,59,42.4,6,11,54.5,12,22,54.5,24,30,54,13,10,30,20,2,80,1
3748,86807,116_06_15,AUSTRIA,0,TOTALS,AUSTRIA,200,28,66,42.4,24,54,44.4,4,12,33.3,9,12,75.0,12,26,38,8,15,17,10,2,69,1
3749,86820,116_06_15,SWEDEN,0,TOTALS,SWEDEN,200,26,69,37.7,23,57,40.4,3,12,25.0,9,17,52.9,21,28,49,10,16,25,11,3,64,0
3750,86833,116_06_16,NETHERLANDS,0,TOTALS,NETHERLANDS,200,24,75,32.0,18,55,32.7,6,20,30.0,11,16,68.8,23,22,45,5,22,23,9,0,65,0
3751,86846,116_06_16,BOSNIA AND HERZEGOVINA,0,TOTALS,BOSNIA AND HERZEGOVINA,200,28,64,43.8,16,38,42.1,12,26,46.2,11,25,44.0,16,27,43,8,21,26,12,4,79,1
3752,86859,116_06_17,POLAND,0,TOTALS,POLAND,200,32,59,54.2,26,47,55.3,6,12,50.0,2,9,22.2,6,29,35,19,13,18,5,6,72,1
3753,86872,116_06_17,FINLAND,0,TOTALS,FINLAND,200,24,68,35.3,17,44,38.6,7,24,29.2,6,12,50.0,20,25,45,8,13,19,6,0,61,0
3754,86885,116_06_18,BULGARIA,0,TOTALS,BULGARIA,200,23,65,35.4,15,42,35.7,8,23,34.8,13,22,59.1,11,22,33,14,20,13,16,2,67,0
3755,86898,116_06_18,CZECH REPUBLIC,0,TOTALS,CZECH REPUBLIC,200,27,61,44.3,17,37,45.9,10,24,41.7,12,19,63.2,15,34,49,14,16,22,8,3,76,1
3756,86911,116_06_19,SLOVAK REPUBLIC,0,TOTALS,SLOVAK REPUBLIC,200,28,80,35.0,24,57,42.1,4,23,17.4,6,12,50.0,23,29,52,8,23,22,10,10,66,0
3757,86923,116_06_19,IRELAND,0,TOTALS,IRELAND,200,26,62,41.9,19,41,46.3,7,21,33.3,12,23,52.2,9,32,41,7,12,20,10,0,71,1
3758,86936,116_06_20,HUNGARY,0,TOTALS,HUNGARY,200,27,71,38.0,22,51,43.1,5,20,25.0,13,24,54.2,24,34,58,8,11,19,8,5,72,1
3759,86949,116_06_20,LUXEMBOURG,0,TOTALS,LUXEMBOURG,200,23,71,32.4,15,43,34.9,8,28,28.6,7,13,53.8,16,24,40,12,23,13,10,3,61,0
3760,86962,116_06_21,BOSNIA AND HERZEGOVINA,0,TOTALS,BOSNIA AND HERZEGOVINA,200,47,85,55.3,37,68,54.4,10,17,58.8,22,28,78.6,24,31,55,8,23,12,15,2,126,0
3761,86975,116_06_21,ROMANIA,0,TOTALS,ROMANIA,200,22,74,29.7,19,54,35.2,3,20,15.0,14,24,58.3,21,15,36,10,20,20,6,1,61,1
3762,86988,116_06_22,ESTONIA,0,TOTALS,ESTONIA,200,16,58,27.6,10,32,31.2,6,26,23.1,7,14,50.0,15,26,41,11,17,25,14,11,45,0
3763,87001,116_06_22,AUSTRIA,0,TOTALS,AUSTRIA,200,24,62,38.7,19,49,38.8,5,13,38.5,9,15,60.0,13,29,42,9,20,21,18,3,62,1
3764,87014,116_06_23,ENGLAND,0,TOTALS,ENGLAND,200,24,63,38.1,20,50,40.0,4,13,30.8,13,16,81.2,14,36,50,9,21,24,16,5,65,1
3765,87027,116_06_23,NETHERLANDS,0,TOTALS,NETHERLANDS,200,18,60,30.0,13,38,34.2,5,22,22.7,11,22,50.0,11,27,38,5,20,27,7,3,52,0
3766,87040,116_06_24,SWEDEN,0,TOTALS,SWEDEN,200,15,65,23.1,10,29,34.5,5,36,13.9,20,31,64.5,30,31,61,4,23,23,6,3,55,0
3767,87053,116_06_24,NORWAY,0,TOTALS,NORWAY,200,19,53,35.8,13,33,39.4,6,20,30.0,16,28,57.1,10,24,34,7,26,15,13,2,60,1
3768,87066,116_06_25,LUXEMBOURG,0,TOTALS,LUXEMBOURG,200,19,64,29.7,15,47,31.9,4,17,23.5,3,5,60.0,9,17,26,13,18,22,10,2,45,0
3769,87079,116_06_25,BULGARIA,0,TOTALS,BULGARIA,200,35,63,55.6,26,40,65.0,9,23,39.1,15,20,75.0,14,37,51,18,11,21,12,6,94,1
3770,87092,116_06_26,FINLAND,0,TOTALS,FINLAND,200,33,74,44.6,23,41,56.1,10,33,30.3,1,1,100.0,19,31,50,13,19,20,8,2,77,1
3771,87104,116_06_26,IRELAND,0,TOTALS,IRELAND,200,22,55,40.0,17,33,51.5,5,22,22.7,7,12,58.3,4,22,26,10,6,19,7,0,56,0
3772,87117,116_06_27,BELGIUM,0,TOTALS,BELGIUM,250,37,90,41.1,34,67,50.7,3,23,13.0,14,28,50.0,22,42,64,17,24,18,14,8,91,1
3773,87130,116_06_27,HUNGARY,0,TOTALS,HUNGARY,250,25,82,30.5,21,65,32.3,4,17,23.5,24,34,70.6,16,37,53,3,24,19,8,7,78,0
3774,87143,116_06_28,POLAND,0,TOTALS,POLAND,200,24,60,40.0,22,47,46.8,2,13,15.4,11,24,45.8,21,37,58,10,23,36,7,10,61,0
3775,87156,116_06_28,SLOVAK REPUBLIC,0,TOTALS,SLOVAK REPUBLIC,200,31,82,37.8,30,70,42.9,1,12,8.3,16,28,57.1,17,21,38,7,22,11,22,5,79,1
3776,87169,116_06_29,NORWAY,0,TOTALS,NORWAY,200,18,61,29.5,15,38,39.5,3,23,13.0,14,24,58.3,22,25,47,5,16,26,9,2,53,0
3777,87182,116_06_29,ESTONIA,0,TOTALS,ESTONIA,200,29,67,43.3,21,40,52.5,8,27,29.6,5,13,38.5,13,25,38,13,21,20,13,1,71,1
3778,87195,116_06_30,ROMANIA,0,TOTALS,ROMANIA,200,22,60,36.7,19,50,38.0,3,10,30.0,5,14,35.7,10,19,29,13,30,30,7,6,52,0
3779,87208,116_06_30,NETHERLANDS,0,TOTALS,NETHERLANDS,200,34,86,39.5,28,70,40.0,6,16,37.5,23,45,51.1,40,33,73,12,18,23,13,1,97,1
3780,87221,116_06_31,GEORGIA,0,TOTALS,GEORGIA,200,28,64,43.8,27,55,49.1,1,9,11.1,16,22,72.7,9,25,34,16,20,13,14,1,73,0
3781,87234,116_06_31,SWEDEN,0,TOTALS,SWEDEN,200,28,64,43.8,22,44,50.0,6,20,30.0,18,26,69.2,14,28,42,11,15,16,4,0,80,1
3782,87247,116_06_32,BOSNIA AND HERZEGOVINA,0,TOTALS,BOSNIA AND HERZEGOVINA,200,24,66,36.4,17,41,41.5,7,25,28.0,19,31,61.3,17,32,49,9,18,20,10,4,74,1
3783,87260,116_06_32,ENGLAND,0,TOTALS,ENGLAND,200,21,74,28.4,17,58,29.3,4,16,25.0,10,13,76.9,19,29,48,11,25,23,10,1,56,0
3784,87273,116_06_33,SLOVAK REPUBLIC,0,TOTALS,SLOVAK REPUBLIC,200,21,71,29.6,18,52,34.6,3,19,15.8,16,25,64.0,24,23,47,5,22,23,17,3,61,1
3785,87286,116_06_33,NORWAY,0,TOTALS,NORWAY,200,22,55,40.0,20,37,54.1,2,18,11.1,13,18,72.2,12,31,43,6,17,32,13,0,59,0
3786,87299,116_06_34,GEORGIA,0,TOTALS,GEORGIA,200,26,59,44.1,23,48,47.9,3,11,27.3,17,36,47.2,15,35,50,12,13,18,13,8,72,1
3787,87312,116_06_34,ENGLAND,0,TOTALS,ENGLAND,200,16,69,23.2,13,56,23.2,3,13,23.1,9,10,90.0,18,24,42,6,27,20,6,1,44,0
3788,87325,116_06_35,HUNGARY,0,TOTALS,HUNGARY,200,27,79,34.2,20,57,35.1,7,22,31.8,11,15,73.3,23,26,49,8,16,11,11,9,72,1
3789,87338,116_06_35,NETHERLANDS,0,TOTALS,NETHERLANDS,200,25,73,34.2,18,55,32.7,7,18,38.9,10,20,50.0,27,31,58,3,14,19,5,1,67,0
3790,87351,116_06_36,FINLAND,0,TOTALS,FINLAND,200,32,71,45.1,21,42,50.0,11,29,37.9,9,13,69.2,14,17,31,16,20,10,14,0,84,1
3791,87364,116_06_36,CZECH REPUBLIC,0,TOTALS,CZECH REPUBLIC,200,32,56,57.1,29,46,63.0,3,10,30.0,7,16,43.8,11,26,37,12,20,21,7,3,74,0
3792,87377,116_06_37,ROMANIA,0,TOTALS,ROMANIA,200,25,68,36.8,20,49,40.8,5,19,26.3,12,22,54.5,23,30,53,4,16,28,9,5,67,0
3793,87390,116_06_37,LUXEMBOURG,0,TOTALS,LUXEMBOURG,200,34,75,45.3,26,54,48.1,8,21,38.1,9,20,45.0,16,23,39,15,20,15,20,3,85,1
3794,87403,116_06_38,AUSTRIA,0,TOTALS,AUSTRIA,200,26,66,39.4,22,46,47.8,4,20,20.0,13,22,59.1,15,34,49,11,17,19,13,3,69,1
3795,87416,116_06_38,BOSNIA AND HERZEGOVINA,0,TOTALS,BOSNIA AND HERZEGOVINA,200,21,69,30.4,18,50,36.0,3,19,15.8,7,10,70.0,17,29,46,8,22,23,4,1,52,0
3796,87429,116_06_39,ESTONIA,0,TOTALS,ESTONIA,200,31,62,50.0,25,41,61.0,6,21,28.6,8,18,44.4,13,48,61,17,22,30,7,4,76,1
3797,87441,116_06_39,IRELAND,0,TOTALS,IRELAND,200,20,81,24.7,14,47,29.8,6,34,17.6,10,18,55.6,16,22,38,8,15,12,17,0,56,0
3798,87454,116_06_40,POLAND,0,TOTALS,POLAND,200,19,53,35.8,14,38,36.8,5,15,33.3,9,16,56.2,10,29,39,9,23,27,5,3,52,0
3799,87467,116_06_40,BULGARIA,0,TOTALS,BULGARIA,200,32,66,48.5,27,47,57.4,5,19,26.3,18,29,62.1,10,25,35,16,19,16,17,2,87,1
3800,87480,116_06_41,SWEDEN,0,TOTALS,SWEDEN,200,32,79,40.5,23,49,46.9,9,30,30.0,8,15,53.3,27,33,60,12,11,13,8,3,81,1
3801,87493,116_06_41,HUNGARY,0,TOTALS,HUNGARY,200,18,64,28.1,16,44,36.4,2,20,10.0,7,10,70.0,14,25,39,7,15,19,8,4,45,0
3802,87506,116_06_42,CZECH REPUBLIC,0,TOTALS,CZECH REPUBLIC,200,25,67,37.3,21,55,38.2,4,12,33.3,16,25,64.0,21,24,45,9,14,16,8,3,70,1
3803,87519,116_06_42,GEORGIA,0,TOTALS,GEORGIA,200,25,63,39.7,20,38,52.6,5,25,20.0,10,11,90.9,13,26,39,12,22,17,9,5,65,0
3804,87532,116_06_43,NETHERLANDS,0,TOTALS,NETHERLANDS,200,48,91,52.7,40,71,56.3,8,20,40.0,16,26,61.5,30,45,75,14,23,26,14,1,120,0
3805,87545,116_06_43,SLOVAK REPUBLIC,0,TOTALS,SLOVAK REPUBLIC,200,22,77,28.6,19,63,30.2,3,14,21.4,17,25,68.0,13,18,31,8,20,23,13,3,64,1
3806,87558,116_06_44,ENGLAND,0,TOTALS,ENGLAND,200,25,61,41.0,19,41,46.3,6,20,30.0,8,14,57.1,20,32,52,10,9,19,1,1,64,1
3807,87571,116_06_44,FINLAND,0,TOTALS,FINLAND,200,23,62,37.1,12,25,48.0,11,37,29.7,6,9,66.7,9,18,27,14,19,11,8,1,63,0
3808,87584,116_06_45,BELGIUM,0,TOTALS,BELGIUM,200,31,71,43.7,30,65,46.2,1,6,16.7,8,17,47.1,11,41,52,11,15,20,19,4,71,1
3809,87597,116_06_45,ESTONIA,0,TOTALS,ESTONIA,200,18,66,27.3,11,46,23.9,7,20,35.0,8,19,42.1,13,34,47,7,21,25,11,4,51,0
3810,87610,116_06_46,BULGARIA,0,TOTALS,BULGARIA,200,24,70,34.3,16,38,42.1,8,32,25.0,9,13,69.2,10,9,19,13,17,13,20,2,65,0
3811,87623,116_06_46,AUSTRIA,0,TOTALS,AUSTRIA,200,26,44,59.1,19,30,63.3,7,14,50.0,9,13,69.2,10,37,47,13,17,37,5,3,68,1
3812,87635,116_06_47,IRELAND,0,TOTALS,IRELAND,200,22,75,29.3,19,52,36.5,3,23,13.0,14,32,43.8,19,27,46,2,17,15,24,0,61,1
3813,87648,116_06_47,ROMANIA,0,TOTALS,ROMANIA,200,24,60,40.0,21,48,43.8,3,12,25.0,6,18,33.3,13,41,54,8,23,32,5,2,57,0
3814,87661,116_06_48,BOSNIA AND HERZEGOVINA,0,TOTALS,BOSNIA AND HERZEGOVINA,200,18,71,25.4,16,58,27.6,2,13,15.4,6,16,37.5,15,23,38,4,15,9,5,1,44,0
3815,87674,116_06_48,POLAND,0,TOTALS,POLAND,200,28,67,41.8,24,54,44.4,4,13,30.8,12,23,52.2,19,41,60,12,16,15,4,5,72,1
3816,87687,116_06_49,NORWAY,0,TOTALS,NORWAY,200,30,64,46.9,29,52,55.8,1,12,8.3,18,25,72.0,11,25,36,6,13,19,15,3,79,1
3817,87700,116_06_49,NETHERLANDS,0,TOTALS,NETHERLANDS,200,32,73,43.8,25,51,49.0,7,22,31.8,6,11,54.5,18,27,45,14,23,24,9,2,77,0
3818,87713,116_06_50,GEORGIA,0,TOTALS,GEORGIA,200,26,60,43.3,24,51,47.1,2,9,22.2,10,16,62.5,12,27,39,12,16,19,14,3,64,1
3819,87726,116_06_50,FINLAND,0,TOTALS,FINLAND,200,23,58,39.7,16,36,44.4,7,22,31.8,7,12,58.3,10,23,33,16,18,22,10,0,60,0
3820,87739,116_06_51,SLOVAK REPUBLIC,0,TOTALS,SLOVAK REPUBLIC,200,22,61,36.1,18,41,43.9,4,20,20.0,17,21,81.0,7,22,29,5,25,14,15,0,65,0
3821,87752,116_06_51,SWEDEN,0,TOTALS,SWEDEN,200,25,74,33.8,19,52,36.5,6,22,27.3,22,29,75.9,28,32,60,9,15,18,6,0,78,1
3822,87765,116_06_52,CZECH REPUBLIC,0,TOTALS,CZECH REPUBLIC,200,31,63,49.2,24,43,55.8,7,20,35.0,7,18,38.9,10,35,45,13,14,19,11,10,76,1
3823,87778,116_06_52,ENGLAND,0,TOTALS,ENGLAND,200,25,75,33.3,23,63,36.5,2,12,16.7,6,13,46.2,19,26,45,6,15,21,12,3,58,0
3824,87791,116_06_53,LUXEMBOURG,0,TOTALS,LUXEMBOURG,200,31,61,50.8,29,52,55.8,2,9,22.2,5,11,45.5,12,43,55,11,26,27,7,8,69,1
3825,87803,116_06_53,IRELAND,0,TOTALS,IRELAND,200,14,60,23.3,12,47,25.5,2,13,15.4,20,39,51.3,10,21,31,4,12,12,10,1,50,0
3826,87816,116_06_54,AUSTRIA,0,TOTALS,AUSTRIA,200,21,61,34.4,17,50,34.0,4,11,36.4,9,21,42.9,14,24,38,7,18,14,13,3,55,1
3827,87829,116_06_54,POLAND,0,TOTALS,POLAND,200,16,53,30.2,14,26,53.8,2,27,7.4,11,17,64.7,13,31,44,4,21,21,5,7,45,0
3828,87842,116_06_55,ROMANIA,0,TOTALS,ROMANIA,200,18,58,31.0,12,44,27.3,6,14,42.9,8,14,57.1,14,20,34,7,17,27,8,1,50,0
3829,87855,116_06_55,BELGIUM,0,TOTALS,BELGIUM,200,41,75,54.7,36,59,61.0,5,16,31.2,8,16,50.0,18,29,47,15,11,16,20,1,95,1
3830,87868,116_06_56,BULGARIA,0,TOTALS,BULGARIA,200,33,66,50.0,25,44,56.8,8,22,36.4,18,33,54.5,18,27,45,18,15,19,19,8,92,1
3831,87881,116_06_56,BOSNIA AND HERZEGOVINA,0,TOTALS,BOSNIA AND HERZEGOVINA,200,21,65,32.3,18,53,34.0,3,12,25.0,12,20,60.0,20,22,42,4,21,28,12,3,57,0
3832,87894,116_06_57,HUNGARY,0,TOTALS,HUNGARY,200,34,68,50.0,30,54,55.6,4,14,28.6,21,33,63.6,13,34,47,15,19,20,9,13,93,1
3833,87907,116_06_57,SLOVAK REPUBLIC,0,TOTALS,SLOVAK REPUBLIC,200,27,81,33.3,22,61,36.1,5,20,25.0,16,25,64.0,25,26,51,10,27,17,8,4,75,0
3834,87920,116_06_58,SWEDEN,0,TOTALS,SWEDEN,200,29,77,37.7,17,47,36.2,12,30,40.0,6,11,54.5,24,40,64,14,13,16,8,8,76,1
3835,87933,116_06_58,NORWAY,0,TOTALS,NORWAY,200,14,70,20.0,8,44,18.2,6,26,23.1,11,12,91.7,16,27,43,7,13,14,9,3,45,0
3836,87946,116_06_59,ESTONIA,0,TOTALS,ESTONIA,200,37,90,41.1,28,66,42.4,9,24,37.5,18,27,66.7,25,33,58,11,19,16,24,3,101,0
3837,87959,116_06_59,ROMANIA,0,TOTALS,ROMANIA,200,21,65,32.3,19,51,37.3,2,14,14.3,13,21,61.9,13,25,38,7,22,31,11,2,57,1
3838,87972,116_06_60,BELGIUM,0,TOTALS,BELGIUM,200,35,48,72.9,32,43,74.4,3,5,60.0,17,26,65.4,8,29,37,13,19,22,8,2,90,1
3839,87985,116_06_60,LUXEMBOURG,0,TOTALS,LUXEMBOURG,200,17,47,36.2,15,33,45.5,2,14,14.3,14,22,63.6,3,10,13,6,23,23,8,1,50,0
3840,87998,116_06_61,ENGLAND,0,TOTALS,ENGLAND,200,28,87,32.2,23,68,33.8,5,19,26.3,5,10,50.0,19,18,37,7,32,10,5,3,66,0
3841,88011,116_06_61,BOSNIA AND HERZEGOVINA,0,TOTALS,BOSNIA AND HERZEGOVINA,200,31,73,42.5,26,50,52.0,5,23,21.7,31,41,75.6,30,40,70,17,16,17,6,2,98,1
3842,88024,116_06_62,NETHERLANDS,0,TOTALS,NETHERLANDS,200,27,65,41.5,24,54,44.4,3,11,27.3,10,19,52.6,15,33,48,10,19,22,7,5,67,0
3843,88037,116_06_62,SWEDEN,0,TOTALS,SWEDEN,200,29,87,33.3,24,66,36.4,5,21,23.8,9,13,69.2,26,27,53,10,14,17,11,8,72,1
3844,88050,116_06_63,FINLAND,0,TOTALS,FINLAND,200,20,58,34.5,13,33,39.4,7,25,28.0,13,25,52.0,8,31,39,8,23,20,13,0,60,1
3845,88063,116_06_63,POLAND,0,TOTALS,POLAND,200,19,61,31.1,18,43,41.9,1,18,5.6,9,15,60.0,14,32,46,7,23,24,12,6,48,0
3846,88076,116_06_64,NORWAY,0,TOTALS,NORWAY,200,21,71,29.6,10,31,32.3,11,40,27.5,17,21,81.0,19,19,38,11,25,14,14,2,70,0
3847,88089,116_06_64,HUNGARY,0,TOTALS,HUNGARY,200,24,51,47.1,20,35,57.1,4,16,25.0,29,36,80.6,11,32,43,13,22,21,8,6,81,1
3848,88102,116_06_65,CZECH REPUBLIC,0,TOTALS,CZECH REPUBLIC,250,34,75,45.3,29,56,51.8,5,19,26.3,17,27,63.0,17,37,54,13,16,24,9,2,90,1
3849,88115,116_06_65,BULGARIA,0,TOTALS,BULGARIA,250,32,84,38.1,24,48,50.0,8,36,22.2,16,20,80.0,14,28,42,12,18,16,19,4,88,0
3850,88127,116_06_66,IRELAND,0,TOTALS,IRELAND,200,17,64,26.6,14,52,26.9,3,12,25.0,14,20,70.0,12,19,31,0,7,22,5,1,51,0
3851,88140,116_06_66,BELGIUM,0,TOTALS,BELGIUM,200,33,61,54.1,28,51,54.9,5,10,50.0,7,10,70.0,10,36,46,12,18,25,14,4,78,1
3852,88153,116_06_67,GEORGIA,0,TOTALS,GEORGIA,200,26,52,50.0,20,39,51.3,6,13,46.2,13,22,59.1,12,29,41,15,19,31,9,4,71,1
3853,88166,116_06_67,AUSTRIA,0,TOTALS,AUSTRIA,200,23,70,32.9,18,50,36.0,5,20,25.0,14,22,63.6,18,18,36,12,21,18,18,2,65,0
3854,88179,116_06_68,LUXEMBOURG,0,TOTALS,LUXEMBOURG,200,27,70,38.6,22,50,44.0,5,20,25.0,10,18,55.6,17,15,32,2,25,15,14,1,69,0
3855,88192,116_06_68,ESTONIA,0,TOTALS,ESTONIA,200,26,45,57.8,15,27,55.6,11,18,61.1,20,34,58.8,11,29,40,8,20,26,9,5,83,1
3856,88205,116_06_69,SLOVAK REPUBLIC,0,TOTALS,SLOVAK REPUBLIC,200,39,88,44.3,33,70,47.1,6,18,33.3,25,32,78.1,22,18,40,16,14,10,28,4,109,0
3857,88218,116_06_69,ROMANIA,0,TOTALS,ROMANIA,200,27,61,44.3,24,49,49.0,3,12,25.0,7,13,53.8,15,31,46,15,23,40,5,8,64,1
3858,88231,116_06_70,ENGLAND,0,TOTALS,ENGLAND,200,22,64,34.4,19,51,37.3,3,13,23.1,4,9,44.4,9,25,34,10,23,23,13,0,51,0
3859,88244,116_06_70,POLAND,0,TOTALS,POLAND,200,32,61,52.5,24,43,55.8,8,18,44.4,15,19,78.9,7,35,42,20,18,22,14,8,87,1
3860,88257,116_06_71,NETHERLANDS,0,TOTALS,NETHERLANDS,200,23,73,31.5,18,55,32.7,5,18,27.8,24,37,64.9,30,33,63,4,9,18,11,0,75,1
3861,88270,116_06_71,LUXEMBOURG,0,TOTALS,LUXEMBOURG,200,27,66,40.9,20,38,52.6,7,28,25.0,2,5,40.0,6,24,30,10,25,16,9,7,63,0
3862,88283,116_06_72,BOSNIA AND HERZEGOVINA,0,TOTALS,BOSNIA AND HERZEGOVINA,200,36,75,48.0,31,53,58.5,5,22,22.7,12,17,70.6,18,29,47,10,22,20,10,3,89,1
3863,88296,116_06_72,FINLAND,0,TOTALS,FINLAND,200,28,66,42.4,21,42,50.0,7,24,29.2,13,21,61.9,14,21,35,15,19,17,14,0,76,0
3864,88309,116_06_73,HUNGARY,0,TOTALS,HUNGARY,200,35,69,50.7,24,48,50.0,11,21,52.4,13,22,59.1,15,26,41,11,17,19,13,1,94,1
3865,88322,116_06_73,ESTONIA,0,TOTALS,ESTONIA,200,27,70,38.6,18,41,43.9,9,29,31.0,12,23,52.2,19,22,41,8,17,19,14,3,75,0
3866,88335,116_06_74,BULGARIA,0,TOTALS,BULGARIA,225,28,73,38.4,17,36,47.2,11,37,29.7,18,25,72.0,18,27,45,20,18,20,16,4,85,1
3867,88348,116_06_74,AUSTRIA,0,TOTALS,AUSTRIA,225,28,68,41.2,21,45,46.7,7,23,30.4,12,16,75.0,14,28,42,12,17,24,13,6,75,0
3868,88361,116_06_75,SWEDEN,0,TOTALS,SWEDEN,200,24,61,39.3,21,47,44.7,3,14,21.4,22,29,75.9,18,29,47,3,16,16,10,3,73,1
3869,88374,116_06_75,BELGIUM,0,TOTALS,BELGIUM,200,25,64,39.1,21,48,43.8,4,16,25.0,6,13,46.2,13,20,33,5,26,14,8,2,60,0
3870,88387,116_06_76,CZECH REPUBLIC,0,TOTALS,CZECH REPUBLIC,200,27,65,41.5,21,49,42.9,6,16,37.5,7,14,50.0,13,31,44,14,18,14,7,4,67,1
3871,88400,116_06_76,GEORGIA,0,TOTALS,GEORGIA,200,19,66,28.8,16,47,34.0,3,19,15.8,13,22,59.1,21,28,49,4,16,16,6,4,54,0
3872,88413,117_06_01,CYPRUS,0,TOTALS,CYPRUS,200,24,63,38.1,19,45,42.2,5,18,27.8,9,22,40.9,12,26,38,13,20,23,14,5,62,1
3873,88426,117_06_01,MALTA,0,TOTALS,MALTA,200,12,59,20.3,10,49,20.4,2,10,20.0,9,21,42.9,10,26,36,3,21,29,8,3,35,0
3874,88439,117_06_02,LUXEMBOURG,0,TOTALS,LUXEMBOURG,200,42,91,46.2,35,68,51.5,7,23,30.4,13,27,48.1,28,21,49,13,27,16,25,0,104,0
3875,88452,117_06_02,SAN MARINO,0,TOTALS,SAN MARINO,200,13,40,32.5,13,34,38.2,0,6,0.0,13,25,52.0,9,21,30,3,22,41,5,1,39,1
3876,88465,117_06_03,SCOTLAND,0,TOTALS,SCOTLAND,200,48,82,58.5,47,79,59.5,1,3,33.3,4,16,25.0,16,24,40,21,22,26,19,4,101,0
3877,88478,117_06_03,WALES,0,TOTALS,WALES,200,20,59,33.9,20,40,50.0,0,19,0.0,8,17,47.1,5,17,22,8,20,37,12,0,48,1
3878,88491,117_06_04,ANDORRA,0,TOTALS,ANDORRA,200,21,84,25.0,16,63,25.4,5,21,23.8,12,20,60.0,24,25,49,8,26,26,13,4,59,0
3879,88504,117_06_04,PRINCIPALITY OF MONACO,0,TOTALS,PRINCIPALITY OF MONACO,200,25,69,36.2,25,63,39.7,0,6,0.0,15,32,46.9,16,37,53,4,16,32,6,1,65,1
3880,88517,117_06_05,WALES,0,TOTALS,WALES,200,6,39,15.4,6,28,21.4,0,11,0.0,11,24,45.8,13,19,32,2,29,68,6,2,23,1
3881,88530,117_06_05,LUXEMBOURG,0,TOTALS,LUXEMBOURG,200,47,89,52.8,45,78,57.7,2,11,18.2,21,30,70.0,23,22,45,27,24,32,44,4,117,0
3882,88543,117_06_06,PRINCIPALITY OF MONACO,0,TOTALS,PRINCIPALITY OF MONACO,200,22,60,36.7,19,54,35.2,3,6,50.0,8,15,53.3,9,14,23,9,12,26,4,0,55,0
3883,88556,117_06_06,CYPRUS,0,TOTALS,CYPRUS,200,31,66,47.0,27,51,52.9,4,15,26.7,8,10,80.0,12,30,42,17,19,29,16,1,74,1
3884,88569,117_06_07,SAN MARINO,0,TOTALS,SAN MARINO,200,23,57,40.4,23,50,46.0,0,7,0.0,4,8,50.0,5,26,31,6,22,47,7,3,50,0
3885,88582,117_06_07,SCOTLAND,0,TOTALS,SCOTLAND,200,36,87,41.4,34,78,43.6,2,9,22.2,14,33,42.4,23,21,44,13,19,16,24,1,88,1
3886,88595,117_06_08,MALTA,0,TOTALS,MALTA,200,24,63,38.1,23,58,39.7,1,5,20.0,20,39,51.3,25,43,68,6,23,45,18,10,69,1
3887,88608,117_06_08,ANDORRA,0,TOTALS,ANDORRA,200,22,89,24.7,17,57,29.8,5,32,15.6,7,27,25.9,24,21,45,8,33,37,31,5,56,0
3888,88621,117_06_09,LUXEMBOURG,0,TOTALS,LUXEMBOURG,200,33,79,41.8,28,60,46.7,5,19,26.3,6,17,35.3,17,30,47,15,29,24,18,4,77,1
3889,88634,117_06_09,SCOTLAND,0,TOTALS,SCOTLAND,200,16,60,26.7,14,51,27.5,2,9,22.2,16,28,57.1,10,35,45,11,19,41,6,2,50,0
3890,88647,117_06_10,MALTA,0,TOTALS,MALTA,200,21,66,31.8,18,54,33.3,3,12,25.0,13,25,52.0,20,41,61,12,19,32,14,5,58,1
3891,88660,117_06_10,PRINCIPALITY OF MONACO,0,TOTALS,PRINCIPALITY OF MONACO,200,23,82,28.0,21,67,31.3,2,15,13.3,7,23,30.4,19,23,42,9,21,26,14,4,55,0
3892,88673,117_06_11,WALES,0,TOTALS,WALES,200,24,66,36.4,18,46,39.1,6,20,30.0,11,16,68.8,13,33,46,14,22,24,12,2,65,1
3893,88686,117_06_11,SAN MARINO,0,TOTALS,SAN MARINO,200,20,64,31.2,16,52,30.8,4,12,33.3,7,14,50.0,7,25,32,7,17,26,7,2,51,0
3894,88699,117_06_12,ANDORRA,0,TOTALS,ANDORRA,200,14,55,25.5,11,35,31.4,3,20,15.0,4,11,36.4,6,20,26,6,13,25,6,3,35,0
3895,88712,117_06_12,CYPRUS,0,TOTALS,CYPRUS,200,30,69,43.5,28,58,48.3,2,11,18.2,6,17,35.3,16,32,48,9,8,22,14,2,68,1
3896,88725,117_06_13,PRINCIPALITY OF MONACO,0,TOTALS,PRINCIPALITY OF MONACO,200,21,76,27.6,21,75,28.0,0,1,0.0,7,18,38.9,17,33,50,6,30,34,11,1,49,0
3897,88738,117_06_13,SAN MARINO,0,TOTALS,SAN MARINO,200,29,68,42.6,28,61,45.9,1,7,14.3,17,42,40.5,14,39,53,12,19,27,19,2,76,1
3898,88751,117_06_14,ANDORRA,0,TOTALS,ANDORRA,200,26,86,30.2,19,67,28.4,7,19,36.8,11,39,28.2,24,21,45,9,30,27,22,5,70,1
3899,88764,117_06_14,WALES,0,TOTALS,WALES,200,21,77,27.3,21,63,33.3,0,14,0.0,26,42,61.9,29,35,64,4,29,45,15,6,68,0
3900,88777,117_06_15,CYPRUS,0,TOTALS,CYPRUS,200,23,60,38.3,18,40,45.0,5,20,25.0,3,7,42.9,11,27,38,6,11,19,6,0,54,0
3901,88790,117_06_15,SCOTLAND,0,TOTALS,SCOTLAND,200,26,76,34.2,21,57,36.8,5,19,26.3,2,7,28.6,18,29,47,16,7,14,5,3,59,1
3902,88803,117_06_16,MALTA,0,TOTALS,MALTA,200,11,40,27.5,11,31,35.5,0,9,0.0,9,26,34.6,7,24,31,2,20,62,9,4,31,1
3903,88816,117_06_16,LUXEMBOURG,0,TOTALS,LUXEMBOURG,200,41,86,47.7,31,55,56.4,10,31,32.3,16,28,57.1,26,24,50,25,26,34,41,4,108,0
3904,88829,117_06_17,PRINCIPALITY OF MONACO,0,TOTALS,PRINCIPALITY OF MONACO,200,24,75,32.0,23,66,34.8,1,9,11.1,5,21,23.8,22,15,37,9,14,24,20,3,54,0
3905,88842,117_06_17,WALES,0,TOTALS,WALES,200,22,52,42.3,17,40,42.5,5,12,41.7,7,12,58.3,11,28,39,11,17,43,12,7,56,1
3906,88855,117_06_18,SAN MARINO,0,TOTALS,SAN MARINO,200,28,74,37.8,25,62,40.3,3,12,25.0,12,22,54.5,19,36,55,7,21,36,14,3,71,1
3907,88868,117_06_18,ANDORRA,0,TOTALS,ANDORRA,200,24,86,27.9,19,67,28.4,5,19,26.3,14,27,51.9,20,25,45,4,20,24,20,4,67,0
3908,88881,117_06_19,CYPRUS,0,TOTALS,CYPRUS,200,24,74,32.4,21,56,37.5,3,18,16.7,8,29,27.6,23,33,56,9,19,24,7,6,59,1
3909,88894,117_06_19,MALTA,0,TOTALS,MALTA,200,15,64,23.4,12,45,26.7,3,19,15.8,9,23,39.1,16,30,46,5,22,27,7,2,42,0
3910,88907,117_06_20,SCOTLAND,0,TOTALS,SCOTLAND,200,28,67,41.8,25,56,44.6,3,11,27.3,10,25,40.0,14,29,43,14,14,23,7,3,69,0
3911,88920,117_06_20,LUXEMBOURG,0,TOTALS,LUXEMBOURG,200,36,80,45.0,33,66,50.0,3,14,21.4,10,17,58.8,15,24,39,15,27,15,12,4,85,1
3912,93745,126_07_01,LITHUANIA,0,TOTALS,LITHUANIA,200,33,69,47.8,25,49,51.0,8,20,40.0,8,15,53.3,15,22,37,19,27,20,9,1,82,0
3913,93758,126_07_01,FRANCE,0,TOTALS,FRANCE,200,28,62,45.2,25,49,51.0,3,13,23.1,26,34,76.5,14,16,30,8,22,16,15,7,85,1
3914,93771,126_07_02,BRAZIL,0,TOTALS,BRAZIL,200,25,60,41.7,19,39,48.7,6,21,28.6,27,46,58.7,22,24,46,14,25,18,17,2,83,1
3915,93784,126_07_02,LEBANON,0,TOTALS,LEBANON,200,25,50,50.0,20,37,54.1,5,13,38.5,12,31,38.7,11,23,34,14,32,26,4,1,67,0
3916,93797,126_07_03,NIGERIA,0,TOTALS,NIGERIA,200,23,80,28.7,19,53,35.8,4,27,14.8,10,16,62.5,24,30,54,14,16,21,9,7,60,0
3917,93810,126_07_03,CANADA,0,TOTALS,CANADA,200,32,70,45.7,20,44,45.5,12,26,46.2,6,12,50.0,9,34,43,16,13,15,7,3,82,1
3918,93823,126_07_04,PUERTO RICO,0,TOTALS,PUERTO RICO,200,31,72,43.1,19,46,41.3,12,26,46.2,15,27,55.6,9,22,31,12,26,8,10,1,89,0
3919,93836,126_07_04,SPAIN,0,TOTALS,SPAIN,200,32,65,49.2,24,38,63.2,8,27,29.6,19,35,54.3,13,35,48,17,23,15,5,2,91,1
3920,93849,126_07_05,MALI,0,TOTALS,MALI,200,19,70,27.1,15,50,30.0,4,20,20.0,14,17,82.4,17,10,27,9,24,17,10,0,56,1
3921,93862,126_07_05,USA,0,TOTALS,USA,200,45,68,66.2,37,46,80.4,8,22,36.4,20,30,66.7,17,34,51,22,18,15,8,10,118,0
3922,93875,126_07_06,CHINA,0,TOTALS,CHINA,200,21,55,38.2,16,36,44.4,5,19,26.3,14,19,73.7,9,26,35,8,23,23,3,4,61,0
3923,93888,126_07_06,SERBIA,0,TOTALS,SERBIA,200,31,71,43.7,25,46,54.3,6,25,24.0,10,22,45.5,19,26,45,17,22,13,13,5,78,1
3924,93901,126_07_07,TURKEY,0,TOTALS,TURKEY,200,25,67,37.3,20,46,43.5,5,21,23.8,10,16,62.5,20,21,41,13,26,26,12,0,65,0
3925,93914,126_07_07,AUSTRALIA,0,TOTALS,AUSTRALIA,200,27,52,51.9,23,38,60.5,4,14,28.6,19,30,63.3,6,22,28,14,20,22,19,2,77,1
3926,93927,126_07_08,ARGENTINA,0,TOTALS,ARGENTINA,200,32,71,45.1,25,50,50.0,7,21,33.3,20,27,74.1,14,28,42,19,26,14,10,1,91,1
3927,93940,126_07_08,KOREA,0,TOTALS,KOREA,200,28,70,40.0,18,41,43.9,10,29,34.5,19,25,76.0,18,26,44,16,25,18,3,3,85,0
3928,93953,126_07_09,LEBANON,0,TOTALS,LEBANON,200,23,64,35.9,17,49,34.7,6,15,40.0,17,34,50.0,13,27,40,8,22,21,15,3,69,1
3929,93966,126_07_09,LITHUANIA,0,TOTALS,LITHUANIA,200,40,77,51.9,27,46,58.7,13,31,41.9,12,20,60.0,15,36,51,24,29,18,20,7,105,0
3930,93979,126_07_10,FRANCE,0,TOTALS,FRANCE,200,35,59,59.3,29,42,69.0,6,17,35.3,22,28,78.6,6,30,36,16,23,20,11,7,98,1
3931,93992,126_07_10,BRAZIL,0,TOTALS,BRAZIL,200,24,70,34.3,19,46,41.3,5,24,20.8,20,30,66.7,22,19,41,8,25,24,11,2,73,0
3932,94005,126_07_11,AUSTRALIA,0,TOTALS,AUSTRALIA,200,28,63,44.4,21,46,45.7,7,17,41.2,14,24,58.3,11,21,32,16,21,16,18,4,77,1
3933,94018,126_07_11,NIGERIA,0,TOTALS,NIGERIA,200,29,70,41.4,26,50,52.0,3,20,15.0,12,22,54.5,23,25,48,15,26,24,18,5,73,0
3934,94031,126_07_12,KOREA,0,TOTALS,KOREA,200,33,78,42.3,20,33,60.6,13,45,28.9,19,26,73.1,19,22,41,15,20,12,8,7,98,1
3935,94044,126_07_12,PUERTO RICO,0,TOTALS,PUERTO RICO,200,36,76,47.4,30,51,58.8,6,25,24.0,16,28,57.1,17,24,41,12,26,16,6,1,94,0
3936,94057,126_07_13,SERBIA,0,TOTALS,SERBIA,200,20,57,35.1,12,30,40.0,8,27,29.6,22,42,52.4,16,41,57,13,17,23,17,3,70,1
3937,94070,126_07_13,MALI,0,TOTALS,MALI,200,17,76,22.4,11,47,23.4,6,29,20.7,7,15,46.7,18,30,48,7,32,23,17,2,47,0
3938,94083,126_07_14,CANADA,0,TOTALS,CANADA,200,16,61,26.2,11,40,27.5,5,21,23.8,21,25,84.0,11,27,38,6,20,19,7,2,58,0
3939,94096,126_07_14,TURKEY,0,TOTALS,TURKEY,200,29,62,46.8,18,33,54.5,11,29,37.9,12,20,60.0,9,31,40,19,25,21,10,2,81,1
3940,94109,126_07_15,USA,0,TOTALS,USA,200,44,83,53.0,38,67,56.7,6,16,37.5,9,15,60.0,20,24,44,20,27,17,21,4,103,0
3941,94122,126_07_15,CHINA,0,TOTALS,CHINA,200,24,53,45.3,17,35,48.6,7,18,38.9,22,36,61.1,9,23,32,11,17,28,2,3,77,1
3942,94135,126_07_16,SPAIN,0,TOTALS,SPAIN,200,30,60,50.0,25,39,64.1,5,21,23.8,23,30,76.7,9,33,42,12,21,27,19,4,88,1
3943,94148,126_07_16,ARGENTINA,0,TOTALS,ARGENTINA,200,23,68,33.8,17,36,47.2,6,32,18.8,16,25,64.0,10,21,31,12,30,24,20,0,68,0
3944,94161,126_07_17,LITHUANIA,0,TOTALS,LITHUANIA,200,29,72,40.3,26,51,51.0,3,21,14.3,14,21,66.7,17,18,35,12,20,20,12,0,75,0
3945,94174,126_07_17,BRAZIL,0,TOTALS,BRAZIL,200,33,67,49.3,30,53,56.6,3,14,21.4,12,19,63.2,19,32,51,6,21,24,9,4,81,1
3946,94187,126_07_18,AUSTRALIA,0,TOTALS,AUSTRALIA,200,34,66,51.5,30,47,63.8,4,19,21.1,9,15,60.0,13,30,43,17,16,12,11,4,81,1
3947,94200,126_07_18,CANADA,0,TOTALS,CANADA,200,29,70,41.4,21,48,43.8,8,22,36.4,4,9,44.4,17,21,38,8,16,15,10,3,70,0
3948,94213,126_07_19,LEBANON,0,TOTALS,LEBANON,200,26,69,37.7,21,46,45.7,5,23,21.7,1,5,20.0,11,21,32,9,15,24,16,5,58,1
3949,94226,126_07_19,FRANCE,0,TOTALS,FRANCE,200,43,82,52.4,38,66,57.6,5,16,31.2,9,12,75.0,16,32,48,19,11,19,18,5,100,0
3950,94239,126_07_20,MALI,0,TOTALS,MALI,200,15,70,21.4,8,38,21.1,7,32,21.9,9,26,34.6,25,25,50,4,27,13,9,5,46,0
3951,94252,126_07_20,CHINA,0,TOTALS,CHINA,200,16,47,34.0,13,26,50.0,3,21,14.3,24,40,60.0,13,35,48,10,25,22,6,1,59,1
3952,94265,126_07_21,SERBIA,0,TOTALS,SERBIA,200,26,57,45.6,19,30,63.3,7,27,25.9,19,31,61.3,5,26,31,14,19,15,6,4,78,0
3953,94278,126_07_21,USA,0,TOTALS,USA,200,29,65,44.6,22,42,52.4,7,23,30.4,17,21,81.0,9,28,37,7,26,13,13,3,82,1
3954,94291,126_07_22,NIGERIA,0,TOTALS,NIGERIA,200,28,69,40.6,22,49,44.9,6,20,30.0,20,33,60.6,15,20,35,11,32,14,9,3,82,0
3955,94304,126_07_22,TURKEY,0,TOTALS,TURKEY,200,30,59,50.8,19,31,61.3,11,28,39.3,20,33,60.6,7,24,31,7,26,22,8,3,91,1
3956,94317,126_07_23,ARGENTINA,0,TOTALS,ARGENTINA,200,34,61,55.7,17,30,56.7,17,31,54.8,27,38,71.1,9,34,43,25,33,14,8,2,112,0
3957,94330,126_07_23,PUERTO RICO,0,TOTALS,PUERTO RICO,200,21,60,35.0,15,34,44.1,6,26,23.1,24,39,61.5,13,21,34,5,33,15,4,1,72,1
3958,94343,126_07_24,SPAIN,0,TOTALS,SPAIN,200,39,63,61.9,33,53,62.3,6,10,60.0,13,21,61.9,12,24,36,16,19,23,12,2,97,1
3959,94356,126_07_24,KOREA,0,TOTALS,KOREA,200,29,68,42.6,15,36,41.7,14,32,43.8,8,12,66.7,16,17,33,14,23,24,14,0,80,0
3960,94369,126_07_25,LEBANON,0,TOTALS,LEBANON,200,22,51,43.1,16,29,55.2,6,22,27.3,26,31,83.9,10,35,45,6,17,24,10,2,76,1
3961,94382,126_07_25,MALI,0,TOTALS,MALI,200,23,71,32.4,19,45,42.2,4,26,15.4,6,22,27.3,18,15,33,9,24,18,15,5,56,0
3962,94395,126_07_26,NIGERIA,0,TOTALS,NIGERIA,200,39,85,45.9,32,57,56.1,7,28,25.0,12,17,70.6,21,36,57,19,18,23,10,7,97,1
3963,94408,126_07_26,PUERTO RICO,0,TOTALS,PUERTO RICO,200,31,78,39.7,25,50,50.0,6,28,21.4,9,17,52.9,10,19,29,9,18,17,11,3,77,0
3964,94421,126_07_27,KOREA,0,TOTALS,KOREA,200,31,85,36.5,22,53,41.5,9,32,28.1,8,9,88.9,16,17,33,16,32,20,6,3,79,1
3965,94434,126_07_27,AUSTRALIA,0,TOTALS,AUSTRALIA,200,51,80,63.7,48,70,68.6,3,10,30.0,30,38,78.9,15,37,52,24,17,16,8,2,135,0
3966,94447,126_07_28,SPAIN,0,TOTALS,SPAIN,200,30,51,58.8,23,35,65.7,7,16,43.8,16,31,51.6,8,35,43,12,18,23,6,3,83,1
3967,94460,126_07_28,CANADA,0,TOTALS,CANADA,200,26,71,36.6,19,52,36.5,7,19,36.8,10,18,55.6,14,20,34,7,26,13,7,1,69,0
3968,94473,126_07_29,SERBIA,0,TOTALS,SERBIA,200,30,61,49.2,24,41,58.5,6,20,30.0,21,30,70.0,11,22,33,12,29,23,21,5,87,1
3969,94486,126_07_29,BRAZIL,0,TOTALS,BRAZIL,200,25,60,41.7,19,43,44.2,6,17,35.3,19,33,57.6,10,21,31,10,27,22,16,1,75,0
3970,94499,126_07_30,ARGENTINA,0,TOTALS,ARGENTINA,200,22,48,45.8,16,27,59.3,6,21,28.6,18,22,81.8,8,27,35,13,26,25,6,0,68,1
3971,94512,126_07_30,TURKEY,0,TOTALS,TURKEY,200,21,62,33.9,18,39,46.2,3,23,13.0,14,27,51.9,19,18,37,5,23,18,8,1,59,0
3972,94525,126_07_31,CHINA,0,TOTALS,CHINA,200,20,58,34.5,16,40,40.0,4,18,22.2,13,17,76.5,15,22,37,6,16,32,6,0,57,1
3973,94538,126_07_31,FRANCE,0,TOTALS,FRANCE,200,47,82,57.3,41,66,62.1,6,16,37.5,6,13,46.2,18,26,44,22,16,15,23,5,106,0
3974,94551,126_07_32,USA,0,TOTALS,USA,200,35,66,53.0,28,49,57.1,7,17,41.2,13,17,76.5,9,19,28,12,19,20,26,2,90,1
3975,94564,126_07_32,LITHUANIA,0,TOTALS,LITHUANIA,200,32,63,50.8,22,33,66.7,10,30,33.3,7,19,36.8,11,17,28,22,20,24,10,3,81,0
3976,94577,126_07_33,MALI,0,TOTALS,MALI,200,34,83,41.0,30,66,45.5,4,17,23.5,17,33,51.5,18,25,43,13,27,17,15,1,89,1
3977,94590,126_07_33,PUERTO RICO,0,TOTALS,PUERTO RICO,200,25,56,44.6,18,30,60.0,7,26,26.9,24,35,68.6,9,38,47,12,23,33,8,4,81,0
3978,94603,126_07_34,LEBANON,0,TOTALS,LEBANON,200,26,74,35.1,22,46,47.8,4,28,14.3,9,17,52.9,9,19,28,14,13,13,16,1,65,0
3979,94616,126_07_34,NIGERIA,0,TOTALS,NIGERIA,200,32,80,40.0,27,59,45.8,5,21,23.8,13,19,68.4,25,33,58,11,18,22,15,6,82,1
3980,94629,126_07_35,LITHUANIA,0,TOTALS,LITHUANIA,200,35,70,50.0,25,48,52.1,10,22,45.5,5,13,38.5,12,22,34,18,23,17,11,4,85,1
3981,94642,126_07_35,CHINA,0,TOTALS,CHINA,200,20,52,38.5,15,40,37.5,5,12,41.7,21,27,77.8,9,20,29,8,18,22,11,3,66,0
3982,94655,126_07_36,CANADA,0,TOTALS,CANADA,200,37,80,46.2,30,57,52.6,7,23,30.4,18,26,69.2,25,31,56,17,18,17,6,3,99,1
3983,94668,126_07_36,KOREA,0,TOTALS,KOREA,200,32,78,41.0,19,36,52.8,13,42,31.0,6,12,50.0,15,22,37,15,26,14,5,1,83,0
3984,94681,126_07_37,FRANCE,0,TOTALS,FRANCE,200,27,55,49.1,25,41,61.0,2,14,14.3,6,12,50.0,10,26,36,16,18,24,9,3,62,0
3985,94694,126_07_37,SERBIA,0,TOTALS,SERBIA,200,24,64,37.5,14,31,45.2,10,33,30.3,21,25,84.0,15,20,35,15,17,13,20,2,79,1
3986,94707,126_07_38,TURKEY,0,TOTALS,TURKEY,200,24,70,34.3,22,53,41.5,2,17,11.8,9,18,50.0,16,34,50,8,22,18,12,4,59,1
3987,94720,126_07_38,SPAIN,0,TOTALS,SPAIN,200,16,65,24.6,9,35,25.7,7,30,23.3,17,26,65.4,17,34,51,6,20,19,10,4,56,0
3988,94733,126_07_39,BRAZIL,0,TOTALS,BRAZIL,200,23,63,36.5,18,41,43.9,5,22,22.7,14,28,50.0,14,19,33,10,22,29,14,0,65,1
3989,94746,126_07_39,USA,0,TOTALS,USA,200,37,67,55.2,29,50,58.0,8,17,47.1,22,31,71.0,14,30,44,11,28,20,20,2,104,0
3990,94759,126_07_40,AUSTRALIA,0,TOTALS,AUSTRALIA,200,27,52,51.9,21,29,72.4,6,23,26.1,19,27,70.4,14,25,39,18,16,24,7,6,79,1
3991,94772,126_07_40,ARGENTINA,0,TOTALS,ARGENTINA,200,31,65,47.7,24,42,57.1,7,23,30.4,9,11,81.8,9,16,25,13,25,16,10,0,78,0
3992,94785,126_07_41,CHINA,0,TOTALS,CHINA,200,27,50,54.0,21,37,56.8,6,13,46.2,17,32,53.1,9,24,33,12,22,23,9,5,77,0
3993,94798,126_07_41,BRAZIL,0,TOTALS,BRAZIL,200,34,81,42.0,30,66,45.5,4,15,26.7,17,25,68.0,28,21,49,16,25,16,15,1,89,1
3994,94811,126_07_42,KOREA,0,TOTALS,KOREA,200,35,69,50.7,29,48,60.4,6,21,28.6,28,35,80.0,16,22,38,14,22,10,8,1,104,0
3995,94824,126_07_42,TURKEY,0,TOTALS,TURKEY,200,38,80,47.5,27,54,50.0,11,26,42.3,9,24,37.5,26,22,48,15,28,13,7,2,96,1
3996,94837,126_07_43,SERBIA,0,TOTALS,SERBIA,200,31,50,62.0,26,40,65.0,5,10,50.0,22,28,78.6,7,22,29,16,23,15,9,2,89,1
3997,94850,126_07_43,LITHUANIA,0,TOTALS,LITHUANIA,200,29,60,48.3,22,35,62.9,7,25,28.0,11,17,64.7,11,14,25,12,22,13,11,2,76,0
3998,94863,126_07_44,SPAIN,0,TOTALS,SPAIN,200,36,74,48.6,32,55,58.2,4,19,21.1,8,13,61.5,13,23,36,14,23,17,10,6,84,0
3999,94876,126_07_44,AUSTRALIA,0,TOTALS,AUSTRALIA,200,30,64,46.9,24,49,49.0,6,15,40.0,20,30,66.7,13,27,40,15,14,20,9,2,86,1
4000,94889,126_07_45,USA,0,TOTALS,USA,200,37,76,48.7,29,55,52.7,8,21,38.1,5,11,45.5,16,24,40,10,20,16,15,2,87,1
4001,94902,126_07_45,FRANCE,0,TOTALS,FRANCE,200,31,73,42.5,21,46,45.7,10,27,37.0,10,18,55.6,21,24,45,14,16,18,15,4,82,0
4002,94915,126_07_46,ARGENTINA,0,TOTALS,ARGENTINA,200,31,72,43.1,27,49,55.1,4,23,17.4,16,28,57.1,13,21,34,12,27,7,13,3,82,0
4003,94928,126_07_46,CANADA,0,TOTALS,CANADA,200,31,67,46.3,23,42,54.8,8,25,32.0,17,27,63.0,15,36,51,13,23,19,4,3,87,1
4004,94941,126_07_47,LITHUANIA,0,TOTALS,LITHUANIA,200,49,88,55.7,47,73,64.4,2,15,13.3,27,41,65.9,25,32,57,29,20,14,10,8,127,0
4005,94954,126_07_47,KOREA,0,TOTALS,KOREA,200,25,69,36.2,17,45,37.8,8,24,33.3,16,22,72.7,9,16,25,9,30,22,4,1,74,1
4006,94967,126_07_48,USA,0,TOTALS,USA,200,36,76,47.4,26,48,54.2,10,28,35.7,30,40,75.0,20,28,48,15,27,20,9,4,112,0
4007,94980,126_07_48,ARGENTINA,0,TOTALS,ARGENTINA,200,30,62,48.4,21,35,60.0,9,27,33.3,17,28,60.7,6,23,29,19,33,21,12,0,86,1
4008,94993,126_07_49,CHINA,0,TOTALS,CHINA,225,34,72,47.2,28,54,51.9,6,18,33.3,16,33,48.5,12,36,48,11,24,20,7,5,90,0
4009,95006,126_07_49,CANADA,0,TOTALS,CANADA,225,37,90,41.1,30,70,42.9,7,20,35.0,13,30,43.3,18,25,43,15,26,14,12,1,94,1
4010,95019,126_07_50,BRAZIL,0,TOTALS,BRAZIL,200,28,70,40.0,23,50,46.0,5,20,25.0,12,16,75.0,15,22,37,11,28,25,18,5,73,1
4011,95032,126_07_50,AUSTRALIA,0,TOTALS,AUSTRALIA,200,22,56,39.3,17,39,43.6,5,17,29.4,23,38,60.5,12,25,37,11,18,27,19,3,72,0
4012,95045,126_07_51,SERBIA,0,TOTALS,SERBIA,200,34,68,50.0,26,43,60.5,8,25,32.0,18,19,94.7,14,30,44,16,18,11,10,3,94,1
4013,95058,126_07_51,TURKEY,0,TOTALS,TURKEY,200,18,49,36.7,14,27,51.9,4,22,18.2,16,23,69.6,2,17,19,5,19,14,4,1,56,0
4014,95071,126_07_52,FRANCE,0,TOTALS,FRANCE,200,35,61,57.4,31,50,62.0,4,11,36.4,26,36,72.2,11,27,38,20,25,20,14,4,100,0
4015,95084,126_07_52,SPAIN,0,TOTALS,SPAIN,200,27,65,41.5,16,38,42.1,11,27,40.7,18,28,64.3,11,17,28,16,28,16,10,1,83,1
4016,95097,126_07_53,KOREA,0,TOTALS,KOREA,200,35,71,49.3,33,58,56.9,2,13,15.4,19,30,63.3,17,26,43,20,20,13,15,3,91,1
4017,95110,126_07_53,CHINA,0,TOTALS,CHINA,200,26,70,37.1,20,46,43.5,6,24,25.0,17,27,63.0,17,18,35,10,24,18,6,1,75,0
4018,95123,126_07_54,ARGENTINA,0,TOTALS,ARGENTINA,200,25,52,48.1,16,32,50.0,9,20,45.0,19,26,73.1,8,34,42,18,20,19,10,1,78,1
4019,95136,126_07_54,SPAIN,0,TOTALS,SPAIN,200,25,72,34.7,18,38,47.4,7,34,20.6,18,23,78.3,14,16,30,13,22,10,11,1,75,0
4020,95149,126_07_55,TURKEY,0,TOTALS,TURKEY,200,27,64,42.2,22,40,55.0,5,24,20.8,8,13,61.5,4,24,28,10,29,12,6,2,67,0
4021,95162,126_07_55,AUSTRALIA,0,TOTALS,AUSTRALIA,200,27,61,44.3,27,55,49.1,0,6,0.0,28,38,73.7,12,29,41,11,17,12,5,2,82,1
4022,95175,126_07_56,LITHUANIA,0,TOTALS,LITHUANIA,200,34,64,53.1,24,37,64.9,10,27,37.0,8,16,50.0,15,26,41,19,20,15,2,0,86,1
4023,95188,126_07_56,CANADA,0,TOTALS,CANADA,200,28,66,42.4,23,57,40.4,5,9,55.6,14,15,93.3,9,14,23,7,15,6,7,4,75,0
4024,95201,126_07_57,SERBIA,0,TOTALS,SERBIA,200,31,57,54.4,19,36,52.8,12,21,57.1,15,22,68.2,5,20,25,18,30,18,13,2,89,1
4025,95214,126_07_57,BRAZIL,0,TOTALS,BRAZIL,200,20,51,39.2,14,29,48.3,6,22,27.3,28,36,77.8,9,24,33,9,21,19,11,2,74,0
4026,95227,126_07_58,USA,0,TOTALS,USA,200,31,76,40.8,27,49,55.1,4,27,14.8,12,13,92.3,14,25,39,16,23,13,12,2,78,1
4027,95240,126_07_58,FRANCE,0,TOTALS,FRANCE,200,25,57,43.9,19,36,52.8,6,21,28.6,19,27,70.4,6,27,33,13,20,15,7,3,75,0
4028,95253,126_07_59,SPAIN,0,TOTALS,SPAIN,200,24,61,39.3,16,32,50.0,8,29,27.6,13,21,61.9,13,22,35,12,24,18,5,1,69,0
4029,95266,126_07_59,TURKEY,0,TOTALS,TURKEY,200,29,65,44.6,21,35,60.0,8,30,26.7,14,25,56.0,16,23,39,10,22,17,9,1,80,1
4030,95279,126_07_60,ARGENTINA,0,TOTALS,ARGENTINA,200,22,58,37.9,14,33,42.4,8,25,32.0,7,9,77.8,5,17,22,11,23,14,6,1,59,0
4031,95292,126_07_60,AUSTRALIA,0,TOTALS,AUSTRALIA,200,29,58,50.0,20,36,55.6,9,22,40.9,16,19,84.2,10,28,38,15,14,14,8,0,83,1
4032,95305,126_07_61,FRANCE,0,TOTALS,FRANCE,200,32,76,42.1,24,55,43.6,8,21,38.1,3,7,42.9,13,22,35,11,22,18,18,6,75,1
4033,95318,126_07_61,BRAZIL,0,TOTALS,BRAZIL,200,26,61,42.6,22,45,48.9,4,16,25.0,11,23,47.8,10,26,36,12,15,23,16,4,67,0
4034,95331,126_07_62,USA,0,TOTALS,USA,200,26,58,44.8,20,37,54.1,6,21,28.6,11,24,45.8,12,20,32,8,23,19,14,4,69,0
4035,95344,126_07_62,SERBIA,0,TOTALS,SERBIA,200,24,56,42.9,14,32,43.8,10,24,41.7,16,24,66.7,9,25,34,14,23,18,13,2,74,1
4036,96900,128_07_01,RWANDA,0,TOTALS,RWANDA,200,22,54,40.7,13,34,38.2,9,20,45.0,13,21,61.9,8,17,25,8,24,27,7,1,66,1
4037,96913,128_07_01,ANGOLA,0,TOTALS,ANGOLA,200,40,69,58.0,30,38,78.9,10,31,32.3,19,22,86.4,9,20,29,24,23,16,21,2,109,0
4038,96926,128_07_02,MOROCCO,0,TOTALS,MOROCCO,225,25,46,54.3,21,33,63.6,4,13,30.8,26,44,59.1,10,23,33,12,34,35,13,2,80,0
4039,96939,128_07_02,CAPE VERDE,0,TOTALS,CAPE VERDE,225,24,58,41.4,15,33,45.5,9,25,36.0,28,36,77.8,16,24,40,15,38,29,19,2,85,1
4040,96952,128_07_03,MALI,0,TOTALS,MALI,200,20,58,34.5,14,33,42.4,6,25,24.0,24,29,82.8,11,16,27,6,29,19,2,2,70,0
4041,96965,128_07_03,SENEGAL,0,TOTALS,SENEGAL,200,34,65,52.3,30,48,62.5,4,17,23.5,13,25,52.0,17,31,48,18,28,16,11,3,85,1
4042,96978,128_07_04,EGYPT,0,TOTALS,EGYPT,200,25,51,49.0,16,27,59.3,9,24,37.5,14,20,70.0,11,19,30,17,23,14,12,5,73,1
4043,96991,128_07_04,COTE D'IVOIRE,0,TOTALS,COTE D'IVOIRE,200,23,56,41.1,16,41,39.0,7,15,46.7,12,20,60.0,18,20,38,10,21,19,10,0,65,0
4044,97004,128_07_05,LIBERIA,0,TOTALS,LIBERIA,200,13,51,25.5,7,31,22.6,6,20,30.0,3,11,27.3,5,13,18,1,24,23,9,0,35,1
4045,97016,128_07_05,NIGERIA,0,TOTALS,NIGERIA,200,45,69,65.2,38,51,74.5,7,18,38.9,12,29,41.4,18,33,51,23,18,20,13,9,109,0
4046,97029,128_07_06,DEM.REP. OF CONGO,0,TOTALS,DEM.REP. OF CONGO,200,23,61,37.7,17,40,42.5,6,21,28.6,6,19,31.6,6,23,29,12,19,17,9,3,58,0
4047,97042,128_07_06,CAF,0,TOTALS,CAF,200,19,51,37.3,14,28,50.0,5,23,21.7,23,29,79.3,7,30,37,8,20,20,12,2,66,1
4048,97054,128_07_07,CAMEROON,0,TOTALS,CAMEROON,200,18,55,32.7,17,40,42.5,1,15,6.7,29,42,69.0,14,31,45,10,20,24,17,8,66,1
4049,97067,128_07_07,MOZAMBIQUE,0,TOTALS,MOZAMBIQUE,200,17,44,38.6,11,25,44.0,6,19,31.6,14,27,51.9,6,25,31,11,27,24,10,0,54,0
4050,97080,128_07_08,SOUTH AFRICA,0,TOTALS,SOUTH AFRICA,200,22,49,44.9,18,35,51.4,4,14,28.6,18,32,56.2,12,22,34,10,22,22,9,0,66,0
4051,97093,128_07_08,TUNISIA,0,TOTALS,TUNISIA,200,25,52,48.1,19,30,63.3,6,22,27.3,16,21,76.2,6,21,27,16,27,21,10,1,72,1
4052,97106,128_07_09,ANGOLA,0,TOTALS,ANGOLA,200,31,54,57.4,19,28,67.9,12,26,46.2,26,36,72.2,10,27,37,16,16,24,23,2,100,0
4053,97119,128_07_09,CAPE VERDE,0,TOTALS,CAPE VERDE,200,15,44,34.1,10,22,45.5,5,22,22.7,9,13,69.2,5,17,22,8,25,36,13,0,44,1
4054,97132,128_07_10,RWANDA,0,TOTALS,RWANDA,200,25,46,54.3,16,25,64.0,9,21,42.9,9,16,56.2,6,20,26,14,20,24,10,2,68,0
4055,97145,128_07_10,MOROCCO,0,TOTALS,MOROCCO,200,28,62,45.2,21,37,56.8,7,25,28.0,11,21,52.4,16,23,39,13,21,23,12,6,74,1
4056,97158,128_07_11,SENEGAL,0,TOTALS,SENEGAL,200,22,53,41.5,19,35,54.3,3,18,16.7,16,22,72.7,13,18,31,9,18,23,10,1,63,0
4057,97171,128_07_11,COTE D'IVOIRE,0,TOTALS,COTE D'IVOIRE,200,20,48,41.7,10,24,41.7,10,24,41.7,15,18,83.3,11,19,30,9,21,24,11,0,65,1
4058,97184,128_07_12,MALI,0,TOTALS,MALI,200,23,46,50.0,17,31,54.8,6,15,40.0,21,29,72.4,10,33,43,14,29,29,8,1,73,1
4059,97197,128_07_12,EGYPT,0,TOTALS,EGYPT,200,17,55,30.9,10,25,40.0,7,30,23.3,25,39,64.1,12,17,29,10,27,15,18,2,66,0
4060,97209,128_07_13,NIGERIA,0,TOTALS,NIGERIA,200,27,56,48.2,20,35,57.1,7,21,33.3,16,30,53.3,15,28,43,20,18,15,12,2,77,1
4061,97222,128_07_13,CAF,0,TOTALS,CAF,200,20,50,40.0,13,24,54.2,7,26,26.9,7,18,38.9,7,16,23,9,23,21,3,0,54,0
4062,97235,128_07_14,LIBERIA,0,TOTALS,LIBERIA,200,25,69,36.2,11,39,28.2,14,30,46.7,5,8,62.5,21,25,46,13,31,24,9,1,69,0
4063,97248,128_07_14,DEM.REP. OF CONGO,0,TOTALS,DEM.REP. OF CONGO,200,27,52,51.9,23,39,59.0,4,13,30.8,22,43,51.2,14,25,39,13,15,15,14,7,80,1
4064,97261,128_07_15,MOZAMBIQUE,0,TOTALS,MOZAMBIQUE,200,22,52,42.3,15,29,51.7,7,23,30.4,10,19,52.6,13,19,32,11,31,29,12,0,61,0
4065,97274,128_07_15,TUNISIA,0,TOTALS,TUNISIA,200,23,50,46.0,19,35,54.3,4,15,26.7,23,36,63.9,11,21,32,10,24,31,17,2,73,1
4066,97287,128_07_16,CAMEROON,0,TOTALS,CAMEROON,200,26,46,56.5,14,23,60.9,12,23,52.2,25,37,67.6,7,15,22,17,27,19,19,2,89,1
4067,97300,128_07_16,SOUTH AFRICA,0,TOTALS,SOUTH AFRICA,200,17,30,56.7,11,16,68.8,6,14,42.9,19,30,63.3,5,20,25,10,25,33,7,0,59,0
4068,97313,128_07_17,ANGOLA,0,TOTALS,ANGOLA,200,36,66,54.5,22,38,57.9,14,28,50.0,22,29,75.9,16,19,35,17,19,12,18,2,108,0
4069,97326,128_07_17,MOROCCO,0,TOTALS,MOROCCO,200,20,45,44.4,16,34,47.1,4,11,36.4,14,20,70.0,7,15,22,6,22,25,7,2,58,1
4070,97339,128_07_18,CAPE VERDE,0,TOTALS,CAPE VERDE,200,29,65,44.6,23,31,74.2,6,34,17.6,7,11,63.6,14,17,31,20,19,15,8,2,71,1
4071,97352,128_07_18,RWANDA,0,TOTALS,RWANDA,200,21,47,44.7,15,28,53.6,6,19,31.6,14,17,82.4,6,21,27,5,16,20,2,0,62,0
4072,97365,128_07_19,SENEGAL,0,TOTALS,SENEGAL,200,22,51,43.1,16,33,48.5,6,18,33.3,13,20,65.0,17,24,41,8,25,31,12,5,63,0
4073,97378,128_07_19,EGYPT,0,TOTALS,EGYPT,200,18,46,39.1,15,36,41.7,3,10,30.0,27,34,79.4,7,19,26,12,21,19,13,2,66,1
4074,97391,128_07_20,COTE D'IVOIRE,0,TOTALS,COTE D'IVOIRE,200,23,50,46.0,18,38,47.4,5,12,41.7,14,27,51.9,13,24,37,8,18,27,10,2,65,1
4075,97404,128_07_20,MALI,0,TOTALS,MALI,200,21,55,38.2,13,33,39.4,8,22,36.4,13,16,81.2,11,22,33,10,24,25,12,0,63,0
4076,97416,128_07_21,NIGERIA,0,TOTALS,NIGERIA,200,32,63,50.8,27,47,57.4,5,16,31.2,21,29,72.4,11,19,30,17,29,20,13,2,90,1
4077,97429,128_07_21,DEM.REP. OF CONGO,0,TOTALS,DEM.REP. OF CONGO,200,26,50,52.0,20,31,64.5,6,19,31.6,16,31,51.6,9,19,28,14,20,25,8,4,74,0
4078,97442,128_07_22,CAF,0,TOTALS,CAF,200,25,48,52.1,18,29,62.1,7,19,36.8,39,43,90.7,10,35,45,15,23,27,12,5,96,1
4079,97455,128_07_22,LIBERIA,0,TOTALS,LIBERIA,200,18,64,28.1,10,33,30.3,8,31,25.8,15,28,53.6,15,13,28,8,31,19,16,0,59,0
4080,97468,128_07_23,MOZAMBIQUE,0,TOTALS,MOZAMBIQUE,200,19,57,33.3,10,29,34.5,9,28,32.1,12,30,40.0,10,22,32,12,25,19,12,1,59,1
4081,97481,128_07_23,SOUTH AFRICA,0,TOTALS,SOUTH AFRICA,200,19,49,38.8,16,28,57.1,3,21,14.3,17,29,58.6,7,33,40,11,24,23,15,1,58,0
4082,97494,128_07_24,TUNISIA,0,TOTALS,TUNISIA,200,24,51,47.1,15,23,65.2,9,28,32.1,13,22,59.1,7,15,22,19,26,24,10,2,70,0
4083,97507,128_07_24,CAMEROON,0,TOTALS,CAMEROON,200,28,60,46.7,26,43,60.5,2,17,11.8,17,31,54.8,23,27,50,13,25,23,17,3,75,1
4084,97520,128_07_25,MOROCCO,0,TOTALS,MOROCCO,200,31,59,52.5,28,46,60.9,3,13,23.1,28,43,65.1,14,28,42,16,23,24,22,3,93,1
4085,97533,128_07_25,LIBERIA,0,TOTALS,LIBERIA,200,16,53,30.2,10,24,41.7,6,29,20.7,16,27,59.3,11,17,28,8,33,37,11,0,54,0
4086,97546,128_07_26,EGYPT,0,TOTALS,EGYPT,200,24,50,48.0,18,32,56.2,6,18,33.3,13,15,86.7,10,26,36,11,31,26,8,1,67,1
4087,97559,128_07_26,TUNISIA,0,TOTALS,TUNISIA,200,13,51,25.5,8,31,25.8,5,20,25.0,26,40,65.0,15,15,30,6,19,17,15,1,57,0
4088,97572,128_07_27,SOUTH AFRICA,0,TOTALS,SOUTH AFRICA,200,25,54,46.3,19,36,52.8,6,18,33.3,20,28,71.4,9,21,30,10,16,13,5,2,76,0
4089,97585,128_07_27,SENEGAL,0,TOTALS,SENEGAL,200,37,74,50.0,24,47,51.1,13,27,48.1,12,17,70.6,14,23,37,27,20,14,8,3,99,1
4090,97597,128_07_28,NIGERIA,0,TOTALS,NIGERIA,200,13,50,26.0,10,28,35.7,3,22,13.6,24,35,68.6,12,23,35,9,18,14,5,3,53,0
4091,97610,128_07_28,CAPE VERDE,0,TOTALS,CAPE VERDE,200,21,53,39.6,11,24,45.8,10,29,34.5,10,21,47.6,10,28,38,9,29,17,5,0,62,1
4092,97623,128_07_29,MALI,0,TOTALS,MALI,200,19,43,44.2,13,22,59.1,6,21,28.6,23,32,71.9,7,30,37,17,26,23,9,1,67,1
4093,97636,128_07_29,MOZAMBIQUE,0,TOTALS,MOZAMBIQUE,200,18,47,38.3,10,28,35.7,8,19,42.1,17,32,53.1,7,22,29,8,22,23,9,5,61,0
4094,97649,128_07_30,CAMEROON,0,TOTALS,CAMEROON,200,25,53,47.2,17,32,53.1,8,21,38.1,18,30,60.0,12,23,35,14,25,18,8,1,76,1
4095,97662,128_07_30,COTE D'IVOIRE,0,TOTALS,COTE D'IVOIRE,200,18,43,41.9,13,27,48.1,5,16,31.2,15,27,55.6,4,20,24,6,21,26,7,1,56,0
4096,97675,128_07_31,DEM.REP. OF CONGO,0,TOTALS,DEM.REP. OF CONGO,225,30,62,48.4,24,39,61.5,6,23,26.1,21,39,53.8,12,39,51,16,35,30,13,5,87,0
4097,97688,128_07_31,RWANDA,0,TOTALS,RWANDA,225,25,65,38.5,15,43,34.9,10,22,45.5,29,46,63.0,7,30,37,14,29,23,16,0,89,1
4098,97701,128_07_32,ANGOLA,0,TOTALS,ANGOLA,200,25,43,58.1,14,18,77.8,11,25,44.0,17,28,60.7,8,16,24,14,20,14,6,0,78,1
4099,97714,128_07_32,CAF,0,TOTALS,CAF,200,15,30,50.0,10,18,55.6,5,12,41.7,16,27,59.3,2,15,17,3,28,17,7,2,51,0
4100,97727,128_07_33,LIBERIA,0,TOTALS,LIBERIA,200,22,62,35.5,13,36,36.1,9,26,34.6,12,20,60.0,15,17,32,12,33,23,12,0,65,0
4101,97740,128_07_33,MOZAMBIQUE,0,TOTALS,MOZAMBIQUE,200,25,51,49.0,20,37,54.1,5,14,35.7,26,42,61.9,19,26,45,15,24,27,17,0,81,1
4102,97753,128_07_34,SOUTH AFRICA,0,TOTALS,SOUTH AFRICA,200,20,49,40.8,16,36,44.4,4,13,30.8,33,44,75.0,8,21,29,9,27,17,10,2,77,1
4103,97766,128_07_34,DEM.REP. OF CONGO,0,TOTALS,DEM.REP. OF CONGO,200,24,56,42.9,16,31,51.6,8,25,32.0,18,31,58.1,15,20,35,18,33,25,7,1,74,0
4104,97779,128_07_35,MOROCCO,0,TOTALS,MOROCCO,200,31,55,56.4,28,44,63.6,3,11,27.3,21,28,75.0,10,21,31,14,21,19,10,2,86,1
4105,97792,128_07_35,MALI,0,TOTALS,MALI,200,27,57,47.4,22,41,53.7,5,16,31.2,17,26,65.4,14,17,31,12,27,21,11,0,76,0
4106,97805,128_07_36,CAF,0,TOTALS,CAF,200,18,49,36.7,12,30,40.0,6,19,31.6,4,9,44.4,5,13,18,8,23,17,9,0,46,0
4107,97818,128_07_36,NIGERIA,0,TOTALS,NIGERIA,200,28,57,49.1,22,35,62.9,6,22,27.3,18,25,72.0,17,26,43,25,10,18,8,6,80,1
4108,97831,128_07_37,SENEGAL,0,TOTALS,SENEGAL,200,32,61,52.5,22,42,52.4,10,19,52.6,19,30,63.3,9,29,38,19,21,22,13,5,93,1
4109,97844,128_07_37,RWANDA,0,TOTALS,RWANDA,200,20,58,34.5,15,35,42.9,5,23,21.7,13,23,56.5,8,23,31,9,22,24,12,2,58,0
4110,97857,128_07_38,TUNISIA,0,TOTALS,TUNISIA,200,25,51,49.0,18,29,62.1,7,22,31.8,17,23,73.9,6,21,27,15,17,18,11,2,74,1
4111,97870,128_07_38,COTE D'IVOIRE,0,TOTALS,COTE D'IVOIRE,200,24,59,40.7,18,38,47.4,6,21,28.6,9,12,75.0,8,23,31,12,22,20,5,0,63,0
4112,97883,128_07_39,LIBERIA,0,TOTALS,LIBERIA,200,31,61,50.8,26,38,68.4,5,23,21.7,17,24,70.8,14,10,24,17,22,20,8,0,84,0
4113,97896,128_07_39,DEM.REP. OF CONGO,0,TOTALS,DEM.REP. OF CONGO,200,32,50,64.0,28,37,75.7,4,13,30.8,24,31,77.4,7,20,27,25,22,26,11,1,92,1
4114,97909,128_07_40,MOZAMBIQUE,0,TOTALS,MOZAMBIQUE,200,34,61,55.7,27,40,67.5,7,21,33.3,10,18,55.6,8,17,25,17,18,16,7,1,85,0
4115,97922,128_07_40,SOUTH AFRICA,0,TOTALS,SOUTH AFRICA,200,36,58,62.1,26,38,68.4,10,20,50.0,15,23,65.2,7,18,25,21,18,12,12,0,97,1
4116,97935,128_07_41,CAF,0,TOTALS,CAF,200,27,45,60.0,24,31,77.4,3,14,21.4,12,17,70.6,8,29,37,10,26,21,8,1,69,1
4117,97948,128_07_41,COTE D'IVOIRE,0,TOTALS,COTE D'IVOIRE,200,22,49,44.9,20,33,60.6,2,16,12.5,17,28,60.7,13,11,24,2,18,20,7,0,63,0
4118,97961,128_07_42,MALI,0,TOTALS,MALI,200,25,58,43.1,16,31,51.6,9,27,33.3,19,32,59.4,11,29,40,16,26,20,9,1,78,1
4119,97974,128_07_42,RWANDA,0,TOTALS,RWANDA,200,25,69,36.2,21,42,50.0,4,27,14.8,20,32,62.5,19,24,43,14,22,16,6,0,74,0
4120,97987,128_07_43,EGYPT,0,TOTALS,EGYPT,200,18,43,41.9,12,28,42.9,6,15,40.0,10,16,62.5,10,20,30,12,24,28,7,4,52,0
4121,98000,128_07_43,CAMEROON,0,TOTALS,CAMEROON,200,19,53,35.8,16,37,43.2,3,16,18.8,17,23,73.9,18,22,40,8,16,21,16,4,58,1
4122,98013,128_07_44,MOROCCO,0,TOTALS,MOROCCO,200,25,57,43.9,23,43,53.5,2,14,14.3,16,23,69.6,15,21,36,9,21,34,8,2,68,0
4123,98026,128_07_44,SENEGAL,0,TOTALS,SENEGAL,200,28,56,50.0,25,39,64.1,3,17,17.6,20,28,71.4,10,20,30,21,25,19,16,2,79,1
4124,98039,128_07_45,ANGOLA,0,TOTALS,ANGOLA,200,33,62,53.2,25,36,69.4,8,26,30.8,19,25,76.0,11,23,34,14,19,10,9,3,93,1
4125,98052,128_07_45,CAPE VERDE,0,TOTALS,CAPE VERDE,200,22,57,38.6,18,37,48.6,4,20,20.0,12,17,70.6,14,20,34,10,22,19,4,0,60,0
4126,98065,128_07_46,NIGERIA,0,TOTALS,NIGERIA,225,30,61,49.2,26,37,70.3,4,24,16.7,19,34,55.9,13,27,40,13,26,19,6,1,83,1
4127,98078,128_07_46,TUNISIA,0,TOTALS,TUNISIA,225,29,60,48.3,21,43,48.8,8,17,47.1,16,23,69.6,6,23,29,11,25,18,9,2,82,0
4128,98091,128_07_47,CAPE VERDE,0,TOTALS,CAPE VERDE,200,20,59,33.9,13,39,33.3,7,20,35.0,6,12,50.0,11,21,32,12,21,18,10,3,53,1
4129,98104,128_07_47,EGYPT,0,TOTALS,EGYPT,200,16,38,42.1,15,30,50.0,1,8,12.5,18,23,78.3,2,27,29,6,14,27,11,4,51,0
4130,98117,128_07_48,ANGOLA,0,TOTALS,ANGOLA,200,29,50,58.0,21,31,67.7,8,19,42.1,20,22,90.9,3,17,20,15,25,10,7,3,86,1
4131,98130,128_07_48,CAMEROON,0,TOTALS,CAMEROON,200,23,53,43.4,18,40,45.0,5,13,38.5,21,28,75.0,16,18,34,11,25,16,4,3,72,0
4132,98143,129_07_01,RWANDA,0,TOTALS,RWANDA,200,24,71,33.8,17,39,43.6,7,32,21.9,11,17,64.7,11,22,33,11,21,15,5,2,66,0
4133,98156,129_07_01,EGYPT,0,TOTALS,EGYPT,200,27,66,40.9,20,41,48.8,7,25,28.0,21,27,77.8,10,21,31,8,15,10,4,3,82,1
4134,98169,129_07_02,KENYA,0,TOTALS,KENYA,200,29,59,49.2,21,40,52.5,8,19,42.1,14,22,63.6,12,19,31,11,16,27,15,1,80,1
4135,98180,129_07_02,ETHIOPIA,0,TOTALS,ETHIOPIA,200,17,55,30.9,11,26,42.3,6,29,20.7,14,21,66.7,12,16,28,7,14,25,5,2,54,0
4136,98193,129_07_03,EGYPT,0,TOTALS,EGYPT,200,27,71,38.0,22,44,50.0,5,27,18.5,14,21,66.7,13,20,33,11,15,28,16,1,73,1
4137,98206,129_07_03,BURUNDI,0,TOTALS,BURUNDI,200,19,67,28.4,17,43,39.5,2,24,8.3,4,10,40.0,18,20,38,8,17,37,12,0,44,0
4138,98219,129_07_04,BURUNDI,0,TOTALS,BURUNDI,200,35,79,44.3,31,63,49.2,4,16,25.0,13,30,43.3,15,25,40,18,25,31,24,1,87,1
4139,98230,129_07_04,ETHIOPIA,0,TOTALS,ETHIOPIA,200,21,58,36.2,16,36,44.4,5,22,22.7,23,34,67.6,13,32,45,7,20,40,14,3,70,0
4140,98243,129_07_05,RWANDA,0,TOTALS,RWANDA,200,27,74,36.5,19,49,38.8,8,25,32.0,13,26,50.0,12,27,39,15,27,13,13,0,75,1
4141,98256,129_07_05,KENYA,0,TOTALS,KENYA,200,22,75,29.3,17,58,29.3,5,17,29.4,15,28,53.6,20,28,48,10,23,17,4,2,64,0
4142,98269,129_07_06,KENYA,0,TOTALS,KENYA,200,38,62,61.3,32,46,69.6,6,16,37.5,19,30,63.3,13,19,32,16,29,18,10,1,101,0
4143,98282,129_07_06,BURUNDI,0,TOTALS,BURUNDI,200,29,61,47.5,23,46,50.0,6,15,40.0,21,34,61.8,10,13,23,9,26,19,8,1,85,1
4144,98293,129_07_07,ETHIOPIA,0,TOTALS,ETHIOPIA,200,23,58,39.7,15,32,46.9,8,26,30.8,15,20,75.0,11,21,32,15,21,32,4,0,69,1
4145,98306,129_07_07,EGYPT,0,TOTALS,EGYPT,200,39,73,53.4,31,42,73.8,8,31,25.8,22,31,71.0,13,24,37,22,25,15,16,0,108,0
4146,98319,129_07_08,EGYPT,0,TOTALS,EGYPT,200,34,63,54.0,25,41,61.0,9,22,40.9,15,22,68.2,7,22,29,12,18,16,17,4,92,1
4147,98332,129_07_08,KENYA,0,TOTALS,KENYA,200,27,62,43.5,23,43,53.5,4,19,21.1,13,16,81.2,10,23,33,17,20,26,8,2,71,0
4148,98345,129_07_09,BURUNDI,0,TOTALS,BURUNDI,200,24,73,32.9,23,58,39.7,1,15,6.7,6,24,25.0,13,34,47,9,21,23,16,3,55,0
4149,98358,129_07_09,RWANDA,0,TOTALS,RWANDA,200,25,77,32.5,20,52,38.5,5,25,20.0,15,27,55.6,15,34,49,11,18,31,12,7,70,1
4150,98371,129_07_10,LIBYA,0,TOTALS,LIBYA,200,20,53,37.7,11,22,50.0,9,31,29.0,11,23,47.8,6,10,16,8,13,8,6,0,60,0
4151,98384,129_07_10,TUNISIA,0,TOTALS,TUNISIA,200,22,57,38.6,15,33,45.5,7,24,29.2,17,17,100.0,22,25,47,11,26,26,7,1,68,1
4152,98397,129_07_11,BURKINA FASO,0,TOTALS,BURKINA FASO,200,24,69,34.8,18,44,40.9,6,25,24.0,5,8,62.5,17,20,37,8,17,22,12,0,59,1
4153,98410,129_07_11,TOGO,0,TOTALS,TOGO,200,14,71,19.7,10,45,22.2,4,26,15.4,9,23,39.1,31,24,55,12,12,32,3,3,41,0
4154,98423,129_07_12,COTE D'IVOIRE,0,TOTALS,COTE D'IVOIRE,200,27,66,40.9,21,34,61.8,6,32,18.8,9,21,42.9,17,28,45,13,15,17,8,4,69,1
4155,98436,129_07_12,LIBERIA,0,TOTALS,LIBERIA,200,25,71,35.2,17,46,37.0,8,25,32.0,4,10,40.0,12,17,29,15,20,15,5,0,62,0
4156,98449,129_07_13,BURKINA FASO,0,TOTALS,BURKINA FASO,200,12,64,18.8,10,45,22.2,2,19,10.5,12,27,44.4,21,20,41,9,13,29,12,3,38,0
4157,98462,129_07_13,LIBERIA,0,TOTALS,LIBERIA,200,22,79,27.8,19,53,35.8,3,26,11.5,8,14,57.1,24,34,58,10,21,22,17,1,55,1
4158,98475,129_07_14,COTE D'IVOIRE,0,TOTALS,COTE D'IVOIRE,200,31,69,44.9,26,46,56.5,5,23,21.7,15,27,55.6,14,23,37,17,19,19,11,0,82,1
4159,98488,129_07_14,TOGO,0,TOTALS,TOGO,200,22,66,33.3,14,40,35.0,8,26,30.8,11,20,55.0,10,22,32,4,19,18,12,3,63,0
4160,98501,129_07_15,TOGO,0,TOTALS,TOGO,200,21,62,33.9,19,39,48.7,2,23,8.7,20,32,62.5,27,22,49,4,19,30,8,4,64,0
4161,98514,129_07_15,LIBERIA,0,TOTALS,LIBERIA,200,28,71,39.4,20,51,39.2,8,20,40.0,10,18,55.6,24,24,48,12,30,29,23,0,74,1
4162,98527,129_07_16,ZAMBIA,0,TOTALS,ZAMBIA,200,23,56,41.1,19,39,48.7,4,17,23.5,20,37,54.1,5,22,27,8,40,18,10,2,70,0
4163,98540,129_07_16,MOZAMBIQUE,0,TOTALS,MOZAMBIQUE,200,23,54,42.6,21,41,51.2,2,13,15.4,27,52,51.9,12,30,42,11,24,21,9,0,75,1
4164,98553,129_07_17,ZIMBABWE,0,TOTALS,ZIMBABWE,200,43,82,52.4,38,60,63.3,5,22,22.7,10,21,47.6,11,34,45,25,18,12,17,2,101,0
4165,98566,129_07_17,MALAWI,0,TOTALS,MALAWI,200,12,50,24.0,11,34,32.4,1,16,6.2,10,21,47.6,6,23,29,9,16,28,7,2,35,1
4166,98579,129_07_18,MALAWI,0,TOTALS,MALAWI,200,15,71,21.1,13,44,29.5,2,27,7.4,12,20,60.0,11,14,25,8,23,22,13,0,44,1
4167,98592,129_07_18,SOUTH AFRICA,0,TOTALS,SOUTH AFRICA,200,39,61,63.9,34,46,73.9,5,15,33.3,25,38,65.8,14,46,60,34,15,21,11,6,108,0
4168,98605,129_07_19,ZAMBIA,0,TOTALS,ZAMBIA,200,22,51,43.1,18,42,42.9,4,9,44.4,24,35,68.6,7,29,36,16,19,31,9,5,72,1
4169,98618,129_07_19,ZIMBABWE,0,TOTALS,ZIMBABWE,200,23,74,31.1,17,43,39.5,6,31,19.4,14,24,58.3,22,27,49,12,22,20,12,3,66,0
4170,98631,129_07_20,TOGO,0,TOTALS,TOGO,200,23,53,43.4,19,38,50.0,4,15,26.7,14,33,42.4,13,24,37,3,13,21,8,3,64,1
4171,98644,129_07_20,BURKINA FASO,0,TOTALS,BURKINA FASO,200,18,66,27.3,15,47,31.9,3,19,15.8,8,18,44.4,8,24,32,7,27,27,13,2,47,0
4172,98657,129_07_21,LIBERIA,0,TOTALS,LIBERIA,200,16,63,25.4,11,39,28.2,5,24,20.8,6,11,54.5,17,21,38,6,16,22,6,2,43,0
4173,98670,129_07_21,COTE D'IVOIRE,0,TOTALS,COTE D'IVOIRE,200,36,77,46.8,32,58,55.2,4,19,21.1,7,13,53.8,11,21,32,18,14,15,12,6,83,1
4174,98683,129_07_22,ZIMBABWE,0,TOTALS,ZIMBABWE,200,29,77,37.7,25,58,43.1,4,19,21.1,16,29,55.2,14,14,28,13,25,15,11,4,78,0
4175,98696,129_07_22,SOUTH AFRICA,0,TOTALS,SOUTH AFRICA,200,28,53,52.8,21,32,65.6,7,21,33.3,18,27,66.7,13,38,51,18,22,35,6,5,81,1
4176,98709,129_07_23,LIBERIA,0,TOTALS,LIBERIA,200,22,53,41.5,16,28,57.1,6,25,24.0,8,15,53.3,16,6,22,11,25,10,10,0,58,0
4177,98722,129_07_23,BURKINA FASO,0,TOTALS,BURKINA FASO,200,24,39,61.5,18,28,64.3,6,11,54.5,10,15,66.7,7,17,24,9,15,15,0,0,64,1
4178,98735,129_07_24,SOUTH AFRICA,0,TOTALS,SOUTH AFRICA,200,33,55,60.0,27,40,67.5,6,15,40.0,25,36,69.4,8,30,38,17,23,26,10,4,97,1
4179,98748,129_07_24,ZAMBIA,0,TOTALS,ZAMBIA,200,29,82,35.4,25,62,40.3,4,20,20.0,15,30,50.0,26,19,45,16,27,20,11,4,77,0
4180,98761,129_07_25,TOGO,0,TOTALS,TOGO,200,22,72,30.6,16,48,33.3,6,24,25.0,15,21,71.4,12,19,31,13,27,21,6,3,65,0
4181,98774,129_07_25,COTE D'IVOIRE,0,TOTALS,COTE D'IVOIRE,200,26,69,37.7,20,45,44.4,6,24,25.0,18,32,56.2,15,32,47,18,22,23,9,0,76,1
4182,98787,129_07_26,MOZAMBIQUE,0,TOTALS,MOZAMBIQUE,200,24,59,40.7,20,39,51.3,4,20,20.0,12,21,57.1,7,26,33,14,15,18,12,4,64,1
4183,98800,129_07_26,ZIMBABWE,0,TOTALS,ZIMBABWE,200,23,62,37.1,23,52,44.2,0,10,0.0,14,28,50.0,19,33,52,13,16,18,11,0,60,0
4184,98813,129_07_27,LIBERIA,0,TOTALS,LIBERIA,200,26,89,29.2,20,57,35.1,6,32,18.8,19,32,59.4,27,26,53,10,22,21,3,0,77,1
4185,98826,129_07_27,TOGO,0,TOTALS,TOGO,200,19,68,27.9,7,33,21.2,12,35,34.3,12,22,54.5,8,24,32,13,24,23,7,3,62,0
4186,98839,129_07_28,MALAWI,0,TOTALS,MALAWI,200,31,74,41.9,25,53,47.2,6,21,28.6,13,31,41.9,14,23,37,18,17,23,9,3,81,1
4187,98852,129_07_28,ZAMBIA,0,TOTALS,ZAMBIA,200,42,89,47.2,38,75,50.7,4,14,28.6,16,31,51.6,29,35,64,21,23,20,16,6,104,0
4188,98865,129_07_29,COTE D'IVOIRE,0,TOTALS,COTE D'IVOIRE,200,21,62,33.9,17,32,53.1,4,30,13.3,4,10,40.0,6,30,36,15,14,33,7,0,50,0
4189,98878,129_07_29,BURKINA FASO,0,TOTALS,BURKINA FASO,200,20,71,28.2,16,43,37.2,4,28,14.3,11,16,68.8,6,27,33,13,8,20,18,3,55,1
4190,98891,129_07_30,SOUTH AFRICA,0,TOTALS,SOUTH AFRICA,200,26,53,49.1,19,35,54.3,7,18,38.9,15,25,60.0,10,37,47,15,22,16,4,0,74,1
4191,98904,129_07_30,MOZAMBIQUE,0,TOTALS,MOZAMBIQUE,200,18,60,30.0,16,39,41.0,2,21,9.5,12,24,50.0,9,22,31,12,22,16,8,3,50,0
4192,98917,129_07_31,CAMEROON,0,TOTALS,CAMEROON,200,18,56,32.1,17,50,34.0,1,6,16.7,19,27,70.4,8,31,39,10,23,29,4,4,56,1
4193,98930,129_07_31,REPUBLIC OF CONGO,0,TOTALS,REPUBLIC OF CONGO,200,19,80,23.8,16,58,27.6,3,22,13.6,9,24,37.5,11,20,31,15,19,15,9,3,50,0
4194,98943,129_07_32,DEM.REP. OF CONGO,0,TOTALS,DEM.REP. OF CONGO,200,24,55,43.6,15,31,48.4,9,24,37.5,18,33,54.5,7,23,30,26,32,19,13,12,75,1
4195,98956,129_07_32,CHAD,0,TOTALS,CHAD,200,13,53,24.5,13,46,28.3,0,7,0.0,12,42,28.6,8,23,31,0,24,23,2,2,38,0
4196,98969,129_07_33,GABON,0,TOTALS,GABON,200,24,62,38.7,22,46,47.8,2,16,12.5,9,20,45.0,10,18,28,16,0,19,9,1,59,0
4197,98982,129_07_33,REPUBLIC OF CONGO,0,TOTALS,REPUBLIC OF CONGO,200,28,63,44.4,22,47,46.8,6,16,37.5,13,35,37.1,26,30,56,4,0,24,9,2,75,1
4198,98995,129_07_34,DEM.REP. OF CONGO,0,TOTALS,DEM.REP. OF CONGO,200,20,54,37.0,17,41,41.5,3,13,23.1,33,49,67.3,13,16,29,5,37,16,6,2,76,1
4199,99008,129_07_34,CAMEROON,0,TOTALS,CAMEROON,200,16,64,25.0,12,53,22.6,4,11,36.4,36,65,55.4,11,11,22,0,35,13,1,0,72,0
4200,99021,129_07_35,CHAD,0,TOTALS,CHAD,200,19,61,31.1,19,49,38.8,0,12,0.0,19,33,57.6,7,25,32,7,25,21,7,4,57,0
4201,99034,129_07_35,CAMEROON,0,TOTALS,CAMEROON,200,25,69,36.2,16,49,32.7,9,20,45.0,22,27,81.5,12,29,41,2,24,15,10,4,81,1
4202,99047,129_07_36,GABON,0,TOTALS,GABON,200,17,44,38.6,14,29,48.3,3,15,20.0,23,44,52.3,6,21,27,3,27,20,4,1,60,0
4203,99060,129_07_36,DEM.REP. OF CONGO,0,TOTALS,DEM.REP. OF CONGO,200,21,52,40.4,16,32,50.0,5,20,25.0,20,31,64.5,6,17,23,7,22,27,6,5,67,1
4204,99073,129_07_37,CAMEROON,0,TOTALS,CAMEROON,200,27,68,39.7,25,52,48.1,2,16,12.5,19,37,51.4,6,11,17,4,23,15,13,4,75,1
4205,99086,129_07_37,GABON,0,TOTALS,GABON,200,17,49,34.7,13,36,36.1,4,13,30.8,15,34,44.1,5,11,16,9,27,17,9,3,53,0
4206,99099,129_07_38,REPUBLIC OF CONGO,0,TOTALS,REPUBLIC OF CONGO,200,28,64,43.8,24,46,52.2,4,18,22.2,19,28,67.9,3,16,19,10,29,16,8,2,79,1
4207,99112,129_07_38,CHAD,0,TOTALS,CHAD,200,18,63,28.6,16,46,34.8,2,17,11.8,28,45,62.2,4,19,23,3,26,22,5,5,66,0
4208,99125,129_07_39,CHAD,0,TOTALS,CHAD,200,27,74,36.5,27,69,39.1,0,5,0.0,21,31,67.7,8,15,23,4,31,23,8,2,75,0
4209,99138,129_07_39,GABON,0,TOTALS,GABON,200,29,70,41.4,25,53,47.2,4,17,23.5,20,38,52.6,11,14,25,8,22,25,6,5,82,1
4210,99151,129_07_40,REPUBLIC OF CONGO,0,TOTALS,REPUBLIC OF CONGO,200,26,41,63.4,23,36,63.9,3,5,60.0,9,23,39.1,5,19,24,6,25,20,2,1,64,0
4211,99164,129_07_40,DEM.REP. OF CONGO,0,TOTALS,DEM.REP. OF CONGO,200,25,54,46.3,18,37,48.6,7,17,41.2,17,30,56.7,5,21,26,5,21,16,2,6,74,1
4212,100797,132_07_01,QATAR,0,TOTALS,QATAR,200,40,65,61.5,30,39,76.9,10,26,38.5,16,30,53.3,7,25,32,15,10,8,4,2,106,0
4213,100810,132_07_01,INDIA,0,TOTALS,INDIA,200,21,60,35.0,14,36,38.9,7,24,29.2,0,5,0.0,6,11,17,5,24,12,2,0,49,1
4214,100823,132_07_02,KAZAKHSTAN,0,TOTALS,KAZAKHSTAN,200,37,66,56.1,28,38,73.7,9,28,32.1,24,32,75.0,13,17,30,1,10,9,8,2,107,0
4215,100836,132_07_02,INDONESIA,0,TOTALS,INDONESIA,200,22,61,36.1,17,43,39.5,5,18,27.8,4,8,50.0,9,14,23,5,23,16,2,0,53,1
4216,100849,132_07_03,CHINA,0,TOTALS,CHINA,200,22,60,36.7,16,41,39.0,6,19,31.6,15,22,68.2,11,19,30,3,28,13,4,1,65,0
4217,100862,132_07_03,JORDAN,0,TOTALS,JORDAN,200,27,54,50.0,22,37,59.5,5,17,29.4,19,32,59.4,11,25,36,11,19,12,5,1,78,1
4218,100874,132_07_04,KOREA,0,TOTALS,KOREA,200,41,70,58.6,33,51,64.7,8,19,42.1,17,25,68.0,10,33,43,13,14,12,6,2,107,0
4219,100887,132_07_04,HONG KONG,0,TOTALS,HONG KONG,200,25,73,34.2,13,35,37.1,12,38,31.6,5,11,45.5,5,19,24,11,22,14,3,0,67,1
4220,100899,132_07_05,SYRIA,0,TOTALS,SYRIA,200,29,71,40.8,26,48,54.2,3,23,13.0,5,12,41.7,11,23,34,5,14,11,4,1,66,0
4221,100912,132_07_05,CHINESE TAIPEI,0,TOTALS,CHINESE TAIPEI,200,32,60,53.3,22,33,66.7,10,27,37.0,16,19,84.2,4,34,38,9,13,10,8,2,90,1
4222,100925,132_07_06,UNITED ARAB EMIRATES,0,TOTALS,UNITED ARAB EMIRATES,200,22,57,38.6,16,43,37.2,6,14,42.9,16,24,66.7,4,21,25,3,23,9,4,0,66,1
4223,100938,132_07_06,JAPAN,0,TOTALS,JAPAN,200,41,70,58.6,29,45,64.4,12,25,48.0,15,25,60.0,10,28,38,20,24,12,4,0,109,0
4224,100951,132_07_07,IRAN,0,TOTALS,IRAN,200,22,55,40.0,16,36,44.4,6,19,31.6,25,49,51.0,8,30,38,5,31,17,11,6,75,1
4225,100964,132_07_07,PHILIPPINES,0,TOTALS,PHILIPPINES,200,15,66,22.7,9,42,21.4,6,24,25.0,33,43,76.7,15,28,43,4,33,17,8,1,69,0
4226,100977,132_07_08,LEBANON,0,TOTALS,LEBANON,200,39,67,58.2,33,42,78.6,6,25,24.0,20,28,71.4,18,26,44,2,11,5,6,1,104,0
4227,100990,132_07_08,KUWAIT,0,TOTALS,KUWAIT,200,23,60,38.3,14,40,35.0,9,20,45.0,4,6,66.7,6,9,15,2,21,8,3,0,59,1
4228,101003,132_07_09,INDIA,0,TOTALS,INDIA,200,25,64,39.1,21,45,46.7,4,19,21.1,20,27,74.1,13,11,24,5,31,17,8,0,74,0
4229,101016,132_07_09,KAZAKHSTAN,0,TOTALS,KAZAKHSTAN,200,28,65,43.1,15,32,46.9,13,33,39.4,28,44,63.6,20,20,40,14,26,19,5,3,97,1
4230,101029,132_07_10,HONG KONG,0,TOTALS,HONG KONG,200,35,70,50.0,20,39,51.3,15,31,48.4,19,28,67.9,8,26,34,20,35,20,6,1,104,1
4231,101042,132_07_10,SYRIA,0,TOTALS,SYRIA,200,32,71,45.1,24,39,61.5,8,32,25.0,28,50,56.0,19,26,45,12,24,12,10,0,100,0
4232,101055,132_07_11,KUWAIT,0,TOTALS,KUWAIT,200,25,75,33.3,19,52,36.5,6,23,26.1,12,18,66.7,12,19,31,7,24,20,12,5,68,0
4233,101068,132_07_11,UNITED ARAB EMIRATES,0,TOTALS,UNITED ARAB EMIRATES,200,23,58,39.7,19,40,47.5,4,18,22.2,19,26,73.1,4,29,33,6,13,17,4,2,69,1
4234,101081,132_07_12,INDONESIA,0,TOTALS,INDONESIA,200,18,54,33.3,12,36,33.3,6,18,33.3,3,5,60.0,3,12,15,2,17,14,3,0,45,0
4235,101094,132_07_12,QATAR,0,TOTALS,QATAR,200,32,63,50.8,26,42,61.9,6,21,28.6,16,22,72.7,11,19,30,9,12,7,6,4,86,1
4236,101107,132_07_13,CHINESE TAIPEI,0,TOTALS,CHINESE TAIPEI,200,27,64,42.2,22,42,52.4,5,22,22.7,11,17,64.7,9,17,26,8,22,17,7,1,70,0
4237,101119,132_07_13,KOREA,0,TOTALS,KOREA,200,28,52,53.8,19,25,76.0,9,27,33.3,20,25,80.0,8,27,35,15,21,20,7,4,85,1
4238,101132,132_07_14,JAPAN,0,TOTALS,JAPAN,200,27,54,50.0,20,34,58.8,7,20,35.0,16,31,51.6,5,20,25,15,23,11,3,1,77,1
4239,101145,132_07_14,LEBANON,0,TOTALS,LEBANON,200,21,54,38.9,13,33,39.4,8,21,38.1,17,24,70.8,10,18,28,8,26,10,0,3,67,0
4240,101158,132_07_15,PHILIPPINES,0,TOTALS,PHILIPPINES,200,25,66,37.9,18,45,40.0,7,21,33.3,22,29,75.9,18,16,34,9,17,12,5,0,79,1
4241,101171,132_07_15,CHINA,0,TOTALS,CHINA,200,25,52,48.1,15,29,51.7,10,23,43.5,14,19,73.7,7,20,27,12,25,13,4,1,74,0
4242,101184,132_07_16,JORDAN,0,TOTALS,JORDAN,200,19,58,32.8,10,23,43.5,9,35,25.7,7,14,50.0,13,21,34,8,19,20,1,1,54,0
4243,101197,132_07_16,IRAN,0,TOTALS,IRAN,200,18,50,36.0,13,37,35.1,5,13,38.5,19,27,70.4,8,22,30,6,21,10,4,2,60,1
4244,101210,132_07_17,UNITED ARAB EMIRATES,0,TOTALS,UNITED ARAB EMIRATES,200,26,71,36.6,17,44,38.6,9,27,33.3,3,4,75.0,4,14,18,6,23,13,6,1,64,1
4245,101223,132_07_17,LEBANON,0,TOTALS,LEBANON,200,39,62,62.9,29,38,76.3,10,24,41.7,18,26,69.2,20,36,56,10,17,16,7,2,106,0
4246,101236,132_07_18,INDONESIA,0,TOTALS,INDONESIA,200,26,64,40.6,24,42,57.1,2,22,9.1,12,22,54.5,10,22,32,2,25,21,11,2,66,0
4247,101249,132_07_18,INDIA,0,TOTALS,INDIA,200,25,55,45.5,19,43,44.2,6,12,50.0,16,30,53.3,8,23,31,3,22,22,12,1,72,1
4248,101262,132_07_19,CHINESE TAIPEI,0,TOTALS,CHINESE TAIPEI,200,31,58,53.4,20,29,69.0,11,29,37.9,25,35,71.4,7,24,31,14,20,7,6,2,98,1
4249,101275,132_07_19,HONG KONG,0,TOTALS,HONG KONG,200,27,68,39.7,12,28,42.9,15,40,37.5,12,23,52.2,14,19,33,7,27,14,4,2,81,0
4250,101287,132_07_20,SYRIA,0,TOTALS,SYRIA,200,31,71,43.7,28,57,49.1,3,14,21.4,14,27,51.9,9,23,32,3,17,12,6,0,79,0
4251,101299,132_07_20,KOREA,0,TOTALS,KOREA,200,37,80,46.2,29,41,70.7,8,39,20.5,7,14,50.0,18,36,54,13,26,16,5,2,89,1
4252,101312,132_07_21,KAZAKHSTAN,0,TOTALS,KAZAKHSTAN,200,24,56,42.9,16,32,50.0,8,24,33.3,13,22,59.1,4,29,33,9,24,16,7,2,69,0
4253,101325,132_07_21,QATAR,0,TOTALS,QATAR,200,28,66,42.4,20,47,42.6,8,19,42.1,12,30,40.0,14,24,38,15,16,13,6,4,76,1
4254,101338,132_07_22,IRAN,0,TOTALS,IRAN,200,31,61,50.8,28,44,63.6,3,17,17.6,12,15,80.0,11,26,37,12,23,22,9,2,77,1
4255,101351,132_07_22,CHINA,0,TOTALS,CHINA,200,19,52,36.5,11,27,40.7,8,25,32.0,22,30,73.3,5,16,21,8,19,19,10,2,68,0
4256,101364,132_07_23,PHILIPPINES,0,TOTALS,PHILIPPINES,200,33,67,49.3,25,43,58.1,8,24,33.3,2,7,28.6,7,21,28,11,25,14,1,0,76,0
4257,101377,132_07_23,JORDAN,0,TOTALS,JORDAN,200,27,62,43.5,18,34,52.9,9,28,32.1,21,31,67.7,15,27,42,13,13,8,4,0,84,1
4258,101390,132_07_24,JAPAN,0,TOTALS,JAPAN,200,35,61,57.4,22,30,73.3,13,31,41.9,18,23,78.3,11,29,40,23,20,14,11,0,101,0
4259,101403,132_07_24,KUWAIT,0,TOTALS,KUWAIT,200,15,56,26.8,11,41,26.8,4,15,26.7,14,19,73.7,10,15,25,4,15,17,5,2,48,1
4260,101416,132_07_25,PHILIPPINES,0,TOTALS,PHILIPPINES,225,39,80,48.8,32,57,56.1,7,23,30.4,22,33,66.7,9,29,38,9,28,12,6,2,107,1
4261,101428,132_07_25,SYRIA,0,TOTALS,SYRIA,225,34,85,40.0,27,57,47.4,7,28,25.0,25,33,75.8,12,32,44,5,19,15,5,1,100,0
4262,101441,132_07_26,CHINA,0,TOTALS,CHINA,200,30,56,53.6,24,36,66.7,6,20,30.0,27,34,79.4,11,20,31,11,19,8,8,3,93,1
4263,101454,132_07_26,HONG KONG,0,TOTALS,HONG KONG,200,26,60,43.3,19,36,52.8,7,24,29.2,10,12,83.3,11,13,24,11,28,16,4,0,69,0
4264,101467,132_07_27,KUWAIT,0,TOTALS,KUWAIT,200,18,47,38.3,11,29,37.9,7,18,38.9,29,42,69.0,6,29,35,6,24,16,6,3,72,1
4265,101480,132_07_27,INDIA,0,TOTALS,INDIA,200,25,61,41.0,16,33,48.5,9,28,32.1,9,29,31.0,11,23,34,14,33,12,9,3,68,0
4266,101493,132_07_28,UNITED ARAB EMIRATES,0,TOTALS,UNITED ARAB EMIRATES,225,25,60,41.7,21,45,46.7,4,15,26.7,27,44,61.4,11,21,32,4,14,13,6,0,81,0
4267,101506,132_07_28,INDONESIA,0,TOTALS,INDONESIA,225,32,60,53.3,21,37,56.8,11,23,47.8,8,15,53.3,8,24,32,13,28,17,4,0,83,1
4268,101519,132_07_29,IRAN,0,TOTALS,IRAN,200,31,63,49.2,26,45,57.8,5,18,27.8,9,12,75.0,14,28,42,10,21,15,4,2,76,1
4269,101532,132_07_29,CHINESE TAIPEI,0,TOTALS,CHINESE TAIPEI,200,23,55,41.8,18,36,50.0,5,19,26.3,13,18,72.2,5,16,21,6,17,10,4,2,64,0
4270,101545,132_07_30,JORDAN,0,TOTALS,JORDAN,200,23,64,35.9,19,42,45.2,4,22,18.2,15,25,60.0,17,19,36,3,19,10,6,0,65,0
4271,101558,132_07_30,KOREA,0,TOTALS,KOREA,200,27,59,45.8,20,38,52.6,7,21,33.3,9,11,81.8,13,22,35,10,24,13,4,4,70,1
4272,101571,132_07_31,LEBANON,0,TOTALS,LEBANON,200,33,63,52.4,23,42,54.8,10,21,47.6,14,23,60.9,10,28,38,13,24,10,5,0,90,1
4273,101584,132_07_31,QATAR,0,TOTALS,QATAR,200,22,60,36.7,17,44,38.6,5,16,31.2,19,31,61.3,12,18,30,4,22,13,6,3,68,0
4274,101597,132_07_32,JAPAN,0,TOTALS,JAPAN,200,29,59,49.2,14,29,48.3,15,30,50.0,12,21,57.1,6,15,21,16,20,12,10,0,85,0
4275,101610,132_07_32,KAZAKHSTAN,0,TOTALS,KAZAKHSTAN,200,32,63,50.8,21,38,55.3,11,25,44.0,18,21,85.7,7,23,30,8,18,16,9,0,93,1
4276,101623,132_07_33,INDIA,0,TOTALS,INDIA,200,27,82,32.9,17,45,37.8,10,37,27.0,5,11,45.5,11,28,39,13,27,11,4,1,69,1
4277,101636,132_07_33,PHILIPPINES,0,TOTALS,PHILIPPINES,200,35,71,49.3,26,47,55.3,9,24,37.5,25,36,69.4,11,40,51,12,14,11,7,1,104,0
4278,101649,132_07_34,INDONESIA,0,TOTALS,INDONESIA,200,19,63,30.2,15,44,34.1,4,19,21.1,5,8,62.5,9,19,28,10,22,15,6,1,47,1
4279,101662,132_07_34,CHINA,0,TOTALS,CHINA,200,37,64,57.8,28,40,70.0,9,24,37.5,19,26,73.1,10,34,44,9,16,11,8,2,102,0
4280,101674,132_07_35,SYRIA,0,TOTALS,SYRIA,200,40,66,60.6,35,50,70.0,5,16,31.2,24,40,60.0,11,42,53,14,19,18,5,1,109,0
4281,101687,132_07_35,KUWAIT,0,TOTALS,KUWAIT,200,28,74,37.8,19,45,42.2,9,29,31.0,4,19,21.1,6,17,23,13,27,12,7,1,69,1
4282,101700,132_07_36,HONG KONG,0,TOTALS,HONG KONG,200,28,67,41.8,13,23,56.5,15,44,34.1,16,29,55.2,9,35,44,13,29,8,6,0,87,1
4283,101713,132_07_36,UNITED ARAB EMIRATES,0,TOTALS,UNITED ARAB EMIRATES,200,16,57,28.1,9,27,33.3,7,30,23.3,25,40,62.5,6,26,32,5,23,13,4,1,64,0
4284,101726,132_07_37,KAZAKHSTAN,0,TOTALS,KAZAKHSTAN,200,24,44,54.5,14,24,58.3,10,20,50.0,15,23,65.2,1,21,22,8,19,12,1,0,73,0
4285,101739,132_07_37,JORDAN,0,TOTALS,JORDAN,200,30,62,48.4,22,40,55.0,8,22,36.4,14,20,70.0,11,17,28,15,19,11,9,4,82,1
4286,101752,132_07_38,CHINESE TAIPEI,0,TOTALS,CHINESE TAIPEI,200,25,58,43.1,20,37,54.1,5,21,23.8,9,17,52.9,5,17,22,9,22,16,4,0,64,0
4287,101765,132_07_38,LEBANON,0,TOTALS,LEBANON,200,34,58,58.6,28,39,71.8,6,19,31.6,21,24,87.5,7,22,29,6,21,10,7,1,95,1
4288,101778,132_07_39,QATAR,0,TOTALS,QATAR,200,29,71,40.8,23,49,46.9,6,22,27.3,23,30,76.7,8,17,25,7,25,8,3,2,87,0
4289,101791,132_07_39,IRAN,0,TOTALS,IRAN,200,29,55,52.7,15,29,51.7,14,26,53.8,23,29,79.3,7,22,29,13,23,14,4,5,95,1
4290,101804,132_07_40,KOREA,0,TOTALS,KOREA,200,35,58,60.3,32,49,65.3,3,9,33.3,20,26,76.9,6,26,32,8,26,13,7,1,93,1
4291,101817,132_07_40,JAPAN,0,TOTALS,JAPAN,200,27,67,40.3,18,44,40.9,9,23,39.1,20,29,69.0,15,16,31,8,26,12,4,1,83,0
4292,101830,132_07_41,PHILIPPINES,0,TOTALS,PHILIPPINES,200,34,80,42.5,27,53,50.9,7,27,25.9,14,21,66.7,20,40,60,16,13,18,5,3,89,1
4293,101843,132_07_41,KUWAIT,0,TOTALS,KUWAIT,200,23,66,34.8,16,43,37.2,7,23,30.4,5,9,55.6,3,26,29,10,13,17,11,1,58,0
4294,101856,132_07_42,CHINA,0,TOTALS,CHINA,200,36,61,59.0,26,42,61.9,10,19,52.6,18,23,78.3,13,29,42,21,17,11,10,0,100,0
4295,101869,132_07_42,UNITED ARAB EMIRATES,0,TOTALS,UNITED ARAB EMIRATES,200,21,55,38.2,16,36,44.4,5,19,26.3,8,18,44.4,7,14,21,7,25,21,4,0,55,1
4296,101882,132_07_43,INDIA,0,TOTALS,INDIA,200,24,71,33.8,21,55,38.2,3,16,18.8,3,5,60.0,10,19,29,6,31,26,7,1,54,1
4297,101894,132_07_43,SYRIA,0,TOTALS,SYRIA,200,38,66,57.6,31,45,68.9,7,21,33.3,22,36,61.1,11,33,44,16,11,20,8,0,105,0
4298,101907,132_07_44,INDONESIA,0,TOTALS,INDONESIA,200,30,72,41.7,21,42,50.0,9,30,30.0,12,20,60.0,15,25,40,11,26,16,5,1,81,1
4299,101920,132_07_44,HONG KONG,0,TOTALS,HONG KONG,200,26,54,48.1,18,30,60.0,8,24,33.3,18,31,58.1,3,30,33,13,20,17,5,1,78,0
4300,101933,132_07_45,QATAR,0,TOTALS,QATAR,200,27,62,43.5,20,40,50.0,7,22,31.8,26,43,60.5,17,21,38,13,24,15,4,1,87,1
4301,101946,132_07_45,CHINESE TAIPEI,0,TOTALS,CHINESE TAIPEI,200,26,64,40.6,18,39,46.2,8,25,32.0,14,27,51.9,13,19,32,7,29,9,4,3,74,0
4302,101959,132_07_46,KAZAKHSTAN,0,TOTALS,KAZAKHSTAN,200,25,56,44.6,17,36,47.2,8,20,40.0,17,24,70.8,14,20,34,5,23,15,5,0,75,1
4303,101972,132_07_46,KOREA,0,TOTALS,KOREA,200,25,60,41.7,20,38,52.6,5,22,22.7,18,26,69.2,11,16,27,13,20,9,4,0,73,0
4304,101985,132_07_47,IRAN,0,TOTALS,IRAN,200,26,66,39.4,21,47,44.7,5,19,26.3,3,5,60.0,10,15,25,8,14,11,3,2,60,0
4305,101998,132_07_47,LEBANON,0,TOTALS,LEBANON,200,33,65,50.8,24,41,58.5,9,24,37.5,7,11,63.6,7,24,31,15,7,7,3,2,82,1
4306,102011,132_07_48,JORDAN,0,TOTALS,JORDAN,200,27,68,39.7,21,46,45.7,6,22,27.3,8,15,53.3,16,18,34,8,21,13,10,0,68,0
4307,102024,132_07_48,JAPAN,0,TOTALS,JAPAN,200,26,48,54.2,16,30,53.3,10,18,55.6,9,16,56.2,4,19,23,14,24,21,3,4,71,1
4308,102036,132_07_49,SYRIA,0,TOTALS,SYRIA,200,42,73,57.5,35,53,66.0,7,20,35.0,17,26,65.4,13,27,40,12,11,16,6,0,108,0
4309,102049,132_07_49,INDONESIA,0,TOTALS,INDONESIA,200,32,77,41.6,23,50,46.0,9,27,33.3,6,8,75.0,12,19,31,12,20,13,11,0,79,1
4310,102062,132_07_50,INDIA,0,TOTALS,INDIA,200,27,55,49.1,24,43,55.8,3,12,25.0,25,43,58.1,8,26,34,13,27,17,11,3,82,1
4311,102075,132_07_50,UNITED ARAB EMIRATES,0,TOTALS,UNITED ARAB EMIRATES,200,24,52,46.2,20,38,52.6,4,14,28.6,25,39,64.1,9,23,32,8,30,19,8,2,77,0
4312,102088,132_07_51,KUWAIT,0,TOTALS,KUWAIT,200,22,63,34.9,12,27,44.4,10,36,27.8,12,25,48.0,17,21,38,10,15,17,9,0,66,0
4313,102101,132_07_51,HONG KONG,0,TOTALS,HONG KONG,200,27,63,42.9,19,38,50.0,8,25,32.0,10,15,66.7,14,26,40,13,20,16,9,0,72,1
4314,102114,132_07_52,PHILIPPINES,0,TOTALS,PHILIPPINES,200,26,56,46.4,22,45,48.9,4,11,36.4,22,32,68.8,8,23,31,4,21,10,2,2,78,1
4315,102127,132_07_52,CHINA,0,TOTALS,CHINA,200,29,71,40.8,24,48,50.0,5,23,21.7,13,24,54.2,14,20,34,6,26,8,3,1,76,0
4316,102140,132_07_53,QATAR,0,TOTALS,QATAR,200,27,57,47.4,25,45,55.6,2,12,16.7,11,15,73.3,5,28,33,7,8,12,3,0,67,0
4317,102153,132_07_53,JORDAN,0,TOTALS,JORDAN,200,30,76,39.5,16,43,37.2,14,33,42.4,3,6,50.0,15,24,39,7,19,6,4,1,77,1
4318,102166,132_07_54,JAPAN,0,TOTALS,JAPAN,200,28,62,45.2,14,27,51.9,14,35,40.0,10,13,76.9,5,16,21,15,24,12,6,0,80,0
4319,102179,132_07_54,CHINESE TAIPEI,0,TOTALS,CHINESE TAIPEI,200,26,49,53.1,20,36,55.6,6,13,46.2,27,33,81.8,7,25,32,6,16,16,3,1,85,1
4320,102192,132_07_55,LEBANON,0,TOTALS,LEBANON,200,29,68,42.6,22,40,55.0,7,28,25.0,11,17,64.7,15,23,38,3,24,9,6,1,76,1
4321,102205,132_07_55,KOREA,0,TOTALS,KOREA,200,23,52,44.2,14,30,46.7,9,22,40.9,19,27,70.4,7,18,25,7,19,8,5,2,74,0
4322,102218,132_07_56,KAZAKHSTAN,0,TOTALS,KAZAKHSTAN,200,23,65,35.4,18,43,41.9,5,22,22.7,11,15,73.3,14,21,35,7,18,19,4,1,62,0
4323,102231,132_07_56,IRAN,0,TOTALS,IRAN,200,30,67,44.8,23,43,53.5,7,24,29.2,8,14,57.1,10,24,34,9,20,13,9,5,75,1
4324,102244,132_07_57,CHINESE TAIPEI,0,TOTALS,CHINESE TAIPEI,200,27,58,46.6,17,27,63.0,10,31,32.3,10,17,58.8,7,20,27,8,22,12,4,1,74,0
4325,102257,132_07_57,JORDAN,0,TOTALS,JORDAN,200,37,70,52.9,28,45,62.2,9,25,36.0,14,28,50.0,16,24,40,11,16,9,6,2,97,1
4326,102270,132_07_58,JAPAN,0,TOTALS,JAPAN,200,30,74,40.5,18,38,47.4,12,36,33.3,10,12,83.3,8,19,27,13,28,13,10,0,82,0
4327,102283,132_07_58,QATAR,0,TOTALS,QATAR,200,31,58,53.4,24,40,60.0,7,18,38.9,17,25,68.0,8,30,38,9,16,20,7,4,86,1
4328,102296,132_07_59,KAZAKHSTAN,0,TOTALS,KAZAKHSTAN,200,29,56,51.8,23,35,65.7,6,21,28.6,12,22,54.5,9,14,23,8,26,17,4,0,76,0
4329,102309,132_07_59,KOREA,0,TOTALS,KOREA,200,29,58,50.0,24,41,58.5,5,17,29.4,17,26,65.4,9,19,28,13,25,19,8,1,80,1
4330,102322,132_07_60,IRAN,0,TOTALS,IRAN,200,29,65,44.6,24,48,50.0,5,17,29.4,11,19,57.9,14,28,42,7,26,15,7,4,74,1
4331,102335,132_07_60,LEBANON,0,TOTALS,LEBANON,200,18,53,34.0,11,31,35.5,7,22,31.8,26,34,76.5,6,23,29,8,18,12,5,3,69,0
4332,103297,135_07_01,URUGUAY,0,TOTALS,URUGUAY,225,27,72,37.5,20,49,40.8,7,23,30.4,27,36,75.0,15,22,37,11,27,15,13,0,88,1
4333,103310,135_07_01,PANAMA,0,TOTALS,PANAMA,225,32,57,56.1,29,38,76.3,3,19,15.8,17,36,47.2,7,31,38,8,31,25,6,5,84,0
4334,103323,135_07_02,PUERTO RICO,0,TOTALS,PUERTO RICO,200,30,78,38.5,24,49,49.0,6,29,20.7,23,40,57.5,21,32,53,18,34,27,6,2,89,1
4335,103336,135_07_02,MEXICO,0,TOTALS,MEXICO,200,29,64,45.3,23,38,60.5,6,26,23.1,36,46,78.3,5,32,37,10,32,18,15,5,100,0
4336,103349,135_07_03,CANADA,0,TOTALS,CANADA,200,26,61,42.6,22,43,51.2,4,18,22.2,11,19,57.9,6,28,34,13,27,11,5,2,67,0
4337,103362,135_07_03,BRAZIL,0,TOTALS,BRAZIL,200,25,61,41.0,20,38,52.6,5,23,21.7,20,29,69.0,13,28,41,15,24,14,4,1,75,1
4338,103375,135_07_04,USA,0,TOTALS,USA,200,41,75,54.7,31,49,63.3,10,26,38.5,20,29,69.0,12,31,43,25,20,11,10,9,112,0
4339,103388,135_07_04,VENEZUELA,0,TOTALS,VENEZUELA,200,23,68,33.8,15,47,31.9,8,21,38.1,15,29,51.7,15,26,41,9,23,19,6,3,69,1
4340,103401,135_07_05,ARGENTINA,0,TOTALS,ARGENTINA,200,30,58,51.7,23,41,56.1,7,17,41.2,23,29,79.3,14,27,41,17,22,20,11,1,90,1
4341,103414,135_07_05,URUGUAY,0,TOTALS,URUGUAY,200,22,54,40.7,13,27,48.1,9,27,33.3,16,19,84.2,6,15,21,11,27,19,8,0,69,0
4342,103427,135_07_06,VENEZUELA,0,TOTALS,VENEZUELA,200,23,60,38.3,15,38,39.5,8,22,36.4,19,25,76.0,11,26,37,13,24,12,4,2,73,0
4343,103440,135_07_06,CANADA,0,TOTALS,CANADA,200,30,69,43.5,23,54,42.6,7,15,46.7,13,19,68.4,14,25,39,12,18,9,5,7,80,1
4344,103453,135_07_07,PANAMA,0,TOTALS,PANAMA,200,24,71,33.8,20,51,39.2,4,20,20.0,15,20,75.0,16,25,41,6,13,17,3,1,67,1
4345,103465,135_07_07,PUERTO RICO,0,TOTALS,PUERTO RICO,200,39,71,54.9,22,39,56.4,17,32,53.1,13,14,92.9,7,30,37,25,21,9,8,8,108,0
4346,103478,135_07_08,VIRGIN ISLANDS,0,TOTALS,VIRGIN ISLANDS,200,17,65,26.2,13,42,31.0,4,23,17.4,21,25,84.0,12,22,34,5,23,19,2,2,59,1
4347,103491,135_07_08,USA,0,TOTALS,USA,200,43,72,59.7,28,42,66.7,15,30,50.0,22,30,73.3,7,36,43,30,19,4,15,6,123,0
4348,103504,135_07_09,MEXICO,0,TOTALS,MEXICO,200,38,88,43.2,32,61,52.5,6,27,22.2,8,14,57.1,17,27,44,15,30,21,14,0,90,0
4349,103517,135_07_09,PANAMA,0,TOTALS,PANAMA,200,33,65,50.8,26,43,60.5,7,22,31.8,22,30,73.3,7,31,38,13,17,26,12,2,95,1
4350,103530,135_07_10,CANADA,0,TOTALS,CANADA,200,33,64,51.6,24,40,60.0,9,24,37.5,18,25,72.0,9,30,39,24,22,13,10,7,93,1
4351,103543,135_07_10,VIRGIN ISLANDS,0,TOTALS,VIRGIN ISLANDS,200,28,61,45.9,15,37,40.5,13,24,54.2,14,22,63.6,8,20,28,12,24,15,4,2,83,0
4352,103555,135_07_11,PUERTO RICO,0,TOTALS,PUERTO RICO,200,26,74,35.1,17,41,41.5,9,33,27.3,14,16,87.5,13,25,38,9,25,14,6,2,75,0
4353,103568,135_07_11,ARGENTINA,0,TOTALS,ARGENTINA,200,30,64,46.9,23,42,54.8,7,22,31.8,20,28,71.4,11,34,45,18,18,15,7,3,87,1
4354,103581,135_07_12,BRAZIL,0,TOTALS,BRAZIL,200,36,68,52.9,24,42,57.1,12,26,46.2,17,30,56.7,14,26,40,24,18,18,12,2,101,0
4355,103594,135_07_12,VENEZUELA,0,TOTALS,VENEZUELA,200,26,57,45.6,21,40,52.5,5,17,29.4,18,28,64.3,10,25,35,13,24,19,12,2,75,1
4356,103607,135_07_13,USA,0,TOTALS,USA,200,39,71,54.9,24,41,58.5,15,30,50.0,20,22,90.9,10,33,43,22,13,9,10,6,113,0
4357,103620,135_07_13,CANADA,0,TOTALS,CANADA,200,21,64,32.8,16,49,32.7,5,15,33.3,16,18,88.9,10,23,33,7,16,16,7,1,63,1
4358,103633,135_07_14,VIRGIN ISLANDS,0,TOTALS,VIRGIN ISLANDS,200,33,65,50.8,27,52,51.9,6,13,46.2,17,27,63.0,10,27,37,5,23,18,7,6,89,0
4359,103646,135_07_14,BRAZIL,0,TOTALS,BRAZIL,200,33,72,45.8,27,53,50.9,6,19,31.6,21,28,75.0,17,26,43,25,25,17,10,1,93,1
4360,103659,135_07_15,URUGUAY,0,TOTALS,URUGUAY,200,30,66,45.5,21,45,46.7,9,21,42.9,13,23,56.5,15,16,31,15,22,17,10,1,82,1
4361,103672,135_07_15,PUERTO RICO,0,TOTALS,PUERTO RICO,200,30,53,56.6,20,31,64.5,10,22,45.5,9,13,69.2,8,23,31,12,31,28,6,2,79,0
4362,103685,135_07_16,ARGENTINA,0,TOTALS,ARGENTINA,200,33,66,50.0,18,35,51.4,15,31,48.4,23,32,71.9,15,26,41,23,22,22,9,2,104,0
4363,103698,135_07_16,MEXICO,0,TOTALS,MEXICO,200,30,65,46.2,25,50,50.0,5,15,33.3,18,21,85.7,8,20,28,10,24,20,9,3,83,1
4364,103711,135_07_17,VENEZUELA,0,TOTALS,VENEZUELA,200,38,61,62.3,31,41,75.6,7,20,35.0,17,22,77.3,9,28,37,24,23,21,8,3,100,0
4365,103724,135_07_17,VIRGIN ISLANDS,0,TOTALS,VIRGIN ISLANDS,200,32,74,43.2,24,55,43.6,8,19,42.1,18,27,66.7,16,18,34,13,20,14,10,0,90,1
4366,103737,135_07_18,MEXICO,0,TOTALS,MEXICO,200,28,65,43.1,25,44,56.8,3,21,14.3,23,32,71.9,17,22,39,6,26,20,6,2,82,0
4367,103750,135_07_18,URUGUAY,0,TOTALS,URUGUAY,200,28,58,48.3,16,32,50.0,12,26,46.2,23,30,76.7,9,20,29,16,27,16,6,2,91,1
4368,103763,135_07_19,BRAZIL,0,TOTALS,BRAZIL,200,25,64,39.1,20,43,46.5,5,21,23.8,21,29,72.4,12,25,37,15,19,15,11,1,76,1
4369,103776,135_07_19,USA,0,TOTALS,USA,200,38,69,55.1,19,33,57.6,19,36,52.8,18,24,75.0,8,29,37,21,22,14,7,5,113,0
4370,103789,135_07_20,URUGUAY,0,TOTALS,URUGUAY,200,26,64,40.6,17,33,51.5,9,31,29.0,27,35,77.1,10,19,29,9,31,10,5,0,88,0
4371,103802,135_07_20,CANADA,0,TOTALS,CANADA,200,32,57,56.1,27,44,61.4,5,13,38.5,26,33,78.8,12,31,43,15,30,18,2,5,95,1
4372,103815,135_07_21,ARGENTINA,0,TOTALS,ARGENTINA,200,37,69,53.6,23,43,53.5,14,26,53.8,10,13,76.9,11,34,45,19,18,11,5,3,98,1
4373,103828,135_07_21,VENEZUELA,0,TOTALS,VENEZUELA,200,23,65,35.4,18,44,40.9,5,21,23.8,12,19,63.2,11,21,32,9,21,10,7,2,63,0
4374,103841,135_07_22,BRAZIL,0,TOTALS,BRAZIL,200,26,60,43.3,22,44,50.0,4,16,25.0,19,24,79.2,9,25,34,14,20,15,8,5,75,0
4375,103854,135_07_22,PUERTO RICO,0,TOTALS,PUERTO RICO,200,40,75,53.3,30,52,57.7,10,23,43.5,7,12,58.3,12,28,40,18,21,13,6,1,97,1
4376,103867,135_07_23,USA,0,TOTALS,USA,200,46,79,58.2,37,54,68.5,9,25,36.0,26,34,76.5,13,29,42,28,17,12,11,7,127,1
4377,103880,135_07_23,MEXICO,0,TOTALS,MEXICO,200,38,83,45.8,23,55,41.8,15,28,53.6,9,13,69.2,13,24,37,17,26,19,6,3,100,0
4378,103893,135_07_24,VENEZUELA,0,TOTALS,VENEZUELA,200,29,62,46.8,16,35,45.7,13,27,48.1,17,23,73.9,12,31,43,19,22,18,4,10,88,1
4379,103906,135_07_24,URUGUAY,0,TOTALS,URUGUAY,200,27,71,38.0,17,40,42.5,10,31,32.3,15,20,75.0,17,22,39,10,27,13,5,1,79,0
4380,103919,135_07_25,CANADA,0,TOTALS,CANADA,200,28,68,41.2,20,52,38.5,8,16,50.0,6,10,60.0,15,29,44,9,16,19,5,1,70,0
4381,103932,135_07_25,ARGENTINA,0,TOTALS,ARGENTINA,200,31,70,44.3,19,40,47.5,12,30,40.0,11,15,73.3,12,28,40,21,15,12,9,2,85,1
4382,103945,135_07_26,MEXICO,0,TOTALS,MEXICO,200,32,72,44.4,24,52,46.2,8,20,40.0,18,23,78.3,16,19,35,15,16,19,10,2,90,1
4383,103958,135_07_26,BRAZIL,0,TOTALS,BRAZIL,200,42,74,56.8,34,57,59.6,8,17,47.1,12,16,75.0,13,26,39,31,22,16,14,5,104,0
4384,103971,135_07_27,PUERTO RICO,0,TOTALS,PUERTO RICO,200,29,80,36.2,22,47,46.8,7,33,21.2,13,15,86.7,16,21,37,13,20,10,2,4,78,1
4385,103984,135_07_27,USA,0,TOTALS,USA,200,47,79,59.5,35,45,77.8,12,34,35.3,11,23,47.8,13,35,48,26,15,4,6,9,117,0
4386,103997,135_07_28,CANADA,0,TOTALS,CANADA,200,38,81,46.9,29,56,51.8,9,25,36.0,12,21,57.1,26,35,61,21,17,21,5,3,97,1
4387,104010,135_07_28,MEXICO,0,TOTALS,MEXICO,200,32,74,43.2,25,52,48.1,7,22,31.8,9,11,81.8,8,22,30,16,23,10,7,5,80,0
4388,104023,135_07_29,VENEZUELA,0,TOTALS,VENEZUELA,200,22,66,33.3,18,44,40.9,4,22,18.2,15,18,83.3,8,29,37,7,17,14,6,4,63,0
4389,104036,135_07_29,PUERTO RICO,0,TOTALS,PUERTO RICO,200,35,74,47.3,23,45,51.1,12,29,41.4,10,12,83.3,8,34,42,15,15,10,8,5,92,1
4390,104049,135_07_30,ARGENTINA,0,TOTALS,ARGENTINA,225,26,61,42.6,19,39,48.7,7,22,31.8,27,35,77.1,10,34,44,12,21,17,9,1,86,1
4391,104062,135_07_30,BRAZIL,0,TOTALS,BRAZIL,225,30,70,42.9,19,48,39.6,11,22,50.0,8,17,47.1,9,27,36,17,26,17,7,5,79,0
4392,104075,135_07_31,URUGUAY,0,TOTALS,URUGUAY,200,30,80,37.5,18,44,40.9,12,36,33.3,7,9,77.8,17,22,39,14,17,15,8,0,79,1
4393,104088,135_07_31,USA,0,TOTALS,USA,200,46,72,63.9,33,46,71.7,13,26,50.0,13,18,72.2,4,32,36,31,8,8,13,5,118,0
4394,104101,135_07_32,MEXICO,0,TOTALS,MEXICO,200,37,69,53.6,30,54,55.6,7,15,46.7,20,26,76.9,15,29,44,22,17,20,10,1,101,0
4395,104114,135_07_32,VENEZUELA,0,TOTALS,VENEZUELA,200,33,74,44.6,22,42,52.4,11,32,34.4,14,22,63.6,14,17,31,21,19,14,10,9,91,1
4396,104127,135_07_33,BRAZIL,0,TOTALS,BRAZIL,200,40,61,65.6,33,48,68.8,7,13,53.8,9,10,90.0,9,26,35,21,17,15,6,1,96,1
4397,104140,135_07_33,URUGUAY,0,TOTALS,URUGUAY,200,24,62,38.7,20,40,50.0,4,22,18.2,10,15,66.7,13,13,26,8,12,18,10,1,62,0
4398,104153,135_07_34,PUERTO RICO,0,TOTALS,PUERTO RICO,200,28,70,40.0,16,40,40.0,12,30,40.0,4,4,100.0,16,35,51,11,19,12,3,4,72,1
4399,104166,135_07_34,CANADA,0,TOTALS,CANADA,200,24,75,32.0,18,52,34.6,6,23,26.1,12,24,50.0,22,25,47,9,15,9,5,5,66,0
4400,104179,135_07_35,USA,0,TOTALS,USA,200,30,56,53.6,19,27,70.4,11,29,37.9,20,27,74.1,4,27,31,17,22,21,15,4,91,1
4401,104192,135_07_35,ARGENTINA,0,TOTALS,ARGENTINA,200,28,68,41.2,23,47,48.9,5,21,23.8,15,20,75.0,14,26,40,12,24,21,10,1,76,0
4402,104205,135_07_36,ARGENTINA,0,TOTALS,ARGENTINA,200,30,56,53.6,22,40,55.0,8,16,50.0,23,32,71.9,12,21,33,15,19,11,6,4,91,1
4403,104218,135_07_36,BRAZIL,0,TOTALS,BRAZIL,200,29,63,46.0,21,42,50.0,8,21,38.1,14,18,77.8,13,18,31,14,27,11,6,1,80,0
4404,104231,135_07_37,USA,0,TOTALS,USA,200,48,69,69.6,25,33,75.8,23,36,63.9,16,23,69.6,5,31,36,31,20,10,8,2,135,0
4405,104244,135_07_37,PUERTO RICO,0,TOTALS,PUERTO RICO,200,31,77,40.3,22,48,45.8,9,29,31.0,20,30,66.7,19,19,38,13,22,14,7,0,91,1
4406,104257,135_07_38,BRAZIL,0,TOTALS,BRAZIL,200,36,69,52.2,23,39,59.0,13,30,43.3,22,26,84.6,12,19,31,20,24,16,5,2,107,0
4407,104270,135_07_38,PUERTO RICO,0,TOTALS,PUERTO RICO,200,35,70,50.0,20,42,47.6,15,28,53.6,26,28,92.9,15,24,39,17,22,14,9,0,111,1
4408,104283,135_07_39,ARGENTINA,0,TOTALS,ARGENTINA,200,33,76,43.4,24,49,49.0,9,27,33.3,6,10,60.0,15,21,36,15,18,11,4,0,81,1
4409,104296,135_07_39,USA,0,TOTALS,USA,200,42,73,57.5,22,32,68.8,20,41,48.8,14,20,70.0,12,29,41,28,16,11,8,7,118,0
4410,104798,137_07_01,ARGENTINA,0,TOTALS,ARGENTINA,200,27,65,41.5,22,49,44.9,5,16,31.2,16,21,76.2,11,27,38,18,26,18,9,3,75,1
4411,104811,137_07_01,BRAZIL,0,TOTALS,BRAZIL,200,23,56,41.1,19,35,54.3,4,21,19.0,17,30,56.7,7,24,31,10,24,21,11,3,67,0
4412,104824,137_07_02,PUERTO RICO,0,TOTALS,PUERTO RICO,225,22,73,30.1,16,47,34.0,6,26,23.1,13,16,81.2,8,27,35,14,13,12,6,2,63,0
4413,104837,137_07_02,CANADA,0,TOTALS,CANADA,225,27,73,37.0,23,55,41.8,4,18,22.2,7,11,63.6,15,36,51,14,16,19,7,2,65,1
4414,104850,137_07_03,CANADA,0,TOTALS,CANADA,200,28,52,53.8,20,37,54.1,8,15,53.3,20,24,83.3,4,25,29,9,29,28,4,1,84,1
4415,104863,137_07_03,ARGENTINA,0,TOTALS,ARGENTINA,200,26,66,39.4,21,45,46.7,5,21,23.8,21,29,72.4,10,15,25,13,19,12,14,1,78,0
4416,104876,137_07_04,BRAZIL,0,TOTALS,BRAZIL,200,26,57,45.6,22,40,55.0,4,17,23.5,23,38,60.5,10,31,41,14,16,12,6,3,79,1
4417,104889,137_07_04,PUERTO RICO,0,TOTALS,PUERTO RICO,200,26,67,38.8,18,42,42.9,8,25,32.0,7,11,63.6,4,21,25,16,27,9,7,4,67,0
4418,104901,137_07_05,CANADA,0,TOTALS,CANADA,200,20,59,33.9,14,42,33.3,6,17,35.3,15,24,62.5,13,28,41,9,17,21,10,3,61,0
4419,104913,137_07_05,BRAZIL,0,TOTALS,BRAZIL,200,28,65,43.1,25,48,52.1,3,17,17.6,15,21,71.4,9,25,34,11,17,19,12,4,74,1
4420,104924,137_07_06,PUERTO RICO,0,TOTALS,PUERTO RICO,200,32,72,44.4,23,52,44.2,9,20,45.0,16,27,59.3,13,24,37,15,22,7,6,2,89,0
4421,104936,137_07_06,ARGENTINA,0,TOTALS,ARGENTINA,200,32,62,51.6,24,42,57.1,8,20,40.0,18,27,66.7,6,28,34,16,21,11,6,2,90,1
4422,104948,138_07_01,TRINIDAD AND TOBAGO,0,TOTALS,TRINIDAD AND TOBAGO,200,22,94,23.4,17,70,24.3,5,24,20.8,19,26,73.1,33,24,57,5,29,17,14,7,68,0
4423,104960,138_07_01,BARBADOS,0,TOTALS,BARBADOS,200,22,67,32.8,16,48,33.3,6,19,31.6,19,27,70.4,16,32,48,14,22,25,3,16,69,1
4424,104973,138_07_02,BAHAMAS,0,TOTALS,BAHAMAS,200,25,61,41.0,19,37,51.4,6,24,25.0,14,22,63.6,8,23,31,14,30,24,9,5,70,0
4425,104986,138_07_02,ANTIGUA,0,TOTALS,ANTIGUA,200,26,64,40.6,20,45,44.4,6,19,31.6,20,32,62.5,15,24,39,12,23,23,10,2,78,1
4426,104999,138_07_03,PUERTO RICO,0,TOTALS,PUERTO RICO,200,33,58,56.9,17,27,63.0,16,31,51.6,25,29,86.2,3,36,39,26,23,20,12,7,107,0
4427,105012,138_07_03,BRITISH VIRGIN ISLANDS,0,TOTALS,BRITISH VIRGIN ISLANDS,200,18,72,25.0,13,45,28.9,5,27,18.5,15,30,50.0,17,22,39,5,22,20,8,1,56,1
4428,105024,138_07_04,CUBA,0,TOTALS,CUBA,200,34,72,47.2,25,50,50.0,9,22,40.9,16,26,61.5,20,18,38,22,21,21,23,1,93,1
4429,105037,138_07_04,BARBADOS,0,TOTALS,BARBADOS,200,28,60,46.7,24,48,50.0,4,12,33.3,9,16,56.2,11,18,29,11,20,35,9,7,69,0
4430,105049,138_07_05,TRINIDAD AND TOBAGO,0,TOTALS,TRINIDAD AND TOBAGO,200,24,72,33.3,21,59,35.6,3,13,23.1,16,26,61.5,14,19,33,4,22,14,5,3,67,0
4431,105062,138_07_05,PUERTO RICO,0,TOTALS,PUERTO RICO,200,32,63,50.8,26,40,65.0,6,23,26.1,23,27,85.2,10,33,43,18,24,14,8,6,93,1
4432,105075,138_07_06,BRITISH VIRGIN ISLANDS,0,TOTALS,BRITISH VIRGIN ISLANDS,200,27,56,48.2,23,41,56.1,4,15,26.7,23,51,45.1,6,16,22,15,25,26,12,2,81,1
4433,105087,138_07_06,CUBA,0,TOTALS,CUBA,200,37,77,48.1,32,61,52.5,5,16,31.2,26,37,70.3,18,25,43,22,30,22,16,2,105,0
4434,105100,138_07_07,PUERTO RICO,0,TOTALS,PUERTO RICO,200,37,75,49.3,23,41,56.1,14,34,41.2,16,20,80.0,13,40,53,26,18,9,13,6,104,0
4435,105113,138_07_07,BARBADOS,0,TOTALS,BARBADOS,200,14,68,20.6,12,50,24.0,2,18,11.1,8,23,34.8,12,20,32,6,18,15,5,3,38,1
4436,105126,138_07_08,BRITISH VIRGIN ISLANDS,0,TOTALS,BRITISH VIRGIN ISLANDS,200,26,64,40.6,21,46,45.7,5,18,27.8,16,24,66.7,14,27,41,12,26,23,7,3,73,1
4437,105139,138_07_08,BARBADOS,0,TOTALS,BARBADOS,200,18,57,31.6,14,40,35.0,4,17,23.5,24,36,66.7,10,20,30,11,20,21,15,4,64,0
4438,105152,138_07_09,CUBA,0,TOTALS,CUBA,200,32,67,47.8,25,55,45.5,7,12,58.3,13,19,68.4,15,15,30,9,24,24,9,3,84,1
4439,105164,138_07_09,TRINIDAD AND TOBAGO,0,TOTALS,TRINIDAD AND TOBAGO,200,26,58,44.8,24,45,53.3,2,13,15.4,10,17,58.8,7,19,26,9,19,23,8,5,64,0
4440,105177,138_07_10,ANTIGUA,0,TOTALS,ANTIGUA,200,24,62,38.7,22,52,42.3,2,10,20.0,14,15,93.3,11,19,30,7,24,16,6,1,64,0
4441,105190,138_07_10,DOMINICAN REPUBLIC,0,TOTALS,DOMINICAN REPUBLIC,200,29,62,46.8,23,47,48.9,6,15,40.0,24,29,82.8,10,23,33,15,16,12,6,5,88,1
4442,105203,138_07_11,BRITISH VIRGIN ISLANDS,0,TOTALS,BRITISH VIRGIN ISLANDS,200,26,68,38.2,22,52,42.3,4,16,25.0,24,33,72.7,15,20,35,7,26,18,13,5,80,1
4443,105215,138_07_11,TRINIDAD AND TOBAGO,0,TOTALS,TRINIDAD AND TOBAGO,200,24,58,41.4,16,43,37.2,8,15,53.3,17,31,54.8,15,22,37,13,26,20,11,5,73,0
4444,105228,138_07_12,PUERTO RICO,0,TOTALS,PUERTO RICO,200,37,76,48.7,27,49,55.1,10,27,37.0,5,7,71.4,10,30,40,20,18,7,7,7,89,1
4445,105241,138_07_12,CUBA,0,TOTALS,CUBA,200,25,72,34.7,22,58,37.9,3,14,21.4,15,21,71.4,14,34,48,13,15,12,4,0,68,0
4446,105254,138_07_13,BRITISH VIRGIN ISLANDS,0,TOTALS,BRITISH VIRGIN ISLANDS,200,19,64,29.7,16,44,36.4,3,20,15.0,23,34,67.6,12,22,34,5,16,15,8,12,64,0
4447,105267,138_07_13,ANTIGUA,0,TOTALS,ANTIGUA,200,26,63,41.3,17,40,42.5,9,23,39.1,15,20,75.0,7,34,41,14,24,17,9,2,76,1
4448,105280,138_07_14,DOMINICAN REPUBLIC,0,TOTALS,DOMINICAN REPUBLIC,200,30,56,53.6,25,41,61.0,5,15,33.3,28,34,82.4,9,24,33,9,20,13,6,2,93,1
4449,105293,138_07_14,CUBA,0,TOTALS,CUBA,200,32,62,51.6,26,50,52.0,6,12,50.0,12,18,66.7,7,14,21,15,27,11,5,1,82,0
4450,105306,138_07_15,PUERTO RICO,0,TOTALS,PUERTO RICO,200,29,81,35.8,21,56,37.5,8,25,32.0,11,12,91.7,17,26,43,17,15,6,6,4,77,1
4451,105319,138_07_15,BAHAMAS,0,TOTALS,BAHAMAS,200,26,68,38.2,23,58,39.7,3,10,30.0,9,12,75.0,13,31,44,9,14,14,5,9,64,0
4452,105332,138_07_16,CUBA,0,TOTALS,CUBA,225,26,57,45.6,21,42,50.0,5,15,33.3,33,47,70.2,9,18,27,12,26,21,8,2,90,1
4453,105345,138_07_16,BAHAMAS,0,TOTALS,BAHAMAS,225,34,64,53.1,30,51,58.8,4,13,30.8,16,26,61.5,8,24,32,24,38,22,8,6,88,0
4454,105358,138_07_17,BARBADOS,0,TOTALS,BARBADOS,200,29,67,43.3,18,44,40.9,11,23,47.8,4,5,80.0,8,25,33,13,17,20,13,7,73,0
4455,105371,138_07_17,ANTIGUA,0,TOTALS,ANTIGUA,200,27,74,36.5,22,54,40.7,5,20,25.0,18,28,64.3,15,24,39,13,11,18,12,1,77,1
4456,105384,138_07_18,DOMINICAN REPUBLIC,0,TOTALS,DOMINICAN REPUBLIC,200,31,68,45.6,26,54,48.1,5,14,35.7,5,8,62.5,11,31,42,10,12,15,1,2,72,0
4457,105397,138_07_18,PUERTO RICO,0,TOTALS,PUERTO RICO,200,33,77,42.9,23,44,52.3,10,33,30.3,5,6,83.3,11,26,37,12,12,7,3,3,81,1
4458,105410,139_07_01,ARGENTINA,0,TOTALS,ARGENTINA,200,36,66,54.5,31,48,64.6,5,18,27.8,10,27,37.0,8,11,19,16,25,15,28,2,87,1
4459,105423,139_07_01,COLOMBIA,0,TOTALS,COLOMBIA,200,11,50,22.0,11,41,26.8,0,9,0.0,14,26,53.8,9,16,25,1,21,19,10,1,36,0
4460,105436,139_07_02,URUGUAY,0,TOTALS,URUGUAY,200,23,58,39.7,20,44,45.5,3,14,21.4,19,33,57.6,8,16,24,7,19,16,23,1,68,1
4461,105449,139_07_02,ECUADOR,0,TOTALS,ECUADOR,200,17,54,31.5,9,26,34.6,8,28,28.6,12,20,60.0,4,11,15,6,27,28,20,1,54,0
4462,105462,139_07_03,BRAZIL,0,TOTALS,BRAZIL,200,32,62,51.6,27,43,62.8,5,19,26.3,15,30,50.0,9,22,31,8,22,13,20,2,84,1
4463,105475,139_07_03,CHILE,0,TOTALS,CHILE,200,21,54,38.9,16,35,45.7,5,19,26.3,10,15,66.7,2,9,11,9,20,18,18,0,57,0
4464,105488,139_07_04,VENEZUELA,0,TOTALS,VENEZUELA,200,37,71,52.1,27,46,58.7,10,25,40.0,17,30,56.7,14,11,25,21,17,9,32,3,101,0
4465,105501,139_07_04,PERU,0,TOTALS,PERU,200,10,34,29.4,8,19,42.1,2,15,13.3,4,10,40.0,2,9,11,1,21,16,4,0,26,1
4466,105514,139_07_05,PERU,0,TOTALS,PERU,200,12,44,27.3,9,25,36.0,3,19,15.8,8,15,53.3,1,12,13,2,18,23,12,0,35,0
4467,105527,139_07_05,ARGENTINA,0,TOTALS,ARGENTINA,200,39,66,59.1,27,47,57.4,12,19,63.2,9,19,47.4,14,17,31,9,17,14,16,2,99,1
4468,105540,139_07_06,ECUADOR,0,TOTALS,ECUADOR,200,14,43,32.6,10,28,35.7,4,15,26.7,7,19,36.8,2,10,12,2,16,41,24,0,39,0
4469,105553,139_07_06,CHILE,0,TOTALS,CHILE,200,30,78,38.5,22,51,43.1,8,27,29.6,10,16,62.5,3,10,13,8,17,8,43,0,78,1
4470,105566,139_07_07,URUGUAY,0,TOTALS,URUGUAY,200,15,52,28.8,11,31,35.5,4,21,19.0,11,29,37.9,7,8,15,4,21,18,15,2,45,0
4471,105579,139_07_07,BRAZIL,0,TOTALS,BRAZIL,200,27,54,50.0,21,35,60.0,6,19,31.6,14,23,60.9,6,14,20,6,30,17,29,0,74,1
4472,105592,139_07_08,COLOMBIA,0,TOTALS,COLOMBIA,200,13,55,23.6,10,36,27.8,3,19,15.8,7,18,38.9,6,12,18,4,20,33,18,0,36,1
4473,105605,139_07_08,VENEZUELA,0,TOTALS,VENEZUELA,200,40,65,61.5,27,38,71.1,13,27,48.1,17,25,68.0,11,23,34,21,18,9,23,4,110,0
4474,105618,139_07_09,ARGENTINA,0,TOTALS,ARGENTINA,200,24,55,43.6,23,38,60.5,1,17,5.9,17,26,65.4,5,16,21,11,24,10,14,2,66,0
4475,105631,139_07_09,VENEZUELA,0,TOTALS,VENEZUELA,200,27,65,41.5,24,55,43.6,3,10,30.0,16,27,59.3,9,14,23,7,20,16,18,3,73,1
4476,105644,139_07_10,BRAZIL,0,TOTALS,BRAZIL,200,36,78,46.2,31,53,58.5,5,25,20.0,13,25,52.0,23,21,44,20,10,13,23,3,90,1
4477,105657,139_07_10,ECUADOR,0,TOTALS,ECUADOR,200,12,46,26.1,7,29,24.1,5,17,29.4,2,7,28.6,2,5,7,5,16,31,15,1,31,0
4478,105670,139_07_11,URUGUAY,0,TOTALS,URUGUAY,200,18,48,37.5,12,33,36.4,6,15,40.0,17,37,45.9,9,19,28,3,27,23,23,0,59,1
4479,105683,139_07_11,CHILE,0,TOTALS,CHILE,200,17,48,35.4,11,27,40.7,6,21,28.6,14,29,48.3,6,4,10,7,32,10,11,1,54,0
4480,105696,139_07_12,PERU,0,TOTALS,PERU,200,24,53,45.3,13,29,44.8,11,24,45.8,15,28,53.6,3,18,21,6,34,19,18,0,74,1
4481,105709,139_07_12,COLOMBIA,0,TOTALS,COLOMBIA,200,23,60,38.3,21,44,47.7,2,16,12.5,20,42,47.6,6,25,31,2,25,10,17,2,68,0
4482,105722,139_07_13,COLOMBIA,0,TOTALS,COLOMBIA,200,26,57,45.6,22,38,57.9,4,19,21.1,11,21,52.4,8,26,34,5,20,17,13,0,67,1
4483,105735,139_07_13,ECUADOR,0,TOTALS,ECUADOR,200,23,55,41.8,13,30,43.3,10,25,40.0,10,24,41.7,1,11,12,9,21,18,31,0,66,0
4484,105748,139_07_14,PERU,0,TOTALS,PERU,200,30,60,50.0,21,41,51.2,9,19,47.4,9,20,45.0,2,9,11,11,22,15,29,1,78,1
4485,105761,139_07_14,CHILE,0,TOTALS,CHILE,200,23,60,38.3,15,41,36.6,8,19,42.1,19,35,54.3,5,21,26,10,17,17,27,0,73,0
4486,105774,139_07_15,BRAZIL,0,TOTALS,BRAZIL,200,23,48,47.9,20,38,52.6,3,10,30.0,14,22,63.6,4,19,23,7,19,13,13,2,63,0
4487,105787,139_07_15,ARGENTINA,0,TOTALS,ARGENTINA,200,25,59,42.4,17,33,51.5,8,26,30.8,6,11,54.5,4,12,16,9,18,13,21,0,64,1
4488,105800,139_07_16,VENEZUELA,0,TOTALS,VENEZUELA,200,30,68,44.1,26,43,60.5,4,25,16.0,15,19,78.9,7,13,20,24,19,5,25,2,79,1
4489,105813,139_07_16,URUGUAY,0,TOTALS,URUGUAY,200,18,50,36.0,15,35,42.9,3,15,20.0,6,11,54.5,4,17,21,4,20,19,9,2,45,0
4490,105826,139_07_17,BRAZIL,0,TOTALS,BRAZIL,200,24,60,40.0,22,39,56.4,2,21,9.5,16,21,76.2,3,12,15,13,25,12,18,5,66,0
4491,105839,139_07_17,URUGUAY,0,TOTALS,URUGUAY,200,25,48,52.1,17,30,56.7,8,18,44.4,11,26,42.3,10,12,22,8,22,10,17,0,69,1
4492,105852,139_07_18,ARGENTINA,0,TOTALS,ARGENTINA,200,21,59,35.6,12,30,40.0,9,29,31.0,10,17,58.8,12,22,34,6,22,23,19,0,61,1
4493,105865,139_07_18,VENEZUELA,0,TOTALS,VENEZUELA,200,21,64,32.8,19,50,38.0,2,14,14.3,11,21,52.4,10,18,28,10,18,8,16,5,55,0
4494,105982,142_07_01,MEXICO,0,TOTALS,MEXICO,200,31,75,41.3,29,65,44.6,2,10,20.0,25,43,58.1,10,32,42,16,20,19,10,4,89,1
4495,105995,142_07_01,BAHAMAS,0,TOTALS,BAHAMAS,200,27,133,20.3,18,96,18.8,9,37,24.3,12,22,54.5,33,26,59,17,34,23,6,8,75,0
4496,106008,142_07_02,VIRGIN ISLANDS,0,TOTALS,VIRGIN ISLANDS,200,23,81,28.4,15,50,30.0,8,31,25.8,11,21,52.4,15,23,38,11,21,28,16,3,65,0
4497,106021,142_07_02,DOMINICAN REPUBLIC,0,TOTALS,DOMINICAN REPUBLIC,200,29,74,39.2,27,62,43.5,2,12,16.7,17,26,65.4,15,23,38,11,21,28,16,3,77,1
4498,106034,142_07_03,PUERTO RICO,0,TOTALS,PUERTO RICO,200,44,102,43.1,31,68,45.6,13,34,38.2,10,21,47.6,27,31,58,28,18,18,24,3,111,0
4499,106047,142_07_03,TRINIDAD AND TOBAGO,0,TOTALS,TRINIDAD AND TOBAGO,200,26,68,38.2,25,58,43.1,1,10,10.0,8,20,40.0,16,32,48,11,17,38,11,10,61,1
4500,106060,142_07_04,TRINIDAD AND TOBAGO,0,TOTALS,TRINIDAD AND TOBAGO,200,17,59,28.8,12,47,25.5,5,12,41.7,13,26,50.0,16,26,42,12,20,29,4,8,52,0
4501,106073,142_07_04,MEXICO,0,TOTALS,MEXICO,200,38,85,44.7,34,69,49.3,4,16,25.0,16,23,69.6,21,31,52,27,19,11,23,6,96,1
4502,106086,142_07_05,BAHAMAS,0,TOTALS,BAHAMAS,200,28,74,37.8,25,57,43.9,3,17,17.6,13,19,68.4,20,34,54,13,16,26,11,5,72,1
4503,106099,142_07_05,DOMINICAN REPUBLIC,0,TOTALS,DOMINICAN REPUBLIC,200,28,76,36.8,22,45,48.9,6,31,19.4,6,12,50.0,12,25,37,16,17,25,14,8,68,0
4504,106112,142_07_06,VIRGIN ISLANDS,0,TOTALS,VIRGIN ISLANDS,200,24,81,29.6,20,58,34.5,4,23,17.4,15,29,51.7,26,22,48,8,42,31,10,6,67,1
4505,106125,142_07_06,PUERTO RICO,0,TOTALS,PUERTO RICO,200,35,87,40.2,27,65,41.5,8,22,36.4,34,51,66.7,28,27,55,22,22,17,16,4,112,0
4506,106138,142_07_07,TRINIDAD AND TOBAGO,0,TOTALS,TRINIDAD AND TOBAGO,200,28,65,43.1,26,58,44.8,2,7,28.6,15,36,41.7,14,33,47,12,16,41,10,7,73,0
4507,106151,142_07_07,VIRGIN ISLANDS,0,TOTALS,VIRGIN ISLANDS,200,34,107,31.8,30,82,36.6,4,25,16.0,13,20,65.0,29,27,56,10,27,22,15,5,85,1
4508,106164,142_07_08,MEXICO,0,TOTALS,MEXICO,200,29,60,48.3,21,39,53.8,8,21,38.1,13,29,44.8,9,26,35,12,19,24,10,4,79,0
4509,106177,142_07_08,DOMINICAN REPUBLIC,0,TOTALS,DOMINICAN REPUBLIC,200,29,73,39.7,20,51,39.2,9,22,40.9,15,23,65.2,15,19,34,18,27,17,12,5,82,1
4510,106190,142_07_09,PUERTO RICO,0,TOTALS,PUERTO RICO,200,40,77,51.9,30,54,55.6,10,23,43.5,26,44,59.1,14,32,46,23,33,18,7,9,116,0
4511,106203,142_07_09,BAHAMAS,0,TOTALS,BAHAMAS,200,24,86,27.9,20,66,30.3,4,20,20.0,32,48,66.7,23,33,56,8,38,20,11,4,84,1
4512,106216,142_07_10,BAHAMAS,0,TOTALS,BAHAMAS,200,35,72,48.6,30,65,46.2,5,7,71.4,28,51,54.9,17,48,65,14,28,25,9,9,103,0
4513,106229,142_07_10,VIRGIN ISLANDS,0,TOTALS,VIRGIN ISLANDS,200,31,100,31.0,21,55,38.2,10,45,22.2,21,40,52.5,24,29,53,13,34,18,14,5,93,1
4514,106242,142_07_11,TRINIDAD AND TOBAGO,0,TOTALS,TRINIDAD AND TOBAGO,200,19,55,34.5,16,37,43.2,3,18,16.7,6,22,27.3,8,22,30,11,14,35,13,4,47,0
4515,106255,142_07_11,DOMINICAN REPUBLIC,0,TOTALS,DOMINICAN REPUBLIC,200,36,79,45.6,32,61,52.5,4,18,22.2,7,9,77.8,18,25,43,19,21,22,23,3,83,1
4516,106268,142_07_12,MEXICO,0,TOTALS,MEXICO,200,27,61,44.3,24,43,55.8,3,18,16.7,16,25,64.0,9,21,30,12,28,32,7,6,73,1
4517,106281,142_07_12,PUERTO RICO,0,TOTALS,PUERTO RICO,200,46,90,51.1,31,59,52.5,15,31,48.4,19,31,61.3,18,26,44,23,20,15,14,9,126,0
4518,106294,142_07_13,BAHAMAS,0,TOTALS,BAHAMAS,200,27,89,30.3,20,65,30.8,7,24,29.2,17,31,54.8,28,23,51,17,21,20,22,5,78,1
4519,106307,142_07_13,TRINIDAD AND TOBAGO,0,TOTALS,TRINIDAD AND TOBAGO,200,22,57,38.6,22,48,45.8,0,9,0.0,19,31,61.3,12,34,46,12,25,28,6,12,63,0
4520,106320,142_07_14,MEXICO,0,TOTALS,MEXICO,200,42,80,52.5,36,70,51.4,6,10,60.0,13,26,50.0,16,44,60,22,26,30,10,8,103,0
4521,106333,142_07_14,VIRGIN ISLANDS,0,TOTALS,VIRGIN ISLANDS,200,31,94,33.0,21,63,33.3,10,31,32.3,16,37,43.2,21,43,64,14,25,20,15,8,88,1
4522,106346,142_07_15,DOMINICAN REPUBLIC,0,TOTALS,DOMINICAN REPUBLIC,200,24,69,34.8,23,57,40.4,1,12,8.3,13,17,76.5,9,18,27,10,32,18,10,2,62,0
4523,106359,142_07_15,PUERTO RICO,0,TOTALS,PUERTO RICO,200,28,54,51.9,22,36,61.1,6,18,33.3,25,44,56.8,30,44,74,13,18,24,8,4,87,1
4524,106372,143_06_01,CZECH REPUBLIC,0,TOTALS,CZECH REPUBLIC,200,32,68,47.1,21,40,52.5,11,28,39.3,10,13,76.9,18,17,35,18,22,8,11,2,85,1
4525,106385,143_06_01,BELGIUM,0,TOTALS,BELGIUM,200,20,46,43.5,16,32,50.0,4,14,28.6,23,31,74.2,12,18,30,6,20,19,6,2,67,0
4526,106398,143_06_02,BULGARIA,0,TOTALS,BULGARIA,200,28,59,47.5,18,34,52.9,10,25,40.0,14,17,82.4,11,20,31,12,21,5,5,1,80,1
4527,106411,143_06_02,UKRAINE,0,TOTALS,UKRAINE,200,26,54,48.1,17,27,63.0,9,27,33.3,16,21,76.2,12,27,39,8,16,14,1,5,77,0
4528,106424,143_06_03,CROATIA,0,TOTALS,CROATIA,200,33,55,60.0,27,42,64.3,6,13,46.2,12,18,66.7,8,28,36,20,20,8,5,1,84,1
4529,106437,143_06_03,LATVIA,0,TOTALS,LATVIA,200,22,51,43.1,20,36,55.6,2,15,13.3,10,14,71.4,9,16,25,9,25,2,2,2,56,0
4530,106450,143_06_04,ESTONIA,0,TOTALS,ESTONIA,200,22,57,38.6,19,38,50.0,3,19,15.8,4,9,44.4,10,18,28,14,15,10,13,3,51,1
4531,106463,143_06_04,DENMARK,0,TOTALS,DENMARK,200,21,46,45.7,19,34,55.9,2,12,16.7,6,7,85.7,7,26,33,7,16,21,5,0,50,0
4532,106476,143_06_05,SWEDEN,0,TOTALS,SWEDEN,200,24,61,39.3,18,36,50.0,6,25,24.0,21,28,75.0,12,22,34,14,22,10,6,2,75,0
4533,106489,143_06_05,POLAND,0,TOTALS,POLAND,200,27,55,49.1,16,30,53.3,11,25,44.0,16,20,80.0,6,24,30,15,23,11,6,4,81,1
4534,106502,143_06_06,RUSSIA,0,TOTALS,RUSSIA,200,33,59,55.9,30,44,68.2,3,15,20.0,13,16,81.2,9,24,33,8,20,5,4,0,82,1
4535,106515,143_06_06,HUNGARY,0,TOTALS,HUNGARY,200,24,62,38.7,19,42,45.2,5,20,25.0,9,16,56.2,14,20,34,7,20,7,3,0,62,0
4536,106528,143_06_07,ISRAEL,0,TOTALS,ISRAEL,200,30,57,52.6,23,39,59.0,7,18,38.9,21,23,91.3,9,21,30,15,27,15,8,2,88,1
4537,106541,143_06_07,BOSNIA AND HERZEGOVINA,0,TOTALS,BOSNIA AND HERZEGOVINA,200,24,51,47.1,12,24,50.0,12,27,44.4,21,28,75.0,6,17,23,10,21,13,8,3,81,0
4538,106554,143_06_08,PORTUGAL,0,TOTALS,PORTUGAL,200,37,71,52.1,23,44,52.3,14,27,51.9,20,26,76.9,8,18,26,18,24,14,8,0,108,0
4539,106566,143_06_08,MKD,0,TOTALS,MKD,200,27,64,42.2,20,42,47.6,7,22,31.8,29,38,76.3,7,14,21,11,22,11,8,3,90,1
4540,106579,143_06_09,DENMARK,0,TOTALS,DENMARK,200,23,65,35.4,19,42,45.2,4,23,17.4,17,26,65.4,12,18,30,14,17,8,3,1,67,0
4541,106592,143_06_09,CROATIA,0,TOTALS,CROATIA,200,35,68,51.5,28,46,60.9,7,22,31.8,15,25,60.0,14,33,47,15,22,10,5,2,92,1
4542,106605,143_06_10,BELGIUM,0,TOTALS,BELGIUM,200,33,57,57.9,22,39,56.4,11,18,61.1,14,26,53.8,6,25,31,19,25,15,6,7,91,1
4543,106618,143_06_10,RUSSIA,0,TOTALS,RUSSIA,200,28,61,45.9,17,39,43.6,11,22,50.0,13,26,50.0,11,18,29,5,23,12,6,1,80,0
4544,106631,143_06_11,HUNGARY,0,TOTALS,HUNGARY,200,26,56,46.4,19,38,50.0,7,18,38.9,17,25,68.0,8,17,25,18,28,19,9,4,76,0
4545,106644,143_06_11,CZECH REPUBLIC,0,TOTALS,CZECH REPUBLIC,200,21,47,44.7,18,36,50.0,3,11,27.3,35,41,85.4,7,22,29,12,25,10,6,3,80,1
4546,106657,143_06_12,POLAND,0,TOTALS,POLAND,200,26,57,45.6,18,36,50.0,8,21,38.1,15,26,57.7,11,19,30,16,20,14,10,0,75,1
4547,106670,143_06_12,BULGARIA,0,TOTALS,BULGARIA,200,22,51,43.1,14,29,48.3,8,22,36.4,16,23,69.6,10,19,29,13,25,13,10,1,68,0
4548,106683,143_06_13,UKRAINE,0,TOTALS,UKRAINE,200,20,52,38.5,14,28,50.0,6,24,25.0,20,29,69.0,16,28,44,17,19,13,4,7,66,1
4549,106696,143_06_13,SWEDEN,0,TOTALS,SWEDEN,200,20,62,32.3,13,40,32.5,7,22,31.8,14,20,70.0,12,18,30,9,24,7,5,3,61,0
4550,106709,143_06_14,LATVIA,0,TOTALS,LATVIA,200,32,65,49.2,20,40,50.0,12,25,48.0,11,16,68.8,16,20,36,20,19,9,9,5,87,1
4551,106722,143_06_14,ESTONIA,0,TOTALS,ESTONIA,200,21,51,41.2,15,31,48.4,6,20,30.0,9,11,81.8,10,19,29,16,21,17,6,2,57,0
4552,106735,143_06_15,BOSNIA AND HERZEGOVINA,0,TOTALS,BOSNIA AND HERZEGOVINA,200,24,58,41.4,12,32,37.5,12,26,46.2,18,28,64.3,3,16,19,15,22,17,5,2,78,0
4553,106748,143_06_15,PORTUGAL,0,TOTALS,PORTUGAL,200,27,58,46.6,18,38,47.4,9,20,45.0,17,20,85.0,8,29,37,17,30,19,11,5,80,1
4554,106761,143_06_16,MKD,0,TOTALS,MKD,200,31,57,54.4,21,34,61.8,10,23,43.5,18,22,81.8,9,27,36,16,24,16,3,2,90,1
4555,106774,143_06_16,ISRAEL,0,TOTALS,ISRAEL,200,31,59,52.5,23,40,57.5,8,19,42.1,17,26,65.4,3,16,19,16,22,7,7,2,87,0
4556,106787,143_06_17,BULGARIA,0,TOTALS,BULGARIA,200,24,63,38.1,13,30,43.3,11,33,33.3,23,33,69.7,16,23,39,5,32,12,9,3,82,0
4557,106800,143_06_17,SWEDEN,0,TOTALS,SWEDEN,200,26,50,52.0,12,27,44.4,14,23,60.9,24,36,66.7,10,29,39,6,28,17,8,1,90,1
4558,106813,143_06_18,CROATIA,0,TOTALS,CROATIA,200,27,54,50.0,21,39,53.8,6,15,40.0,16,20,80.0,12,26,38,16,20,12,7,1,76,1
4559,106826,143_06_18,ESTONIA,0,TOTALS,ESTONIA,200,17,57,29.8,13,41,31.7,4,16,25.0,9,15,60.0,15,17,32,10,23,14,8,3,47,0
4560,106839,143_06_19,MKD,0,TOTALS,MKD,200,27,56,48.2,16,29,55.2,11,27,40.7,16,17,94.1,10,14,24,9,17,7,5,2,81,1
4561,106852,143_06_19,BOSNIA AND HERZEGOVINA,0,TOTALS,BOSNIA AND HERZEGOVINA,200,29,57,50.9,17,26,65.4,12,31,38.7,7,10,70.0,9,18,27,14,19,9,6,1,77,0
4562,106865,143_06_20,POLAND,0,TOTALS,POLAND,200,26,57,45.6,19,43,44.2,7,14,50.0,15,21,71.4,11,21,32,13,18,17,13,2,74,1
4563,106878,143_06_20,UKRAINE,0,TOTALS,UKRAINE,200,24,55,43.6,22,36,61.1,2,19,10.5,8,11,72.7,6,18,24,10,21,25,9,1,58,0
4564,106891,143_06_21,ISRAEL,0,TOTALS,ISRAEL,200,20,49,40.8,16,32,50.0,4,17,23.5,17,27,63.0,3,30,33,12,24,15,9,1,61,0
4565,106904,143_06_21,PORTUGAL,0,TOTALS,PORTUGAL,200,23,64,35.9,16,41,39.0,7,23,30.4,14,20,70.0,15,32,47,5,27,18,8,3,67,1
4566,106917,143_06_22,DENMARK,0,TOTALS,DENMARK,200,27,56,48.2,22,42,52.4,5,14,35.7,15,19,78.9,5,24,29,16,22,15,4,0,74,0
4567,106930,143_06_22,LATVIA,0,TOTALS,LATVIA,200,28,62,45.2,18,32,56.2,10,30,33.3,24,35,68.6,11,25,36,18,19,7,7,0,90,1
4568,106943,143_06_23,RUSSIA,0,TOTALS,RUSSIA,200,36,60,60.0,25,39,64.1,11,21,52.4,21,27,77.8,9,21,30,19,22,14,13,1,104,0
4569,106956,143_06_23,CZECH REPUBLIC,0,TOTALS,CZECH REPUBLIC,200,23,53,43.4,12,29,41.4,11,24,45.8,24,26,92.3,4,18,22,10,27,21,7,1,81,1
4570,106969,143_06_24,BELGIUM,0,TOTALS,BELGIUM,200,16,55,29.1,10,33,30.3,6,22,27.3,21,30,70.0,14,29,43,9,25,23,5,3,59,0
4571,106982,143_06_24,HUNGARY,0,TOTALS,HUNGARY,200,25,63,39.7,18,42,42.9,7,21,33.3,16,26,61.5,13,28,41,14,28,13,11,2,73,1
4572,106995,143_06_25,DENMARK,0,TOTALS,DENMARK,200,24,58,41.4,18,36,50.0,6,22,27.3,15,19,78.9,13,18,31,16,26,12,3,2,69,1
4573,107008,143_06_25,ESTONIA,0,TOTALS,ESTONIA,200,19,49,38.8,10,25,40.0,9,24,37.5,21,32,65.6,11,18,29,12,24,16,5,0,68,0
4574,107021,143_06_26,HUNGARY,0,TOTALS,HUNGARY,200,21,61,34.4,13,34,38.2,8,27,29.6,20,24,83.3,15,23,38,16,25,8,6,2,70,0
4575,107034,143_06_26,RUSSIA,0,TOTALS,RUSSIA,200,26,54,48.1,22,39,56.4,4,15,26.7,20,25,80.0,5,21,26,5,22,5,5,2,76,1
4576,107047,143_06_27,POLAND,0,TOTALS,POLAND,200,30,54,55.6,18,34,52.9,12,20,60.0,16,21,76.2,6,32,38,21,23,13,7,4,88,1
4577,107059,143_06_27,SWEDEN,0,TOTALS,SWEDEN,200,21,56,37.5,15,34,44.1,6,22,27.3,19,28,67.9,9,19,28,12,18,11,4,3,67,0
4578,107072,143_06_28,UKRAINE,0,TOTALS,UKRAINE,200,36,54,66.7,26,34,76.5,10,20,50.0,10,17,58.8,8,30,38,19,18,15,7,4,92,1
4579,107085,143_06_28,BULGARIA,0,TOTALS,BULGARIA,200,22,59,37.3,14,35,40.0,8,24,33.3,9,13,69.2,8,12,20,9,19,13,7,1,61,0
4580,107098,143_06_29,LATVIA,0,TOTALS,LATVIA,200,22,53,41.5,16,28,57.1,6,25,24.0,20,25,80.0,13,24,37,13,20,12,3,0,70,0
4581,107111,143_06_29,CROATIA,0,TOTALS,CROATIA,200,28,56,50.0,20,36,55.6,8,20,40.0,14,18,77.8,7,19,26,14,27,7,5,0,78,1
4582,107124,143_06_30,BOSNIA AND HERZEGOVINA,0,TOTALS,BOSNIA AND HERZEGOVINA,200,26,54,48.1,20,34,58.8,6,20,30.0,27,33,81.8,10,18,28,13,18,11,8,3,85,1
4583,107137,143_06_30,ISRAEL,0,TOTALS,ISRAEL,200,23,52,44.2,16,30,53.3,7,22,31.8,10,15,66.7,4,17,21,11,23,15,5,1,63,0
4584,107150,143_06_31,BELGIUM,0,TOTALS,BELGIUM,200,19,49,38.8,13,32,40.6,6,17,35.3,17,24,70.8,6,30,36,11,16,18,5,9,61,0
4585,107163,143_06_31,CZECH REPUBLIC,0,TOTALS,CZECH REPUBLIC,200,28,76,36.8,21,59,35.6,7,17,41.2,11,14,78.6,18,26,44,16,22,7,8,4,74,1
4586,107176,143_06_32,MKD,0,TOTALS,MKD,200,31,64,48.4,23,38,60.5,8,26,30.8,13,20,65.0,8,26,34,15,15,5,6,6,83,1
4587,107189,143_06_32,PORTUGAL,0,TOTALS,PORTUGAL,200,22,66,33.3,12,33,36.4,10,33,30.3,9,9,100.0,14,24,38,13,23,14,2,2,63,0
4588,107202,143_06_33,PORTUGAL,0,TOTALS,PORTUGAL,200,26,58,44.8,20,39,51.3,6,19,31.6,17,31,54.8,12,20,32,15,26,17,6,4,75,0
4589,107215,143_06_33,BOSNIA AND HERZEGOVINA,0,TOTALS,BOSNIA AND HERZEGOVINA,200,28,52,53.8,18,28,64.3,10,24,41.7,20,26,76.9,5,23,28,14,26,16,4,0,86,1
4590,107228,143_06_34,CZECH REPUBLIC,0,TOTALS,CZECH REPUBLIC,200,31,57,54.4,27,44,61.4,4,13,30.8,17,31,54.8,12,22,34,23,24,11,9,4,83,1
4591,107241,143_06_34,HUNGARY,0,TOTALS,HUNGARY,200,20,50,40.0,14,33,42.4,6,17,35.3,18,28,64.3,5,17,22,10,26,15,5,1,64,0
4592,107254,143_06_35,BULGARIA,0,TOTALS,BULGARIA,200,35,58,60.3,21,32,65.6,14,26,53.8,15,19,78.9,7,30,37,11,25,11,12,1,99,1
4593,107267,143_06_35,POLAND,0,TOTALS,POLAND,200,20,56,35.7,13,35,37.1,7,21,33.3,18,31,58.1,12,20,32,8,22,18,8,3,65,0
4594,107280,143_06_36,CROATIA,0,TOTALS,CROATIA,200,33,63,52.4,25,45,55.6,8,18,44.4,17,23,73.9,11,20,31,18,19,12,13,0,91,1
4595,107293,143_06_36,DENMARK,0,TOTALS,DENMARK,200,29,53,54.7,20,30,66.7,9,23,39.1,12,13,92.3,4,20,24,17,25,16,5,0,79,0
4596,107306,143_06_37,ISRAEL,0,TOTALS,ISRAEL,200,27,66,40.9,18,42,42.9,9,24,37.5,20,24,83.3,12,34,46,16,24,17,9,5,83,1
4597,107318,143_06_37,MKD,0,TOTALS,MKD,200,24,62,38.7,17,39,43.6,7,23,30.4,15,24,62.5,9,29,38,8,22,16,7,4,70,0
4598,107331,143_06_38,ESTONIA,0,TOTALS,ESTONIA,200,22,55,40.0,14,29,48.3,8,26,30.8,12,22,54.5,13,18,31,11,24,19,12,2,64,0
4599,107344,143_06_38,LATVIA,0,TOTALS,LATVIA,200,25,53,47.2,17,33,51.5,8,20,40.0,15,20,75.0,10,22,32,11,24,18,8,1,73,1
4600,107357,143_06_39,SWEDEN,0,TOTALS,SWEDEN,200,25,66,37.9,11,32,34.4,14,34,41.2,17,26,65.4,13,25,38,20,19,11,9,4,81,1
4601,107370,143_06_39,UKRAINE,0,TOTALS,UKRAINE,200,26,58,44.8,16,38,42.1,10,20,50.0,9,14,64.3,9,31,40,15,21,19,8,7,71,0
4602,107383,143_06_40,RUSSIA,0,TOTALS,RUSSIA,200,33,64,51.6,22,37,59.5,11,27,40.7,19,21,90.5,9,22,31,14,14,10,9,1,96,1
4603,107394,143_06_40,BELGIUM,0,TOTALS,BELGIUM,200,24,55,43.6,19,33,57.6,5,22,22.7,10,13,76.9,9,19,28,8,19,21,4,1,63,0
4604,107407,143_06_41,SWEDEN,0,TOTALS,SWEDEN,200,28,65,43.1,23,43,53.5,5,22,22.7,18,26,69.2,14,25,39,14,17,5,13,2,79,1
4605,107420,143_06_41,BULGARIA,0,TOTALS,BULGARIA,200,18,49,36.7,11,27,40.7,7,22,31.8,7,12,58.3,7,25,32,10,21,24,3,2,50,0
4606,107433,143_06_42,ESTONIA,0,TOTALS,ESTONIA,200,26,53,49.1,16,30,53.3,10,23,43.5,16,31,51.6,12,20,32,12,26,14,7,4,78,1
4607,107444,143_06_42,CROATIA,0,TOTALS,CROATIA,200,24,55,43.6,16,30,53.3,8,25,32.0,21,28,75.0,15,24,39,9,28,16,9,4,77,0
4608,107457,143_06_43,CZECH REPUBLIC,0,TOTALS,CZECH REPUBLIC,200,19,56,33.9,13,35,37.1,6,21,28.6,11,20,55.0,12,31,43,14,22,18,10,5,55,0
4609,107470,143_06_43,RUSSIA,0,TOTALS,RUSSIA,200,24,58,41.4,17,39,43.6,7,19,36.8,14,20,70.0,7,26,33,14,20,14,13,1,69,1
4610,107483,143_06_44,HUNGARY,0,TOTALS,HUNGARY,200,23,52,44.2,17,34,50.0,6,18,33.3,23,26,88.5,8,21,29,11,26,6,11,2,75,1
4611,107496,143_06_44,BELGIUM,0,TOTALS,BELGIUM,200,23,50,46.0,18,33,54.5,5,17,29.4,8,14,57.1,10,23,33,12,22,15,4,1,59,0
4612,107509,143_06_45,UKRAINE,0,TOTALS,UKRAINE,200,25,57,43.9,16,27,59.3,9,30,30.0,21,27,77.8,10,29,39,14,29,15,6,6,80,1
4613,107522,143_06_45,POLAND,0,TOTALS,POLAND,200,23,67,34.3,17,40,42.5,6,27,22.2,22,34,64.7,15,20,35,11,27,10,8,1,74,0
4614,107535,143_06_46,PORTUGAL,0,TOTALS,PORTUGAL,200,30,60,50.0,23,34,67.6,7,26,26.9,2,6,33.3,9,23,32,16,20,18,11,3,69,1
4615,107548,143_06_46,ISRAEL,0,TOTALS,ISRAEL,200,17,46,37.0,13,29,44.8,4,17,23.5,11,14,78.6,2,20,22,4,19,24,5,2,49,0
4616,107561,143_06_47,LATVIA,0,TOTALS,LATVIA,200,21,58,36.2,17,33,51.5,4,25,16.0,32,40,80.0,10,26,36,9,21,8,12,0,78,1
4617,107574,143_06_47,DENMARK,0,TOTALS,DENMARK,200,20,55,36.4,13,30,43.3,7,25,28.0,19,24,79.2,10,29,39,12,27,16,1,2,66,0
4618,107587,143_06_48,BOSNIA AND HERZEGOVINA,0,TOTALS,BOSNIA AND HERZEGOVINA,200,25,61,41.0,17,33,51.5,8,28,28.6,17,23,73.9,13,19,32,9,25,8,5,1,75,1
4619,107600,143_06_48,MKD,0,TOTALS,MKD,200,24,50,48.0,18,33,54.5,6,17,35.3,18,23,78.3,4,25,29,10,27,13,5,1,72,0
4620,107613,143_07_49,UKRAINE,0,TOTALS,UKRAINE,200,15,55,27.3,14,34,41.2,1,21,4.8,14,21,66.7,8,23,31,7,11,12,4,4,45,0
4621,107626,143_07_49,BELGIUM,0,TOTALS,BELGIUM,200,31,64,48.4,25,45,55.6,6,19,31.6,2,4,50.0,11,32,43,10,21,12,5,2,70,1
4622,107639,143_07_50,DENMARK,0,TOTALS,DENMARK,200,23,55,41.8,17,35,48.6,6,20,30.0,8,20,40.0,6,18,24,11,17,11,9,1,60,0
4623,107652,143_07_50,ISRAEL,0,TOTALS,ISRAEL,200,31,65,47.7,28,46,60.9,3,19,15.8,7,13,53.8,6,23,29,16,32,9,8,11,72,1
4624,107665,143_07_51,BOSNIA AND HERZEGOVINA,0,TOTALS,BOSNIA AND HERZEGOVINA,225,22,71,31.0,16,46,34.8,6,25,24.0,25,39,64.1,16,21,37,11,27,9,3,5,75,1
4625,107678,143_07_51,BULGARIA,0,TOTALS,BULGARIA,225,24,60,40.0,18,35,51.4,6,25,24.0,17,28,60.7,11,18,29,4,30,17,2,2,71,0
4626,107691,143_07_52,SWEDEN,0,TOTALS,SWEDEN,200,17,62,27.4,13,36,36.1,4,26,15.4,12,18,66.7,17,23,40,9,24,15,11,4,50,0
4627,107704,143_07_52,ESTONIA,0,TOTALS,ESTONIA,200,18,49,36.7,13,32,40.6,5,17,29.4,16,22,72.7,12,28,40,8,22,19,8,8,57,1
4628,107717,143_07_53,BULGARIA,0,TOTALS,BULGARIA,200,22,53,41.5,16,29,55.2,6,24,25.0,29,43,67.4,13,31,44,13,24,12,4,1,79,1
4629,107730,143_07_53,HUNGARY,0,TOTALS,HUNGARY,200,26,63,41.3,20,39,51.3,6,24,25.0,16,25,64.0,11,23,34,16,32,7,6,4,74,0
4630,107743,143_07_54,BELGIUM,0,TOTALS,BELGIUM,200,32,74,43.2,24,39,61.5,8,35,22.9,8,16,50.0,13,25,38,19,26,8,11,3,80,1
4631,107756,143_07_54,DENMARK,0,TOTALS,DENMARK,200,22,47,46.8,15,35,42.9,7,12,58.3,15,30,50.0,4,25,29,6,20,19,1,2,66,0
4632,107769,143_07_55,ISRAEL,0,TOTALS,ISRAEL,200,29,68,42.6,25,59,42.4,4,9,44.4,19,25,76.0,15,27,42,18,23,12,6,1,81,1
4633,107782,143_07_55,UKRAINE,0,TOTALS,UKRAINE,200,24,58,41.4,18,35,51.4,6,23,26.1,19,30,63.3,8,29,37,11,25,11,6,7,73,0
4634,107795,143_07_56,ESTONIA,0,TOTALS,ESTONIA,200,24,53,45.3,14,30,46.7,10,23,43.5,14,22,63.6,8,28,36,12,19,9,5,2,72,1
4635,107808,143_07_56,MKD,0,TOTALS,MKD,200,26,65,40.0,16,34,47.1,10,31,32.3,4,5,80.0,11,25,36,12,19,7,3,3,66,0
4636,107821,143_07_57,UKRAINE,0,TOTALS,UKRAINE,200,24,55,43.6,18,35,51.4,6,20,30.0,20,31,64.5,16,32,48,8,27,22,7,12,74,1
4637,107834,143_07_57,DENMARK,0,TOTALS,DENMARK,200,21,65,32.3,13,49,26.5,8,16,50.0,14,26,53.8,14,23,37,8,29,16,9,1,64,0
4638,107847,143_07_58,ISRAEL,0,TOTALS,ISRAEL,200,32,60,53.3,26,42,61.9,6,18,33.3,15,20,75.0,13,27,40,15,15,15,5,4,85,1
4639,107860,143_07_58,BELGIUM,0,TOTALS,BELGIUM,200,25,62,40.3,14,29,48.3,11,33,33.3,5,10,50.0,12,18,30,14,23,16,4,3,66,0
4640,107873,143_07_59,HUNGARY,0,TOTALS,HUNGARY,200,19,53,35.8,12,32,37.5,7,21,33.3,23,28,82.1,9,25,34,11,21,9,5,0,68,0
4641,107886,143_07_59,BOSNIA AND HERZEGOVINA,0,TOTALS,BOSNIA AND HERZEGOVINA,200,30,58,51.7,18,31,58.1,12,27,44.4,11,19,57.9,5,27,32,12,27,7,7,0,83,1
4642,107899,143_07_60,MKD,0,TOTALS,MKD,200,27,65,41.5,17,36,47.2,10,29,34.5,13,17,76.5,8,20,28,8,19,5,10,5,77,1
4643,107912,143_07_60,SWEDEN,0,TOTALS,SWEDEN,200,22,53,41.5,17,40,42.5,5,13,38.5,9,12,75.0,7,28,35,12,22,22,3,1,58,0
4644,107925,143_07_61,BULGARIA,0,TOTALS,BULGARIA,200,25,57,43.9,16,27,59.3,9,30,30.0,11,18,61.1,15,20,35,14,21,11,5,1,70,1
4645,107938,143_07_61,BOSNIA AND HERZEGOVINA,0,TOTALS,BOSNIA AND HERZEGOVINA,200,24,48,50.0,17,25,68.0,7,23,30.4,14,17,82.4,6,19,25,12,23,12,6,2,69,0
4646,107951,143_07_62,BELGIUM,0,TOTALS,BELGIUM,200,28,64,43.8,25,46,54.3,3,18,16.7,13,22,59.1,12,26,38,13,28,17,14,3,72,1
4647,107964,143_07_62,UKRAINE,0,TOTALS,UKRAINE,200,21,60,35.0,17,43,39.5,4,17,23.5,23,34,67.6,13,24,37,7,19,18,6,3,69,0
4648,107977,143_07_63,ISRAEL,0,TOTALS,ISRAEL,200,34,58,58.6,24,35,68.6,10,23,43.5,27,36,75.0,13,27,40,21,26,17,13,3,105,0
4649,107990,143_07_63,DENMARK,0,TOTALS,DENMARK,200,26,57,45.6,17,31,54.8,9,26,34.6,15,27,55.6,12,17,29,13,23,23,6,0,76,1
4650,108003,143_07_64,ESTONIA,0,TOTALS,ESTONIA,200,23,45,51.1,17,27,63.0,6,18,33.3,16,24,66.7,11,31,42,11,30,21,5,1,68,1
4651,108016,143_07_64,SWEDEN,0,TOTALS,SWEDEN,200,15,43,34.9,11,27,40.7,4,16,25.0,20,32,62.5,4,17,21,6,27,10,14,1,54,0
4652,108029,143_07_65,DENMARK,0,TOTALS,DENMARK,200,23,51,45.1,20,35,57.1,3,16,18.8,12,19,63.2,7,23,30,12,19,15,6,2,61,0
4653,108042,143_07_65,BELGIUM,0,TOTALS,BELGIUM,200,25,62,40.3,17,35,48.6,8,27,29.6,13,17,76.5,14,22,36,17,24,12,11,1,71,1
4654,108055,143_07_66,UKRAINE,0,TOTALS,UKRAINE,200,21,57,36.8,16,34,47.1,5,23,21.7,16,23,69.6,11,26,37,10,24,17,7,4,63,0
4655,108068,143_07_66,ISRAEL,0,TOTALS,ISRAEL,200,25,63,39.7,22,48,45.8,3,15,20.0,15,25,60.0,15,28,43,8,25,16,10,2,68,1
4656,108081,143_07_67,HUNGARY,0,TOTALS,HUNGARY,200,23,49,46.9,14,32,43.8,9,17,52.9,19,27,70.4,8,23,31,9,23,16,4,6,74,1
4657,108094,143_07_67,BULGARIA,0,TOTALS,BULGARIA,200,25,54,46.3,21,37,56.8,4,17,23.5,13,21,61.9,10,22,32,8,23,14,3,2,67,0
4658,108107,143_07_68,MKD,0,TOTALS,MKD,200,29,51,56.9,11,20,55.0,18,31,58.1,19,23,82.6,7,21,28,16,18,15,9,11,95,1
4659,108120,143_07_68,ESTONIA,0,TOTALS,ESTONIA,200,19,53,35.8,14,33,42.4,5,20,25.0,7,15,46.7,11,15,26,10,22,20,5,3,50,0
4660,108133,143_07_69,DENMARK,0,TOTALS,DENMARK,200,24,52,46.2,16,30,53.3,8,22,36.4,34,40,85.0,6,24,30,18,28,11,12,2,90,1
4661,108146,143_07_69,UKRAINE,0,TOTALS,UKRAINE,200,27,61,44.3,17,31,54.8,10,30,33.3,21,35,60.0,15,21,36,16,32,15,5,4,85,0
4662,108159,143_07_70,SWEDEN,0,TOTALS,SWEDEN,200,28,58,48.3,20,38,52.6,8,20,40.0,9,15,60.0,6,18,24,6,22,14,9,2,73,0
4663,108172,143_07_70,MKD,0,TOTALS,MKD,200,23,49,46.9,13,27,48.1,10,22,45.5,22,29,75.9,10,27,37,11,17,20,3,1,78,1
4664,108185,143_07_71,BELGIUM,0,TOTALS,BELGIUM,200,27,65,41.5,20,40,50.0,7,25,28.0,22,29,75.9,10,20,30,10,27,13,10,2,83,1
4665,108198,143_07_71,ISRAEL,0,TOTALS,ISRAEL,200,25,54,46.3,21,35,60.0,4,19,21.1,20,34,58.8,9,27,36,8,27,22,3,1,74,0
4666,108211,143_07_72,BOSNIA AND HERZEGOVINA,0,TOTALS,BOSNIA AND HERZEGOVINA,200,26,67,38.8,18,43,41.9,8,24,33.3,10,12,83.3,16,21,37,10,27,18,9,3,70,0
4667,108224,143_07_72,HUNGARY,0,TOTALS,HUNGARY,200,24,49,49.0,15,27,55.6,9,22,40.9,17,28,60.7,8,12,20,7,18,14,5,3,74,1
4668,108237,143_07_73,SWEDEN,0,TOTALS,SWEDEN,200,22,51,43.1,16,35,45.7,6,16,37.5,16,23,69.6,11,27,38,15,24,17,7,2,66,1
4669,108250,143_07_73,DENMARK,0,TOTALS,DENMARK,200,21,56,37.5,16,38,42.1,5,18,27.8,8,16,50.0,7,23,30,8,21,15,9,0,55,0
4670,108263,143_07_74,MKD,0,TOTALS,MKD,200,26,49,53.1,18,31,58.1,8,18,44.4,13,18,72.2,5,27,32,10,20,18,6,4,73,1
4671,108276,143_07_74,BOSNIA AND HERZEGOVINA,0,TOTALS,BOSNIA AND HERZEGOVINA,200,24,63,38.1,19,38,50.0,5,25,20.0,10,16,62.5,13,19,32,6,21,13,8,1,63,0
4672,108289,143_07_75,DENMARK,0,TOTALS,DENMARK,200,23,47,48.9,14,26,53.8,9,21,42.9,15,25,60.0,9,15,24,16,21,23,3,0,70,1
4673,108302,143_07_75,HUNGARY,0,TOTALS,HUNGARY,200,35,59,59.3,22,35,62.9,13,24,54.2,18,23,78.3,13,17,30,24,29,14,12,2,101,0
4674,108315,143_07_76,BOSNIA AND HERZEGOVINA,0,TOTALS,BOSNIA AND HERZEGOVINA,200,19,61,31.1,14,33,42.4,5,28,17.9,17,27,63.0,11,28,39,12,21,11,5,7,60,0
4675,108328,143_07_76,ISRAEL,0,TOTALS,ISRAEL,200,27,66,40.9,23,52,44.2,4,14,28.6,9,14,64.3,11,32,43,15,22,14,5,1,67,1
4676,108341,143_07_77,HUNGARY,0,TOTALS,HUNGARY,200,24,53,45.3,15,35,42.9,9,18,50.0,18,20,90.0,10,23,33,11,23,9,5,1,75,1
4677,108354,143_07_77,SWEDEN,0,TOTALS,SWEDEN,200,24,58,41.4,19,39,48.7,5,19,26.3,11,22,50.0,13,19,32,12,18,9,4,2,64,0
4678,108367,143_07_78,ISRAEL,0,TOTALS,ISRAEL,200,36,66,54.5,26,49,53.1,10,17,58.8,10,13,76.9,12,23,35,15,23,14,9,1,92,1
4679,108380,143_07_78,MKD,0,TOTALS,MKD,200,26,54,48.1,13,28,46.4,13,26,50.0,22,28,78.6,4,19,23,10,19,14,6,3,87,0
4680,108391,144_06_01,SLOVAK REPUBLIC,0,TOTALS,SLOVAK REPUBLIC,200,26,59,44.1,19,41,46.3,7,18,38.9,14,25,56.0,14,26,40,13,27,16,9,1,73,1
4681,108404,144_06_01,GREAT BRITAIN,0,TOTALS,GREAT BRITAIN,200,19,47,40.4,17,37,45.9,2,10,20.0,22,30,73.3,6,23,29,5,31,19,13,2,62,0
4682,108417,144_06_02,FINLAND,0,TOTALS,FINLAND,200,30,56,53.6,15,25,60.0,15,31,48.4,12,19,63.2,7,26,33,7,20,15,8,2,87,1
4683,108430,144_06_02,AUSTRIA,0,TOTALS,AUSTRIA,200,17,53,32.1,13,40,32.5,4,13,30.8,12,17,70.6,11,24,35,4,22,23,12,0,50,0
4684,108443,144_06_03,SWITZERLAND,0,TOTALS,SWITZERLAND,200,18,53,34.0,9,28,32.1,9,25,36.0,14,26,53.8,4,24,28,9,17,11,10,0,59,1
4685,108456,144_06_03,IRELAND,0,TOTALS,IRELAND,200,21,67,31.3,15,38,39.5,6,29,20.7,9,14,64.3,7,28,35,7,22,13,5,0,57,0
4686,108469,144_06_04,BELARUS,0,TOTALS,BELARUS,200,20,47,42.6,15,29,51.7,5,18,27.8,16,30,53.3,8,16,24,9,25,17,10,2,61,0
4687,108482,144_06_04,NETHERLANDS,0,TOTALS,NETHERLANDS,200,25,52,48.1,18,35,51.4,7,17,41.2,17,26,65.4,13,20,33,11,25,16,8,2,74,1
4688,108495,144_06_05,GEORGIA,0,TOTALS,GEORGIA,200,33,71,46.5,23,44,52.3,10,27,37.0,10,18,55.6,15,26,41,22,16,16,15,2,86,1
4689,108508,144_06_05,LUXEMBOURG,0,TOTALS,LUXEMBOURG,200,17,47,36.2,13,33,39.4,4,14,28.6,6,11,54.5,4,24,28,15,19,27,4,2,44,0
4690,108521,144_06_06,ROMANIA,0,TOTALS,ROMANIA,200,26,47,55.3,14,26,53.8,12,21,57.1,15,20,75.0,6,27,33,3,24,22,7,1,79,1
4691,108534,144_06_06,CYPRUS,0,TOTALS,CYPRUS,200,23,52,44.2,17,33,51.5,6,19,31.6,12,22,54.5,4,18,22,3,22,18,12,0,64,0
4692,108547,144_06_07,ALBANIA,0,TOTALS,ALBANIA,200,24,50,48.0,16,27,59.3,8,23,34.8,17,23,73.9,4,14,18,12,26,23,16,0,73,0
4693,108560,144_06_07,BELARUS,0,TOTALS,BELARUS,200,24,48,50.0,19,31,61.3,5,17,29.4,25,38,65.8,12,21,33,13,26,26,15,0,78,1
4694,108573,144_06_08,NETHERLANDS,0,TOTALS,NETHERLANDS,200,26,58,44.8,18,36,50.0,8,22,36.4,11,19,57.9,9,30,39,13,23,21,9,4,71,1
4695,108586,144_06_08,SLOVAK REPUBLIC,0,TOTALS,SLOVAK REPUBLIC,200,21,57,36.8,17,34,50.0,4,23,17.4,17,24,70.8,7,28,35,8,24,16,12,2,63,0
4696,108599,144_06_09,ICELAND,0,TOTALS,ICELAND,200,29,68,42.6,18,41,43.9,11,27,40.7,17,28,60.7,11,25,36,18,23,12,6,4,86,0
4697,108612,144_06_09,FINLAND,0,TOTALS,FINLAND,200,35,67,52.2,28,47,59.6,7,20,35.0,16,20,80.0,6,33,39,21,27,13,8,1,93,1
4698,108625,144_06_10,AUSTRIA,0,TOTALS,AUSTRIA,200,22,55,40.0,15,34,44.1,7,21,33.3,12,17,70.6,9,25,34,11,30,11,2,0,63,0
4699,108638,144_06_10,GEORGIA,0,TOTALS,GEORGIA,200,18,43,41.9,9,22,40.9,9,21,42.9,23,33,69.7,4,26,30,9,21,11,5,3,68,1
4700,108651,144_06_11,IRELAND,0,TOTALS,IRELAND,200,23,59,39.0,12,30,40.0,11,29,37.9,5,6,83.3,8,22,30,16,19,17,11,0,62,0
4701,108664,144_06_11,ROMANIA,0,TOTALS,ROMANIA,200,29,56,51.8,21,39,53.8,8,17,47.1,15,24,62.5,11,28,39,13,14,15,10,1,81,1
4702,108677,144_06_12,SLOVAK REPUBLIC,0,TOTALS,SLOVAK REPUBLIC,200,37,69,53.6,28,48,58.3,9,21,42.9,18,27,66.7,19,20,39,18,24,19,14,1,101,0
4703,108690,144_06_12,ALBANIA,0,TOTALS,ALBANIA,200,31,56,55.4,26,37,70.3,5,19,26.3,21,26,80.8,7,17,24,10,23,20,13,0,88,1
4704,108703,144_06_13,CYPRUS,0,TOTALS,CYPRUS,200,16,48,33.3,13,33,39.4,3,15,20.0,11,12,91.7,9,13,22,8,18,15,8,2,46,0
4705,108715,144_06_13,SWITZERLAND,0,TOTALS,SWITZERLAND,200,23,47,48.9,12,24,50.0,11,23,47.8,7,13,53.8,11,22,33,11,21,21,5,2,64,1
4706,108728,144_06_14,GEORGIA,0,TOTALS,GEORGIA,200,26,68,38.2,24,44,54.5,2,24,8.3,26,31,83.9,16,34,50,15,26,16,10,3,80,1
4707,108741,144_06_14,ICELAND,0,TOTALS,ICELAND,200,19,59,32.2,12,38,31.6,7,21,33.3,20,30,66.7,9,25,34,10,24,17,5,2,65,0
4708,108754,144_06_15,GREAT BRITAIN,0,TOTALS,GREAT BRITAIN,200,22,57,38.6,18,39,46.2,4,18,22.2,15,22,68.2,11,36,47,13,21,18,7,5,63,1
4709,108767,144_06_15,NETHERLANDS,0,TOTALS,NETHERLANDS,200,14,61,23.0,13,43,30.2,1,18,5.6,10,16,62.5,12,28,40,7,19,19,9,3,39,0
4710,108780,144_06_16,LUXEMBOURG,0,TOTALS,LUXEMBOURG,200,18,47,38.3,13,32,40.6,5,15,33.3,21,23,91.3,6,29,35,2,21,19,6,3,62,0
4711,108793,144_06_16,AUSTRIA,0,TOTALS,AUSTRIA,200,22,64,34.4,20,48,41.7,2,16,12.5,18,28,64.3,13,19,32,4,24,9,10,2,64,1
4712,108806,144_06_17,ALBANIA,0,TOTALS,ALBANIA,225,25,58,43.1,19,33,57.6,6,25,24.0,13,24,54.2,8,28,36,15,26,22,14,2,69,0
4713,108819,144_06_17,GREAT BRITAIN,0,TOTALS,GREAT BRITAIN,225,27,71,38.0,24,45,53.3,3,26,11.5,15,26,57.7,18,26,44,6,21,23,13,1,72,1
4714,108832,144_06_18,FINLAND,0,TOTALS,FINLAND,200,34,73,46.6,24,47,51.1,10,26,38.5,13,17,76.5,12,19,31,13,29,5,7,1,91,1
4715,108845,144_06_18,GEORGIA,0,TOTALS,GEORGIA,200,20,47,42.6,11,25,44.0,9,22,40.9,32,39,82.1,11,29,40,6,19,18,1,0,81,0
4716,108858,144_06_19,BELARUS,0,TOTALS,BELARUS,200,27,48,56.2,17,30,56.7,10,18,55.6,18,31,58.1,9,24,33,17,29,21,15,2,82,1
4717,108871,144_06_19,SLOVAK REPUBLIC,0,TOTALS,SLOVAK REPUBLIC,200,17,51,33.3,13,33,39.4,4,18,22.2,21,33,63.6,8,16,24,9,24,21,10,1,59,0
4718,108884,144_06_20,ICELAND,0,TOTALS,ICELAND,200,38,84,45.2,27,48,56.2,11,36,30.6,11,17,64.7,15,27,42,26,18,13,10,6,98,1
4719,108897,144_06_20,LUXEMBOURG,0,TOTALS,LUXEMBOURG,200,24,60,40.0,14,38,36.8,10,22,45.5,18,22,81.8,2,28,30,18,14,19,6,5,76,0
4720,108910,144_06_21,IRELAND,0,TOTALS,IRELAND,200,25,58,43.1,13,27,48.1,12,31,38.7,14,19,73.7,8,32,40,18,18,14,6,0,76,1
4721,108923,144_06_21,CYPRUS,0,TOTALS,CYPRUS,200,25,61,41.0,17,36,47.2,8,25,32.0,12,16,75.0,7,26,33,10,20,11,8,0,70,0
4722,108936,144_06_22,GREAT BRITAIN,0,TOTALS,GREAT BRITAIN,200,26,65,40.0,20,46,43.5,6,19,31.6,10,18,55.6,17,18,35,13,22,11,8,5,68,0
4723,108949,144_06_22,BELARUS,0,TOTALS,BELARUS,200,28,49,57.1,24,39,61.5,4,10,40.0,9,14,64.3,5,24,29,13,25,18,5,3,69,1
4724,108962,144_06_23,NETHERLANDS,0,TOTALS,NETHERLANDS,200,33,63,52.4,21,34,61.8,12,29,41.4,16,21,76.2,12,33,45,19,23,13,10,0,94,1
4725,108975,144_06_23,ALBANIA,0,TOTALS,ALBANIA,200,18,55,32.7,11,28,39.3,7,27,25.9,12,21,57.1,6,20,26,3,18,19,7,4,55,0
4726,108988,144_06_24,AUSTRIA,0,TOTALS,AUSTRIA,200,26,68,38.2,17,42,40.5,9,26,34.6,24,36,66.7,17,26,43,19,24,15,8,11,85,1
4727,109001,144_06_24,ICELAND,0,TOTALS,ICELAND,200,21,62,33.9,13,38,34.2,8,24,33.3,14,25,56.0,6,25,31,7,29,15,9,1,64,0
4728,109014,144_06_25,LUXEMBOURG,0,TOTALS,LUXEMBOURG,200,15,52,28.8,9,32,28.1,6,20,30.0,17,24,70.8,7,27,34,10,29,31,2,7,53,1
4729,109027,144_06_25,FINLAND,0,TOTALS,FINLAND,200,38,81,46.9,25,57,43.9,13,24,54.2,22,34,64.7,17,27,44,14,26,8,21,3,111,0
4730,109040,144_06_26,ROMANIA,0,TOTALS,ROMANIA,200,20,49,40.8,15,33,45.5,5,16,31.2,23,29,79.3,8,29,37,8,20,10,7,2,68,1
4731,109052,144_06_26,SWITZERLAND,0,TOTALS,SWITZERLAND,200,21,59,35.6,14,33,42.4,7,26,26.9,10,11,90.9,10,22,32,7,22,15,8,1,59,0
4732,109065,144_07_27,NETHERLANDS,0,TOTALS,NETHERLANDS,200,25,56,44.6,20,42,47.6,5,14,35.7,22,27,81.5,12,27,39,11,20,14,6,7,77,1
4733,109078,144_07_27,BELARUS,0,TOTALS,BELARUS,200,27,62,43.5,18,42,42.9,9,20,45.0,9,12,75.0,7,21,28,15,24,11,8,3,72,0
4734,109089,144_07_28,GREAT BRITAIN,0,TOTALS,GREAT BRITAIN,200,26,56,46.4,21,37,56.8,5,19,26.3,20,27,74.1,12,34,46,11,17,20,16,3,77,1
4735,109102,144_07_28,SLOVAK REPUBLIC,0,TOTALS,SLOVAK REPUBLIC,200,20,56,35.7,15,43,34.9,5,13,38.5,7,15,46.7,4,17,21,7,24,21,12,2,52,0
4736,109115,144_07_29,LUXEMBOURG,0,TOTALS,LUXEMBOURG,200,20,49,40.8,14,29,48.3,6,20,30.0,14,19,73.7,4,15,19,8,26,24,14,4,60,0
4737,109128,144_07_29,GEORGIA,0,TOTALS,GEORGIA,200,30,54,55.6,25,40,62.5,5,14,35.7,23,34,67.6,8,22,30,8,23,21,12,4,88,1
4738,109141,144_07_30,AUSTRIA,0,TOTALS,AUSTRIA,200,20,51,39.2,17,31,54.8,3,20,15.0,20,35,57.1,11,19,30,10,24,18,4,5,63,0
4739,109154,144_07_30,FINLAND,0,TOTALS,FINLAND,200,32,59,54.2,21,34,61.8,11,25,44.0,12,17,70.6,9,24,33,15,29,10,9,0,87,1
4740,109167,144_07_31,BELARUS,0,TOTALS,BELARUS,200,29,69,42.0,17,34,50.0,12,35,34.3,17,32,53.1,14,32,46,14,14,10,11,2,87,1
4741,109180,144_07_31,ALBANIA,0,TOTALS,ALBANIA,200,16,52,30.8,11,35,31.4,5,17,29.4,8,14,57.1,4,31,35,3,25,16,4,1,45,0
4742,109193,144_07_32,FINLAND,0,TOTALS,FINLAND,200,31,62,50.0,18,36,50.0,13,26,50.0,10,14,71.4,15,27,42,12,18,23,11,3,85,1
4743,109206,144_07_32,ICELAND,0,TOTALS,ICELAND,200,26,58,44.8,19,38,50.0,7,20,35.0,7,16,43.8,9,18,27,12,15,20,13,1,66,0
4744,109219,144_07_33,CYPRUS,0,TOTALS,CYPRUS,200,21,65,32.3,12,31,38.7,9,34,26.5,14,18,77.8,17,21,38,12,14,8,6,0,65,0
4745,109232,144_07_33,ROMANIA,0,TOTALS,ROMANIA,200,24,53,45.3,14,27,51.9,10,26,38.5,10,12,83.3,9,25,34,11,22,11,3,0,68,1
4746,109245,144_07_34,IRELAND,0,TOTALS,IRELAND,200,23,56,41.1,15,33,45.5,8,23,34.8,4,10,40.0,12,20,32,7,26,20,3,3,58,0
4747,109258,144_07_34,SWITZERLAND,0,TOTALS,SWITZERLAND,200,28,57,49.1,18,33,54.5,10,24,41.7,20,29,69.0,8,21,29,10,19,12,10,5,86,1
4748,109271,144_07_35,GEORGIA,0,TOTALS,GEORGIA,200,30,61,49.2,20,35,57.1,10,26,38.5,15,22,68.2,10,24,34,13,16,13,8,2,85,1
4749,109283,144_07_35,AUSTRIA,0,TOTALS,AUSTRIA,200,30,62,48.4,25,45,55.6,5,17,29.4,9,12,75.0,7,24,31,10,22,15,9,0,74,0
4750,109296,144_07_36,SLOVAK REPUBLIC,0,TOTALS,SLOVAK REPUBLIC,200,29,67,43.3,21,47,44.7,8,20,40.0,14,19,73.7,15,24,39,11,30,18,12,2,80,1
4751,109309,144_07_36,NETHERLANDS,0,TOTALS,NETHERLANDS,200,26,51,51.0,21,34,61.8,5,17,29.4,18,30,60.0,7,27,34,13,19,18,12,4,75,0
4752,109322,144_07_37,ICELAND,0,TOTALS,ICELAND,200,28,72,38.9,15,41,36.6,13,31,41.9,7,11,63.6,16,29,45,18,20,17,2,1,76,1
4753,109335,144_07_37,GEORGIA,0,TOTALS,GEORGIA,200,24,59,40.7,15,37,40.5,9,22,40.9,18,26,69.2,9,30,39,15,15,14,13,6,75,0
4754,109348,144_07_38,NETHERLANDS,0,TOTALS,NETHERLANDS,200,21,65,32.3,17,50,34.0,4,15,26.7,18,21,85.7,15,27,42,8,30,19,9,4,64,0
4755,109359,144_07_38,GREAT BRITAIN,0,TOTALS,GREAT BRITAIN,200,28,58,48.3,24,44,54.5,4,14,28.6,23,38,60.5,10,29,39,12,22,18,10,4,83,1
4756,109372,144_07_39,ALBANIA,0,TOTALS,ALBANIA,200,20,61,32.8,14,34,41.2,6,27,22.2,17,26,65.4,11,20,31,7,24,21,7,0,63,0
4757,109385,144_07_39,SLOVAK REPUBLIC,0,TOTALS,SLOVAK REPUBLIC,200,32,69,46.4,22,41,53.7,10,28,35.7,19,25,76.0,11,31,42,14,26,15,12,2,93,1
4758,109398,144_07_40,AUSTRIA,0,TOTALS,AUSTRIA,200,30,73,41.1,23,47,48.9,7,26,26.9,12,21,57.1,12,33,45,23,17,9,18,4,79,1
4759,109410,144_07_40,LUXEMBOURG,0,TOTALS,LUXEMBOURG,200,16,54,29.6,13,38,34.2,3,16,18.8,11,16,68.8,7,27,34,7,18,20,6,2,46,0
4760,109423,144_07_41,SWITZERLAND,0,TOTALS,SWITZERLAND,200,29,56,51.8,22,33,66.7,7,23,30.4,11,19,57.9,9,19,28,10,20,11,11,4,76,1
4761,109435,144_07_41,CYPRUS,0,TOTALS,CYPRUS,200,27,51,52.9,20,35,57.1,7,16,43.8,6,17,35.3,7,21,28,16,21,19,9,2,67,0
4762,109448,144_07_42,ROMANIA,0,TOTALS,ROMANIA,200,22,56,39.3,18,32,56.2,4,24,16.7,16,22,72.7,11,26,37,9,21,18,11,1,64,1
4763,109460,144_07_42,IRELAND,0,TOTALS,IRELAND,200,21,62,33.9,18,33,54.5,3,29,10.3,9,14,64.3,16,26,42,5,23,16,5,1,54,0
4764,109471,144_07_43,GREAT BRITAIN,0,TOTALS,GREAT BRITAIN,200,46,75,61.3,37,52,71.2,9,23,39.1,9,16,56.2,14,29,43,24,13,9,4,9,110,0
4765,109482,144_07_43,ALBANIA,0,TOTALS,ALBANIA,200,27,64,42.2,16,46,34.8,11,18,61.1,13,18,72.2,9,18,27,11,16,13,4,1,78,1
4766,109494,144_07_44,SLOVAK REPUBLIC,0,TOTALS,SLOVAK REPUBLIC,200,23,64,35.9,19,44,43.2,4,20,20.0,18,25,72.0,8,28,36,9,31,10,6,3,68,0
4767,109507,144_07_44,BELARUS,0,TOTALS,BELARUS,200,23,47,48.9,15,36,41.7,8,11,72.7,21,36,58.3,7,35,42,11,23,14,5,3,75,1
4768,109520,144_07_45,LUXEMBOURG,0,TOTALS,LUXEMBOURG,200,27,67,40.3,21,43,48.8,6,24,25.0,13,24,54.2,8,22,30,16,25,11,8,3,73,0
4769,109533,144_07_45,ICELAND,0,TOTALS,ICELAND,200,28,60,46.7,17,34,50.0,11,26,42.3,22,40,55.0,14,33,47,11,23,13,2,4,89,1
4770,109546,144_07_46,GEORGIA,0,TOTALS,GEORGIA,200,25,63,39.7,16,42,38.1,9,21,42.9,18,30,60.0,13,28,41,18,22,12,6,9,77,1
4771,109559,144_07_46,FINLAND,0,TOTALS,FINLAND,200,26,64,40.6,17,36,47.2,9,28,32.1,15,23,65.2,7,27,34,10,28,13,5,2,76,0
4772,109570,144_07_47,CYPRUS,0,TOTALS,CYPRUS,200,27,66,40.9,15,29,51.7,12,37,32.4,12,17,70.6,15,23,38,12,19,20,6,2,78,1
4773,109583,144_07_47,IRELAND,0,TOTALS,IRELAND,200,27,65,41.5,19,32,59.4,8,33,24.2,11,16,68.8,15,25,40,6,20,17,5,1,73,0
4774,109596,144_07_48,BELARUS,0,TOTALS,BELARUS,200,17,66,25.8,14,46,30.4,3,20,15.0,14,21,66.7,16,20,36,7,25,19,6,1,51,0
4775,109606,144_07_48,GREAT BRITAIN,0,TOTALS,GREAT BRITAIN,200,31,60,51.7,25,46,54.3,6,14,42.9,15,29,51.7,14,27,41,11,17,17,7,1,83,1
4776,109619,144_07_49,FINLAND,0,TOTALS,FINLAND,200,38,63,60.3,31,43,72.1,7,20,35.0,17,22,77.3,8,27,35,16,23,18,18,8,100,0
4777,109631,144_07_49,LUXEMBOURG,0,TOTALS,LUXEMBOURG,200,22,57,38.6,17,44,38.6,5,13,38.5,10,16,62.5,9,18,27,7,17,25,9,1,59,1
4778,109644,144_07_50,ICELAND,0,TOTALS,ICELAND,200,32,78,41.0,15,33,45.5,17,45,37.8,10,17,58.8,19,23,42,22,14,9,9,4,91,1
4779,109655,144_07_50,AUSTRIA,0,TOTALS,AUSTRIA,200,28,60,46.7,18,29,62.1,10,31,32.3,11,14,78.6,8,30,38,26,17,17,3,6,77,0
4780,109668,144_07_51,ALBANIA,0,TOTALS,ALBANIA,200,18,59,30.5,11,35,31.4,7,24,29.2,20,28,71.4,8,17,25,6,23,13,9,1,63,0
4781,109681,144_07_51,NETHERLANDS,0,TOTALS,NETHERLANDS,200,30,58,51.7,19,35,54.3,11,23,47.8,25,29,86.2,11,33,44,15,26,16,11,0,96,1
4782,109694,144_07_52,SWITZERLAND,0,TOTALS,SWITZERLAND,200,24,57,42.1,17,31,54.8,7,26,26.9,10,18,55.6,10,16,26,13,21,13,15,2,65,1
4783,109707,144_07_52,ROMANIA,0,TOTALS,ROMANIA,200,16,53,30.2,13,36,36.1,3,17,17.6,16,20,80.0,12,25,37,10,19,14,8,0,51,0
4784,109720,144_07_53,ROMANIA,0,TOTALS,ROMANIA,200,30,55,54.5,24,37,64.9,6,18,33.3,17,26,65.4,8,22,30,19,29,15,5,0,83,1
4785,109733,144_07_53,FINLAND,0,TOTALS,FINLAND,200,22,58,37.9,12,30,40.0,10,28,35.7,22,26,84.6,11,22,33,8,23,15,6,1,76,0
4786,109744,144_07_54,GREAT BRITAIN,0,TOTALS,GREAT BRITAIN,200,29,65,44.6,26,51,51.0,3,14,21.4,13,23,56.5,13,30,43,13,17,13,12,0,74,1
4787,109756,144_07_54,SWITZERLAND,0,TOTALS,SWITZERLAND,200,15,58,25.9,13,40,32.5,2,18,11.1,9,12,75.0,13,27,40,3,25,21,5,1,41,0
4788,109768,144_07_55,SWITZERLAND,0,TOTALS,SWITZERLAND,200,28,52,53.8,21,36,58.3,7,16,43.8,15,23,65.2,2,17,19,24,18,21,10,2,78,0
4789,109779,144_07_55,GREAT BRITAIN,0,TOTALS,GREAT BRITAIN,200,37,64,57.8,35,54,64.8,2,10,20.0,13,16,81.2,11,19,30,12,22,17,12,2,89,1
4790,109792,144_07_56,FINLAND,0,TOTALS,FINLAND,200,40,72,55.6,26,45,57.8,14,27,51.9,17,26,65.4,15,30,45,17,24,15,16,3,111,0
4791,109804,144_07_56,ROMANIA,0,TOTALS,ROMANIA,200,23,59,39.0,19,39,48.7,4,20,20.0,11,22,50.0,11,19,30,9,26,30,9,3,61,1
4792,109817,145_07_01,SERBIA,0,TOTALS,SERBIA,200,20,61,32.8,13,40,32.5,7,21,33.3,18,31,58.1,12,25,37,7,22,9,5,3,65,0
4793,109830,145_07_01,RUSSIA,0,TOTALS,RUSSIA,200,26,59,44.1,19,37,51.4,7,22,31.8,14,20,70.0,7,31,38,14,27,12,4,5,73,1
4794,109843,145_07_02,CZECH REPUBLIC,0,TOTALS,CZECH REPUBLIC,225,28,69,40.6,22,50,44.0,6,19,31.6,16,24,66.7,10,23,33,12,28,9,5,2,78,0
4795,109856,145_07_02,GERMANY,0,TOTALS,GERMANY,225,26,59,44.1,20,43,46.5,6,16,37.5,25,35,71.4,11,33,44,7,23,13,3,2,83,1
4796,109869,145_07_03,LATVIA,0,TOTALS,LATVIA,200,26,50,52.0,15,32,46.9,11,18,61.1,22,30,73.3,9,24,33,9,26,17,6,0,85,1
4797,109882,145_07_03,CROATIA,0,TOTALS,CROATIA,200,26,59,44.1,18,27,66.7,8,32,25.0,17,22,77.3,11,18,29,13,29,20,4,2,77,0
4798,109895,145_07_04,POLAND,0,TOTALS,POLAND,200,26,55,47.3,22,36,61.1,4,19,21.1,10,17,58.8,8,28,36,9,19,15,4,5,66,0
4799,109908,145_07_04,FRANCE,0,TOTALS,FRANCE,200,27,65,41.5,16,39,41.0,11,26,42.3,9,14,64.3,9,23,32,14,18,7,8,2,74,1
4800,109921,145_07_05,ISRAEL,0,TOTALS,ISRAEL,200,26,57,45.6,21,36,58.3,5,21,23.8,9,12,75.0,13,25,38,13,18,16,6,2,66,0
4801,109934,145_07_05,GREECE,0,TOTALS,GREECE,200,29,59,49.2,19,36,52.8,10,23,43.5,8,13,61.5,7,21,28,10,15,7,12,4,76,1
4802,109947,145_07_06,TURKEY,0,TOTALS,TURKEY,200,20,60,33.3,12,34,35.3,8,26,30.8,21,33,63.6,10,21,31,7,24,8,7,4,69,0
4803,109960,145_07_06,LITHUANIA,0,TOTALS,LITHUANIA,200,30,58,51.7,24,40,60.0,6,18,33.3,20,29,69.0,12,30,42,14,25,15,7,1,86,1
4804,109973,145_07_07,PORTUGAL,0,TOTALS,PORTUGAL,200,22,55,40.0,13,29,44.8,9,26,34.6,3,3,100.0,8,17,25,9,24,24,7,1,56,0
4805,109986,145_07_07,SPAIN,0,TOTALS,SPAIN,200,31,59,52.5,28,41,68.3,3,18,16.7,17,24,70.8,12,25,37,17,11,14,13,2,82,1
4806,109999,145_07_08,ITALY,0,TOTALS,ITALY,200,26,59,44.1,22,37,59.5,4,22,18.2,12,15,80.0,8,21,29,10,24,14,11,3,68,0
4807,110012,145_07_08,SLOVENIA,0,TOTALS,SLOVENIA,200,24,50,48.0,19,33,57.6,5,17,29.4,16,19,84.2,7,25,32,12,22,19,8,2,69,1
4808,110025,145_07_09,RUSSIA,0,TOTALS,RUSSIA,200,36,64,56.2,26,42,61.9,10,22,45.5,8,14,57.1,10,28,38,19,19,10,8,6,90,1
4809,110038,145_07_09,ISRAEL,0,TOTALS,ISRAEL,200,18,55,32.7,14,37,37.8,4,18,22.2,16,25,64.0,9,19,28,6,16,15,6,1,56,0
4810,110051,145_07_10,LITHUANIA,0,TOTALS,LITHUANIA,200,35,56,62.5,22,35,62.9,13,21,61.9,12,23,52.2,5,34,39,19,23,20,6,2,95,1
4811,110064,145_07_10,CZECH REPUBLIC,0,TOTALS,CZECH REPUBLIC,200,26,73,35.6,20,45,44.4,6,28,21.4,17,21,81.0,13,20,33,19,21,12,11,2,75,0
4812,110077,145_07_11,CROATIA,0,TOTALS,CROATIA,200,29,58,50.0,19,34,55.9,10,24,41.7,22,26,84.6,11,20,31,15,29,9,7,3,90,1
4813,110090,145_07_11,PORTUGAL,0,TOTALS,PORTUGAL,200,19,51,37.3,14,35,40.0,5,16,31.2,25,33,75.8,13,21,34,12,25,14,2,2,68,0
4814,110103,145_07_12,FRANCE,0,TOTALS,FRANCE,200,26,55,47.3,21,39,53.8,5,16,31.2,12,16,75.0,9,31,40,5,20,15,3,4,69,1
4815,110116,145_07_12,ITALY,0,TOTALS,ITALY,200,24,61,39.3,16,37,43.2,8,24,33.3,6,13,46.2,9,22,31,8,21,9,5,1,62,0
4816,110129,145_07_13,GREECE,0,TOTALS,GREECE,225,18,55,32.7,12,29,41.4,6,26,23.1,26,35,74.3,7,26,33,8,26,10,8,4,68,1
4817,110142,145_07_13,SERBIA,0,TOTALS,SERBIA,225,23,61,37.7,20,41,48.8,3,20,15.0,18,25,72.0,12,33,45,9,30,14,7,5,67,0
4818,110155,145_07_14,GERMANY,0,TOTALS,GERMANY,200,28,56,50.0,18,35,51.4,10,21,47.6,13,16,81.2,10,28,38,13,24,10,5,2,79,1
4819,110168,145_07_14,TURKEY,0,TOTALS,TURKEY,200,17,56,30.4,14,34,41.2,3,22,13.6,12,24,50.0,14,20,34,2,20,11,6,3,49,0
4820,110181,145_07_15,SPAIN,0,TOTALS,SPAIN,200,34,60,56.7,26,42,61.9,8,18,44.4,17,24,70.8,17,22,39,13,13,12,5,4,93,1
4821,110194,145_07_15,LATVIA,0,TOTALS,LATVIA,200,32,59,54.2,23,37,62.2,9,22,40.9,4,6,66.7,6,13,19,13,27,14,6,1,77,0
4822,110207,145_07_16,SLOVENIA,0,TOTALS,SLOVENIA,200,22,60,36.7,15,35,42.9,7,25,28.0,19,23,82.6,13,33,46,13,22,13,4,4,70,1
4823,110220,145_07_16,POLAND,0,TOTALS,POLAND,200,18,56,32.1,13,39,33.3,5,17,29.4,11,17,64.7,6,22,28,5,23,14,3,3,52,0
4824,110233,145_07_17,ISRAEL,0,TOTALS,ISRAEL,200,26,56,46.4,21,42,50.0,5,14,35.7,30,34,88.2,10,24,34,11,22,21,4,4,87,1
4825,110246,145_07_17,SERBIA,0,TOTALS,SERBIA,200,32,70,45.7,27,48,56.2,5,22,22.7,14,22,63.6,16,21,37,14,29,12,11,5,83,0
4826,110259,145_07_18,LITHUANIA,0,TOTALS,LITHUANIA,200,27,65,41.5,20,43,46.5,7,22,31.8,23,26,88.5,12,28,40,13,24,6,4,1,84,1
4827,110272,145_07_18,GERMANY,0,TOTALS,GERMANY,200,27,65,41.5,16,31,51.6,11,34,32.4,15,19,78.9,11,26,37,3,25,8,2,3,80,0
4828,110285,145_07_19,PORTUGAL,0,TOTALS,PORTUGAL,200,24,54,44.4,15,36,41.7,9,18,50.0,20,22,90.9,7,33,40,9,30,18,3,2,77,1
4829,110298,145_07_19,LATVIA,0,TOTALS,LATVIA,200,16,58,27.6,8,31,25.8,8,27,29.6,27,38,71.1,13,24,37,11,27,10,9,4,67,0
4830,110311,145_07_20,SLOVENIA,0,TOTALS,SLOVENIA,200,22,42,52.4,17,29,58.6,5,13,38.5,18,24,75.0,5,27,32,14,23,14,3,2,67,1
4831,110324,145_07_20,FRANCE,0,TOTALS,FRANCE,200,21,54,38.9,18,41,43.9,3,13,23.1,21,30,70.0,11,16,27,3,21,10,7,3,66,0
4832,110337,145_07_21,RUSSIA,0,TOTALS,RUSSIA,200,20,59,33.9,14,36,38.9,6,23,26.1,15,20,75.0,11,29,40,7,24,15,11,3,61,1
4833,110350,145_07_21,GREECE,0,TOTALS,GREECE,200,18,47,38.3,12,32,37.5,6,15,40.0,11,19,57.9,3,27,30,7,22,20,7,3,53,0
4834,110363,145_07_22,CZECH REPUBLIC,0,TOTALS,CZECH REPUBLIC,200,25,62,40.3,17,37,45.9,8,25,32.0,14,21,66.7,10,26,36,12,29,17,8,2,72,0
4835,110376,145_07_22,TURKEY,0,TOTALS,TURKEY,200,26,61,42.6,16,41,39.0,10,20,50.0,18,31,58.1,12,32,44,13,22,16,4,0,80,1
4836,110389,145_07_23,CROATIA,0,TOTALS,CROATIA,200,31,65,47.7,19,36,52.8,12,29,41.4,11,13,84.6,14,21,35,13,31,20,6,1,85,1
4837,110402,145_07_23,SPAIN,0,TOTALS,SPAIN,200,28,57,49.1,20,39,51.3,8,18,44.4,20,29,69.0,11,21,32,11,16,14,9,0,84,0
4838,110415,145_07_24,POLAND,0,TOTALS,POLAND,200,29,57,50.9,23,35,65.7,6,22,27.3,6,12,50.0,4,22,26,12,21,14,7,2,70,0
4839,110428,145_07_24,ITALY,0,TOTALS,ITALY,200,25,50,50.0,13,29,44.8,12,21,57.1,17,21,81.0,6,28,34,15,20,16,6,2,79,1
4840,110441,145_07_25,PORTUGAL,0,TOTALS,PORTUGAL,200,22,64,34.4,16,36,44.4,6,28,21.4,15,16,93.8,14,23,37,6,24,18,8,1,65,0
4841,110454,145_07_25,RUSSIA,0,TOTALS,RUSSIA,200,29,59,49.2,24,44,54.5,5,15,33.3,15,27,55.6,13,28,41,11,19,14,8,3,78,1
4842,110467,145_07_26,ISRAEL,0,TOTALS,ISRAEL,200,25,55,45.5,18,40,45.0,7,15,46.7,23,28,82.1,11,25,36,13,22,12,4,3,80,1
4843,110480,145_07_26,CROATIA,0,TOTALS,CROATIA,200,25,61,41.0,17,35,48.6,8,26,30.8,17,25,68.0,14,20,34,13,27,13,4,2,75,0
4844,110493,145_07_27,SPAIN,0,TOTALS,SPAIN,200,25,51,49.0,17,30,56.7,8,21,38.1,18,26,69.2,7,25,32,12,21,13,7,1,76,1
4845,110506,145_07_27,GREECE,0,TOTALS,GREECE,200,23,61,37.7,17,36,47.2,6,25,24.0,6,11,54.5,13,23,36,12,20,14,7,2,58,0
4846,110519,145_07_28,FRANCE,0,TOTALS,FRANCE,200,29,63,46.0,19,32,59.4,10,31,32.3,10,14,71.4,7,26,33,14,14,9,8,2,78,1
4847,110532,145_07_28,GERMANY,0,TOTALS,GERMANY,200,27,59,45.8,23,42,54.8,4,17,23.5,8,9,88.9,6,27,33,5,12,13,6,1,66,0
4848,110545,145_07_29,ITALY,0,TOTALS,ITALY,200,29,64,45.3,23,38,60.5,6,26,23.1,10,14,71.4,9,20,29,7,25,12,8,3,74,0
4849,110558,145_07_29,LITHUANIA,0,TOTALS,LITHUANIA,200,28,61,45.9,24,45,53.3,4,16,25.0,19,27,70.4,16,28,44,11,18,15,5,4,79,1
4850,110571,145_07_30,TURKEY,0,TOTALS,TURKEY,200,19,62,30.6,15,37,40.5,4,25,16.0,9,16,56.2,14,23,37,7,25,12,3,3,51,0
4851,110584,145_07_30,SLOVENIA,0,TOTALS,SLOVENIA,200,22,52,42.3,17,33,51.5,5,19,26.3,17,22,77.3,9,29,38,13,18,11,5,1,66,1
4852,110597,145_07_31,PORTUGAL,0,TOTALS,PORTUGAL,200,33,65,50.8,26,46,56.5,7,19,36.8,21,28,75.0,17,28,45,15,17,19,8,4,94,1
4853,110610,145_07_31,ISRAEL,0,TOTALS,ISRAEL,200,32,67,47.8,24,45,53.3,8,22,36.4,13,16,81.2,8,17,25,19,25,17,6,2,85,0
4854,110623,145_07_32,GREECE,0,TOTALS,GREECE,200,27,53,50.9,18,31,58.1,9,22,40.9,18,27,66.7,8,21,29,9,14,7,7,2,81,1
4855,110636,145_07_32,CROATIA,0,TOTALS,CROATIA,200,30,61,49.2,23,38,60.5,7,23,30.4,11,15,73.3,11,19,30,14,25,8,2,1,78,0
4856,110649,145_07_33,RUSSIA,0,TOTALS,RUSSIA,200,24,55,43.6,15,25,60.0,9,30,30.0,12,16,75.0,8,22,30,17,20,13,6,2,69,0
4857,110662,145_07_33,SPAIN,0,TOTALS,SPAIN,200,31,62,50.0,19,29,65.5,12,33,36.4,7,11,63.6,10,23,33,14,19,9,6,2,81,1
4858,110675,145_07_34,ITALY,0,TOTALS,ITALY,225,28,69,40.6,20,43,46.5,8,26,30.8,20,24,83.3,7,30,37,10,22,3,4,3,84,1
4859,110688,145_07_34,TURKEY,0,TOTALS,TURKEY,225,24,57,42.1,13,28,46.4,11,29,37.9,16,29,55.2,8,37,45,8,24,14,2,3,75,0
4860,110701,145_07_35,LITHUANIA,0,TOTALS,LITHUANIA,200,28,56,50.0,21,38,55.3,7,18,38.9,25,30,83.3,11,28,39,11,18,9,8,2,88,1
4861,110714,145_07_35,FRANCE,0,TOTALS,FRANCE,200,24,66,36.4,13,30,43.3,11,36,30.6,14,22,63.6,15,19,34,13,25,13,8,3,73,0
4862,110727,145_07_36,GERMANY,0,TOTALS,GERMANY,200,17,60,28.3,14,41,34.1,3,19,15.8,10,18,55.6,13,20,33,4,24,13,4,4,47,0
4863,110740,145_07_36,SLOVENIA,0,TOTALS,SLOVENIA,200,25,52,48.1,19,39,48.7,6,13,46.2,21,27,77.8,8,34,42,11,22,11,4,5,77,1
4864,110753,145_07_37,CROATIA,0,TOTALS,CROATIA,200,24,56,42.9,18,40,45.0,6,16,37.5,16,20,80.0,10,25,35,10,26,19,3,2,70,0
4865,110766,145_07_37,RUSSIA,0,TOTALS,RUSSIA,200,28,52,53.8,19,33,57.6,9,19,47.4,18,27,66.7,3,25,28,23,20,11,9,2,83,1
4866,110779,145_07_38,GREECE,0,TOTALS,GREECE,200,29,48,60.4,19,30,63.3,10,18,55.6,17,26,65.4,7,30,37,14,26,14,5,3,85,1
4867,110792,145_07_38,PORTUGAL,0,TOTALS,PORTUGAL,200,21,58,36.2,11,31,35.5,10,27,37.0,15,22,68.2,9,15,24,12,24,11,5,1,67,0
4868,110805,145_07_39,SPAIN,0,TOTALS,SPAIN,200,38,72,52.8,27,44,61.4,11,28,39.3,12,13,92.3,9,30,39,18,14,8,10,1,99,1
4869,110818,145_07_39,ISRAEL,0,TOTALS,ISRAEL,200,29,66,43.9,18,38,47.4,11,28,39.3,4,5,80.0,7,26,33,20,24,18,6,2,73,0
4870,110831,145_07_40,GERMANY,0,TOTALS,GERMANY,200,25,66,37.9,18,45,40.0,7,21,33.3,10,13,76.9,21,31,52,7,23,12,5,2,67,1
4871,110844,145_07_40,ITALY,0,TOTALS,ITALY,200,18,56,32.1,13,33,39.4,5,23,21.7,17,21,81.0,8,23,31,9,16,8,9,1,58,0
4872,110857,145_07_41,FRANCE,0,TOTALS,FRANCE,200,32,64,50.0,28,50,56.0,4,14,28.6,17,20,85.0,12,29,41,9,13,16,8,2,85,1
4873,110870,145_07_41,TURKEY,0,TOTALS,TURKEY,200,27,66,40.9,22,46,47.8,5,20,25.0,5,7,71.4,9,22,31,11,19,14,8,4,64,0
4874,110883,145_07_42,SLOVENIA,0,TOTALS,SLOVENIA,200,24,59,40.7,19,38,50.0,5,21,23.8,8,14,57.1,4,18,22,9,21,7,9,2,61,0
4875,110896,145_07_42,LITHUANIA,0,TOTALS,LITHUANIA,200,28,58,48.3,17,38,44.7,11,20,55.0,13,16,81.2,11,33,44,15,20,15,2,2,80,1
4876,110909,145_07_43,RUSSIA,0,TOTALS,RUSSIA,200,29,52,55.8,21,36,58.3,8,16,50.0,9,17,52.9,4,21,25,15,21,17,11,5,75,1
4877,110922,145_07_43,FRANCE,0,TOTALS,FRANCE,200,27,57,47.4,19,35,54.3,8,22,36.4,9,20,45.0,14,23,37,11,20,20,10,4,71,0
4878,110935,145_07_44,SPAIN,0,TOTALS,SPAIN,200,31,54,57.4,23,33,69.7,8,21,38.1,13,18,72.2,3,29,32,11,11,10,10,8,83,1
4879,110948,145_07_44,GERMANY,0,TOTALS,GERMANY,200,23,70,32.9,16,44,36.4,7,26,26.9,2,5,40.0,19,22,41,12,23,16,8,1,55,0
4880,110961,145_07_45,LITHUANIA,0,TOTALS,LITHUANIA,200,23,58,39.7,17,37,45.9,6,21,28.6,22,26,84.6,17,25,42,12,20,13,3,1,74,1
4881,110974,145_07_45,CROATIA,0,TOTALS,CROATIA,200,27,66,40.9,17,37,45.9,10,29,34.5,8,19,42.1,19,17,36,14,23,9,9,0,72,0
4882,110987,145_07_46,SLOVENIA,0,TOTALS,SLOVENIA,200,27,57,47.4,21,35,60.0,6,22,27.3,2,8,25.0,11,22,33,14,18,15,4,5,62,0
4883,111000,145_07_46,GREECE,0,TOTALS,GREECE,200,23,55,41.8,18,38,47.4,5,17,29.4,12,19,63.2,14,19,33,4,17,11,9,2,63,1
4884,111013,145_07_47,FRANCE,0,TOTALS,FRANCE,200,24,58,41.4,17,32,53.1,7,26,26.9,14,17,82.4,11,22,33,12,22,12,3,1,69,0
4885,111026,145_07_47,CROATIA,0,TOTALS,CROATIA,200,32,57,56.1,24,38,63.2,8,19,42.1,14,19,73.7,8,23,31,13,25,9,5,1,86,1
4886,111039,145_07_48,GERMANY,0,TOTALS,GERMANY,200,23,56,41.1,16,35,45.7,7,21,33.3,16,19,84.2,9,22,31,10,23,9,6,1,69,1
4887,111052,145_07_48,SLOVENIA,0,TOTALS,SLOVENIA,200,21,48,43.8,13,25,52.0,8,23,34.8,15,21,71.4,7,24,31,11,21,13,6,3,65,0
4888,111065,145_07_49,SPAIN,0,TOTALS,SPAIN,200,22,43,51.2,11,21,52.4,11,22,50.0,27,28,96.4,4,26,30,12,17,16,5,4,82,1
4889,111078,145_07_49,GREECE,0,TOTALS,GREECE,200,28,66,42.4,20,44,45.5,8,22,36.4,13,18,72.2,14,17,31,14,25,11,11,2,77,0
4890,111091,145_07_50,RUSSIA,0,TOTALS,RUSSIA,200,27,54,50.0,19,35,54.3,8,19,42.1,24,31,77.4,11,22,33,8,24,13,9,6,86,1
4891,111104,145_07_50,LITHUANIA,0,TOTALS,LITHUANIA,200,24,58,41.4,12,31,38.7,12,27,44.4,14,18,77.8,13,20,33,12,26,18,7,3,74,0
4892,111117,145_07_51,FRANCE,0,TOTALS,FRANCE,200,23,60,38.3,17,37,45.9,6,23,26.1,22,30,73.3,13,25,38,9,28,10,3,3,74,0
4893,111130,145_07_51,SLOVENIA,0,TOTALS,SLOVENIA,200,28,61,45.9,18,36,50.0,10,25,40.0,22,29,75.9,10,24,34,14,24,5,3,4,88,1
4894,111143,145_07_52,CROATIA,0,TOTALS,CROATIA,200,27,60,45.0,20,37,54.1,7,23,30.4,10,17,58.8,12,23,35,14,25,18,11,1,71,0
4895,111156,145_07_52,GERMANY,0,TOTALS,GERMANY,200,26,53,49.1,17,27,63.0,9,26,34.6,19,25,76.0,7,25,32,15,21,13,10,5,80,1
4896,111169,145_07_53,GREECE,0,TOTALS,GREECE,200,19,55,34.5,13,33,39.4,6,22,27.3,25,28,89.3,10,22,32,8,20,7,5,4,69,0
4897,111182,145_07_53,LITHUANIA,0,TOTALS,LITHUANIA,200,24,54,44.4,9,28,32.1,15,26,57.7,15,19,78.9,9,26,35,14,26,13,4,4,78,1
4898,111195,145_07_54,SPAIN,0,TOTALS,SPAIN,200,17,59,28.8,7,35,20.0,10,24,41.7,15,26,57.7,17,26,43,11,16,15,5,4,59,0
4899,111208,145_07_54,RUSSIA,0,TOTALS,RUSSIA,200,22,55,40.0,17,35,48.6,5,20,25.0,11,15,73.3,8,30,38,13,26,14,10,2,60,1
4900,115362,149_07_01,SPAIN,0,TOTALS,SPAIN,200,33,65,50.8,26,45,57.8,7,20,35.0,15,21,71.4,8,30,38,16,26,11,14,0,88,1
4901,115375,149_07_01,CROATIA,0,TOTALS,CROATIA,200,23,54,42.6,19,38,50.0,4,16,25.0,19,30,63.3,6,25,31,10,22,18,6,1,69,0
4902,115388,149_07_02,LATVIA,0,TOTALS,LATVIA,200,23,62,37.1,18,42,42.9,5,20,25.0,21,31,67.7,14,19,33,11,26,11,7,1,72,1
4903,115401,149_07_02,GEORGIA,0,TOTALS,GEORGIA,200,34,58,58.6,19,32,59.4,15,26,57.7,19,24,79.2,6,31,37,19,25,18,7,5,102,0
4904,115414,149_07_03,ISRAEL,0,TOTALS,ISRAEL,200,34,60,56.7,29,44,65.9,5,16,31.2,22,30,73.3,9,29,38,18,25,19,12,0,95,1
4905,115427,149_07_03,MKD,0,TOTALS,MKD,200,19,57,33.3,14,33,42.4,5,24,20.8,22,35,62.9,12,16,28,8,24,22,9,3,65,0
4906,115440,149_07_04,RUSSIA,0,TOTALS,RUSSIA,200,24,49,49.0,18,34,52.9,6,15,40.0,24,31,77.4,10,17,27,10,25,21,5,1,78,1
4907,115453,149_07_04,GREECE,0,TOTALS,GREECE,200,20,54,37.0,13,31,41.9,7,23,30.4,23,34,67.6,13,15,28,3,26,12,9,0,70,0
4908,115466,149_07_05,SERBIA,0,TOTALS,SERBIA,200,24,58,41.4,15,30,50.0,9,28,32.1,21,26,80.8,8,27,35,12,26,11,5,3,78,0
4909,115479,149_07_05,SLOVENIA,0,TOTALS,SLOVENIA,200,27,65,41.5,21,44,47.7,6,21,28.6,20,27,74.1,14,27,41,11,24,8,6,2,80,1
4910,115492,149_07_06,TURKEY,0,TOTALS,TURKEY,225,31,76,40.8,26,50,52.0,5,26,19.2,23,35,65.7,17,24,41,11,31,20,11,1,90,1
4911,115505,149_07_06,LITHUANIA,0,TOTALS,LITHUANIA,225,27,70,38.6,23,54,42.6,4,16,25.0,27,39,69.2,16,26,42,8,26,23,7,4,85,0
4912,115518,149_07_07,FRANCE,0,TOTALS,FRANCE,200,31,67,46.3,25,40,62.5,6,27,22.2,24,37,64.9,16,22,38,16,21,13,16,0,92,1
4913,115530,149_07_07,HUNGARY,0,TOTALS,HUNGARY,200,22,54,40.7,17,40,42.5,5,14,35.7,17,28,60.7,7,23,30,8,35,28,6,3,66,0
4914,115543,149_07_08,ITALY,0,TOTALS,ITALY,200,33,82,40.2,27,63,42.9,6,19,31.6,14,16,87.5,27,31,58,13,21,13,14,3,86,1
4915,115556,149_07_08,BULGARIA,0,TOTALS,BULGARIA,200,16,58,27.6,11,40,27.5,5,18,27.8,14,24,58.3,11,16,27,6,14,17,7,1,51,0
4916,115569,149_07_09,LITHUANIA,0,TOTALS,LITHUANIA,200,17,55,30.9,12,27,44.4,5,28,17.9,22,34,64.7,13,28,41,8,32,17,9,1,61,0
4917,115582,149_07_09,RUSSIA,0,TOTALS,RUSSIA,200,21,56,37.5,13,33,39.4,8,23,34.8,19,37,51.4,16,30,46,11,27,19,10,3,69,1
4918,115595,149_07_10,MKD,0,TOTALS,MKD,200,25,63,39.7,20,42,47.6,5,21,23.8,5,15,33.3,8,16,24,13,27,15,10,2,60,0
4919,115608,149_07_10,SPAIN,0,TOTALS,SPAIN,200,31,53,58.5,23,37,62.2,8,16,50.0,23,36,63.9,7,32,39,19,16,19,9,1,93,1
4920,115621,149_07_11,GREECE,0,TOTALS,GREECE,200,23,57,40.4,18,41,43.9,5,16,31.2,12,23,52.2,13,20,33,10,27,9,3,2,63,1
4921,115634,149_07_11,TURKEY,0,TOTALS,TURKEY,200,17,51,33.3,13,29,44.8,4,22,18.2,24,30,80.0,12,23,35,10,26,11,4,1,62,0
4922,115647,149_07_12,BULGARIA,0,TOTALS,BULGARIA,200,33,59,55.9,23,39,59.0,10,20,50.0,20,25,80.0,6,19,25,12,23,16,13,0,96,1
4923,115660,149_07_12,LATVIA,0,TOTALS,LATVIA,200,33,63,52.4,25,40,62.5,8,23,34.8,15,22,68.2,9,17,26,5,22,17,8,0,89,0
4924,115673,149_07_13,SLOVENIA,0,TOTALS,SLOVENIA,200,27,56,48.2,23,39,59.0,4,17,23.5,26,38,68.4,11,28,39,15,23,16,5,1,84,1
4925,115686,149_07_13,FRANCE,0,TOTALS,FRANCE,200,29,64,45.3,27,42,64.3,2,22,9.1,18,23,78.3,9,24,33,7,29,13,10,3,78,0
4926,115699,149_07_14,CROATIA,0,TOTALS,CROATIA,200,23,49,46.9,17,36,47.2,6,13,46.2,12,21,57.1,6,28,34,10,25,18,3,4,64,0
4927,115712,149_07_14,ISRAEL,0,TOTALS,ISRAEL,200,28,67,41.8,23,52,44.2,5,15,33.3,16,26,61.5,9,22,31,7,19,10,8,1,77,1
4928,115724,149_07_15,HUNGARY,0,TOTALS,HUNGARY,200,15,61,24.6,10,33,30.3,5,28,17.9,5,9,55.6,11,21,32,8,34,22,7,1,40,0
4929,115737,149_07_15,SERBIA,0,TOTALS,SERBIA,200,31,61,50.8,28,44,63.6,3,17,17.6,19,38,50.0,17,34,51,19,21,18,7,3,84,1
4930,115750,149_07_16,GEORGIA,0,TOTALS,GEORGIA,200,16,52,30.8,9,26,34.6,7,26,26.9,17,25,68.0,2,13,15,7,20,22,8,2,56,0
4931,115763,149_07_16,ITALY,0,TOTALS,ITALY,200,36,69,52.2,29,49,59.2,7,20,35.0,15,21,71.4,9,36,45,18,21,20,12,3,94,1
4932,115776,149_07_17,MKD,0,TOTALS,MKD,200,26,65,40.0,16,31,51.6,10,34,29.4,8,13,61.5,7,16,23,8,25,16,8,2,70,0
4933,115789,149_07_17,CROATIA,0,TOTALS,CROATIA,200,33,61,54.1,25,46,54.3,8,15,53.3,14,25,56.0,7,28,35,6,17,15,9,1,88,1
4934,115802,149_07_18,TURKEY,0,TOTALS,TURKEY,200,29,57,50.9,24,38,63.2,5,19,26.3,11,23,47.8,5,18,23,15,23,11,11,3,74,0
4935,115815,149_07_18,RUSSIA,0,TOTALS,RUSSIA,200,33,60,55.0,23,39,59.0,10,21,47.6,12,18,66.7,7,19,26,18,25,13,7,0,88,1
4936,115828,149_07_19,SERBIA,0,TOTALS,SERBIA,200,35,70,50.0,29,44,65.9,6,26,23.1,20,29,69.0,12,24,36,23,24,14,4,4,96,1
4937,115841,149_07_19,FRANCE,0,TOTALS,FRANCE,200,28,59,47.5,19,29,65.5,9,30,30.0,16,24,66.7,3,22,25,7,27,15,11,2,81,0
4938,115854,149_07_20,GEORGIA,0,TOTALS,GEORGIA,200,28,58,48.3,24,39,61.5,4,19,21.1,15,19,78.9,10,28,38,12,26,19,8,6,75,1
4939,115867,149_07_20,BULGARIA,0,TOTALS,BULGARIA,200,24,64,37.5,14,38,36.8,10,26,38.5,16,28,57.1,12,20,32,13,21,15,4,2,74,0
4940,115879,149_07_21,HUNGARY,0,TOTALS,HUNGARY,200,19,52,36.5,15,39,38.5,4,13,30.8,14,28,50.0,7,21,28,5,23,21,6,1,56,0
4941,115892,149_07_21,SLOVENIA,0,TOTALS,SLOVENIA,200,28,62,45.2,22,41,53.7,6,21,28.6,7,14,50.0,7,23,30,14,25,17,10,3,69,1
4942,115905,149_07_22,GREECE,0,TOTALS,GREECE,200,27,64,42.2,20,41,48.8,7,23,30.4,14,20,70.0,10,29,39,8,34,15,8,1,75,0
4943,115918,149_07_22,LITHUANIA,0,TOTALS,LITHUANIA,200,27,57,47.4,20,36,55.6,7,21,33.3,23,41,56.1,12,27,39,13,20,16,6,4,84,1
4944,115931,149_07_23,SPAIN,0,TOTALS,SPAIN,200,25,53,47.2,19,34,55.9,6,19,31.6,21,31,67.7,9,31,40,13,20,16,6,5,77,1
4945,115944,149_07_23,ISRAEL,0,TOTALS,ISRAEL,200,28,71,39.4,20,52,38.5,8,19,42.1,9,13,69.2,9,19,28,7,24,9,8,2,73,0
4946,115957,149_07_24,ITALY,0,TOTALS,ITALY,200,24,66,36.4,19,43,44.2,5,23,21.7,19,26,73.1,12,26,38,14,26,17,12,3,72,1
4947,115970,149_07_24,LATVIA,0,TOTALS,LATVIA,200,23,64,35.9,20,38,52.6,3,26,11.5,16,22,72.7,15,31,46,11,27,22,7,1,65,0
4948,115983,149_07_25,GREECE,0,TOTALS,GREECE,200,24,51,47.1,18,38,47.4,6,13,46.2,30,39,76.9,9,38,47,11,31,17,4,7,84,1
4949,115996,149_07_25,MKD,0,TOTALS,MKD,200,18,65,27.7,13,31,41.9,5,34,14.7,17,33,51.5,13,18,31,8,32,11,8,1,58,0
4950,116008,149_07_26,HUNGARY,0,TOTALS,HUNGARY,200,27,61,44.3,20,37,54.1,7,24,29.2,4,10,40.0,9,21,30,3,25,19,6,0,65,0
4951,116021,149_07_26,LATVIA,0,TOTALS,LATVIA,200,29,66,43.9,18,35,51.4,11,31,35.5,12,20,60.0,13,20,33,11,16,17,12,0,81,1
4952,116034,149_07_27,GEORGIA,0,TOTALS,GEORGIA,200,22,59,37.3,13,29,44.8,9,30,30.0,21,26,80.8,17,21,38,13,20,14,1,2,74,0
4953,116047,149_07_27,ISRAEL,0,TOTALS,ISRAEL,200,31,64,48.4,26,49,53.1,5,15,33.3,14,21,66.7,15,20,35,16,21,10,8,1,81,1
4954,116060,149_07_28,TURKEY,0,TOTALS,TURKEY,200,32,59,54.2,25,44,56.8,7,15,46.7,12,21,57.1,6,27,33,16,31,14,6,2,83,0
4955,116073,149_07_28,SERBIA,0,TOTALS,SERBIA,200,26,52,50.0,19,31,61.3,7,21,33.3,29,44,65.9,3,23,26,11,22,8,7,4,88,1
4956,116086,149_07_29,LITHUANIA,0,TOTALS,LITHUANIA,200,31,61,50.8,23,43,53.5,8,18,44.4,14,26,53.8,12,17,29,10,31,13,3,3,84,0
4957,116099,149_07_29,SLOVENIA,0,TOTALS,SLOVENIA,200,34,62,54.8,30,48,62.5,4,14,28.6,24,31,77.4,11,26,37,14,27,11,9,3,96,1
4958,116112,149_07_30,RUSSIA,0,TOTALS,RUSSIA,200,28,58,48.3,24,37,64.9,4,21,19.0,24,35,68.6,10,22,32,10,18,13,7,2,84,1
4959,116125,149_07_30,FRANCE,0,TOTALS,FRANCE,200,27,65,41.5,15,31,48.4,12,34,35.3,13,16,81.2,11,19,30,13,26,16,7,1,79,0
4960,116138,149_07_31,BULGARIA,0,TOTALS,BULGARIA,200,24,60,40.0,13,36,36.1,11,24,45.8,11,17,64.7,10,22,32,15,24,18,4,1,70,0
4961,116151,149_07_31,SPAIN,0,TOTALS,SPAIN,200,35,64,54.7,28,47,59.6,7,17,41.2,14,21,66.7,7,26,33,17,20,14,11,1,91,1
4962,116164,149_07_32,ITALY,0,TOTALS,ITALY,200,31,59,52.5,23,36,63.9,8,23,34.8,12,14,85.7,7,16,23,11,20,12,13,2,82,1
4963,116177,149_07_32,CROATIA,0,TOTALS,CROATIA,200,27,56,48.2,25,49,51.0,2,7,28.6,13,20,65.0,11,20,31,13,22,18,5,0,69,0
4964,116190,149_07_33,SERBIA,0,TOTALS,SERBIA,200,28,58,48.3,24,38,63.2,4,20,20.0,11,19,57.9,9,20,29,11,23,11,8,2,71,1
4965,116203,149_07_33,RUSSIA,0,TOTALS,RUSSIA,200,22,52,42.3,18,34,52.9,4,18,22.2,17,22,77.3,9,24,33,6,23,13,6,3,65,0
4966,116216,149_07_34,FRANCE,0,TOTALS,FRANCE,200,28,73,38.4,26,56,46.4,2,17,11.8,18,25,72.0,18,24,42,8,23,15,18,0,76,1
4967,116229,149_07_34,LITHUANIA,0,TOTALS,LITHUANIA,200,28,54,51.9,24,34,70.6,4,20,20.0,11,22,50.0,6,25,31,10,23,24,5,1,71,0
4968,116242,149_07_35,SLOVENIA,0,TOTALS,SLOVENIA,200,27,60,45.0,18,39,46.2,9,21,42.9,19,24,79.2,6,21,27,16,20,10,11,6,82,1
4969,116255,149_07_35,TURKEY,0,TOTALS,TURKEY,200,27,65,41.5,18,40,45.0,9,25,36.0,11,17,64.7,13,22,35,10,25,19,3,5,74,0
4970,116268,149_07_36,SPAIN,0,TOTALS,SPAIN,200,36,70,51.4,27,48,56.2,9,22,40.9,15,20,75.0,14,20,34,16,19,13,10,3,96,1
4971,116281,149_07_36,GEORGIA,0,TOTALS,GEORGIA,200,25,56,44.6,19,32,59.4,6,24,25.0,12,20,60.0,9,19,28,8,21,20,6,1,68,0
4972,116294,149_07_37,CROATIA,0,TOTALS,CROATIA,200,27,68,39.7,23,45,51.1,4,23,17.4,12,17,70.6,14,26,40,12,24,20,9,3,70,0
4973,116307,149_07_37,BULGARIA,0,TOTALS,BULGARIA,200,32,69,46.4,22,43,51.2,10,26,38.5,14,19,73.7,13,26,39,18,17,18,11,4,88,1
4974,116320,149_07_38,ISRAEL,0,TOTALS,ISRAEL,200,22,53,41.5,19,40,47.5,3,13,23.1,15,25,60.0,7,19,26,9,20,18,8,2,62,0
4975,116333,149_07_38,ITALY,0,TOTALS,ITALY,200,24,54,44.4,17,35,48.6,7,19,36.8,11,16,68.8,6,24,30,5,23,21,11,2,66,1
4976,116346,149_07_39,TURKEY,0,TOTALS,TURKEY,200,27,54,50.0,18,39,46.2,9,15,60.0,17,24,70.8,10,23,33,12,26,21,8,5,80,1
4977,116359,149_07_39,FRANCE,0,TOTALS,FRANCE,200,24,62,38.7,16,42,38.1,8,20,40.0,23,28,82.1,15,17,32,13,26,17,12,0,79,0
4978,116372,149_07_40,MKD,0,TOTALS,MKD,200,29,62,46.8,18,36,50.0,11,26,42.3,17,18,94.4,6,22,28,18,15,11,15,4,86,1
4979,116384,149_07_40,HUNGARY,0,TOTALS,HUNGARY,200,20,60,33.3,16,41,39.0,4,19,21.1,12,16,75.0,10,24,34,1,18,21,8,1,56,0
4980,116397,149_07_41,LITHUANIA,0,TOTALS,LITHUANIA,200,28,66,42.4,24,49,49.0,4,17,23.5,16,19,84.2,9,17,26,10,26,10,5,4,76,0
4981,116410,149_07_41,SERBIA,0,TOTALS,SERBIA,200,33,61,54.1,25,44,56.8,8,17,47.1,20,27,74.1,11,30,41,18,22,14,3,8,94,1
4982,116423,149_07_42,LATVIA,0,TOTALS,LATVIA,200,28,69,40.6,19,46,41.3,9,23,39.1,11,16,68.8,11,19,30,11,25,14,5,2,76,0
4983,116436,149_07_42,GREECE,0,TOTALS,GREECE,200,27,55,49.1,23,41,56.1,4,14,28.6,20,31,64.5,8,25,33,8,19,14,13,4,78,1
4984,116449,149_07_43,GEORGIA,0,TOTALS,GEORGIA,200,29,61,47.5,20,33,60.6,9,28,32.1,11,16,68.8,6,16,22,13,20,12,7,1,78,0
4985,116462,149_07_43,CROATIA,0,TOTALS,CROATIA,200,40,64,62.5,35,51,68.6,5,13,38.5,14,24,58.3,10,27,37,15,21,11,8,3,99,1
4986,116475,149_07_44,BULGARIA,0,TOTALS,BULGARIA,200,26,58,44.8,20,33,60.6,6,25,24.0,11,19,57.9,11,19,30,8,24,20,8,1,69,0
4987,116488,149_07_44,ISRAEL,0,TOTALS,ISRAEL,200,33,61,54.1,28,48,58.3,5,13,38.5,14,22,63.6,8,18,26,17,20,14,15,0,85,1
4988,116501,149_07_45,RUSSIA,0,TOTALS,RUSSIA,200,22,51,43.1,17,36,47.2,5,15,33.3,14,20,70.0,13,22,35,12,17,19,12,6,63,1
4989,116514,149_07_45,SLOVENIA,0,TOTALS,SLOVENIA,200,20,54,37.0,14,34,41.2,6,20,30.0,9,13,69.2,13,17,30,10,22,23,8,5,55,0
4990,116527,149_07_46,ITALY,0,TOTALS,ITALY,200,28,65,43.1,22,45,48.9,6,20,30.0,13,15,86.7,11,17,28,8,22,19,11,3,75,0
4991,116540,149_07_46,SPAIN,0,TOTALS,SPAIN,200,29,57,50.9,20,43,46.5,9,14,64.3,22,26,84.6,11,14,25,10,17,15,11,5,89,1
4992,116553,149_07_47,ISRAEL,0,TOTALS,ISRAEL,200,30,63,47.6,28,53,52.8,2,10,20.0,12,21,57.1,6,15,21,10,20,9,12,2,74,1
4993,116566,149_07_47,TURKEY,0,TOTALS,TURKEY,200,24,56,42.9,18,31,58.1,6,25,24.0,10,18,55.6,8,23,31,10,22,20,6,2,64,0
4994,116578,149_07_48,HUNGARY,0,TOTALS,HUNGARY,200,16,48,33.3,11,28,39.3,5,20,25.0,8,13,61.5,10,20,30,10,22,28,10,2,45,0
4995,116591,149_07_48,GREECE,0,TOTALS,GREECE,200,25,61,41.0,23,44,52.3,2,17,11.8,10,14,71.4,10,25,35,10,16,18,15,5,62,1
4996,116604,149_07_49,SLOVENIA,0,TOTALS,SLOVENIA,200,31,58,53.4,27,41,65.9,4,17,23.5,13,20,65.0,11,25,36,14,24,16,11,2,79,1
4997,116617,149_07_49,BULGARIA,0,TOTALS,BULGARIA,200,20,63,31.7,14,36,38.9,6,27,22.2,13,17,76.5,12,15,27,8,20,19,9,0,59,0
4998,116630,149_07_50,MKD,0,TOTALS,MKD,200,30,70,42.9,21,45,46.7,9,25,36.0,13,24,54.2,7,21,28,11,27,15,13,3,82,0
4999,116643,149_07_50,LATVIA,0,TOTALS,LATVIA,200,32,68,47.1,26,45,57.8,6,23,26.1,20,29,69.0,16,39,55,17,23,22,6,1,90,1
5000,116656,149_07_51,SPAIN,0,TOTALS,SPAIN,200,27,56,48.2,20,35,57.1,7,21,33.3,15,20,75.0,5,20,25,10,18,12,7,4,76,1
5001,116669,149_07_51,RUSSIA,0,TOTALS,RUSSIA,200,26,68,38.2,15,35,42.9,11,33,33.3,6,9,66.7,17,19,36,5,22,14,6,1,69,0
5002,116682,149_07_52,CROATIA,0,TOTALS,CROATIA,200,32,63,50.8,19,40,47.5,13,23,56.5,19,25,76.0,6,39,45,20,30,26,8,7,96,1
5003,116695,149_07_52,LITHUANIA,0,TOTALS,LITHUANIA,200,31,78,39.7,30,66,45.5,1,12,8.3,19,34,55.9,15,24,39,11,24,16,16,7,82,0
5004,116708,149_07_53,SERBIA,0,TOTALS,SERBIA,200,26,55,47.3,20,36,55.6,6,19,31.6,19,27,70.4,11,28,39,6,19,20,4,0,77,1
5005,116721,149_07_53,ITALY,0,TOTALS,ITALY,200,23,70,32.9,19,48,39.6,4,22,18.2,12,16,75.0,12,19,31,3,28,9,13,1,62,0
5006,116734,149_07_54,FRANCE,0,TOTALS,FRANCE,200,38,69,55.1,30,51,58.8,8,18,44.4,12,18,66.7,10,29,39,18,27,13,9,2,96,1
5007,116747,149_07_54,GEORGIA,0,TOTALS,GEORGIA,200,21,62,33.9,11,28,39.3,10,34,29.4,17,29,58.6,13,18,31,15,18,15,5,3,69,0
5008,116760,149_07_55,GEORGIA,0,TOTALS,GEORGIA,200,24,59,40.7,15,33,45.5,9,26,34.6,13,15,86.7,10,30,40,16,16,20,6,5,70,0
5009,116773,149_07_55,LITHUANIA,0,TOTALS,LITHUANIA,200,33,74,44.6,31,58,53.4,2,16,12.5,13,21,61.9,14,23,37,13,19,9,13,2,81,1
5010,116786,149_07_56,SLOVENIA,0,TOTALS,SLOVENIA,200,31,58,53.4,24,39,61.5,7,19,36.8,21,27,77.8,8,29,37,12,22,21,6,4,90,1
5011,116799,149_07_56,ISRAEL,0,TOTALS,ISRAEL,200,26,70,37.1,17,49,34.7,9,21,42.9,20,26,76.9,5,16,21,7,25,12,16,3,81,0
5012,116812,149_07_57,FRANCE,0,TOTALS,FRANCE,200,39,73,53.4,29,51,56.9,10,22,45.5,3,7,42.9,8,22,30,19,27,15,12,4,91,1
5013,116825,149_07_57,CROATIA,0,TOTALS,CROATIA,200,29,57,50.9,26,41,63.4,3,16,18.8,21,30,70.0,6,26,32,12,14,18,9,3,82,0
5014,116838,149_07_58,ITALY,0,TOTALS,ITALY,200,29,64,45.3,20,34,58.8,9,30,30.0,7,10,70.0,9,12,21,13,21,9,10,0,74,1
5015,116851,149_07_58,RUSSIA,0,TOTALS,RUSSIA,200,23,49,46.9,19,32,59.4,4,17,23.5,13,21,61.9,11,23,34,8,16,20,5,1,63,0
5016,116864,149_07_59,BULGARIA,0,TOTALS,BULGARIA,200,34,71,47.9,23,44,52.3,11,27,40.7,9,14,64.3,12,13,25,17,17,18,15,2,88,0
5017,116877,149_07_59,TURKEY,0,TOTALS,TURKEY,200,37,64,57.8,29,42,69.0,8,22,36.4,15,20,75.0,14,25,39,20,19,24,12,5,97,1
5018,116890,149_07_60,SERBIA,0,TOTALS,SERBIA,200,32,62,51.6,21,37,56.8,11,25,44.0,12,24,50.0,6,27,33,10,19,13,4,2,87,1
5019,116903,149_07_60,SPAIN,0,TOTALS,SPAIN,200,29,75,38.7,22,49,44.9,7,26,26.9,13,16,81.2,9,21,30,7,25,7,10,2,78,0
5020,116916,150_07_01,GERMANY,0,TOTALS,GERMANY,200,25,60,41.7,18,42,42.9,7,18,38.9,17,24,70.8,9,25,34,12,26,13,8,2,74,0
5021,116929,150_07_01,MONTENEGRO,0,TOTALS,MONTENEGRO,200,28,68,41.2,22,39,56.4,6,29,20.7,14,23,60.9,15,22,37,18,23,12,5,4,76,1
5022,116942,150_07_02,PORTUGAL,0,TOTALS,PORTUGAL,200,20,55,36.4,15,32,46.9,5,23,21.7,9,14,64.3,9,30,39,13,13,22,9,5,54,0
5023,116955,150_07_02,SLOVAK REPUBLIC,0,TOTALS,SLOVAK REPUBLIC,200,23,63,36.5,20,47,42.6,3,16,18.8,6,12,50.0,14,24,38,10,20,18,8,1,55,1
5024,116968,150_07_03,ESTONIA,0,TOTALS,ESTONIA,200,25,63,39.7,19,41,46.3,6,22,27.3,15,23,65.2,10,38,48,17,22,17,6,2,71,1
5025,116981,150_07_03,IRELAND,0,TOTALS,IRELAND,200,19,74,25.7,17,57,29.8,2,17,11.8,7,20,35.0,19,29,48,10,26,12,12,1,47,0
5026,116994,150_07_04,FINLAND,0,TOTALS,FINLAND,200,30,67,44.8,21,41,51.2,9,26,34.6,15,25,60.0,13,30,43,18,14,15,9,1,84,1
5027,117007,150_07_04,GREAT BRITAIN,0,TOTALS,GREAT BRITAIN,200,24,70,34.3,21,51,41.2,3,19,15.8,7,12,58.3,12,23,35,9,22,18,11,2,58,0
5028,117020,150_07_05,SWEDEN,0,TOTALS,SWEDEN,200,21,54,38.9,16,38,42.1,5,16,31.2,15,31,48.4,11,25,36,14,24,24,13,4,62,1
5029,117033,150_07_05,CZECH REPUBLIC,0,TOTALS,CZECH REPUBLIC,200,14,59,23.7,11,34,32.4,3,25,12.0,14,20,70.0,11,22,33,6,30,21,17,1,45,0
5030,117046,150_07_06,UKRAINE,0,TOTALS,UKRAINE,200,40,76,52.6,34,55,61.8,6,21,28.6,21,29,72.4,15,31,46,13,16,9,9,7,107,0
5031,117059,150_07_06,BELARUS,0,TOTALS,BELARUS,200,23,65,35.4,17,44,38.6,6,21,28.6,8,15,53.3,14,23,37,12,28,16,3,3,60,1
5032,117072,150_07_07,POLAND,0,TOTALS,POLAND,200,33,63,52.4,29,51,56.9,4,12,33.3,16,26,61.5,19,33,52,20,18,28,16,6,86,1
5033,117085,150_07_07,SWITZERLAND,0,TOTALS,SWITZERLAND,200,19,62,30.6,14,49,28.6,5,13,38.5,5,10,50.0,9,10,19,8,26,24,18,3,48,0
5034,117098,150_07_08,BELGIUM,0,TOTALS,BELGIUM,200,26,73,35.6,20,49,40.8,6,24,25.0,7,13,53.8,18,28,46,14,20,10,15,3,65,1
5035,117111,150_07_08,ROMANIA,0,TOTALS,ROMANIA,200,21,63,33.3,18,44,40.9,3,19,15.8,10,20,50.0,19,28,47,5,18,17,3,4,55,0
5036,117124,150_07_09,NETHERLANDS,0,TOTALS,NETHERLANDS,200,18,61,29.5,14,40,35.0,4,21,19.0,23,34,67.6,18,29,47,7,32,30,12,5,63,0
5037,117137,150_07_09,ESTONIA,0,TOTALS,ESTONIA,200,19,56,33.9,13,30,43.3,6,26,23.1,26,38,68.4,8,22,30,11,27,24,13,3,70,1
5038,117150,150_07_10,AUSTRIA,0,TOTALS,AUSTRIA,200,28,69,40.6,20,43,46.5,8,26,30.8,14,17,82.4,11,25,36,10,22,15,10,0,78,1
5039,117163,150_07_10,SWEDEN,0,TOTALS,SWEDEN,200,26,62,41.9,16,35,45.7,10,27,37.0,13,18,72.2,8,27,35,12,20,20,8,7,75,0
5040,117176,150_07_11,IRELAND,0,TOTALS,IRELAND,200,16,55,29.1,12,34,35.3,4,21,19.0,8,26,30.8,8,14,22,11,27,17,13,2,44,0
5041,117189,150_07_11,POLAND,0,TOTALS,POLAND,200,29,60,48.3,27,44,61.4,2,16,12.5,18,28,64.3,13,36,49,9,26,22,13,2,78,1
5042,117202,150_07_12,CZECH REPUBLIC,0,TOTALS,CZECH REPUBLIC,200,18,54,33.3,14,29,48.3,4,25,16.0,33,50,66.0,7,16,23,6,42,8,14,1,73,0
5043,117215,150_07_12,GERMANY,0,TOTALS,GERMANY,200,19,45,42.2,16,28,57.1,3,17,17.6,38,55,69.1,10,30,40,8,40,17,5,1,79,1
5044,117228,150_07_13,BELARUS,0,TOTALS,BELARUS,200,26,66,39.4,21,42,50.0,5,24,20.8,15,26,57.7,17,18,35,11,31,25,8,2,72,0
5045,117241,150_07_13,PORTUGAL,0,TOTALS,PORTUGAL,200,26,56,46.4,19,36,52.8,7,20,35.0,18,30,60.0,9,23,32,8,24,25,14,3,77,1
5046,117254,150_07_14,SWITZERLAND,0,TOTALS,SWITZERLAND,200,28,62,45.2,23,46,50.0,5,16,31.2,12,17,70.6,13,25,38,13,25,15,6,1,73,0
5047,117267,150_07_14,IRELAND,0,TOTALS,IRELAND,200,25,53,47.2,17,29,58.6,8,24,33.3,16,30,53.3,9,23,32,14,18,14,4,0,74,1
5048,117280,150_07_15,SLOVAK REPUBLIC,0,TOTALS,SLOVAK REPUBLIC,200,23,65,35.4,20,53,37.7,3,12,25.0,5,8,62.5,10,17,27,6,30,29,11,0,54,0
5049,117293,150_07_15,UKRAINE,0,TOTALS,UKRAINE,200,28,58,48.3,21,38,55.3,7,20,35.0,32,41,78.0,11,28,39,11,11,20,23,8,95,1
5050,117306,150_07_16,MONTENEGRO,0,TOTALS,MONTENEGRO,200,32,57,56.1,27,39,69.2,5,18,27.8,19,36,52.8,11,23,34,22,21,18,15,1,88,1
5051,117319,150_07_16,CZECH REPUBLIC,0,TOTALS,CZECH REPUBLIC,200,23,56,41.1,16,35,45.7,7,21,33.3,13,16,81.2,12,20,32,14,32,28,6,0,66,0
5052,117332,150_07_17,ROMANIA,0,TOTALS,ROMANIA,225,26,78,33.3,17,49,34.7,9,29,31.0,26,36,72.2,18,26,44,7,30,16,11,1,87,1
5053,117345,150_07_17,FINLAND,0,TOTALS,FINLAND,225,27,67,40.3,21,43,48.8,6,24,25.0,26,43,60.5,14,29,43,11,31,21,8,3,86,0
5054,117358,150_07_18,GERMANY,0,TOTALS,GERMANY,200,23,62,37.1,17,34,50.0,6,28,21.4,19,24,79.2,12,35,47,8,22,12,7,3,71,1
5055,117371,150_07_18,AUSTRIA,0,TOTALS,AUSTRIA,200,22,67,32.8,16,40,40.0,6,27,22.2,13,18,72.2,12,25,37,10,23,12,9,2,63,0
5056,117384,150_07_19,GREAT BRITAIN,0,TOTALS,GREAT BRITAIN,200,26,61,42.6,21,39,53.8,5,22,22.7,20,38,52.6,16,27,43,8,19,19,8,6,77,1
5057,117397,150_07_19,BELGIUM,0,TOTALS,BELGIUM,200,27,70,38.6,19,41,46.3,8,29,27.6,6,8,75.0,10,24,34,17,25,23,12,0,68,0
5058,117410,150_07_20,POLAND,0,TOTALS,POLAND,200,31,50,62.0,28,44,63.6,3,6,50.0,20,29,69.0,14,24,38,18,23,28,9,2,85,1
5059,117423,150_07_20,NETHERLANDS,0,TOTALS,NETHERLANDS,200,26,69,37.7,18,49,36.7,8,20,40.0,13,20,65.0,18,10,28,16,29,21,19,3,73,0
5060,117436,150_07_21,SWEDEN,0,TOTALS,SWEDEN,200,21,61,34.4,17,38,44.7,4,23,17.4,15,28,53.6,13,27,40,8,24,10,5,2,61,0
5061,117449,150_07_21,GERMANY,0,TOTALS,GERMANY,200,22,55,40.0,14,35,40.0,8,20,40.0,13,26,50.0,10,29,39,10,30,12,6,7,65,1
5062,117462,150_07_22,AUSTRIA,0,TOTALS,AUSTRIA,200,33,58,56.9,27,43,62.8,6,15,40.0,13,17,76.5,4,21,25,14,23,11,5,1,85,1
5063,117475,150_07_22,MONTENEGRO,0,TOTALS,MONTENEGRO,200,25,61,41.0,14,30,46.7,11,31,35.5,22,32,68.8,17,21,38,15,23,12,8,0,83,0
5064,117488,150_07_23,ESTONIA,0,TOTALS,ESTONIA,200,16,56,28.6,8,30,26.7,8,26,30.8,8,19,42.1,8,19,27,11,19,14,8,1,48,0
5065,117501,150_07_23,POLAND,0,TOTALS,POLAND,200,24,60,40.0,16,38,42.1,8,22,36.4,11,19,57.9,17,31,48,13,20,21,8,3,67,1
5066,117514,150_07_24,NETHERLANDS,0,TOTALS,NETHERLANDS,200,29,73,39.7,26,57,45.6,3,16,18.8,23,27,85.2,15,30,45,14,22,20,13,2,84,1
5067,117527,150_07_24,SWITZERLAND,0,TOTALS,SWITZERLAND,200,23,65,35.4,20,45,44.4,3,20,15.0,13,23,56.5,15,28,43,8,25,28,13,6,62,0
5068,117540,150_07_25,PORTUGAL,0,TOTALS,PORTUGAL,200,28,65,43.1,21,48,43.8,7,17,41.2,17,26,65.4,17,17,34,10,23,17,7,3,80,0
5069,117553,150_07_25,UKRAINE,0,TOTALS,UKRAINE,200,32,64,50.0,25,46,54.3,7,18,38.9,16,21,76.2,11,23,34,16,25,15,9,8,87,1
5070,117566,150_07_26,CZECH REPUBLIC,0,TOTALS,CZECH REPUBLIC,200,25,56,44.6,14,27,51.9,11,29,37.9,9,14,64.3,9,23,32,14,21,27,11,5,70,1
5071,117579,150_07_26,AUSTRIA,0,TOTALS,AUSTRIA,200,26,68,38.2,24,48,50.0,2,20,10.0,10,16,62.5,8,22,30,15,21,15,12,0,64,0
5072,117592,150_07_27,FINLAND,0,TOTALS,FINLAND,200,26,61,42.6,21,41,51.2,5,20,25.0,30,41,73.2,16,23,39,14,20,18,13,4,87,1
5073,117605,150_07_27,BELGIUM,0,TOTALS,BELGIUM,200,27,61,44.3,17,40,42.5,10,21,47.6,10,13,76.9,7,14,21,16,30,26,13,2,74,0
5074,117618,150_07_28,IRELAND,0,TOTALS,IRELAND,200,28,69,40.6,21,53,39.6,7,16,43.8,13,25,52.0,11,20,31,16,23,10,10,0,76,0
5075,117631,150_07_28,NETHERLANDS,0,TOTALS,NETHERLANDS,200,32,72,44.4,28,56,50.0,4,16,25.0,14,24,58.3,22,32,54,12,26,21,6,3,82,1
5076,117644,150_07_29,ROMANIA,0,TOTALS,ROMANIA,200,23,66,34.8,14,42,33.3,9,24,37.5,7,16,43.8,14,22,36,9,25,23,7,3,62,0
5077,117657,150_07_29,GREAT BRITAIN,0,TOTALS,GREAT BRITAIN,200,27,64,42.2,18,41,43.9,9,23,39.1,16,30,53.3,18,28,46,9,19,18,14,4,79,1
5078,117670,150_07_30,SWITZERLAND,0,TOTALS,SWITZERLAND,200,26,57,45.6,20,36,55.6,6,21,28.6,11,18,61.1,12,33,45,15,22,22,10,2,69,1
5079,117683,150_07_30,ESTONIA,0,TOTALS,ESTONIA,200,20,65,30.8,13,35,37.1,7,30,23.3,10,18,55.6,13,17,30,11,21,19,10,1,57,0
5080,117696,150_07_31,BELARUS,0,TOTALS,BELARUS,200,18,57,31.6,13,39,33.3,5,18,27.8,6,16,37.5,15,14,29,13,17,20,9,7,47,0
5081,117709,150_07_31,SLOVAK REPUBLIC,0,TOTALS,SLOVAK REPUBLIC,200,28,52,53.8,18,36,50.0,10,16,62.5,13,24,54.2,9,25,34,14,22,19,13,6,79,1
5082,117722,150_07_32,MONTENEGRO,0,TOTALS,MONTENEGRO,200,32,59,54.2,22,37,59.5,10,22,45.5,18,25,72.0,6,18,24,18,31,16,7,3,92,1
5083,117735,150_07_32,SWEDEN,0,TOTALS,SWEDEN,200,20,54,37.0,18,40,45.0,2,14,14.3,27,42,64.3,14,18,32,7,26,20,5,3,69,0
5084,117748,150_07_33,ROMANIA,0,TOTALS,ROMANIA,200,19,68,27.9,16,50,32.0,3,18,16.7,4,11,36.4,14,32,46,10,19,22,14,5,45,0
5085,117761,150_07_33,IRELAND,0,TOTALS,IRELAND,200,23,65,35.4,19,50,38.0,4,15,26.7,10,16,62.5,11,33,44,11,13,17,11,1,60,1
5086,117774,150_07_34,BELGIUM,0,TOTALS,BELGIUM,200,35,65,53.8,30,48,62.5,5,17,29.4,19,29,65.5,7,20,27,18,23,19,13,3,94,1
5087,117787,150_07_34,SWITZERLAND,0,TOTALS,SWITZERLAND,200,34,73,46.6,25,50,50.0,9,23,39.1,9,14,64.3,15,22,37,18,22,19,7,2,86,0
5088,117800,150_07_35,BELARUS,0,TOTALS,BELARUS,200,28,68,41.2,23,47,48.9,5,21,23.8,7,15,46.7,16,24,40,13,24,17,10,7,68,0
5089,117813,150_07_35,SWEDEN,0,TOTALS,SWEDEN,200,25,59,42.4,20,43,46.5,5,16,31.2,17,25,68.0,13,25,38,15,20,15,9,6,72,1
5090,117826,150_07_36,PORTUGAL,0,TOTALS,PORTUGAL,200,25,55,45.5,20,42,47.6,5,13,38.5,8,15,53.3,2,31,33,12,16,16,7,5,63,0
5091,117839,150_07_36,CZECH REPUBLIC,0,TOTALS,CZECH REPUBLIC,200,26,73,35.6,17,40,42.5,9,33,27.3,4,6,66.7,12,30,42,14,20,14,6,2,65,1
5092,117852,150_07_37,UKRAINE,0,TOTALS,UKRAINE,200,31,60,51.7,23,37,62.2,8,23,34.8,9,16,56.2,6,26,32,20,25,24,15,4,79,1
5093,117865,150_07_37,GREAT BRITAIN,0,TOTALS,GREAT BRITAIN,200,26,70,37.1,18,44,40.9,8,26,30.8,13,30,43.3,19,23,42,11,19,24,5,1,73,0
5094,117878,150_07_38,SLOVAK REPUBLIC,0,TOTALS,SLOVAK REPUBLIC,200,24,56,42.9,19,38,50.0,5,18,27.8,14,19,73.7,9,24,33,10,26,20,10,1,67,0
5095,117891,150_07_38,FINLAND,0,TOTALS,FINLAND,200,24,56,42.9,17,34,50.0,7,22,31.8,14,23,60.9,10,23,33,11,24,17,7,0,69,1
5096,117904,150_07_39,MONTENEGRO,0,TOTALS,MONTENEGRO,200,27,70,38.6,15,40,37.5,12,30,40.0,14,20,70.0,11,20,31,17,21,10,11,1,80,1
5097,117917,150_07_39,ESTONIA,0,TOTALS,ESTONIA,200,24,54,44.4,13,22,59.1,11,32,34.4,12,17,70.6,4,29,33,13,21,22,5,2,71,0
5098,117930,150_07_40,GERMANY,0,TOTALS,GERMANY,200,30,58,51.7,18,32,56.2,12,26,46.2,13,19,68.4,8,18,26,11,25,15,10,0,85,1
5099,117943,150_07_40,POLAND,0,TOTALS,POLAND,200,27,60,45.0,25,46,54.3,2,14,14.3,12,24,50.0,16,16,32,14,23,18,8,2,68,0
5100,117956,150_07_41,AUSTRIA,0,TOTALS,AUSTRIA,200,37,67,55.2,30,51,58.8,7,16,43.8,12,26,46.2,12,32,44,25,15,16,9,2,93,1
5101,117969,150_07_41,BELARUS,0,TOTALS,BELARUS,200,30,70,42.9,22,39,56.4,8,31,25.8,9,14,64.3,7,23,30,15,21,13,12,3,77,0
5102,117982,150_07_42,SWEDEN,0,TOTALS,SWEDEN,200,31,65,47.7,21,40,52.5,10,25,40.0,10,15,66.7,14,19,33,15,22,13,10,1,82,1
5103,117995,150_07_42,PORTUGAL,0,TOTALS,PORTUGAL,200,27,56,48.2,21,40,52.5,6,16,37.5,16,20,80.0,8,18,26,7,16,16,6,3,76,0
5104,118008,150_07_43,NETHERLANDS,0,TOTALS,NETHERLANDS,200,29,69,42.0,28,58,48.3,1,11,9.1,17,29,58.6,16,23,39,12,32,17,7,4,76,1
5105,118021,150_07_43,ROMANIA,0,TOTALS,ROMANIA,200,20,60,33.3,18,41,43.9,2,19,10.5,23,38,60.5,20,21,41,9,27,22,8,3,65,0
5106,118034,150_07_44,IRELAND,0,TOTALS,IRELAND,200,28,68,41.2,20,39,51.3,8,29,27.6,18,38,47.4,19,20,39,14,19,17,14,2,82,1
5107,118047,150_07_44,BELGIUM,0,TOTALS,BELGIUM,200,29,65,44.6,24,44,54.5,5,21,23.8,12,18,66.7,12,28,40,8,28,26,11,3,75,0
5108,118060,150_07_45,FINLAND,0,TOTALS,FINLAND,200,27,74,36.5,20,52,38.5,7,22,31.8,6,9,66.7,11,13,24,16,25,18,11,0,67,0
5109,118073,150_07_45,UKRAINE,0,TOTALS,UKRAINE,200,33,59,55.9,23,36,63.9,10,23,43.5,17,27,63.0,13,33,46,16,18,21,8,13,93,1
5110,118086,150_07_46,GREAT BRITAIN,0,TOTALS,GREAT BRITAIN,200,26,61,42.6,23,47,48.9,3,14,21.4,14,31,45.2,16,21,37,6,21,14,7,1,69,0
5111,118099,150_07_46,SLOVAK REPUBLIC,0,TOTALS,SLOVAK REPUBLIC,200,28,57,49.1,20,38,52.6,8,19,42.1,20,23,87.0,5,23,28,16,28,14,10,3,84,1
5112,118112,150_07_47,POLAND,0,TOTALS,POLAND,200,26,69,37.7,23,49,46.9,3,20,15.0,6,13,46.2,14,13,27,9,27,17,17,1,61,0
5113,118125,150_07_47,MONTENEGRO,0,TOTALS,MONTENEGRO,200,25,43,58.1,19,27,70.4,6,16,37.5,16,26,61.5,7,26,33,17,22,23,13,1,72,1
5114,118138,150_07_48,ESTONIA,0,TOTALS,ESTONIA,200,22,56,39.3,17,32,53.1,5,24,20.8,13,19,68.4,5,21,26,10,19,17,5,1,62,0
5115,118151,150_07_48,GERMANY,0,TOTALS,GERMANY,200,33,59,55.9,18,34,52.9,15,25,60.0,10,14,71.4,2,22,24,22,23,16,9,7,91,1
5116,118164,150_07_49,ROMANIA,0,TOTALS,ROMANIA,200,26,60,43.3,17,37,45.9,9,23,39.1,13,20,65.0,13,17,30,16,22,21,7,5,74,0
5117,118177,150_07_49,SWITZERLAND,0,TOTALS,SWITZERLAND,200,31,60,51.7,29,55,52.7,2,5,40.0,17,21,81.0,12,20,32,13,19,17,15,4,81,1
5118,118190,150_07_50,BELARUS,0,TOTALS,BELARUS,200,27,56,48.2,21,38,55.3,6,18,33.3,8,14,57.1,3,20,23,18,23,20,15,2,68,0
5119,118203,150_07_50,CZECH REPUBLIC,0,TOTALS,CZECH REPUBLIC,200,25,55,45.5,16,36,44.4,9,19,47.4,16,23,69.6,12,26,38,12,17,27,14,2,75,1
5120,118216,150_07_51,BELGIUM,0,TOTALS,BELGIUM,200,30,63,47.6,24,46,52.2,6,17,35.3,11,21,52.4,7,26,33,17,28,20,18,3,77,1
5121,118229,150_07_51,NETHERLANDS,0,TOTALS,NETHERLANDS,200,23,60,38.3,22,46,47.8,1,14,7.1,13,30,43.3,13,27,40,11,20,24,15,2,60,0
5122,118242,150_07_52,PORTUGAL,0,TOTALS,PORTUGAL,200,23,62,37.1,15,37,40.5,8,25,32.0,13,22,59.1,6,22,28,6,13,12,6,4,67,0
5123,118255,150_07_52,AUSTRIA,0,TOTALS,AUSTRIA,200,37,78,47.4,30,51,58.8,7,27,25.9,10,11,90.9,16,32,48,23,19,13,4,0,91,1
5124,118268,150_07_53,ESTONIA,0,TOTALS,ESTONIA,200,23,64,35.9,18,44,40.9,5,20,25.0,8,16,50.0,8,31,39,18,12,16,17,2,59,1
5125,118281,150_07_53,SLOVAK REPUBLIC,0,TOTALS,SLOVAK REPUBLIC,200,19,65,29.2,13,34,38.2,6,31,19.4,3,3,100.0,11,30,41,8,18,25,7,3,47,0
5126,118294,150_07_54,GREAT BRITAIN,0,TOTALS,GREAT BRITAIN,200,19,67,28.4,17,47,36.2,2,20,10.0,24,40,60.0,15,25,40,6,14,21,10,3,64,0
5127,118307,150_07_54,POLAND,0,TOTALS,POLAND,200,27,65,41.5,23,47,48.9,4,18,22.2,13,17,76.5,13,31,44,14,30,24,10,7,71,1
5128,118320,150_07_55,MONTENEGRO,0,TOTALS,MONTENEGRO,200,29,59,49.2,20,33,60.6,9,26,34.6,16,19,84.2,10,31,41,20,13,18,9,3,83,1
5129,118333,150_07_55,FINLAND,0,TOTALS,FINLAND,200,21,72,29.2,16,40,40.0,5,32,15.6,6,7,85.7,16,16,32,7,19,15,6,0,53,0
5130,118346,150_07_56,UKRAINE,0,TOTALS,UKRAINE,200,26,59,44.1,17,31,54.8,9,28,32.1,19,31,61.3,13,27,40,11,22,17,11,6,80,1
5131,118359,150_07_56,GERMANY,0,TOTALS,GERMANY,200,20,58,34.5,15,36,41.7,5,22,22.7,11,21,52.4,9,24,33,8,27,19,9,1,56,0
5132,118372,150_07_57,BELARUS,0,TOTALS,BELARUS,200,27,63,42.9,21,48,43.8,6,15,40.0,14,23,60.9,9,19,28,17,23,19,13,4,74,0
5133,118385,150_07_57,ROMANIA,0,TOTALS,ROMANIA,200,34,64,53.1,28,48,58.3,6,16,37.5,19,27,70.4,13,24,37,20,21,23,11,5,93,1
5134,118398,150_07_58,PORTUGAL,0,TOTALS,PORTUGAL,200,33,70,47.1,27,45,60.0,6,25,24.0,18,32,56.2,15,24,39,17,12,9,12,3,90,1
5135,118411,150_07_58,SWITZERLAND,0,TOTALS,SWITZERLAND,200,36,76,47.4,32,61,52.5,4,15,26.7,5,9,55.6,17,25,42,14,26,17,6,2,81,0
5136,118424,150_07_59,SLOVAK REPUBLIC,0,TOTALS,SLOVAK REPUBLIC,200,30,65,46.2,24,41,58.5,6,24,25.0,9,18,50.0,18,15,33,12,19,25,17,2,75,1
5137,118437,150_07_59,GREAT BRITAIN,0,TOTALS,GREAT BRITAIN,200,25,53,47.2,19,39,48.7,6,14,42.9,12,18,66.7,9,16,25,15,18,27,9,1,68,0
5138,118450,150_07_60,CZECH REPUBLIC,0,TOTALS,CZECH REPUBLIC,200,23,56,41.1,14,31,45.2,9,25,36.0,18,24,75.0,12,30,42,14,27,25,5,4,73,1
5139,118463,150_07_60,NETHERLANDS,0,TOTALS,NETHERLANDS,200,19,61,31.1,17,46,37.0,2,15,13.3,20,34,58.8,13,20,33,10,25,14,13,3,60,0
5140,118476,150_07_61,AUSTRIA,0,TOTALS,AUSTRIA,200,26,71,36.6,20,49,40.8,6,22,27.3,8,16,50.0,16,29,45,14,11,19,11,3,66,0
5141,118489,150_07_61,IRELAND,0,TOTALS,IRELAND,200,29,71,40.8,23,50,46.0,6,21,28.6,3,6,50.0,13,30,43,14,22,16,12,4,67,1
5142,118502,150_07_62,ESTONIA,0,TOTALS,ESTONIA,200,15,58,25.9,11,32,34.4,4,26,15.4,24,45,53.3,9,22,31,9,22,22,21,4,58,0
5143,118515,150_07_62,POLAND,0,TOTALS,POLAND,200,27,72,37.5,23,52,44.2,4,20,20.0,16,21,76.2,22,36,58,16,34,32,12,2,74,1
5144,118528,150_07_63,SWEDEN,0,TOTALS,SWEDEN,200,33,61,54.1,27,39,69.2,6,22,27.3,12,28,42.9,14,22,36,16,22,20,9,3,84,1
5145,118541,150_07_63,BELGIUM,0,TOTALS,BELGIUM,200,32,63,50.8,28,48,58.3,4,15,26.7,14,19,73.7,7,14,21,19,25,17,10,0,82,0
5146,118554,150_07_64,FINLAND,0,TOTALS,FINLAND,200,26,62,41.9,12,36,33.3,14,26,53.8,10,17,58.8,5,24,29,19,21,12,7,0,76,1
5147,118567,150_07_64,GERMANY,0,TOTALS,GERMANY,200,27,62,43.5,21,41,51.2,6,21,28.6,13,20,65.0,7,28,35,16,22,19,3,0,73,0
5148,118580,150_07_65,MONTENEGRO,0,TOTALS,MONTENEGRO,200,37,75,49.3,28,49,57.1,9,26,34.6,6,10,60.0,15,17,32,17,21,10,16,0,89,1
5149,118593,150_07_65,UKRAINE,0,TOTALS,UKRAINE,200,26,56,46.4,15,31,48.4,11,25,44.0,5,15,33.3,17,20,37,8,11,22,6,5,68,0
5150,121022,153_07_01,ITALY,0,TOTALS,ITALY,200,28,74,37.8,23,62,37.1,5,12,41.7,13,20,65.0,22,23,45,4,22,13,6,3,74,0
5151,121035,153_07_01,LATVIA,0,TOTALS,LATVIA,200,29,60,48.3,25,43,58.1,4,17,23.5,14,22,63.6,9,25,34,9,18,11,9,3,76,1
5152,121048,153_07_02,BULGARIA,0,TOTALS,BULGARIA,200,30,64,46.9,23,42,54.8,7,22,31.8,11,20,55.0,10,37,47,10,15,14,7,3,78,0
5153,121061,153_07_02,TURKEY,0,TOTALS,TURKEY,200,32,77,41.6,25,53,47.2,7,24,29.2,10,16,62.5,14,31,45,15,18,15,9,2,81,1
5154,121074,153_07_03,ESTONIA,0,TOTALS,ESTONIA,200,16,67,23.9,12,43,27.9,4,24,16.7,0,2,0.0,10,21,31,6,18,13,9,1,36,0
5155,121087,153_07_03,FRANCE,0,TOTALS,FRANCE,200,24,57,42.1,18,27,66.7,6,30,20.0,10,16,62.5,14,40,54,13,13,22,9,2,64,1
5156,121100,153_07_04,ISRAEL,0,TOTALS,ISRAEL,200,24,61,39.3,19,44,43.2,5,17,29.4,17,27,63.0,14,29,43,6,27,19,11,2,70,0
5157,121113,153_07_04,GREECE,0,TOTALS,GREECE,200,27,65,41.5,20,40,50.0,7,25,28.0,14,29,48.3,13,30,43,6,23,14,11,8,75,1
5158,121126,153_07_05,RUSSIA,0,TOTALS,RUSSIA,200,19,63,30.2,10,33,30.3,9,30,30.0,9,16,56.2,13,30,43,8,26,20,7,2,56,0
5159,121139,153_07_05,SERBIA,0,TOTALS,SERBIA,200,24,52,46.2,21,36,58.3,3,16,18.8,18,30,60.0,6,32,38,9,22,15,12,2,69,1
5160,121152,153_07_06,CROATIA,0,TOTALS,CROATIA,200,25,73,34.2,22,49,44.9,3,24,12.5,9,12,75.0,18,21,39,12,26,15,9,2,62,0
5161,121165,153_07_06,SLOVENIA,0,TOTALS,SLOVENIA,200,25,57,43.9,23,45,51.1,2,12,16.7,20,29,69.0,14,30,44,4,19,17,10,2,72,1
5162,121178,153_07_07,ROMANIA,0,TOTALS,ROMANIA,200,16,54,29.6,12,40,30.0,4,14,28.6,10,17,58.8,11,28,39,3,26,33,8,1,46,0
5163,121191,153_07_07,SPAIN,0,TOTALS,SPAIN,200,36,77,46.8,28,58,48.3,8,19,42.1,15,28,53.6,22,31,53,15,18,16,23,2,95,1
5164,121204,153_07_08,GERMANY,0,TOTALS,GERMANY,200,20,57,35.1,19,48,39.6,1,9,11.1,16,26,61.5,13,21,34,3,16,22,8,5,57,0
5165,121217,153_07_08,LITHUANIA,0,TOTALS,LITHUANIA,200,33,65,50.8,20,36,55.6,13,29,44.8,6,11,54.5,15,28,43,19,30,22,11,3,85,1
5166,121230,153_07_09,LATVIA,0,TOTALS,LATVIA,200,24,65,36.9,13,27,48.1,11,38,28.9,21,28,75.0,17,34,51,4,22,12,7,0,80,1
5167,121243,153_07_09,ESTONIA,0,TOTALS,ESTONIA,200,24,67,35.8,21,50,42.0,3,17,17.6,13,20,65.0,13,24,37,9,22,10,6,4,64,0
5168,121256,153_07_10,TURKEY,0,TOTALS,TURKEY,200,34,57,59.6,23,37,62.2,11,20,55.0,13,19,68.4,4,25,29,15,24,18,9,3,92,1
5169,121269,153_07_10,ISRAEL,0,TOTALS,ISRAEL,200,30,66,45.5,24,49,49.0,6,17,35.3,14,26,53.8,16,20,36,11,22,17,5,3,80,0
5170,121282,153_07_11,FRANCE,0,TOTALS,FRANCE,200,28,63,44.4,24,47,51.1,4,16,25.0,15,27,55.6,14,32,46,12,21,13,12,1,75,1
5171,121295,153_07_11,ITALY,0,TOTALS,ITALY,200,25,65,38.5,14,41,34.1,11,24,45.8,7,15,46.7,9,26,35,5,25,15,8,3,68,0
5172,121308,153_07_12,GREECE,0,TOTALS,GREECE,200,35,66,53.0,28,49,57.1,7,17,41.2,17,25,68.0,13,40,53,15,14,27,15,2,94,1
5173,121321,153_07_12,BULGARIA,0,TOTALS,BULGARIA,200,23,75,30.7,14,39,35.9,9,36,25.0,9,14,64.3,13,21,34,6,22,22,16,2,64,0
5174,121334,153_07_13,SPAIN,0,TOTALS,SPAIN,200,31,70,44.3,26,50,52.0,5,20,25.0,31,42,73.8,23,26,49,12,15,12,12,3,98,1
5175,121347,153_07_13,RUSSIA,0,TOTALS,RUSSIA,200,24,57,42.1,16,31,51.6,8,26,30.8,8,16,50.0,9,21,30,11,34,21,4,3,64,0
5176,121360,153_07_14,SLOVENIA,0,TOTALS,SLOVENIA,200,18,61,29.5,14,37,37.8,4,24,16.7,13,17,76.5,10,17,27,5,22,19,13,2,53,0
5177,121373,153_07_14,GERMANY,0,TOTALS,GERMANY,200,27,56,48.2,22,44,50.0,5,12,41.7,20,24,83.3,13,35,48,7,19,23,11,5,79,1
5178,121386,153_07_15,SERBIA,0,TOTALS,SERBIA,200,52,81,64.2,39,55,70.9,13,26,50.0,28,47,59.6,21,27,48,26,21,18,31,5,145,0
5179,121399,153_07_15,ROMANIA,0,TOTALS,ROMANIA,200,13,44,29.5,11,35,31.4,2,9,22.2,9,13,69.2,6,18,24,4,31,51,9,2,37,1
5180,121412,153_07_16,LITHUANIA,0,TOTALS,LITHUANIA,200,33,72,45.8,29,59,49.2,4,13,30.8,16,25,64.0,16,27,43,14,24,14,10,4,86,1
5181,121425,153_07_16,CROATIA,0,TOTALS,CROATIA,200,28,70,40.0,25,53,47.2,3,17,17.6,9,21,42.9,18,27,45,7,28,22,10,3,68,0
5182,121438,153_07_17,ITALY,0,TOTALS,ITALY,200,21,59,35.6,17,38,44.7,4,21,19.0,14,20,70.0,12,23,35,8,21,17,10,3,60,0
5183,121451,153_07_17,ESTONIA,0,TOTALS,ESTONIA,200,28,63,44.4,21,46,45.7,7,17,41.2,9,18,50.0,14,29,43,14,22,20,10,1,72,1
5184,121464,153_07_18,ISRAEL,0,TOTALS,ISRAEL,200,30,60,50.0,28,52,53.8,2,8,25.0,12,20,60.0,13,36,49,12,23,24,9,3,74,1
5185,121477,153_07_18,BULGARIA,0,TOTALS,BULGARIA,200,23,66,34.8,14,33,42.4,9,33,27.3,8,19,42.1,14,21,35,7,22,17,11,4,63,0
5186,121490,153_07_19,FRANCE,0,TOTALS,FRANCE,200,22,54,40.7,17,37,45.9,5,17,29.4,18,30,60.0,15,29,44,8,17,23,5,2,67,0
5187,121503,153_07_19,LATVIA,0,TOTALS,LATVIA,200,29,69,42.0,23,43,53.5,6,26,23.1,8,13,61.5,12,25,37,7,23,15,14,3,72,1
5188,121516,153_07_20,LITHUANIA,0,TOTALS,LITHUANIA,200,26,58,44.8,20,36,55.6,6,22,27.3,12,17,70.6,15,30,45,14,18,22,8,6,70,1
5189,121529,153_07_20,SLOVENIA,0,TOTALS,SLOVENIA,200,22,60,36.7,15,42,35.7,7,18,38.9,8,13,61.5,10,18,28,7,21,16,9,2,59,0
5190,121542,153_07_21,RUSSIA,0,TOTALS,RUSSIA,200,24,65,36.9,18,33,54.5,6,32,18.8,9,10,90.0,17,41,58,12,13,12,5,6,63,1
5191,121555,153_07_21,ROMANIA,0,TOTALS,ROMANIA,200,15,70,21.4,12,56,21.4,3,14,21.4,7,14,50.0,18,25,43,5,16,9,7,0,40,0
5192,121568,153_07_22,CROATIA,0,TOTALS,CROATIA,200,29,64,45.3,17,37,45.9,12,27,44.4,18,20,90.0,14,27,41,12,26,16,10,3,88,1
5193,121581,153_07_22,GERMANY,0,TOTALS,GERMANY,200,24,66,36.4,20,54,37.0,4,12,33.3,21,23,91.3,15,22,37,4,22,15,8,2,73,0
5194,121594,153_07_23,TURKEY,0,TOTALS,TURKEY,200,28,78,35.9,21,46,45.7,7,32,21.9,4,10,40.0,18,19,37,9,23,14,7,1,67,0
5195,121607,153_07_23,GREECE,0,TOTALS,GREECE,200,32,63,50.8,29,43,67.4,3,20,15.0,15,23,65.2,16,34,50,9,17,17,9,3,82,1
5196,121620,153_07_24,SPAIN,0,TOTALS,SPAIN,200,30,69,43.5,27,52,51.9,3,17,17.6,13,24,54.2,11,27,38,7,30,9,6,2,76,0
5197,121633,153_07_24,SERBIA,0,TOTALS,SERBIA,200,27,61,44.3,17,34,50.0,10,27,37.0,21,32,65.6,11,35,46,11,28,10,5,1,85,1
5198,121646,153_07_25,ISRAEL,0,TOTALS,ISRAEL,200,31,70,44.3,28,63,44.4,3,7,42.9,13,15,86.7,10,23,33,12,30,16,11,2,78,0
5199,121659,153_07_25,LATVIA,0,TOTALS,LATVIA,200,28,61,45.9,19,41,46.3,9,20,45.0,26,33,78.8,12,28,40,12,15,18,10,4,91,1
5200,121672,153_07_26,BULGARIA,0,TOTALS,BULGARIA,200,28,70,40.0,22,45,48.9,6,25,24.0,17,26,65.4,20,28,48,10,14,20,15,6,79,1
5201,121685,153_07_26,ROMANIA,0,TOTALS,ROMANIA,200,27,75,36.0,23,52,44.2,4,23,17.4,3,3,100.0,20,24,44,5,20,24,15,2,61,0
5202,121698,153_07_27,CROATIA,0,TOTALS,CROATIA,200,29,64,45.3,24,47,51.1,5,17,29.4,18,21,85.7,13,22,35,4,24,15,6,1,81,0
5203,121711,153_07_27,SERBIA,0,TOTALS,SERBIA,200,29,66,43.9,20,37,54.1,9,29,31.0,17,24,70.8,17,22,39,11,25,14,8,1,84,1
5204,121724,153_07_28,ITALY,0,TOTALS,ITALY,200,26,58,44.8,21,44,47.7,5,14,35.7,6,8,75.0,9,25,34,6,17,17,12,3,63,1
5205,121737,153_07_28,SLOVENIA,0,TOTALS,SLOVENIA,200,21,53,39.6,17,40,42.5,4,13,30.8,7,11,63.6,10,25,35,6,16,19,11,1,53,0
5206,121750,153_07_29,TURKEY,0,TOTALS,TURKEY,200,27,67,40.3,22,45,48.9,5,22,22.7,9,17,52.9,8,22,30,7,19,12,9,5,68,0
5207,121763,153_07_29,FRANCE,0,TOTALS,FRANCE,200,31,63,49.2,27,45,60.0,4,18,22.2,16,18,88.9,10,34,44,7,18,20,8,2,82,1
5208,121776,153_07_30,GERMANY,0,TOTALS,GERMANY,200,23,65,35.4,18,48,37.5,5,17,29.4,5,11,45.5,10,29,39,10,20,19,10,4,56,0
5209,121789,153_07_30,SPAIN,0,TOTALS,SPAIN,200,29,64,45.3,18,42,42.9,11,22,50.0,13,26,50.0,12,32,44,18,13,15,12,3,82,1
5210,121802,153_07_31,GREECE,0,TOTALS,GREECE,200,35,68,51.5,27,46,58.7,8,22,36.4,9,16,56.2,7,32,39,21,11,14,12,5,87,1
5211,121815,153_07_31,ESTONIA,0,TOTALS,ESTONIA,200,26,67,38.8,22,47,46.8,4,20,20.0,3,4,75.0,10,28,38,12,18,21,5,1,59,0
5212,121828,153_07_32,LITHUANIA,0,TOTALS,LITHUANIA,200,29,72,40.3,24,56,42.9,5,16,31.2,16,29,55.2,17,33,50,7,17,7,9,5,79,1
5213,121841,153_07_32,RUSSIA,0,TOTALS,RUSSIA,200,25,68,36.8,18,42,42.9,7,26,26.9,8,13,61.5,11,33,44,5,26,15,3,1,65,0
5214,121854,153_07_33,ESTONIA,0,TOTALS,ESTONIA,200,25,57,43.9,13,30,43.3,12,27,44.4,7,13,53.8,8,19,27,18,22,16,7,3,69,0
5215,121867,153_07_33,ISRAEL,0,TOTALS,ISRAEL,200,22,49,44.9,16,31,51.6,6,18,33.3,20,24,83.3,9,24,33,8,20,19,10,1,70,1
5216,121880,153_07_34,LATVIA,0,TOTALS,LATVIA,200,21,67,31.3,14,40,35.0,7,27,25.9,24,35,68.6,16,25,41,5,25,15,13,2,73,1
5217,121893,153_07_34,TURKEY,0,TOTALS,TURKEY,200,26,65,40.0,26,53,49.1,0,12,0.0,16,29,55.2,22,31,53,2,26,27,9,3,68,0
5218,121906,153_07_35,RUSSIA,0,TOTALS,RUSSIA,200,24,62,38.7,15,34,44.1,9,28,32.1,14,19,73.7,10,29,39,5,25,15,6,8,71,1
5219,121919,153_07_35,CROATIA,0,TOTALS,CROATIA,200,22,62,35.5,16,43,37.2,6,19,31.6,13,24,54.2,14,30,44,4,22,15,6,1,63,0
5220,121932,153_07_36,SPAIN,0,TOTALS,SPAIN,200,29,61,47.5,24,46,52.2,5,15,33.3,24,30,80.0,12,27,39,10,33,18,4,10,87,1
5221,121945,153_07_36,LITHUANIA,0,TOTALS,LITHUANIA,200,22,66,33.3,14,44,31.8,8,22,36.4,30,37,81.1,17,23,40,11,26,15,10,3,82,0
5222,121958,153_07_37,FRANCE,0,TOTALS,FRANCE,200,31,63,49.2,24,47,51.1,7,16,43.8,12,15,80.0,9,35,44,8,22,15,6,0,81,0
5223,121971,153_07_37,GREECE,0,TOTALS,GREECE,200,27,64,42.2,17,27,63.0,10,37,27.0,18,24,75.0,4,24,28,10,20,7,8,9,82,1
5224,121984,153_07_38,SERBIA,0,TOTALS,SERBIA,200,40,68,58.8,25,38,65.8,15,30,50.0,12,17,70.6,14,26,40,14,26,11,13,5,107,0
5225,121997,153_07_38,GERMANY,0,TOTALS,GERMANY,200,15,47,31.9,10,32,31.2,5,15,33.3,24,29,82.8,9,15,24,1,15,19,4,3,59,1
5226,122010,153_07_39,TURKEY,0,TOTALS,TURKEY,200,30,66,45.5,21,44,47.7,9,22,40.9,15,27,55.6,19,33,52,13,16,17,10,2,84,1
5227,122023,153_07_39,ESTONIA,0,TOTALS,ESTONIA,200,25,68,36.8,21,52,40.4,4,16,25.0,4,9,44.4,13,23,36,8,25,16,12,3,58,0
5228,122036,153_07_40,ROMANIA,0,TOTALS,ROMANIA,200,13,49,26.5,12,39,30.8,1,10,10.0,15,29,51.7,10,19,29,0,22,22,4,1,42,1
5229,122049,153_07_40,ITALY,0,TOTALS,ITALY,200,48,74,64.9,41,59,69.5,7,15,46.7,18,24,75.0,11,34,45,22,20,6,11,4,121,0
5230,122062,153_07_41,GERMANY,0,TOTALS,GERMANY,200,29,63,46.0,26,50,52.0,3,13,23.1,22,35,62.9,13,34,47,7,17,14,7,2,83,1
5231,122075,153_07_41,RUSSIA,0,TOTALS,RUSSIA,200,28,70,40.0,17,31,54.8,11,39,28.2,10,14,71.4,10,27,37,14,25,14,10,4,77,0
5232,122088,153_07_42,SLOVENIA,0,TOTALS,SLOVENIA,200,21,66,31.8,16,43,37.2,5,23,21.7,4,5,80.0,15,24,39,5,24,15,8,2,51,0
5233,122101,153_07_42,BULGARIA,0,TOTALS,BULGARIA,200,23,55,41.8,18,37,48.6,5,18,27.8,18,24,75.0,11,31,42,8,14,16,9,2,69,1
5234,122114,153_07_43,ISRAEL,0,TOTALS,ISRAEL,200,19,57,33.3,17,44,38.6,2,13,15.4,13,19,68.4,10,19,29,3,35,18,7,1,53,0
5235,122127,153_07_43,FRANCE,0,TOTALS,FRANCE,200,29,65,44.6,19,36,52.8,10,29,34.5,22,38,57.9,22,31,53,15,17,17,9,2,90,1
5236,122140,153_07_44,CROATIA,0,TOTALS,CROATIA,200,27,63,42.9,20,42,47.6,7,21,33.3,17,22,77.3,14,30,44,8,22,23,9,3,78,0
5237,122153,153_07_44,SPAIN,0,TOTALS,SPAIN,200,33,70,47.1,28,51,54.9,5,19,26.3,18,24,75.0,10,25,35,14,23,13,16,2,89,1
5238,122166,153_07_45,GREECE,0,TOTALS,GREECE,200,31,72,43.1,26,55,47.3,5,17,29.4,16,25,64.0,16,33,49,8,17,11,5,4,83,1
5239,122179,153_07_45,LATVIA,0,TOTALS,LATVIA,200,26,75,34.7,16,37,43.2,10,38,26.3,11,17,64.7,18,27,45,2,22,10,5,2,73,0
5240,122192,153_07_46,LITHUANIA,0,TOTALS,LITHUANIA,200,28,56,50.0,25,50,50.0,3,6,50.0,16,26,61.5,8,30,38,13,19,16,6,6,75,1
5241,122205,153_07_46,SERBIA,0,TOTALS,SERBIA,200,28,69,40.6,19,40,47.5,9,29,31.0,6,14,42.9,12,24,36,7,30,12,6,1,71,0
5242,122218,153_07_47,ITALY,0,TOTALS,ITALY,200,34,66,51.5,20,41,48.8,14,25,56.0,11,16,68.8,11,25,36,13,16,19,11,4,93,1
5243,122231,153_07_47,BULGARIA,0,TOTALS,BULGARIA,200,28,69,40.6,22,45,48.9,6,24,25.0,14,19,73.7,18,24,42,13,17,18,10,3,76,0
5244,122244,153_07_48,ROMANIA,0,TOTALS,ROMANIA,200,25,55,45.5,21,43,48.8,4,12,33.3,4,8,50.0,12,21,33,8,14,23,5,1,58,0
5245,122257,153_07_48,SLOVENIA,0,TOTALS,SLOVENIA,200,32,65,49.2,30,56,53.6,2,9,22.2,11,17,64.7,12,20,32,14,16,10,12,2,77,1
5246,122270,153_07_49,FRANCE,0,TOTALS,FRANCE,200,27,61,44.3,22,45,48.9,5,16,31.2,16,21,76.2,10,30,40,11,15,14,14,2,75,1
5247,122283,153_07_49,CROATIA,0,TOTALS,CROATIA,200,21,68,30.9,16,43,37.2,5,25,20.0,12,15,80.0,19,25,44,10,23,19,10,3,59,0
5248,122296,153_07_50,SPAIN,0,TOTALS,SPAIN,200,33,69,47.8,27,49,55.1,6,20,30.0,12,18,66.7,13,20,33,14,20,15,18,2,84,1
5249,122309,153_07_50,TURKEY,0,TOTALS,TURKEY,200,24,57,42.1,20,36,55.6,4,21,19.0,12,23,52.2,17,25,42,1,20,27,11,3,64,0
5250,122322,153_07_51,RUSSIA,0,TOTALS,RUSSIA,200,34,63,54.0,17,31,54.8,17,32,53.1,9,11,81.8,13,33,46,13,20,18,9,6,94,1
5251,122335,153_07_51,ESTONIA,0,TOTALS,ESTONIA,200,17,54,31.5,13,36,36.1,4,18,22.2,17,26,65.4,9,17,26,8,18,16,13,1,55,0
5252,122348,153_07_52,SERBIA,0,TOTALS,SERBIA,200,29,66,43.9,23,48,47.9,6,18,33.3,18,27,66.7,11,31,42,11,21,8,12,1,82,1
5253,122361,153_07_52,LATVIA,0,TOTALS,LATVIA,200,26,61,42.6,19,38,50.0,7,23,30.4,12,22,54.5,8,27,35,4,24,15,4,6,71,0
5254,122374,153_07_53,ISRAEL,0,TOTALS,ISRAEL,200,23,62,37.1,19,51,37.3,4,11,36.4,11,19,57.9,8,19,27,5,22,21,10,2,61,0
5255,122387,153_07_53,GERMANY,0,TOTALS,GERMANY,200,38,69,55.1,34,53,64.2,4,16,25.0,13,15,86.7,13,31,44,13,17,23,11,7,93,1
5256,122400,153_07_54,GREECE,0,TOTALS,GREECE,200,33,74,44.6,32,59,54.2,1,15,6.7,19,29,65.5,11,34,45,15,15,9,14,7,86,1
5257,122413,153_07_54,LITHUANIA,0,TOTALS,LITHUANIA,200,30,76,39.5,20,45,44.4,10,31,32.3,8,15,53.3,15,34,49,12,26,18,8,3,78,0
5258,122426,153_07_55,ISRAEL,0,TOTALS,ISRAEL,200,23,55,41.8,18,45,40.0,5,10,50.0,17,30,56.7,14,27,41,8,23,14,5,2,68,1
5259,122439,153_07_55,ESTONIA,0,TOTALS,ESTONIA,200,19,59,32.2,13,35,37.1,6,24,25.0,15,22,68.2,15,24,39,8,28,14,7,1,59,0
5260,122452,153_07_56,GERMANY,0,TOTALS,GERMANY,200,28,60,46.7,27,53,50.9,1,7,14.3,13,14,92.9,12,32,44,10,8,19,8,4,70,1
5261,122465,153_07_56,RUSSIA,0,TOTALS,RUSSIA,200,23,76,30.3,16,37,43.2,7,39,17.9,0,0,0.0,18,21,39,6,14,15,4,2,53,0
5262,122478,153_07_57,CROATIA,0,TOTALS,CROATIA,200,32,60,53.3,26,41,63.4,6,19,31.6,20,29,69.0,7,20,27,11,21,10,8,4,90,1
5263,122491,153_07_57,TURKEY,0,TOTALS,TURKEY,200,33,63,52.4,26,49,53.1,7,14,50.0,8,14,57.1,10,23,33,8,25,17,6,0,81,0
5264,122504,153_07_58,FRANCE,0,TOTALS,FRANCE,200,28,62,45.2,19,42,45.2,9,20,45.0,20,31,64.5,14,27,41,7,24,15,4,2,85,0
5265,122517,153_07_58,SPAIN,0,TOTALS,SPAIN,200,29,59,49.2,16,32,50.0,13,27,48.1,21,30,70.0,7,25,32,15,24,10,5,2,92,1
5266,122530,153_07_59,LITHUANIA,0,TOTALS,LITHUANIA,200,31,77,40.3,28,54,51.9,3,23,13.0,7,13,53.8,24,29,53,11,18,11,6,7,72,0
5267,122543,153_07_59,LATVIA,0,TOTALS,LATVIA,200,27,66,40.9,20,47,42.6,7,19,36.8,13,17,76.5,12,26,38,7,18,9,4,1,74,1
5268,122556,153_07_60,GREECE,0,TOTALS,GREECE,200,32,61,52.5,26,44,59.1,6,17,35.3,19,27,70.4,9,23,32,5,24,18,4,2,89,0
5269,122569,153_07_60,SERBIA,0,TOTALS,SERBIA,200,32,70,45.7,24,40,60.0,8,30,26.7,20,30,66.7,17,23,40,10,28,12,8,1,92,1
5270,122582,154_07_01,AUSTRIA,0,TOTALS,AUSTRIA,200,27,71,38.0,23,53,43.4,4,18,22.2,16,25,64.0,17,35,52,8,29,26,11,9,74,1
5271,122595,154_07_01,DENMARK,0,TOTALS,DENMARK,200,24,71,33.8,20,53,37.7,4,18,22.2,19,32,59.4,18,31,49,9,25,20,19,3,71,0
5272,122608,154_07_02,LUXEMBOURG,0,TOTALS,LUXEMBOURG,200,21,55,38.2,18,40,45.0,3,15,20.0,15,24,62.5,8,30,38,14,18,18,15,3,60,1
5273,122621,154_07_02,SWITZERLAND,0,TOTALS,SWITZERLAND,200,13,55,23.6,9,32,28.1,4,23,17.4,8,13,61.5,13,28,41,4,20,25,7,1,38,0
5274,122634,154_07_03,NETHERLANDS,0,TOTALS,NETHERLANDS,200,43,94,45.7,39,80,48.8,4,14,28.6,13,22,59.1,33,39,72,19,15,12,16,2,103,0
5275,122646,154_07_03,ARMENIA,0,TOTALS,ARMENIA,200,18,63,28.6,14,45,31.1,4,18,22.2,0,8,0.0,10,24,34,3,16,24,5,5,40,1
5276,122659,154_07_04,NORWAY,0,TOTALS,NORWAY,200,28,74,37.8,20,52,38.5,8,22,36.4,10,23,43.5,20,21,41,12,32,23,12,1,74,0
5277,122672,154_07_04,MONTENEGRO,0,TOTALS,MONTENEGRO,200,25,52,48.1,20,30,66.7,5,22,22.7,26,38,68.4,12,33,45,15,23,25,12,3,81,1
5278,122685,154_07_05,CZECH REPUBLIC,0,TOTALS,CZECH REPUBLIC,200,19,53,35.8,14,36,38.9,5,17,29.4,11,20,55.0,9,25,34,3,22,24,4,2,54,0
5279,122698,154_07_05,BELGIUM,0,TOTALS,BELGIUM,200,26,59,44.1,19,34,55.9,7,25,28.0,16,21,76.2,8,29,37,10,20,17,13,2,75,1
5280,122711,154_07_06,IRELAND,0,TOTALS,IRELAND,200,21,63,33.3,15,35,42.9,6,28,21.4,16,24,66.7,10,27,37,11,28,18,8,0,64,0
5281,122724,154_07_06,UKRAINE,0,TOTALS,UKRAINE,200,26,68,38.2,19,47,40.4,7,21,33.3,14,27,51.9,20,35,55,9,24,20,6,2,73,1
5282,122737,154_07_07,FINLAND,0,TOTALS,FINLAND,200,25,66,37.9,14,42,33.3,11,24,45.8,20,35,57.1,15,24,39,4,22,17,14,2,81,1
5283,122750,154_07_07,POLAND,0,TOTALS,POLAND,200,27,56,48.2,19,36,52.8,8,20,40.0,14,22,63.6,10,31,41,9,32,26,9,0,76,0
5284,122763,154_07_08,HUNGARY,0,TOTALS,HUNGARY,200,19,67,28.4,10,43,23.3,9,24,37.5,14,20,70.0,13,37,50,9,21,15,7,7,61,1
5285,122776,154_07_08,PORTUGAL,0,TOTALS,PORTUGAL,200,17,62,27.4,12,40,30.0,5,22,22.7,10,20,50.0,12,36,48,4,16,16,5,6,49,0
5286,122789,154_07_09,SLOVAK REPUBLIC,0,TOTALS,SLOVAK REPUBLIC,200,24,64,37.5,19,41,46.3,5,23,21.7,12,18,66.7,10,20,30,8,28,12,14,1,65,0
5287,122802,154_07_09,CZECH REPUBLIC,0,TOTALS,CZECH REPUBLIC,200,31,60,51.7,30,54,55.6,1,6,16.7,17,28,60.7,14,32,46,13,22,17,7,2,80,1
5288,122815,154_07_10,BOSNIA AND HERZEGOVINA,0,TOTALS,BOSNIA AND HERZEGOVINA,200,37,65,56.9,35,52,67.3,2,13,15.4,14,29,48.3,15,37,52,14,18,28,15,2,90,1
5289,122828,154_07_10,IRELAND,0,TOTALS,IRELAND,200,23,72,31.9,15,39,38.5,8,33,24.2,7,16,43.8,16,23,39,12,27,24,12,2,61,0
5290,122841,154_07_11,SWEDEN,0,TOTALS,SWEDEN,200,33,62,53.2,29,49,59.2,4,13,30.8,9,17,52.9,9,31,40,15,18,18,14,1,79,1
5291,122854,154_07_11,FINLAND,0,TOTALS,FINLAND,200,21,63,33.3,11,41,26.8,10,22,45.5,11,14,78.6,13,25,38,8,15,20,11,3,63,0
5292,122867,154_07_12,ENGLAND,0,TOTALS,ENGLAND,200,15,57,26.3,12,44,27.3,3,13,23.1,13,28,46.4,15,23,38,9,25,14,10,2,46,0
5293,122880,154_07_12,HUNGARY,0,TOTALS,HUNGARY,200,18,49,36.7,10,23,43.5,8,26,30.8,19,29,65.5,10,33,43,8,19,17,4,7,63,1
5294,122893,154_07_13,BELGIUM,0,TOTALS,BELGIUM,200,29,71,40.8,25,45,55.6,4,26,15.4,13,24,54.2,17,27,44,11,18,12,15,3,75,1
5295,122906,154_07_13,AUSTRIA,0,TOTALS,AUSTRIA,200,20,61,32.8,12,36,33.3,8,25,32.0,16,22,72.7,16,30,46,4,30,23,5,3,64,0
5296,122919,154_07_14,UKRAINE,0,TOTALS,UKRAINE,200,29,59,49.2,20,37,54.1,9,22,40.9,18,33,54.5,16,31,47,14,23,18,4,4,85,1
5297,122932,154_07_14,LUXEMBOURG,0,TOTALS,LUXEMBOURG,200,24,65,36.9,19,45,42.2,5,20,25.0,17,22,77.3,11,20,31,11,28,11,8,0,70,0
5298,122945,154_07_15,POLAND,0,TOTALS,POLAND,200,28,67,41.8,19,41,46.3,9,26,34.6,6,9,66.7,15,29,44,3,20,18,11,8,71,1
5299,122958,154_07_15,NETHERLANDS,0,TOTALS,NETHERLANDS,200,18,68,26.5,16,57,28.1,2,11,18.2,13,24,54.2,25,26,51,1,16,19,16,2,51,0
5300,122971,154_07_16,PORTUGAL,0,TOTALS,PORTUGAL,200,32,64,50.0,21,43,48.8,11,21,52.4,19,27,70.4,9,35,44,15,21,13,10,2,94,1
5301,122984,154_07_16,NORWAY,0,TOTALS,NORWAY,200,24,65,36.9,16,37,43.2,8,28,28.6,22,26,84.6,8,27,35,8,20,12,6,1,78,0
5302,122997,154_07_17,DENMARK,0,TOTALS,DENMARK,200,19,62,30.6,13,39,33.3,6,23,26.1,13,19,68.4,12,24,36,6,21,14,9,2,57,0
5303,123010,154_07_17,BELGIUM,0,TOTALS,BELGIUM,200,26,58,44.8,22,43,51.2,4,15,26.7,18,26,69.2,14,33,47,12,16,19,12,2,74,1
5304,123023,154_07_18,SWITZERLAND,0,TOTALS,SWITZERLAND,200,13,44,29.5,12,34,35.3,1,10,10.0,14,20,70.0,6,25,31,3,26,23,10,1,41,0
5305,123036,154_07_18,UKRAINE,0,TOTALS,UKRAINE,200,20,57,35.1,11,31,35.5,9,26,34.6,16,31,51.6,18,27,45,7,22,19,12,0,65,1
5306,123048,154_07_19,ARMENIA,0,TOTALS,ARMENIA,200,12,50,24.0,11,36,30.6,1,14,7.1,8,10,80.0,10,15,25,6,17,50,4,0,33,1
5307,123061,154_07_19,POLAND,0,TOTALS,POLAND,200,63,87,72.4,59,72,81.9,4,15,26.7,11,22,50.0,14,28,42,27,17,13,35,3,141,0
5308,123074,154_07_20,MONTENEGRO,0,TOTALS,MONTENEGRO,200,35,63,55.6,30,47,63.8,5,16,31.2,20,32,62.5,15,39,54,22,21,17,11,2,95,1
5309,123087,154_07_20,PORTUGAL,0,TOTALS,PORTUGAL,200,23,80,28.7,19,61,31.1,4,19,21.1,12,19,63.2,22,18,40,7,24,15,10,6,62,0
5310,123100,154_07_21,AUSTRIA,0,TOTALS,AUSTRIA,200,23,55,41.8,18,42,42.9,5,13,38.5,21,27,77.8,10,21,31,10,23,16,9,0,72,0
5311,123113,154_07_21,SLOVAK REPUBLIC,0,TOTALS,SLOVAK REPUBLIC,200,27,56,48.2,20,37,54.1,7,19,36.8,19,31,61.3,14,25,39,5,22,19,10,4,80,1
5312,123126,154_07_22,LUXEMBOURG,0,TOTALS,LUXEMBOURG,200,28,65,43.1,20,39,51.3,8,26,30.8,14,19,73.7,10,17,27,9,23,15,14,2,78,0
5313,123139,154_07_22,BOSNIA AND HERZEGOVINA,0,TOTALS,BOSNIA AND HERZEGOVINA,200,36,72,50.0,27,51,52.9,9,21,42.9,14,27,51.9,24,30,54,18,23,19,13,2,95,1
5314,123152,154_07_23,NETHERLANDS,0,TOTALS,NETHERLANDS,200,20,66,30.3,16,47,34.0,4,19,21.1,2,9,22.2,17,25,42,6,23,20,10,1,46,0
5315,123165,154_07_23,SWEDEN,0,TOTALS,SWEDEN,200,22,59,37.3,14,31,45.2,8,28,28.6,10,20,50.0,16,31,47,16,15,22,7,3,62,1
5316,123178,154_07_24,NORWAY,0,TOTALS,NORWAY,200,28,66,42.4,15,36,41.7,13,30,43.3,14,18,77.8,18,25,43,4,19,16,9,3,83,1
5317,123191,154_07_24,ENGLAND,0,TOTALS,ENGLAND,200,23,62,37.1,17,45,37.8,6,17,35.3,7,16,43.8,17,22,39,7,17,23,11,0,59,0
5318,123204,154_07_25,CZECH REPUBLIC,0,TOTALS,CZECH REPUBLIC,200,23,55,41.8,17,38,44.7,6,17,35.3,19,39,48.7,17,30,47,12,25,27,8,7,71,0
5319,123217,154_07_25,AUSTRIA,0,TOTALS,AUSTRIA,200,31,73,42.5,30,64,46.9,1,9,11.1,18,25,72.0,13,25,38,11,34,12,15,4,81,1
5320,123230,154_07_26,IRELAND,0,TOTALS,IRELAND,200,26,65,40.0,17,43,39.5,9,22,40.9,14,23,60.9,19,37,56,12,21,28,7,2,75,1
5321,123243,154_07_26,LUXEMBOURG,0,TOTALS,LUXEMBOURG,200,28,79,35.4,21,51,41.2,7,28,25.0,9,23,39.1,17,24,41,9,21,14,21,4,72,0
5322,123256,154_07_27,FINLAND,0,TOTALS,FINLAND,200,33,62,53.2,21,37,56.8,12,25,48.0,8,13,61.5,8,26,34,16,27,17,8,2,86,1
5323,123269,154_07_27,NETHERLANDS,0,TOTALS,NETHERLANDS,200,20,63,31.7,19,50,38.0,1,13,7.7,24,35,68.6,23,23,46,6,19,20,8,3,65,0
5324,123282,154_07_28,HUNGARY,0,TOTALS,HUNGARY,200,26,51,51.0,18,33,54.5,8,18,44.4,19,30,63.3,10,30,40,14,18,21,13,4,79,1
5325,123295,154_07_28,NORWAY,0,TOTALS,NORWAY,200,15,59,25.4,7,28,25.0,8,31,25.8,9,14,64.3,14,19,33,6,28,19,12,0,47,0
5326,123308,154_07_29,SLOVAK REPUBLIC,0,TOTALS,SLOVAK REPUBLIC,200,31,62,50.0,26,48,54.2,5,14,35.7,20,31,64.5,13,30,43,12,25,20,9,6,87,1
5327,123321,154_07_29,DENMARK,0,TOTALS,DENMARK,200,28,70,40.0,21,49,42.9,7,21,33.3,20,30,66.7,14,23,37,20,26,14,11,3,83,0
5328,123334,154_07_30,BOSNIA AND HERZEGOVINA,0,TOTALS,BOSNIA AND HERZEGOVINA,200,26,59,44.1,22,46,47.8,4,13,30.8,27,31,87.1,18,24,42,14,17,13,13,2,83,1
5329,123347,154_07_30,SWITZERLAND,0,TOTALS,SWITZERLAND,200,20,60,33.3,15,44,34.1,5,16,31.2,4,9,44.4,18,17,35,4,25,21,9,2,49,0
5330,123360,154_07_31,SWEDEN,0,TOTALS,SWEDEN,200,36,63,57.1,28,48,58.3,8,15,53.3,10,12,83.3,10,35,45,21,5,14,12,2,90,1
5331,123372,154_07_31,ARMENIA,0,TOTALS,ARMENIA,200,13,56,23.2,11,43,25.6,2,13,15.4,4,8,50.0,9,17,26,5,9,22,7,1,32,0
5332,123385,154_07_32,ENGLAND,0,TOTALS,ENGLAND,200,22,57,38.6,18,45,40.0,4,12,33.3,12,32,37.5,10,26,36,7,29,18,9,2,60,0
5333,123398,154_07_32,MONTENEGRO,0,TOTALS,MONTENEGRO,200,25,64,39.1,20,45,44.4,5,19,26.3,17,32,53.1,18,34,52,16,24,19,14,3,72,1
5334,123411,154_07_33,BELGIUM,0,TOTALS,BELGIUM,200,27,62,43.5,22,45,48.9,5,17,29.4,15,26,57.7,17,27,44,12,18,12,12,3,74,1
5335,123424,154_07_33,SLOVAK REPUBLIC,0,TOTALS,SLOVAK REPUBLIC,200,21,65,32.3,15,40,37.5,6,25,24.0,8,9,88.9,16,25,41,4,24,18,8,3,56,0
5336,123437,154_07_34,UKRAINE,0,TOTALS,UKRAINE,200,28,66,42.4,24,53,45.3,4,13,30.8,11,15,73.3,13,24,37,14,28,11,7,1,71,1
5337,123450,154_07_34,BOSNIA AND HERZEGOVINA,0,TOTALS,BOSNIA AND HERZEGOVINA,200,21,48,43.8,19,37,51.4,2,11,18.2,25,36,69.4,8,27,35,9,24,16,3,2,69,0
5338,123463,154_07_35,POLAND,0,TOTALS,POLAND,200,32,66,48.5,26,44,59.1,6,22,27.3,13,19,68.4,10,19,29,13,15,16,23,4,83,1
5339,123476,154_07_35,SWEDEN,0,TOTALS,SWEDEN,200,29,60,48.3,22,43,51.2,7,17,41.2,7,12,58.3,15,27,42,13,19,31,12,3,72,0
5340,123489,154_07_36,PORTUGAL,0,TOTALS,PORTUGAL,200,24,67,35.8,17,40,42.5,7,27,25.9,16,26,61.5,17,27,44,12,20,18,13,3,71,1
5341,123502,154_07_36,ENGLAND,0,TOTALS,ENGLAND,200,27,61,44.3,23,46,50.0,4,15,26.7,7,21,33.3,14,29,43,12,26,21,8,1,65,0
5342,123515,154_07_37,DENMARK,0,TOTALS,DENMARK,200,27,74,36.5,19,49,38.8,8,25,32.0,16,27,59.3,19,21,40,5,19,15,8,0,78,0
5343,123528,154_07_37,CZECH REPUBLIC,0,TOTALS,CZECH REPUBLIC,200,38,71,53.5,31,54,57.4,7,17,41.2,11,18,61.1,16,32,48,18,19,21,11,6,94,1
5344,123541,154_07_38,SWITZERLAND,0,TOTALS,SWITZERLAND,200,17,54,31.5,14,38,36.8,3,16,18.8,12,23,52.2,13,27,40,6,20,18,8,2,49,0
5345,123554,154_07_38,IRELAND,0,TOTALS,IRELAND,200,20,58,34.5,18,37,48.6,2,21,9.5,13,19,68.4,13,30,43,13,24,21,12,2,55,1
5346,123566,154_07_39,ARMENIA,0,TOTALS,ARMENIA,200,13,52,25.0,10,40,25.0,3,12,25.0,8,20,40.0,8,20,28,4,17,36,2,1,37,1
5347,123579,154_07_39,FINLAND,0,TOTALS,FINLAND,200,52,84,61.9,36,50,72.0,16,34,47.1,13,20,65.0,18,36,54,20,19,15,30,2,133,0
5348,123592,154_07_40,MONTENEGRO,0,TOTALS,MONTENEGRO,200,21,56,37.5,13,33,39.4,8,23,34.8,26,35,74.3,12,30,42,17,19,15,10,1,76,1
5349,123605,154_07_40,HUNGARY,0,TOTALS,HUNGARY,200,26,67,38.8,23,49,46.9,3,18,16.7,6,15,40.0,13,29,42,13,27,16,10,7,61,0
5350,123618,154_07_41,BELGIUM,0,TOTALS,BELGIUM,200,35,74,47.3,27,50,54.0,8,24,33.3,13,16,81.2,17,27,44,8,15,14,17,4,91,1
5351,123631,154_07_41,SWEDEN,0,TOTALS,SWEDEN,200,26,66,39.4,19,45,42.2,7,21,33.3,9,14,64.3,14,24,38,9,18,22,6,2,68,0
5352,123644,154_07_42,AUSTRIA,0,TOTALS,AUSTRIA,200,29,61,47.5,23,49,46.9,6,12,50.0,23,42,54.8,12,26,38,11,18,13,16,1,87,1
5353,123657,154_07_42,NETHERLANDS,0,TOTALS,NETHERLANDS,200,21,60,35.0,17,42,40.5,4,18,22.2,12,16,75.0,13,27,40,13,29,25,8,2,58,0
5354,123670,154_07_43,CZECH REPUBLIC,0,TOTALS,CZECH REPUBLIC,200,27,70,38.6,21,45,46.7,6,25,24.0,18,30,60.0,21,25,46,11,21,10,7,3,78,0
5355,123683,154_07_43,POLAND,0,TOTALS,POLAND,200,28,60,46.7,21,43,48.8,7,17,41.2,17,27,63.0,11,26,37,6,23,13,8,3,80,1
5356,123696,154_07_44,SLOVAK REPUBLIC,0,TOTALS,SLOVAK REPUBLIC,200,32,70,45.7,30,56,53.6,2,14,14.3,6,11,54.5,13,33,46,7,25,17,10,1,72,0
5357,123709,154_07_44,FINLAND,0,TOTALS,FINLAND,200,23,56,41.1,14,36,38.9,9,20,45.0,18,33,54.5,10,26,36,7,15,16,9,4,73,1
5358,123722,154_07_45,UKRAINE,0,TOTALS,UKRAINE,200,26,57,45.6,17,29,58.6,9,28,32.1,21,30,70.0,8,29,37,12,24,15,16,3,82,1
5359,123735,154_07_45,HUNGARY,0,TOTALS,HUNGARY,200,18,51,35.3,11,31,35.5,7,20,35.0,13,23,56.5,5,28,33,7,25,22,6,2,56,0
5360,123748,154_07_46,IRELAND,0,TOTALS,IRELAND,200,30,71,42.3,22,46,47.8,8,25,32.0,6,9,66.7,12,28,40,15,25,21,9,0,74,0
5361,123761,154_07_46,NORWAY,0,TOTALS,NORWAY,200,29,65,44.6,26,47,55.3,3,18,16.7,18,27,66.7,14,26,40,10,14,18,13,2,79,1
5362,123774,154_07_47,BOSNIA AND HERZEGOVINA,0,TOTALS,BOSNIA AND HERZEGOVINA,200,28,68,41.2,27,57,47.4,1,11,9.1,12,17,70.6,12,13,25,11,16,13,14,1,69,0
5363,123787,154_07_47,MONTENEGRO,0,TOTALS,MONTENEGRO,200,39,62,62.9,31,45,68.9,8,17,47.1,7,12,58.3,11,29,40,24,16,20,11,9,93,1
5364,123800,154_07_48,LUXEMBOURG,0,TOTALS,LUXEMBOURG,200,27,72,37.5,20,46,43.5,7,26,26.9,14,19,73.7,10,31,41,11,23,10,4,2,75,0
5365,123813,154_07_48,PORTUGAL,0,TOTALS,PORTUGAL,200,28,63,44.4,24,49,49.0,4,14,28.6,20,34,58.8,13,37,50,13,19,17,8,7,80,1
5366,123826,154_07_49,SWEDEN,0,TOTALS,SWEDEN,200,24,55,43.6,17,38,44.7,7,17,41.2,14,27,51.9,13,30,43,9,19,21,11,3,69,0
5367,123839,154_07_49,CZECH REPUBLIC,0,TOTALS,CZECH REPUBLIC,200,25,69,36.2,18,47,38.3,7,22,31.8,14,25,56.0,18,22,40,9,21,14,12,2,71,1
5368,123852,154_07_50,NETHERLANDS,0,TOTALS,NETHERLANDS,200,20,57,35.1,19,50,38.0,1,7,14.3,16,28,57.1,15,20,35,9,24,14,9,2,57,0
5369,123865,154_07_50,SLOVAK REPUBLIC,0,TOTALS,SLOVAK REPUBLIC,200,32,59,54.2,27,45,60.0,5,14,35.7,15,23,65.2,12,27,39,8,29,12,5,2,84,1
5370,123878,154_07_51,MONTENEGRO,0,TOTALS,MONTENEGRO,200,29,55,52.7,24,40,60.0,5,15,33.3,4,9,44.4,7,24,31,18,17,17,15,1,67,1
5371,123891,154_07_51,UKRAINE,0,TOTALS,UKRAINE,200,24,65,36.9,14,37,37.8,10,28,35.7,8,14,57.1,20,20,40,5,15,18,10,2,66,0
5372,123904,154_07_52,PORTUGAL,0,TOTALS,PORTUGAL,200,30,74,40.5,23,54,42.6,7,20,35.0,14,25,56.0,18,33,51,17,11,10,7,2,81,1
5373,123917,154_07_52,IRELAND,0,TOTALS,IRELAND,200,27,68,39.7,16,33,48.5,11,35,31.4,4,6,66.7,9,29,38,16,22,16,5,1,69,0
5374,123930,154_07_53,HUNGARY,0,TOTALS,HUNGARY,200,28,65,43.1,24,47,51.1,4,18,22.2,6,15,40.0,11,22,33,15,21,12,7,1,66,0
5375,123943,154_07_53,BOSNIA AND HERZEGOVINA,0,TOTALS,BOSNIA AND HERZEGOVINA,200,36,69,52.2,31,53,58.5,5,16,31.2,10,19,52.6,14,29,43,13,17,11,4,5,87,1
5376,123956,154_07_54,NORWAY,0,TOTALS,NORWAY,200,28,60,46.7,17,33,51.5,11,27,40.7,19,36,52.8,16,31,47,18,13,15,5,2,86,1
5377,123969,154_07_54,LUXEMBOURG,0,TOTALS,LUXEMBOURG,200,30,78,38.5,15,40,37.5,15,38,39.5,6,8,75.0,17,23,40,19,26,13,8,1,81,0
5378,123982,154_07_55,POLAND,0,TOTALS,POLAND,200,29,57,50.9,25,41,61.0,4,16,25.0,5,9,55.6,10,26,36,13,12,16,9,1,67,1
5379,123995,154_07_55,BELGIUM,0,TOTALS,BELGIUM,200,22,55,40.0,19,37,51.4,3,18,16.7,8,12,66.7,8,19,27,9,16,14,8,0,55,0
5380,124008,154_07_56,FINLAND,0,TOTALS,FINLAND,200,24,58,41.4,16,32,50.0,8,26,30.8,20,31,64.5,9,29,38,16,23,19,12,4,76,1
5381,124021,154_07_56,AUSTRIA,0,TOTALS,AUSTRIA,200,30,71,42.3,29,59,49.2,1,12,8.3,14,22,63.6,16,28,44,12,26,18,12,2,75,0
5382,124034,154_07_57,DENMARK,0,TOTALS,DENMARK,200,30,65,46.2,19,38,50.0,11,27,40.7,22,32,68.8,13,30,43,13,17,14,8,2,93,1
5383,124047,154_07_57,ENGLAND,0,TOTALS,ENGLAND,200,36,76,47.4,33,64,51.6,3,12,25.0,5,18,27.8,18,23,41,15,23,14,8,2,80,0
5384,124059,154_07_58,ARMENIA,0,TOTALS,ARMENIA,200,16,64,25.0,12,46,26.1,4,18,22.2,20,26,76.9,16,27,43,5,14,23,7,7,56,0
5385,124072,154_07_58,SWITZERLAND,0,TOTALS,SWITZERLAND,200,34,84,40.5,32,74,43.2,2,10,20.0,10,15,66.7,24,37,61,11,20,20,18,1,80,1
5386,124085,154_07_59,SWITZERLAND,0,TOTALS,SWITZERLAND,200,20,49,40.8,19,42,45.2,1,7,14.3,9,21,42.9,10,24,34,7,20,23,12,4,50,0
5387,124098,154_07_59,DENMARK,0,TOTALS,DENMARK,200,26,63,41.3,21,43,48.8,5,20,25.0,12,19,63.2,15,25,40,8,20,18,18,2,69,1
5388,124111,154_07_60,ENGLAND,0,TOTALS,ENGLAND,200,57,84,67.9,54,77,70.1,3,7,42.9,13,27,48.1,15,35,50,27,12,15,27,2,130,0
5389,124123,154_07_60,ARMENIA,0,TOTALS,ARMENIA,200,14,60,23.3,9,36,25.0,5,24,20.8,3,6,50.0,12,20,32,6,16,40,6,5,36,1
5390,124136,154_07_61,AUSTRIA,0,TOTALS,AUSTRIA,200,32,64,50.0,28,45,62.2,4,19,21.1,20,32,62.5,15,37,52,17,22,23,9,5,88,1
5391,124149,154_07_61,LUXEMBOURG,0,TOTALS,LUXEMBOURG,200,28,78,35.9,23,58,39.7,5,20,25.0,15,22,68.2,16,23,39,11,25,12,16,1,76,0
5392,124162,154_07_62,CZECH REPUBLIC,0,TOTALS,CZECH REPUBLIC,200,26,63,41.3,23,48,47.9,3,15,20.0,13,24,54.2,12,40,52,16,17,14,8,4,68,1
5393,124175,154_07_62,HUNGARY,0,TOTALS,HUNGARY,200,20,64,31.2,12,41,29.3,8,23,34.8,10,21,47.6,8,28,36,5,19,14,7,8,58,0
5394,124188,154_07_63,IRELAND,0,TOTALS,IRELAND,200,27,56,48.2,23,39,59.0,4,17,23.5,20,29,69.0,11,27,38,17,26,23,7,1,78,0
5395,124201,154_07_63,NETHERLANDS,0,TOTALS,NETHERLANDS,200,27,68,39.7,24,46,52.2,3,22,13.6,22,33,66.7,19,21,40,12,23,16,5,3,79,1
5396,124214,154_07_64,BOSNIA AND HERZEGOVINA,0,TOTALS,BOSNIA AND HERZEGOVINA,200,23,71,32.4,17,47,36.2,6,24,25.0,12,25,48.0,23,22,45,7,21,23,16,0,64,0
5397,124227,154_07_64,SWEDEN,0,TOTALS,SWEDEN,200,31,61,50.8,25,45,55.6,6,16,37.5,14,21,66.7,12,32,44,13,22,21,12,5,82,1
5398,124240,154_07_65,FINLAND,0,TOTALS,FINLAND,200,23,60,38.3,18,38,47.4,5,22,22.7,14,20,70.0,18,24,42,13,14,16,10,1,65,1
5399,124253,154_07_65,NORWAY,0,TOTALS,NORWAY,200,22,59,37.3,15,35,42.9,7,24,29.2,5,8,62.5,14,19,33,7,20,18,7,1,56,0
5400,124266,154_07_66,POLAND,0,TOTALS,POLAND,200,24,53,45.3,16,34,47.1,8,19,42.1,0,3,0.0,11,19,30,10,14,18,9,4,56,0
5401,124279,154_07_66,UKRAINE,0,TOTALS,UKRAINE,200,31,64,48.4,20,35,57.1,11,29,37.9,4,9,44.4,18,20,38,6,12,12,9,2,77,1
5402,124292,154_07_67,PORTUGAL,0,TOTALS,PORTUGAL,200,23,58,39.7,20,45,44.4,3,13,23.1,11,20,55.0,18,28,46,9,14,21,6,4,60,0
5403,124305,154_07_67,SLOVAK REPUBLIC,0,TOTALS,SLOVAK REPUBLIC,200,23,67,34.3,16,42,38.1,7,25,28.0,11,20,55.0,15,20,35,6,14,10,11,2,64,1
5404,124318,154_07_68,MONTENEGRO,0,TOTALS,MONTENEGRO,200,23,63,36.5,14,30,46.7,9,33,27.3,1,5,20.0,17,25,42,11,17,17,3,3,56,0
5405,124331,154_07_68,BELGIUM,0,TOTALS,BELGIUM,200,26,57,45.6,25,43,58.1,1,14,7.1,11,15,73.3,7,24,31,14,9,9,11,1,64,1
5406,124344,154_07_69,SWITZERLAND,0,TOTALS,SWITZERLAND,200,35,67,52.2,28,51,54.9,7,16,43.8,0,2,0.0,15,19,34,16,17,18,9,7,77,0
5407,124357,154_07_69,ENGLAND,0,TOTALS,ENGLAND,200,31,63,49.2,28,49,57.1,3,14,21.4,15,25,60.0,15,17,32,19,11,14,14,1,80,1
5408,124370,154_07_70,DENMARK,0,TOTALS,DENMARK,200,36,77,46.8,29,56,51.8,7,21,33.3,14,20,70.0,21,28,49,16,8,16,22,1,93,1
5409,124382,154_07_70,ARMENIA,0,TOTALS,ARMENIA,200,14,53,26.4,10,32,31.2,4,21,19.0,2,2,100.0,11,22,33,2,14,35,9,2,34,0
5410,124395,154_07_71,LUXEMBOURG,0,TOTALS,LUXEMBOURG,200,41,69,59.4,33,47,70.2,8,22,36.4,16,26,61.5,12,26,38,27,15,14,17,0,106,0
5411,124408,154_07_71,IRELAND,0,TOTALS,IRELAND,200,24,59,40.7,13,31,41.9,11,28,39.3,11,19,57.9,11,20,31,11,17,24,9,0,70,1
5412,124421,154_07_72,HUNGARY,0,TOTALS,HUNGARY,200,29,58,50.0,20,37,54.1,9,21,42.9,11,20,55.0,3,23,26,17,23,16,19,2,78,0
5413,124434,154_07_72,BOSNIA AND HERZEGOVINA,0,TOTALS,BOSNIA AND HERZEGOVINA,200,29,60,48.3,23,44,52.3,6,16,37.5,15,28,53.6,16,29,45,9,19,24,13,2,79,1
5414,124447,154_07_73,AUSTRIA,0,TOTALS,AUSTRIA,200,28,61,45.9,25,51,49.0,3,10,30.0,12,17,70.6,6,31,37,14,23,19,12,2,71,1
5415,124460,154_07_73,NETHERLANDS,0,TOTALS,NETHERLANDS,200,14,52,26.9,11,35,31.4,3,17,17.6,21,25,84.0,7,23,30,5,19,25,11,3,52,0
5416,124473,154_07_74,CZECH REPUBLIC,0,TOTALS,CZECH REPUBLIC,200,24,73,32.9,20,51,39.2,4,22,18.2,4,11,36.4,18,18,36,8,22,20,7,8,56,0
5417,124486,154_07_74,SWEDEN,0,TOTALS,SWEDEN,200,36,74,48.6,31,58,53.4,5,16,31.2,14,25,56.0,23,35,58,15,15,20,9,1,91,1
5418,124499,154_07_75,NORWAY,0,TOTALS,NORWAY,200,25,63,39.7,23,45,51.1,2,18,11.1,10,16,62.5,17,33,50,9,11,16,5,0,62,1
5419,124512,154_07_75,PORTUGAL,0,TOTALS,PORTUGAL,200,19,68,27.9,9,42,21.4,10,26,38.5,10,12,83.3,17,22,39,12,12,12,9,3,58,0
5420,124525,154_07_76,POLAND,0,TOTALS,POLAND,200,33,64,51.6,23,45,51.1,10,19,52.6,4,6,66.7,12,27,39,7,11,17,9,3,80,1
5421,124538,154_07_76,MONTENEGRO,0,TOTALS,MONTENEGRO,200,29,60,48.3,25,48,52.1,4,12,33.3,6,10,60.0,6,20,26,16,13,13,14,2,68,0
5422,124551,154_07_77,FINLAND,0,TOTALS,FINLAND,200,29,62,46.8,22,43,51.2,7,19,36.8,15,24,62.5,6,27,33,18,14,9,8,5,80,1
5423,124564,154_07_77,SLOVAK REPUBLIC,0,TOTALS,SLOVAK REPUBLIC,200,31,73,42.5,27,56,48.2,4,17,23.5,10,12,83.3,15,28,43,7,23,16,6,3,76,0
5424,124577,154_07_78,UKRAINE,0,TOTALS,UKRAINE,200,20,57,35.1,14,31,45.2,6,26,23.1,12,22,54.5,15,26,41,5,16,15,4,4,58,0
5425,124590,154_07_78,BELGIUM,0,TOTALS,BELGIUM,200,32,68,47.1,23,42,54.8,9,26,34.6,13,15,86.7,10,25,35,15,21,5,10,4,86,1
5426,124603,155_07_01,GIBRALTAR,0,TOTALS,GIBRALTAR,200,26,62,41.9,19,44,43.2,7,18,38.9,19,33,57.6,17,32,49,8,23,26,11,4,78,1
5427,124616,155_07_01,SAN MARINO,0,TOTALS,SAN MARINO,200,22,72,30.6,17,48,35.4,5,24,20.8,17,25,68.0,21,20,41,4,26,23,15,0,66,0
5428,124628,155_07_02,PRINCIPALITY OF MONACO,0,TOTALS,PRINCIPALITY OF MONACO,200,27,71,38.0,21,50,42.0,6,21,28.6,12,16,75.0,10,22,32,7,20,17,18,0,72,1
5429,124640,155_07_02,MALTA,0,TOTALS,MALTA,200,18,56,32.1,14,43,32.6,4,13,30.8,9,24,37.5,21,27,48,6,18,34,17,5,49,0
5430,124653,155_07_03,WALES,0,TOTALS,WALES,200,37,81,45.7,34,62,54.8,3,19,15.8,19,38,50.0,20,42,62,21,28,25,18,5,96,1
5431,124664,155_07_03,ANDORRA,0,TOTALS,ANDORRA,200,25,80,31.2,21,51,41.2,4,29,13.8,14,27,51.9,17,31,48,8,30,28,13,3,68,0
5432,124677,155_07_04,SCOTLAND,0,TOTALS,SCOTLAND,200,33,64,51.6,28,49,57.1,5,15,33.3,10,11,90.9,11,35,46,18,21,20,10,1,81,1
5433,124689,155_07_04,PRINCIPALITY OF MONACO,0,TOTALS,PRINCIPALITY OF MONACO,200,20,58,34.5,13,35,37.1,7,23,30.4,17,23,73.9,6,20,26,7,13,17,10,1,64,0
5434,124702,155_07_05,MOLDOVA,0,TOTALS,MOLDOVA,200,34,73,46.6,25,51,49.0,9,22,40.9,8,11,72.7,17,34,51,19,24,26,12,4,85,1
5435,124715,155_07_05,GIBRALTAR,0,TOTALS,GIBRALTAR,200,23,57,40.4,20,43,46.5,3,14,21.4,13,23,56.5,5,24,29,9,14,24,11,2,62,0
5436,124728,155_07_06,AZERBAIJAN,0,TOTALS,AZERBAIJAN,200,12,65,18.5,5,35,14.3,7,30,23.3,5,9,55.6,8,31,39,9,27,34,7,1,36,1
5437,124741,155_07_06,WALES,0,TOTALS,WALES,200,35,82,42.7,27,54,50.0,8,28,28.6,25,35,71.4,20,46,66,24,16,16,18,1,103,0
5438,124754,155_07_07,SAN MARINO,0,TOTALS,SAN MARINO,200,28,69,40.6,24,48,50.0,4,21,19.0,4,13,30.8,11,26,37,10,23,30,15,3,64,0
5439,124767,155_07_07,MOLDOVA,0,TOTALS,MOLDOVA,200,32,77,41.6,26,57,45.6,6,20,30.0,13,21,61.9,24,36,60,18,16,32,12,3,83,1
5440,124778,155_07_08,ANDORRA,0,TOTALS,ANDORRA,200,41,87,47.1,30,62,48.4,11,25,44.0,26,35,74.3,13,22,35,17,23,13,23,3,119,0
5441,124791,155_07_08,AZERBAIJAN,0,TOTALS,AZERBAIJAN,200,32,57,56.1,25,40,62.5,7,17,41.2,13,26,50.0,9,36,45,16,31,43,10,7,84,1
5442,124803,155_07_09,MALTA,0,TOTALS,MALTA,200,22,58,37.9,21,53,39.6,1,5,20.0,23,41,56.1,21,25,46,9,10,30,8,4,68,1
5443,124816,155_07_09,SCOTLAND,0,TOTALS,SCOTLAND,200,43,82,52.4,36,59,61.0,7,23,30.4,9,11,81.8,14,28,42,20,27,16,16,0,102,0
5444,124829,155_07_10,AZERBAIJAN,0,TOTALS,AZERBAIJAN,200,29,61,47.5,23,46,50.0,6,15,40.0,10,24,41.7,8,43,51,19,21,25,6,11,74,1
5445,124842,155_07_10,SAN MARINO,0,TOTALS,SAN MARINO,200,23,84,27.4,19,57,33.3,4,27,14.8,16,27,59.3,23,32,55,9,23,15,17,0,66,0
5446,124854,155_07_11,PRINCIPALITY OF MONACO,0,TOTALS,PRINCIPALITY OF MONACO,200,29,71,40.8,21,37,56.8,8,34,23.5,14,20,70.0,14,26,40,17,16,17,17,1,80,1
5447,124867,155_07_11,GIBRALTAR,0,TOTALS,GIBRALTAR,200,26,63,41.3,19,36,52.8,7,27,25.9,6,12,50.0,13,30,43,10,22,27,6,3,65,0
5448,124880,155_07_12,MOLDOVA,0,TOTALS,MOLDOVA,200,22,73,30.1,15,42,35.7,7,31,22.6,6,8,75.0,17,29,46,10,22,19,11,4,57,0
5449,124893,155_07_12,WALES,0,TOTALS,WALES,200,22,65,33.8,19,51,37.3,3,14,21.4,15,23,65.2,16,32,48,9,13,17,6,1,62,1
5450,124905,155_07_13,MALTA,0,TOTALS,MALTA,200,33,69,47.8,31,62,50.0,2,7,28.6,27,41,65.9,23,45,68,18,17,31,13,10,95,1
5451,124918,155_07_13,SAN MARINO,0,TOTALS,SAN MARINO,200,25,88,28.4,15,50,30.0,10,38,26.3,16,21,76.2,19,21,40,13,29,19,23,1,76,0
5452,124929,155_07_14,ANDORRA,0,TOTALS,ANDORRA,200,33,68,48.5,25,41,61.0,8,27,29.6,12,15,80.0,11,22,33,14,17,21,13,3,86,1
5453,124941,155_07_14,PRINCIPALITY OF MONACO,0,TOTALS,PRINCIPALITY OF MONACO,200,31,60,51.7,24,39,61.5,7,21,33.3,15,21,71.4,9,26,35,14,14,26,12,2,84,0
5454,124954,155_07_15,SCOTLAND,0,TOTALS,SCOTLAND,200,32,83,38.6,19,50,38.0,13,33,39.4,3,7,42.9,18,26,44,24,18,20,18,5,80,1
5455,124967,155_07_15,MOLDOVA,0,TOTALS,MOLDOVA,200,17,54,31.5,11,36,30.6,6,18,33.3,15,19,78.9,13,34,47,8,16,34,13,4,55,0
5456,124980,155_07_16,AZERBAIJAN,0,TOTALS,AZERBAIJAN,200,29,88,33.0,24,56,42.9,5,32,15.6,9,12,75.0,23,32,55,14,17,11,9,2,72,0
5457,124992,155_07_16,MALTA,0,TOTALS,MALTA,200,31,73,42.5,29,63,46.0,2,10,20.0,14,23,60.9,16,37,53,13,13,14,4,3,78,1
5458,125005,155_07_17,GIBRALTAR,0,TOTALS,GIBRALTAR,200,30,67,44.8,29,61,47.5,1,6,16.7,18,31,58.1,10,28,38,18,27,39,11,4,79,1
5459,125016,155_07_17,ANDORRA,0,TOTALS,ANDORRA,200,46,92,50.0,36,67,53.7,10,25,40.0,27,38,71.1,22,33,55,29,26,24,25,4,129,0
5460,125029,155_07_18,WALES,0,TOTALS,WALES,200,24,67,35.8,20,49,40.8,4,18,22.2,10,16,62.5,16,28,44,11,17,28,11,2,62,0
5461,125042,155_07_18,SCOTLAND,0,TOTALS,SCOTLAND,200,34,74,45.9,27,52,51.9,7,22,31.8,11,20,55.0,14,27,41,14,15,20,18,5,86,1
5462,128701,159_07_01,LITHUANIA,0,TOTALS,LITHUANIA,200,40,76,52.6,35,55,63.6,5,21,23.8,18,30,60.0,18,28,46,15,16,23,15,3,103,0
5463,128714,159_07_01,UKRAINE,0,TOTALS,UKRAINE,200,16,53,30.2,9,35,25.7,7,18,38.9,12,21,57.1,9,22,31,13,28,34,11,4,51,1
5464,128727,159_07_02,TURKEY,0,TOTALS,TURKEY,200,30,72,41.7,23,40,57.5,7,32,21.9,12,23,52.2,24,27,51,14,21,17,13,3,79,1
5465,128740,159_07_02,PORTUGAL,0,TOTALS,PORTUGAL,200,15,51,29.4,11,35,31.4,4,16,25.0,4,12,33.3,10,17,27,9,24,28,5,1,38,0
5466,128753,159_07_03,ITALY,0,TOTALS,ITALY,200,18,53,34.0,14,37,37.8,4,16,25.0,22,36,61.1,16,35,51,12,21,18,6,2,62,1
5467,128766,159_07_03,SLOVENIA,0,TOTALS,SLOVENIA,200,20,63,31.7,18,49,36.7,2,14,14.3,9,22,40.9,15,27,42,7,30,17,13,3,51,0
5468,128779,159_07_04,SERBIA,0,TOTALS,SERBIA,200,17,56,30.4,15,38,39.5,2,18,11.1,17,34,50.0,19,32,51,7,23,20,12,3,53,1
5469,128792,159_07_04,ISRAEL,0,TOTALS,ISRAEL,200,18,51,35.3,14,37,37.8,4,14,28.6,11,28,39.3,9,25,34,9,27,20,5,2,51,0
5470,128805,159_07_05,CROATIA,0,TOTALS,CROATIA,200,24,72,33.3,19,49,38.8,5,23,21.7,13,21,61.9,23,22,45,8,23,6,7,0,66,0
5471,128818,159_07_05,GREECE,0,TOTALS,GREECE,200,31,62,50.0,25,45,55.6,6,17,35.3,11,17,64.7,12,28,40,10,20,9,3,9,79,1
5472,128831,159_07_06,SPAIN,0,TOTALS,SPAIN,200,31,72,43.1,26,58,44.8,5,14,35.7,15,27,55.6,17,37,54,23,10,17,18,6,82,1
5473,128844,159_07_06,GEORGIA,0,TOTALS,GEORGIA,200,23,73,31.5,17,51,33.3,6,22,27.3,1,4,25.0,16,27,43,9,23,26,9,8,53,0
5474,128857,159_07_07,RUSSIA,0,TOTALS,RUSSIA,200,27,71,38.0,22,46,47.8,5,25,20.0,11,21,52.4,14,21,35,10,29,16,13,0,70,0
5475,128870,159_07_07,LATVIA,0,TOTALS,LATVIA,200,29,57,50.9,24,46,52.2,5,11,45.5,13,30,43.3,13,30,43,14,21,20,6,2,76,1
5476,128883,159_07_08,FRANCE,0,TOTALS,FRANCE,200,28,55,50.9,21,34,61.8,7,21,33.3,8,14,57.1,11,32,43,15,11,20,6,0,71,1
5477,128896,159_07_08,CZECH REPUBLIC,0,TOTALS,CZECH REPUBLIC,200,24,64,37.5,17,41,41.5,7,23,30.4,2,4,50.0,8,17,25,11,16,12,7,2,57,0
5478,128909,159_07_09,PORTUGAL,0,TOTALS,PORTUGAL,200,16,59,27.1,15,40,37.5,1,19,5.3,3,9,33.3,12,23,35,4,35,39,6,3,36,1
5479,128922,159_07_09,LITHUANIA,0,TOTALS,LITHUANIA,200,41,72,56.9,36,55,65.5,5,17,29.4,30,51,58.8,16,25,41,17,17,11,22,4,117,0
5480,128935,159_07_10,UKRAINE,0,TOTALS,UKRAINE,200,22,69,31.9,18,55,32.7,4,14,28.6,8,12,66.7,15,22,37,6,15,28,11,2,56,0
5481,128948,159_07_10,TURKEY,0,TOTALS,TURKEY,200,34,67,50.7,23,42,54.8,11,25,44.0,12,14,85.7,10,27,37,19,16,22,16,5,91,1
5482,128961,159_07_11,GEORGIA,0,TOTALS,GEORGIA,200,21,75,28.0,19,59,32.2,2,16,12.5,12,22,54.5,23,17,40,10,23,26,15,2,56,0
5483,128974,159_07_11,ITALY,0,TOTALS,ITALY,200,29,55,52.7,24,38,63.2,5,17,29.4,25,32,78.1,7,38,45,16,21,28,17,7,88,1
5484,128987,159_07_12,CZECH REPUBLIC,0,TOTALS,CZECH REPUBLIC,200,20,63,31.7,15,44,34.1,5,19,26.3,9,15,60.0,9,30,39,6,22,15,10,3,54,0
5485,129000,159_07_12,SERBIA,0,TOTALS,SERBIA,200,23,62,37.1,17,43,39.5,6,19,31.6,13,20,65.0,14,35,49,12,18,16,8,9,65,1
5486,129013,159_07_13,GREECE,0,TOTALS,GREECE,200,25,60,41.7,23,45,51.1,2,15,13.3,20,33,60.6,15,25,40,9,25,10,9,3,72,1
5487,129026,159_07_13,RUSSIA,0,TOTALS,RUSSIA,200,17,51,33.3,13,31,41.9,4,20,20.0,18,30,60.0,10,25,35,2,25,17,5,3,56,0
5488,129039,159_07_14,SLOVENIA,0,TOTALS,SLOVENIA,225,27,78,34.6,18,45,40.0,9,33,27.3,9,15,60.0,20,26,46,13,25,18,9,3,72,0
5489,129052,159_07_14,SPAIN,0,TOTALS,SPAIN,225,29,70,41.4,24,50,48.0,5,20,25.0,18,33,54.5,16,37,53,16,17,19,11,5,81,1
5490,129065,159_07_15,ISRAEL,0,TOTALS,ISRAEL,225,24,62,38.7,15,26,57.7,9,36,25.0,6,12,50.0,6,26,32,11,22,12,9,2,63,0
5491,129078,159_07_15,FRANCE,0,TOTALS,FRANCE,225,22,55,40.0,13,25,52.0,9,30,30.0,11,19,57.9,12,32,44,17,14,22,5,0,64,1
5492,129091,159_07_16,LATVIA,0,TOTALS,LATVIA,200,30,69,43.5,24,49,49.0,6,20,30.0,11,16,68.8,11,27,38,14,20,13,7,4,77,0
5493,129104,159_07_16,CROATIA,0,TOTALS,CROATIA,200,26,68,38.2,13,43,30.2,13,25,52.0,15,21,71.4,16,25,41,12,19,12,5,3,80,1
5494,129117,159_07_17,PORTUGAL,0,TOTALS,PORTUGAL,200,20,60,33.3,11,37,29.7,9,23,39.1,6,9,66.7,10,33,43,12,18,21,2,4,55,0
5495,129130,159_07_17,UKRAINE,0,TOTALS,UKRAINE,200,25,77,32.5,18,41,43.9,7,36,19.4,10,15,66.7,18,30,48,15,16,9,13,1,67,1
5496,129143,159_07_18,LITHUANIA,0,TOTALS,LITHUANIA,200,27,60,45.0,25,50,50.0,2,10,20.0,14,26,53.8,18,28,46,11,27,27,10,5,70,0
5497,129156,159_07_18,TURKEY,0,TOTALS,TURKEY,200,27,64,42.2,23,43,53.5,4,21,19.0,15,24,62.5,12,19,31,15,24,22,17,2,73,1
5498,129169,159_07_19,ITALY,0,TOTALS,ITALY,200,23,73,31.5,18,52,34.6,5,21,23.8,12,20,60.0,17,29,46,17,20,19,13,4,63,0
5499,129182,159_07_19,SPAIN,0,TOTALS,SPAIN,200,27,62,43.5,23,48,47.9,4,14,28.6,16,22,72.7,9,36,45,17,18,23,10,2,74,1
5500,129195,159_07_20,SERBIA,0,TOTALS,SERBIA,200,26,56,46.4,19,35,54.3,7,21,33.3,19,25,76.0,12,32,44,11,24,15,6,16,78,1
5501,129208,159_07_20,FRANCE,0,TOTALS,FRANCE,200,25,77,32.5,22,62,35.5,3,15,20.0,13,28,46.4,23,22,45,7,18,9,9,0,66,0
5502,129221,159_07_21,LATVIA,0,TOTALS,LATVIA,200,14,53,26.4,12,36,33.3,2,17,11.8,13,24,54.2,12,24,36,6,22,16,5,5,43,0
5503,129234,159_07_21,GREECE,0,TOTALS,GREECE,200,26,60,43.3,19,48,39.6,7,12,58.3,7,23,30.4,12,34,46,10,20,14,8,4,66,1
5504,129247,159_07_22,GEORGIA,0,TOTALS,GEORGIA,200,39,66,59.1,33,53,62.3,6,13,46.2,16,30,53.3,12,28,40,18,18,19,15,4,100,0
5505,129260,159_07_22,SLOVENIA,0,TOTALS,SLOVENIA,200,27,60,45.0,17,38,44.7,10,22,45.5,6,14,42.9,9,21,30,15,26,29,8,1,70,1
5506,129273,159_07_23,CZECH REPUBLIC,0,TOTALS,CZECH REPUBLIC,200,19,62,30.6,13,34,38.2,6,28,21.4,7,8,87.5,15,35,50,8,19,26,6,3,51,0
5507,129286,159_07_23,ISRAEL,0,TOTALS,ISRAEL,200,24,74,32.4,15,35,42.9,9,39,23.1,13,25,52.0,19,27,46,13,11,12,19,5,70,1
5508,129299,159_07_24,CROATIA,0,TOTALS,CROATIA,200,28,66,42.4,21,44,47.7,7,22,31.8,10,12,83.3,14,22,36,11,22,17,7,0,73,0
5509,129312,159_07_24,RUSSIA,0,TOTALS,RUSSIA,200,31,60,51.7,29,49,59.2,2,11,18.2,10,21,47.6,13,21,34,13,17,13,7,2,74,1
5510,129325,159_07_25,ISRAEL,0,TOTALS,ISRAEL,200,18,60,30.0,15,44,34.1,3,16,18.8,5,7,71.4,9,32,41,12,25,28,12,6,44,0
5511,129338,159_07_25,SPAIN,0,TOTALS,SPAIN,200,23,69,33.3,16,47,34.0,7,22,31.8,16,32,50.0,19,35,54,18,10,20,17,8,69,1
5512,129351,159_07_26,SLOVENIA,0,TOTALS,SLOVENIA,200,21,60,35.0,16,43,37.2,5,17,29.4,10,15,66.7,15,22,37,10,16,19,9,3,57,0
5513,129364,159_07_26,RUSSIA,0,TOTALS,RUSSIA,200,27,63,42.9,21,45,46.7,6,18,33.3,9,19,47.4,16,24,40,11,11,14,11,4,69,1
5514,129377,159_07_27,FRANCE,0,TOTALS,FRANCE,200,18,50,36.0,13,35,37.1,5,15,33.3,17,24,70.8,8,42,50,13,20,26,10,0,58,1
5515,129390,159_07_27,ITALY,0,TOTALS,ITALY,200,18,61,29.5,13,44,29.5,5,17,29.4,4,16,25.0,5,25,30,4,26,18,13,6,45,0
5516,129403,159_07_28,CZECH REPUBLIC,0,TOTALS,CZECH REPUBLIC,200,26,63,41.3,21,50,42.0,5,13,38.5,16,30,53.3,17,40,57,13,20,23,9,3,73,1
5517,129416,159_07_28,PORTUGAL,0,TOTALS,PORTUGAL,200,17,67,25.4,13,52,25.0,4,15,26.7,13,18,72.2,14,26,40,8,26,21,13,6,51,0
5518,129429,159_07_29,SERBIA,0,TOTALS,SERBIA,200,41,74,55.4,37,62,59.7,4,12,33.3,22,33,66.7,22,38,60,19,22,19,9,10,108,0
5519,129442,159_07_29,GEORGIA,0,TOTALS,GEORGIA,200,19,65,29.2,17,53,32.1,2,12,16.7,8,17,47.1,7,14,21,3,24,20,12,2,48,1
5520,129455,159_07_30,GREECE,0,TOTALS,GREECE,200,31,64,48.4,26,46,56.5,5,18,27.8,13,22,59.1,17,27,44,18,16,14,9,3,80,1
5521,129468,159_07_30,UKRAINE,0,TOTALS,UKRAINE,200,26,67,38.8,18,41,43.9,8,26,30.8,4,14,28.6,19,18,37,11,22,14,8,1,64,0
5522,129481,159_07_31,LATVIA,0,TOTALS,LATVIA,200,18,60,30.0,14,45,31.1,4,15,26.7,18,23,78.3,8,28,36,11,27,24,11,5,58,0
5523,129494,159_07_31,LITHUANIA,0,TOTALS,LITHUANIA,200,30,69,43.5,27,55,49.1,3,14,21.4,19,35,54.3,20,34,54,13,24,22,15,5,82,1
5524,129507,159_07_32,CROATIA,0,TOTALS,CROATIA,200,24,65,36.9,21,46,45.7,3,19,15.8,14,21,66.7,12,25,37,9,22,13,3,2,65,0
5525,129520,159_07_32,TURKEY,0,TOTALS,TURKEY,200,27,59,45.8,21,39,53.8,6,20,30.0,12,20,60.0,10,26,36,10,21,13,7,4,72,1
5526,129533,159_07_33,GEORGIA,0,TOTALS,GEORGIA,200,29,71,40.8,20,54,37.0,9,17,52.9,15,27,55.6,21,32,53,12,20,24,12,8,82,1
5527,129546,159_07_33,ISRAEL,0,TOTALS,ISRAEL,200,27,65,41.5,22,49,44.9,5,16,31.2,16,25,64.0,11,26,37,10,23,20,11,2,75,0
5528,129559,159_07_34,UKRAINE,0,TOTALS,UKRAINE,200,26,72,36.1,22,51,43.1,4,21,19.0,6,12,50.0,15,18,33,7,12,19,14,1,62,0
5529,129572,159_07_34,CROATIA,0,TOTALS,CROATIA,200,32,64,50.0,20,36,55.6,12,28,42.9,8,13,61.5,18,30,48,19,19,25,8,1,84,1
5530,129585,159_07_35,LITHUANIA,0,TOTALS,LITHUANIA,200,27,67,40.3,22,52,42.3,5,15,33.3,13,25,52.0,20,35,55,10,26,19,12,3,72,1
5531,129598,159_07_35,GREECE,0,TOTALS,GREECE,200,22,65,33.8,18,49,36.7,4,16,25.0,11,27,40.7,14,27,41,8,23,15,10,6,59,0
5532,129611,159_07_36,SPAIN,0,TOTALS,SPAIN,200,23,57,40.4,18,42,42.9,5,15,33.3,14,20,70.0,15,29,44,10,20,23,10,3,65,1
5533,129624,159_07_36,FRANCE,0,TOTALS,FRANCE,200,12,62,19.4,5,29,17.2,7,33,21.2,15,19,78.9,19,18,37,7,22,24,5,1,46,0
5534,129637,159_07_37,ITALY,0,TOTALS,ITALY,200,25,71,35.2,19,52,36.5,6,19,31.6,10,17,58.8,13,22,35,9,15,8,9,2,66,0
5535,129650,159_07_37,SERBIA,0,TOTALS,SERBIA,200,34,63,54.0,28,52,53.8,6,11,54.5,12,18,66.7,10,38,48,20,19,15,6,6,86,1
5536,129663,159_07_38,LATVIA,0,TOTALS,LATVIA,200,30,67,44.8,24,41,58.5,6,26,23.1,7,11,63.6,11,29,40,15,14,11,12,1,73,1
5537,129676,159_07_38,UKRAINE,0,TOTALS,UKRAINE,200,20,59,33.9,11,31,35.5,9,28,32.1,9,14,64.3,14,28,42,10,17,21,9,2,58,0
5538,129689,159_07_39,PORTUGAL,0,TOTALS,PORTUGAL,200,18,68,26.5,13,41,31.7,5,27,18.5,13,20,65.0,12,16,28,5,22,23,18,2,54,0
5539,129702,159_07_39,SLOVENIA,0,TOTALS,SLOVENIA,200,29,58,50.0,27,52,51.9,2,6,33.3,14,23,60.9,15,37,52,20,22,34,10,4,74,1
5540,129715,159_07_40,ISRAEL,0,TOTALS,ISRAEL,200,24,64,37.5,20,48,41.7,4,16,25.0,10,16,62.5,13,29,42,10,22,28,14,3,62,0
5541,129728,159_07_40,ITALY,0,TOTALS,ITALY,200,25,63,39.7,18,42,42.9,7,21,33.3,16,23,69.6,11,27,38,17,17,20,20,7,73,1
5542,129741,159_07_41,RUSSIA,0,TOTALS,RUSSIA,200,18,69,26.1,14,31,45.2,4,38,10.5,7,12,58.3,13,29,42,6,20,11,9,2,47,0
5543,129754,159_07_41,CZECH REPUBLIC,0,TOTALS,CZECH REPUBLIC,200,21,61,34.4,15,39,38.5,6,22,27.3,14,22,63.6,11,36,47,7,16,16,5,0,62,1
5544,129767,159_07_42,FRANCE,0,TOTALS,FRANCE,200,22,62,35.5,16,36,44.4,6,26,23.1,15,25,60.0,19,35,54,14,15,20,10,0,65,1
5545,129780,159_07_42,GEORGIA,0,TOTALS,GEORGIA,200,22,58,37.9,15,36,41.7,7,22,31.8,7,13,53.8,4,25,29,12,21,17,9,6,58,0
5546,129792,159_07_43,GREECE,0,TOTALS,GREECE,200,21,59,35.6,20,44,45.5,1,15,6.7,11,16,68.8,13,21,34,9,27,21,13,6,54,0
5547,129805,159_07_43,TURKEY,0,TOTALS,TURKEY,200,20,55,36.4,15,32,46.9,5,23,21.7,19,29,65.5,15,24,39,4,18,19,14,1,64,1
5548,129818,159_07_44,SERBIA,0,TOTALS,SERBIA,200,23,60,38.3,21,46,45.7,2,14,14.3,11,19,57.9,13,33,46,11,20,22,10,6,59,1
5549,129831,159_07_44,SPAIN,0,TOTALS,SPAIN,200,19,70,27.1,17,54,31.5,2,16,12.5,8,13,61.5,19,25,44,12,18,20,9,3,48,0
5550,129844,159_07_45,CROATIA,0,TOTALS,CROATIA,200,24,76,31.6,18,56,32.1,6,20,30.0,4,12,33.3,22,16,38,10,27,16,11,1,58,0
5551,129857,159_07_45,LITHUANIA,0,TOTALS,LITHUANIA,200,36,70,51.4,31,53,58.5,5,17,29.4,15,25,60.0,21,32,53,12,13,18,8,4,92,1
5552,129870,159_07_46,PORTUGAL,0,TOTALS,PORTUGAL,200,17,59,28.8,16,42,38.1,1,17,5.9,4,9,44.4,14,26,40,6,19,33,15,2,39,0
5553,129883,159_07_46,RUSSIA,0,TOTALS,RUSSIA,200,27,59,45.8,21,37,56.8,6,22,27.3,12,24,50.0,14,29,43,14,11,24,20,2,72,1
5554,129896,159_07_47,LATVIA,0,TOTALS,LATVIA,200,20,55,36.4,12,30,40.0,8,25,32.0,23,38,60.5,17,29,46,17,13,15,9,1,71,1
5555,129909,159_07_47,ISRAEL,0,TOTALS,ISRAEL,200,25,70,35.7,19,46,41.3,6,24,25.0,6,9,66.7,16,25,41,13,28,16,11,5,62,0
5556,129922,159_07_48,SLOVENIA,0,TOTALS,SLOVENIA,200,17,63,27.0,8,34,23.5,9,29,31.0,10,12,83.3,20,13,33,11,22,17,7,3,53,0
5557,129935,159_07_48,CZECH REPUBLIC,0,TOTALS,CZECH REPUBLIC,200,24,47,51.1,21,38,55.3,3,9,33.3,8,17,47.1,8,25,33,13,19,23,8,5,59,1
5558,129948,159_07_49,GREECE,0,TOTALS,GREECE,200,21,57,36.8,18,41,43.9,3,16,18.8,14,25,56.0,18,26,44,5,14,22,10,6,59,0
5559,129961,159_07_49,ITALY,0,TOTALS,ITALY,200,28,64,43.8,23,44,52.3,5,20,25.0,13,21,61.9,18,19,37,12,22,15,11,4,74,1
5560,129974,159_07_50,FRANCE,0,TOTALS,FRANCE,200,26,67,38.8,23,49,46.9,3,18,16.7,11,17,64.7,14,25,39,11,14,12,10,0,66,1
5561,129987,159_07_50,CROATIA,0,TOTALS,CROATIA,200,24,57,42.1,15,32,46.9,9,25,36.0,6,10,60.0,6,28,34,8,17,18,5,2,63,0
5562,130000,159_07_51,TURKEY,0,TOTALS,TURKEY,200,31,73,42.5,21,38,55.3,10,35,28.6,3,7,42.9,16,22,38,11,31,16,9,1,75,0
5563,130013,159_07_51,SPAIN,0,TOTALS,SPAIN,200,26,55,47.3,16,36,44.4,10,19,52.6,19,36,52.8,15,27,42,16,17,18,9,1,81,1
5564,130026,159_07_52,GEORGIA,0,TOTALS,GEORGIA,200,15,68,22.1,14,49,28.6,1,19,5.3,9,14,64.3,17,24,41,5,20,18,6,4,40,0
5565,130039,159_07_52,UKRAINE,0,TOTALS,UKRAINE,200,25,68,36.8,19,45,42.2,6,23,26.1,15,23,65.2,19,37,56,9,15,11,7,5,71,1
5566,130052,159_07_53,SERBIA,0,TOTALS,SERBIA,200,26,63,41.3,23,47,48.9,3,16,18.8,19,35,54.3,21,28,49,13,22,15,3,8,74,1
5567,130065,159_07_53,LITHUANIA,0,TOTALS,LITHUANIA,200,23,63,36.5,20,48,41.7,3,15,20.0,15,26,57.7,12,28,40,7,29,12,8,5,64,0
5568,130078,159_07_54,GEORGIA,0,TOTALS,GEORGIA,200,24,66,36.4,18,40,45.0,6,26,23.1,10,20,50.0,16,27,43,11,26,18,4,3,64,0
5569,130091,159_07_54,ISRAEL,0,TOTALS,ISRAEL,200,29,67,43.3,26,55,47.3,3,12,25.0,16,28,57.1,21,30,51,17,19,19,12,2,77,1
5570,130104,159_07_55,UKRAINE,0,TOTALS,UKRAINE,200,20,60,33.3,15,43,34.9,5,17,29.4,12,26,46.2,17,29,46,10,21,16,10,2,57,0
5571,130117,159_07_55,LATVIA,0,TOTALS,LATVIA,200,20,64,31.2,13,37,35.1,7,27,25.9,11,19,57.9,18,30,48,9,19,17,5,2,58,1
5572,130130,159_07_56,CROATIA,0,TOTALS,CROATIA,200,18,63,28.6,15,45,33.3,3,18,16.7,16,22,72.7,20,32,52,7,21,19,8,1,55,0
5573,130143,159_07_56,GREECE,0,TOTALS,GREECE,200,22,60,36.7,18,49,36.7,4,11,36.4,14,23,60.9,12,25,37,8,23,15,13,7,62,1
5574,130156,159_07_57,FRANCE,0,TOTALS,FRANCE,200,15,62,24.2,12,30,40.0,3,32,9.4,8,13,61.5,15,26,41,9,18,14,11,1,41,0
5575,130169,159_07_57,ITALY,0,TOTALS,ITALY,200,17,51,33.3,13,34,38.2,4,17,23.5,12,19,63.2,10,30,40,6,14,16,9,3,50,1
5576,130182,159_07_58,LITHUANIA,0,TOTALS,LITHUANIA,200,22,70,31.4,17,51,33.3,5,19,26.3,16,25,64.0,23,30,53,12,16,22,5,6,65,1
5577,130195,159_07_58,TURKEY,0,TOTALS,TURKEY,200,21,67,31.3,17,46,37.0,4,21,19.0,9,19,47.4,20,25,45,12,26,21,15,4,55,0
5578,130208,159_07_59,SERBIA,0,TOTALS,SERBIA,200,21,56,37.5,19,43,44.2,2,13,15.4,12,25,48.0,14,35,49,14,19,18,9,8,56,1
5579,130221,159_07_59,SPAIN,0,TOTALS,SPAIN,200,21,64,32.8,20,51,39.2,1,13,7.7,12,21,57.1,11,26,37,10,21,13,11,0,55,0
5580,130234,160_07_01,SWEDEN,0,TOTALS,SWEDEN,200,31,69,44.9,30,55,54.5,1,14,7.1,12,18,66.7,17,32,49,9,22,19,8,2,75,1
5581,130247,160_07_01,ROMANIA,0,TOTALS,ROMANIA,200,19,63,30.2,17,49,34.7,2,14,14.3,15,25,60.0,11,14,25,7,16,14,6,4,55,0
5582,130260,160_07_02,MONTENEGRO,0,TOTALS,MONTENEGRO,200,41,73,56.2,36,55,65.5,5,18,27.8,10,16,62.5,13,18,31,18,19,17,12,5,97,1
5583,130273,160_07_02,FINLAND,0,TOTALS,FINLAND,200,25,68,36.8,20,46,43.5,5,22,22.7,11,16,68.8,15,16,31,11,15,15,10,1,66,0
5584,130286,160_07_03,NETHERLANDS,0,TOTALS,NETHERLANDS,200,29,69,42.0,23,48,47.9,6,21,28.6,16,26,61.5,12,24,36,7,28,20,15,0,80,0
5585,130299,160_07_03,HUNGARY,0,TOTALS,HUNGARY,200,32,63,50.8,30,55,54.5,2,8,25.0,19,32,59.4,11,29,40,20,20,24,7,6,85,1
5586,130312,160_07_04,NORWAY,0,TOTALS,NORWAY,200,18,64,28.1,8,38,21.1,10,26,38.5,13,19,68.4,12,10,22,7,20,19,9,1,59,0
5587,130325,160_07_04,GERMANY,0,TOTALS,GERMANY,200,30,67,44.8,22,44,50.0,8,23,34.8,19,25,76.0,19,31,50,14,20,25,14,1,87,1
5588,130338,160_07_05,BELGIUM,0,TOTALS,BELGIUM,200,40,72,55.6,32,54,59.3,8,18,44.4,18,21,85.7,10,31,41,19,26,11,9,3,106,0
5589,130351,160_07_05,BELARUS,0,TOTALS,BELARUS,200,29,68,42.6,21,54,38.9,8,14,57.1,16,33,48.5,14,20,34,9,18,20,5,3,82,1
5590,130364,160_07_06,BOSNIA AND HERZEGOVINA,0,TOTALS,BOSNIA AND HERZEGOVINA,200,104,126,82.5,102,120,85.0,2,6,33.3,26,47,55.3,20,31,51,35,31,16,52,1,236,0
5591,130377,160_07_06,ARMENIA,0,TOTALS,ARMENIA,200,8,41,19.5,8,34,23.5,0,7,0.0,11,32,34.4,6,8,14,4,35,77,7,1,27,1
5592,130390,160_07_07,POLAND,0,TOTALS,POLAND,200,30,69,43.5,27,56,48.2,3,13,23.1,24,39,61.5,19,45,64,11,23,22,7,2,87,1
5593,130403,160_07_07,CYPRUS,0,TOTALS,CYPRUS,200,18,75,24.0,15,59,25.4,3,16,18.8,12,25,48.0,10,25,35,5,30,14,13,2,51,0
5594,130416,160_07_08,IRELAND,0,TOTALS,IRELAND,200,14,56,25.0,9,33,27.3,5,23,21.7,10,16,62.5,6,24,30,4,21,25,6,2,43,0
5595,130429,160_07_08,AUSTRIA,0,TOTALS,AUSTRIA,200,32,69,46.4,26,53,49.1,6,16,37.5,19,26,73.1,9,35,44,7,17,15,16,0,89,1
5596,130442,160_07_09,SLOVAK REPUBLIC,0,TOTALS,SLOVAK REPUBLIC,200,34,69,49.3,27,52,51.9,7,17,41.2,25,37,67.6,17,23,40,17,20,9,14,5,100,0
5597,130455,160_07_09,MKD,0,TOTALS,MKD,200,27,66,40.9,23,54,42.6,4,12,33.3,13,26,50.0,17,22,39,7,28,25,3,1,71,1
5598,130468,160_07_10,ENGLAND,0,TOTALS,ENGLAND,200,28,69,40.6,23,48,47.9,5,21,23.8,18,27,66.7,16,29,45,14,23,25,11,7,79,1
5599,130481,160_07_10,BOSNIA AND HERZEGOVINA,0,TOTALS,BOSNIA AND HERZEGOVINA,200,24,72,33.3,19,51,37.3,5,21,23.8,12,22,54.5,15,27,42,9,23,25,11,2,65,0
5600,130494,160_07_11,ESTONIA,0,TOTALS,ESTONIA,200,30,69,43.5,22,42,52.4,8,27,29.6,2,2,100.0,10,12,22,11,30,8,12,0,70,0
5601,130507,160_07_11,POLAND,0,TOTALS,POLAND,200,25,48,52.1,20,32,62.5,5,16,31.2,19,31,61.3,11,23,34,4,11,20,1,6,74,1
5602,130520,160_07_12,ARMENIA,0,TOTALS,ARMENIA,200,16,59,27.1,14,48,29.2,2,11,18.2,1,9,11.1,13,15,28,6,20,30,7,1,35,1
5603,130533,160_07_12,IRELAND,0,TOTALS,IRELAND,200,53,92,57.6,48,76,63.2,5,16,31.2,13,30,43.3,20,33,53,15,7,17,23,3,124,0
5604,130546,160_07_13,CYPRUS,0,TOTALS,CYPRUS,200,26,70,37.1,22,53,41.5,4,17,23.5,17,27,63.0,14,22,36,9,23,16,11,0,73,1
5605,130559,160_07_13,SLOVAK REPUBLIC,0,TOTALS,SLOVAK REPUBLIC,200,24,64,37.5,17,33,51.5,7,31,22.6,15,18,83.3,18,22,40,11,26,22,5,5,70,0
5606,130572,160_07_14,FINLAND,0,TOTALS,FINLAND,200,22,62,35.5,16,40,40.0,6,22,27.3,16,25,64.0,12,18,30,9,18,17,13,1,66,1
5607,130585,160_07_14,SWEDEN,0,TOTALS,SWEDEN,200,19,59,32.2,13,46,28.3,6,13,46.2,18,24,75.0,13,30,43,8,24,24,12,2,62,0
5608,130598,160_07_15,BELARUS,0,TOTALS,BELARUS,200,26,66,39.4,21,43,48.8,5,23,21.7,9,15,60.0,11,20,31,12,13,27,12,9,66,0
5609,130611,160_07_15,NETHERLANDS,0,TOTALS,NETHERLANDS,200,39,74,52.7,32,58,55.2,7,16,43.8,4,16,25.0,16,25,41,13,14,28,12,1,89,1
5610,130624,160_07_16,GERMANY,0,TOTALS,GERMANY,200,24,62,38.7,20,44,45.5,4,18,22.2,13,15,86.7,15,26,41,5,22,33,7,4,65,0
5611,130637,160_07_16,MONTENEGRO,0,TOTALS,MONTENEGRO,200,37,80,46.2,30,53,56.6,7,27,25.9,15,21,71.4,7,18,25,14,21,12,24,6,96,1
5612,130650,160_07_17,BULGARIA,0,TOTALS,BULGARIA,200,29,65,44.6,25,41,61.0,4,24,16.7,19,26,73.1,10,16,26,11,12,10,10,7,81,1
5613,130663,160_07_17,BELGIUM,0,TOTALS,BELGIUM,200,33,67,49.3,27,54,50.0,6,13,46.2,4,5,80.0,15,22,37,15,17,21,10,4,76,0
5614,130676,160_07_18,ROMANIA,0,TOTALS,ROMANIA,200,34,76,44.7,33,54,61.1,1,22,4.5,11,17,64.7,15,29,44,12,16,16,8,8,80,0
5615,130689,160_07_18,NORWAY,0,TOTALS,NORWAY,200,34,80,42.5,22,45,48.9,12,35,34.3,8,18,44.4,11,25,36,10,22,15,13,1,88,1
5616,130702,160_07_19,AUSTRIA,0,TOTALS,AUSTRIA,200,60,95,63.2,51,77,66.2,9,18,50.0,8,12,66.7,18,40,58,40,5,8,24,3,137,0
5617,130715,160_07_19,ARMENIA,0,TOTALS,ARMENIA,200,12,59,20.3,11,50,22.0,1,9,11.1,1,5,20.0,6,15,21,3,13,30,4,2,26,1
5618,130728,160_07_20,HUNGARY,0,TOTALS,HUNGARY,200,25,78,32.1,20,58,34.5,5,20,25.0,23,29,79.3,16,33,49,11,13,23,15,5,78,1
5619,130741,160_07_20,BELARUS,0,TOTALS,BELARUS,200,24,79,30.4,20,59,33.9,4,20,20.0,6,12,50.0,13,25,38,10,24,22,13,6,58,0
5620,130754,160_07_21,NORWAY,0,TOTALS,NORWAY,200,19,69,27.5,15,39,38.5,4,30,13.3,12,17,70.6,10,16,26,5,16,15,14,4,54,0
5621,130767,160_07_21,SWEDEN,0,TOTALS,SWEDEN,200,33,69,47.8,24,48,50.0,9,21,42.9,11,16,68.8,17,32,49,19,11,24,8,3,86,1
5622,130780,160_07_22,NETHERLANDS,0,TOTALS,NETHERLANDS,200,41,90,45.6,36,72,50.0,5,18,27.8,9,20,45.0,27,34,61,14,16,16,17,1,96,1
5623,130793,160_07_22,BULGARIA,0,TOTALS,BULGARIA,200,26,67,38.8,19,43,44.2,7,24,29.2,7,14,50.0,7,21,28,9,18,24,8,6,66,0
5624,130806,160_07_23,MONTENEGRO,0,TOTALS,MONTENEGRO,200,42,82,51.2,35,61,57.4,7,21,33.3,15,20,75.0,16,25,41,18,13,20,24,7,106,0
5625,130819,160_07_23,ROMANIA,0,TOTALS,ROMANIA,200,19,57,33.3,16,41,39.0,3,16,18.8,9,15,60.0,11,22,33,10,14,39,7,3,50,1
5626,130832,160_07_24,MKD,0,TOTALS,MKD,200,20,67,29.9,15,43,34.9,5,24,20.8,8,14,57.1,18,26,44,6,27,23,9,6,53,0
5627,130845,160_07_24,CYPRUS,0,TOTALS,CYPRUS,200,20,59,33.9,17,45,37.8,3,14,21.4,16,34,47.1,14,29,43,3,21,28,15,2,59,1
5628,130858,160_07_25,IRELAND,0,TOTALS,IRELAND,200,19,60,31.7,16,39,41.0,3,21,14.3,7,13,53.8,10,21,31,7,11,32,6,1,48,0
5629,130871,160_07_25,ENGLAND,0,TOTALS,ENGLAND,200,39,75,52.0,33,54,61.1,6,21,28.6,4,5,80.0,9,28,37,20,16,18,20,9,88,1
5630,130884,160_07_26,SLOVAK REPUBLIC,0,TOTALS,SLOVAK REPUBLIC,200,22,66,33.3,16,44,36.4,6,22,27.3,18,28,64.3,15,26,41,4,22,14,4,2,68,0
5631,130897,160_07_26,ESTONIA,0,TOTALS,ESTONIA,200,27,69,39.1,20,45,44.4,7,24,29.2,15,27,55.6,14,27,41,8,25,11,8,2,76,1
5632,130910,160_07_27,GERMANY,0,TOTALS,GERMANY,200,21,57,36.8,15,39,38.5,6,18,33.3,9,15,60.0,9,29,38,8,18,21,3,3,57,0
5633,130923,160_07_27,FINLAND,0,TOTALS,FINLAND,200,25,72,34.7,17,38,44.7,8,34,23.5,4,8,50.0,12,27,39,15,19,11,10,1,62,1
5634,130936,160_07_28,BOSNIA AND HERZEGOVINA,0,TOTALS,BOSNIA AND HERZEGOVINA,200,40,78,51.3,38,68,55.9,2,10,20.0,16,33,48.5,19,25,44,10,18,20,19,1,98,1
5635,130949,160_07_28,IRELAND,0,TOTALS,IRELAND,200,22,54,40.7,15,32,46.9,7,22,31.8,8,14,57.1,11,22,33,9,25,38,8,2,59,0
5636,130962,160_07_29,BELGIUM,0,TOTALS,BELGIUM,200,30,62,48.4,21,41,51.2,9,21,42.9,14,19,73.7,10,24,34,15,27,25,10,2,83,0
5637,130975,160_07_29,NETHERLANDS,0,TOTALS,NETHERLANDS,200,33,57,57.9,29,44,65.9,4,13,30.8,22,39,56.4,8,22,30,12,20,21,11,1,92,1
5638,130988,160_07_30,ENGLAND,0,TOTALS,ENGLAND,200,26,64,40.6,22,47,46.8,4,17,23.5,8,16,50.0,15,20,35,8,14,18,11,4,64,1
5639,131001,160_07_30,AUSTRIA,0,TOTALS,AUSTRIA,200,22,61,36.1,15,36,41.7,7,25,28.0,5,9,55.6,11,25,36,4,19,25,13,0,56,0
5640,131014,160_07_31,POLAND,0,TOTALS,POLAND,200,37,70,52.9,35,59,59.3,2,11,18.2,26,39,66.7,16,28,44,19,22,28,18,4,102,0
5641,131027,160_07_31,SLOVAK REPUBLIC,0,TOTALS,SLOVAK REPUBLIC,200,30,78,38.5,23,54,42.6,7,24,29.2,16,28,57.1,18,20,38,10,28,27,16,7,83,1
5642,131040,160_07_32,FINLAND,0,TOTALS,FINLAND,200,24,79,30.4,14,53,26.4,10,26,38.5,7,15,46.7,21,17,38,10,14,21,15,4,65,1
5643,131053,160_07_32,NORWAY,0,TOTALS,NORWAY,200,21,52,40.4,16,39,41.0,5,13,38.5,8,12,66.7,11,26,37,5,20,26,12,10,55,0
5644,131066,160_07_33,ESTONIA,0,TOTALS,ESTONIA,200,23,61,37.7,17,33,51.5,6,28,21.4,14,23,60.9,14,20,34,7,18,13,7,3,66,1
5645,131079,160_07_33,MKD,0,TOTALS,MKD,200,18,58,31.0,14,40,35.0,4,18,22.2,10,13,76.9,14,24,38,9,21,20,6,3,50,0
5646,131092,160_07_34,ROMANIA,0,TOTALS,ROMANIA,200,19,62,30.6,15,45,33.3,4,17,23.5,7,12,58.3,13,20,33,7,13,17,4,4,49,0
5647,131105,160_07_34,GERMANY,0,TOTALS,GERMANY,200,29,67,43.3,21,42,50.0,8,25,32.0,9,13,69.2,12,28,40,13,13,12,9,4,75,1
5648,131118,160_07_35,BULGARIA,0,TOTALS,BULGARIA,200,27,63,42.9,20,41,48.8,7,22,31.8,13,19,68.4,7,22,29,19,23,31,14,4,74,0
5649,131131,160_07_35,HUNGARY,0,TOTALS,HUNGARY,200,37,75,49.3,33,63,52.4,4,12,33.3,19,31,61.3,16,32,48,19,18,22,20,6,97,1
5650,131144,160_07_36,SWEDEN,0,TOTALS,SWEDEN,200,27,53,50.9,25,42,59.5,2,11,18.2,25,39,64.1,5,28,33,11,13,25,10,2,81,1
5651,131157,160_07_36,MONTENEGRO,0,TOTALS,MONTENEGRO,200,30,83,36.1,21,50,42.0,9,33,27.3,2,3,66.7,21,17,38,14,31,16,9,3,71,0
5652,131170,160_07_37,ROMANIA,0,TOTALS,ROMANIA,200,33,64,51.6,31,56,55.4,2,8,25.0,7,11,63.6,11,19,30,9,11,17,3,2,75,0
5653,131183,160_07_37,FINLAND,0,TOTALS,FINLAND,200,41,74,55.4,30,48,62.5,11,26,42.3,5,10,50.0,10,19,29,15,10,7,8,1,98,1
5654,131196,160_07_38,CYPRUS,0,TOTALS,CYPRUS,225,23,56,41.1,17,35,48.6,6,21,28.6,9,21,42.9,10,20,30,11,15,15,8,1,61,1
5655,131209,160_07_38,ESTONIA,0,TOTALS,ESTONIA,225,23,64,35.9,16,30,53.3,7,34,20.6,5,10,50.0,16,25,41,10,25,23,6,1,58,0
5656,131222,160_07_39,MONTENEGRO,0,TOTALS,MONTENEGRO,200,35,80,43.8,25,52,48.1,10,28,35.7,23,32,71.9,19,35,54,16,22,25,17,6,103,0
5657,131235,160_07_39,NORWAY,0,TOTALS,NORWAY,200,19,64,29.7,11,32,34.4,8,32,25.0,14,18,77.8,6,19,25,7,22,29,13,4,60,1
5658,131248,160_07_40,HUNGARY,0,TOTALS,HUNGARY,200,22,67,32.8,17,51,33.3,5,16,31.2,19,27,70.4,13,13,26,7,18,22,13,3,68,0
5659,131261,160_07_40,BELGIUM,0,TOTALS,BELGIUM,200,29,58,50.0,22,36,61.1,7,22,31.8,13,17,76.5,13,28,41,19,23,26,8,4,78,1
5660,131274,160_07_41,GERMANY,0,TOTALS,GERMANY,200,21,49,42.9,20,42,47.6,1,7,14.3,10,19,52.6,6,26,32,6,20,16,4,0,53,0
5661,131287,160_07_41,SWEDEN,0,TOTALS,SWEDEN,200,32,71,45.1,25,51,49.0,7,20,35.0,7,14,50.0,8,24,32,11,14,9,12,2,78,1
5662,131300,160_07_42,BELARUS,0,TOTALS,BELARUS,200,39,81,48.1,30,62,48.4,9,19,47.4,10,23,43.5,20,33,53,20,17,27,17,7,97,1
5663,131313,160_07_42,BULGARIA,0,TOTALS,BULGARIA,200,30,77,39.0,22,58,37.9,8,19,42.1,12,19,63.2,16,27,43,16,20,28,16,3,80,0
5664,131326,160_07_43,ARMENIA,0,TOTALS,ARMENIA,200,11,50,22.0,10,38,26.3,1,12,8.3,1,6,16.7,6,13,19,1,13,31,4,0,24,1
5665,131339,160_07_43,ENGLAND,0,TOTALS,ENGLAND,200,61,98,62.2,55,88,62.5,6,10,60.0,11,22,50.0,25,28,53,22,11,15,31,8,139,0
5666,131352,160_07_44,MKD,0,TOTALS,MKD,200,20,65,30.8,17,49,34.7,3,16,18.8,6,15,40.0,18,19,37,9,21,34,10,3,49,0
5667,131365,160_07_44,POLAND,0,TOTALS,POLAND,200,36,73,49.3,29,48,60.4,7,25,28.0,19,27,70.4,18,29,47,21,12,21,21,5,98,1
5668,131378,160_07_45,AUSTRIA,0,TOTALS,AUSTRIA,200,20,58,34.5,18,41,43.9,2,17,11.8,11,13,84.6,8,14,22,9,24,20,12,0,53,0
5669,131391,160_07_45,BOSNIA AND HERZEGOVINA,0,TOTALS,BOSNIA AND HERZEGOVINA,200,31,58,53.4,29,50,58.0,2,8,25.0,23,30,76.7,13,29,42,8,18,18,13,1,87,1
5670,131404,160_07_46,MONTENEGRO,0,TOTALS,MONTENEGRO,200,33,57,57.9,24,38,63.2,9,19,47.4,12,19,63.2,7,16,23,18,13,15,7,4,87,1
5671,131417,160_07_46,BOSNIA AND HERZEGOVINA,0,TOTALS,BOSNIA AND HERZEGOVINA,200,22,56,39.3,20,38,52.6,2,18,11.1,8,12,66.7,8,9,17,6,20,12,10,1,54,0
5672,131430,160_07_47,FINLAND,0,TOTALS,FINLAND,200,39,75,52.0,33,60,55.0,6,15,40.0,14,19,73.7,14,38,52,22,19,25,13,4,98,1
5673,131443,160_07_47,IRELAND,0,TOTALS,IRELAND,200,15,64,23.4,13,52,25.0,2,12,16.7,7,13,53.8,9,19,28,5,22,30,13,0,39,0
5674,131456,160_07_48,SWEDEN,0,TOTALS,SWEDEN,200,30,65,46.2,24,45,53.3,6,20,30.0,15,24,62.5,18,23,41,10,18,20,8,1,81,1
5675,131469,160_07_48,ENGLAND,0,TOTALS,ENGLAND,200,23,66,34.8,17,52,32.7,6,14,42.9,12,18,66.7,16,15,31,8,24,15,12,6,64,0
5676,131482,160_07_49,GERMANY,0,TOTALS,GERMANY,200,28,59,47.5,18,42,42.9,10,17,58.8,28,43,65.1,12,22,34,18,25,19,12,2,94,1
5677,131495,160_07_49,AUSTRIA,0,TOTALS,AUSTRIA,200,28,61,45.9,20,40,50.0,8,21,38.1,14,28,50.0,13,23,36,12,28,19,6,2,78,0
5678,131508,160_07_50,HUNGARY,0,TOTALS,HUNGARY,200,21,68,30.9,20,53,37.7,1,15,6.7,16,25,64.0,24,27,51,11,15,23,9,9,59,1
5679,131521,160_07_50,CYPRUS,0,TOTALS,CYPRUS,200,23,62,37.1,17,48,35.4,6,14,42.9,5,14,35.7,11,22,33,13,20,25,14,6,57,0
5680,131534,160_07_51,BELGIUM,0,TOTALS,BELGIUM,200,36,77,46.8,31,61,50.8,5,16,31.2,14,16,87.5,17,25,42,15,18,18,8,2,91,1
5681,131547,160_07_51,SLOVAK REPUBLIC,0,TOTALS,SLOVAK REPUBLIC,200,28,72,38.9,21,58,36.2,7,14,50.0,17,23,73.9,14,21,35,4,13,16,6,7,80,0
5682,131560,160_07_52,NETHERLANDS,0,TOTALS,NETHERLANDS,200,30,81,37.0,25,57,43.9,5,24,20.8,18,25,72.0,14,30,44,15,31,19,11,5,83,0
5683,131573,160_07_52,POLAND,0,TOTALS,POLAND,200,32,74,43.2,27,54,50.0,5,20,25.0,22,42,52.4,20,37,57,16,17,22,10,6,91,1
5684,131586,160_07_53,BELARUS,0,TOTALS,BELARUS,200,23,56,41.1,15,34,44.1,8,22,36.4,6,16,37.5,11,16,27,8,21,26,17,8,60,0
5685,131599,160_07_53,ESTONIA,0,TOTALS,ESTONIA,200,22,60,36.7,12,38,31.6,10,22,45.5,11,20,55.0,18,23,41,12,16,28,17,4,65,1
5686,131612,160_07_54,ROMANIA,0,TOTALS,ROMANIA,200,41,84,48.8,36,66,54.5,5,18,27.8,13,22,59.1,20,44,64,23,10,27,19,13,100,0
5687,131625,160_07_54,ARMENIA,0,TOTALS,ARMENIA,200,17,77,22.1,15,66,22.7,2,11,18.2,2,7,28.6,11,22,33,5,15,32,12,3,38,1
5688,131638,160_07_55,BULGARIA,0,TOTALS,BULGARIA,200,14,54,25.9,11,33,33.3,3,21,14.3,19,27,70.4,15,19,34,7,19,25,4,2,50,0
5689,131651,160_07_55,MKD,0,TOTALS,MKD,200,36,71,50.7,34,58,58.6,2,13,15.4,15,25,60.0,17,29,46,14,22,15,14,4,89,1
5690,131664,160_07_56,CYPRUS,0,TOTALS,CYPRUS,200,17,49,34.7,14,38,36.8,3,11,27.3,2,7,28.6,6,20,26,9,17,24,8,2,39,0
5691,131677,160_07_56,NETHERLANDS,0,TOTALS,NETHERLANDS,200,16,51,31.4,14,35,40.0,2,16,12.5,16,18,88.9,15,27,42,6,15,23,11,3,50,1
5692,131690,160_07_57,ARMENIA,0,TOTALS,ARMENIA,200,8,58,13.8,7,49,14.3,1,9,11.1,10,16,62.5,10,28,38,1,15,39,5,5,27,1
5693,131703,160_07_57,NORWAY,0,TOTALS,NORWAY,200,48,109,44.0,43,82,52.4,5,27,18.5,5,12,41.7,28,38,66,20,16,15,29,2,106,0
5694,131716,160_07_58,POLAND,0,TOTALS,POLAND,200,31,75,41.3,27,55,49.1,4,20,20.0,13,20,65.0,14,32,46,10,17,20,7,6,79,0
5695,131729,160_07_58,HUNGARY,0,TOTALS,HUNGARY,200,39,83,47.0,35,66,53.0,4,17,23.5,10,15,66.7,15,28,43,24,16,15,11,6,92,1
5696,131742,160_07_59,SLOVAK REPUBLIC,0,TOTALS,SLOVAK REPUBLIC,200,36,82,43.9,34,68,50.0,2,14,14.3,23,36,63.9,16,28,44,15,27,17,18,7,97,1
5697,131755,160_07_59,BELARUS,0,TOTALS,BELARUS,200,20,68,29.4,18,56,32.1,2,12,16.7,19,33,57.6,17,31,48,7,27,29,8,6,61,0
5698,131768,160_07_60,ESTONIA,0,TOTALS,ESTONIA,200,21,52,40.4,16,37,43.2,5,15,33.3,16,24,66.7,11,22,33,6,19,21,13,4,63,1
5699,131781,160_07_60,BELGIUM,0,TOTALS,BELGIUM,200,19,47,40.4,15,33,45.5,4,14,28.6,16,21,76.2,6,19,25,7,22,22,7,5,58,0
5700,131794,160_07_61,BOSNIA AND HERZEGOVINA,0,TOTALS,BOSNIA AND HERZEGOVINA,200,23,74,31.1,20,60,33.3,3,14,21.4,16,25,64.0,15,23,38,4,29,21,15,5,65,0
5701,131807,160_07_61,SWEDEN,0,TOTALS,SWEDEN,200,22,61,36.1,14,42,33.3,8,19,42.1,23,35,65.7,19,33,52,12,21,32,8,4,75,1
5702,131820,160_07_62,IRELAND,0,TOTALS,IRELAND,200,14,57,24.6,8,32,25.0,6,25,24.0,2,9,22.2,6,23,29,11,21,33,7,3,36,0
5703,131833,160_07_62,GERMANY,0,TOTALS,GERMANY,200,34,73,46.6,32,57,56.1,2,16,12.5,12,18,66.7,13,36,49,15,13,19,20,3,82,1
5704,131846,160_07_63,ENGLAND,0,TOTALS,ENGLAND,200,22,69,31.9,17,50,34.0,5,19,26.3,15,19,78.9,18,32,50,11,20,31,12,4,64,1
5705,131859,160_07_63,MONTENEGRO,0,TOTALS,MONTENEGRO,200,24,68,35.3,19,41,46.3,5,27,18.5,8,16,50.0,12,28,40,10,25,26,9,10,61,0
5706,131872,160_07_64,AUSTRIA,0,TOTALS,AUSTRIA,200,25,61,41.0,22,46,47.8,3,15,20.0,9,17,52.9,15,20,35,8,19,26,9,3,62,0
5707,131885,160_07_64,FINLAND,0,TOTALS,FINLAND,200,23,57,40.4,17,34,50.0,6,23,26.1,11,18,61.1,11,23,34,12,17,23,11,2,63,1
5708,131898,160_07_65,MKD,0,TOTALS,MKD,200,36,71,50.7,35,63,55.6,1,8,12.5,15,23,65.2,15,27,42,10,19,11,12,8,88,1
5709,131911,160_07_65,ROMANIA,0,TOTALS,ROMANIA,200,18,72,25.0,16,57,28.1,2,15,13.3,11,19,57.9,23,19,42,2,17,19,8,6,49,0
5710,131924,160_07_66,FINLAND,0,TOTALS,FINLAND,200,24,64,37.5,19,41,46.3,5,23,21.7,11,19,57.9,7,23,30,13,9,17,11,5,64,0
5711,131937,160_07_66,BELGIUM,0,TOTALS,BELGIUM,200,29,71,40.8,24,48,50.0,5,23,21.7,3,4,75.0,17,33,50,16,21,25,10,2,66,1
5712,131950,160_07_67,NORWAY,0,TOTALS,NORWAY,200,25,77,32.5,20,50,40.0,5,27,18.5,22,34,64.7,13,18,31,6,18,22,11,2,77,0
5713,131963,160_07_67,BULGARIA,0,TOTALS,BULGARIA,200,36,77,46.8,33,60,55.0,3,17,17.6,11,17,64.7,16,34,50,9,30,27,15,5,86,1
5714,131976,160_07_68,NETHERLANDS,0,TOTALS,NETHERLANDS,200,24,67,35.8,18,50,36.0,6,17,35.3,10,17,58.8,8,22,30,16,27,23,8,3,64,0
5715,131989,160_07_68,BOSNIA AND HERZEGOVINA,0,TOTALS,BOSNIA AND HERZEGOVINA,200,27,71,38.0,26,60,43.3,1,11,9.1,29,37,78.4,20,36,56,5,22,22,14,5,84,1
5716,132002,160_07_69,SLOVAK REPUBLIC,0,TOTALS,SLOVAK REPUBLIC,200,44,92,47.8,39,72,54.2,5,20,25.0,19,25,76.0,23,32,55,10,19,17,10,8,112,0
5717,132015,160_07_69,IRELAND,0,TOTALS,IRELAND,200,23,69,33.3,17,51,33.3,6,18,33.3,15,23,65.2,9,21,30,6,20,26,7,1,67,1
5718,132028,160_07_70,MONTENEGRO,0,TOTALS,MONTENEGRO,200,22,57,38.6,12,28,42.9,10,29,34.5,14,24,58.3,11,24,35,17,22,25,12,6,68,1
5719,132041,160_07_70,CYPRUS,0,TOTALS,CYPRUS,200,23,62,37.1,20,47,42.6,3,15,20.0,9,15,60.0,17,24,41,13,21,26,15,1,58,0
5720,132054,160_07_71,AUSTRIA,0,TOTALS,AUSTRIA,200,27,66,40.9,22,53,41.5,5,13,38.5,18,26,69.2,14,28,42,11,14,20,6,3,77,1
5721,132067,160_07_71,BELARUS,0,TOTALS,BELARUS,200,29,79,36.7,25,58,43.1,4,21,19.0,11,21,52.4,19,27,46,9,21,15,15,7,73,0
5722,132080,160_07_72,HUNGARY,0,TOTALS,HUNGARY,200,35,65,53.8,24,43,55.8,11,22,50.0,20,26,76.9,7,26,33,22,11,14,4,2,101,0
5723,132093,160_07_72,ENGLAND,0,TOTALS,ENGLAND,200,32,71,45.1,27,50,54.0,5,21,23.8,8,10,80.0,8,24,32,16,23,16,9,1,77,1
5724,132106,160_07_73,ESTONIA,0,TOTALS,ESTONIA,200,23,56,41.1,17,30,56.7,6,26,23.1,3,5,60.0,9,18,27,2,16,20,11,1,55,0
5725,132119,160_07_73,GERMANY,0,TOTALS,GERMANY,200,25,55,45.5,19,35,54.3,6,20,30.0,11,14,78.6,5,18,23,8,9,17,8,2,67,1
5726,132132,160_07_74,SWEDEN,0,TOTALS,SWEDEN,200,24,66,36.4,20,52,38.5,4,14,28.6,15,21,71.4,12,28,40,15,18,18,10,5,67,0
5727,132145,160_07_74,POLAND,0,TOTALS,POLAND,200,31,69,44.9,27,52,51.9,4,17,23.5,3,11,27.3,14,30,44,11,18,19,6,6,69,1
5728,132158,160_07_75,ROMANIA,0,TOTALS,ROMANIA,200,32,70,45.7,26,49,53.1,6,21,28.6,15,21,71.4,14,28,42,11,14,18,13,7,85,1
5729,132171,160_07_75,NORWAY,0,TOTALS,NORWAY,200,20,62,32.3,14,40,35.0,6,22,27.3,16,26,61.5,11,21,32,8,15,24,10,1,62,0
5730,132184,160_07_76,GERMANY,0,TOTALS,GERMANY,200,23,52,44.2,20,38,52.6,3,14,21.4,15,20,75.0,9,27,36,12,14,26,12,1,64,0
5731,132197,160_07_76,BELGIUM,0,TOTALS,BELGIUM,200,32,76,42.1,22,53,41.5,10,23,43.5,4,9,44.4,18,19,37,17,15,18,14,0,78,1
5732,132210,160_07_77,MKD,0,TOTALS,MKD,200,22,70,31.4,19,55,34.5,3,15,20.0,15,21,71.4,15,27,42,5,13,14,4,4,62,0
5733,132223,160_07_77,BULGARIA,0,TOTALS,BULGARIA,200,34,74,45.9,28,55,50.9,6,19,31.6,10,14,71.4,12,33,45,16,14,13,7,5,84,1
5734,132236,160_07_78,NETHERLANDS,0,TOTALS,NETHERLANDS,200,28,70,40.0,20,46,43.5,8,24,33.3,13,22,59.1,19,25,44,17,17,18,14,2,77,1
5735,132249,160_07_78,CYPRUS,0,TOTALS,CYPRUS,200,21,62,33.9,18,46,39.1,3,16,18.8,6,11,54.5,12,22,34,8,14,27,9,4,51,0
5736,132262,160_07_79,IRELAND,0,TOTALS,IRELAND,200,19,68,27.9,6,41,14.6,13,27,48.1,5,10,50.0,13,20,33,14,29,22,7,0,56,0
5737,132275,160_07_79,BELARUS,0,TOTALS,BELARUS,200,24,68,35.3,20,55,36.4,4,13,30.8,20,34,58.8,22,33,55,11,13,17,8,6,72,1
5738,132288,160_07_80,BOSNIA AND HERZEGOVINA,0,TOTALS,BOSNIA AND HERZEGOVINA,200,32,64,50.0,30,58,51.7,2,6,33.3,20,25,80.0,13,22,35,10,22,23,16,2,86,1
5739,132301,160_07_80,MONTENEGRO,0,TOTALS,MONTENEGRO,200,30,63,47.6,22,36,61.1,8,27,29.6,12,20,60.0,13,20,33,17,25,25,15,3,80,0
5740,132314,160_07_81,SLOVAK REPUBLIC,0,TOTALS,SLOVAK REPUBLIC,200,31,73,42.5,20,44,45.5,11,29,37.9,2,9,22.2,8,20,28,7,18,12,5,3,75,1
5741,132327,160_07_81,AUSTRIA,0,TOTALS,AUSTRIA,200,31,65,47.7,28,52,53.8,3,13,23.1,9,15,60.0,8,32,40,14,13,14,3,4,74,0
5742,132340,160_07_82,ENGLAND,0,TOTALS,ENGLAND,225,22,57,38.6,21,51,41.2,1,6,16.7,20,31,64.5,8,26,34,8,22,20,12,1,65,0
5743,132353,160_07_82,SWEDEN,0,TOTALS,SWEDEN,225,22,60,36.7,15,40,37.5,7,20,35.0,15,21,71.4,9,23,32,10,20,21,9,5,66,1
5744,132366,160_07_83,ESTONIA,0,TOTALS,ESTONIA,200,20,57,35.1,16,38,42.1,4,19,21.1,7,14,50.0,8,22,30,6,28,19,10,6,51,0
5745,132379,160_07_83,FINLAND,0,TOTALS,FINLAND,200,14,50,28.0,9,31,29.0,5,19,26.3,20,30,66.7,10,28,38,9,18,21,9,4,53,1
5746,132392,160_07_84,HUNGARY,0,TOTALS,HUNGARY,200,28,70,40.0,25,49,51.0,3,21,14.3,14,21,66.7,17,23,40,14,22,26,12,9,73,0
5747,132405,160_07_84,POLAND,0,TOTALS,POLAND,200,29,70,41.4,23,55,41.8,6,15,40.0,16,24,66.7,20,26,46,19,22,26,11,3,80,1
5748,135278,163_07_01,AUSTRALIA,0,TOTALS,AUSTRALIA,200,27,69,39.1,18,49,36.7,9,20,45.0,16,22,72.7,9,21,30,13,22,7,5,2,79,1
5749,135291,163_07_01,NEW ZEALAND,0,TOTALS,NEW ZEALAND,200,21,51,41.2,12,24,50.0,9,27,33.3,16,25,64.0,4,31,35,11,26,18,0,2,67,0
5750,135304,163_07_02,NEW ZEALAND,0,TOTALS,NEW ZEALAND,200,24,57,42.1,18,29,62.1,6,28,21.4,13,25,52.0,11,21,32,9,28,24,2,4,67,0
5751,135317,163_07_02,AUSTRALIA,0,TOTALS,AUSTRALIA,200,31,58,53.4,23,42,54.8,8,16,50.0,23,32,71.9,7,24,31,18,28,17,11,6,93,1
5752,135330,163_07_03,AUSTRALIA,0,TOTALS,AUSTRALIA,200,20,61,32.8,15,35,42.9,5,26,19.2,13,23,56.5,6,23,29,9,25,14,6,5,58,0
5753,135343,163_07_03,NEW ZEALAND,0,TOTALS,NEW ZEALAND,200,27,68,39.7,24,48,50.0,3,20,15.0,10,18,55.6,13,36,49,11,23,14,2,2,67,1
5754,135451,165_08_01,RUSSIA,0,TOTALS,RUSSIA,200,31,62,50.0,27,48,56.2,4,14,28.6,5,9,55.6,10,19,29,12,17,10,11,4,71,1
5755,135464,165_08_01,IRAN,0,TOTALS,IRAN,200,18,47,38.3,11,31,35.5,7,16,43.8,6,12,50.0,10,21,31,8,14,22,2,3,49,0
5756,135477,165_08_02,GERMANY,0,TOTALS,GERMANY,200,34,58,58.6,23,38,60.5,11,20,55.0,16,22,72.7,11,28,39,13,19,14,6,2,95,1
5757,135490,165_08_02,ANGOLA,0,TOTALS,ANGOLA,200,20,60,33.3,11,31,35.5,9,29,31.0,17,19,89.5,7,15,22,7,15,10,8,0,66,0
5758,135503,165_08_03,SPAIN,0,TOTALS,SPAIN,200,26,58,44.8,19,40,47.5,7,18,38.9,22,25,88.0,10,28,38,10,17,14,5,6,81,1
5759,135516,165_08_03,GREECE,0,TOTALS,GREECE,200,24,54,44.4,17,34,50.0,7,20,35.0,11,24,45.8,8,23,31,8,24,15,5,1,66,0
5760,135529,165_08_04,LITHUANIA,0,TOTALS,LITHUANIA,200,25,58,43.1,15,33,45.5,10,25,40.0,19,24,79.2,6,24,30,16,24,16,9,6,79,1
5761,135542,165_08_04,ARGENTINA,0,TOTALS,ARGENTINA,200,26,63,41.3,21,41,51.2,5,22,22.7,18,22,81.8,9,30,39,10,23,18,8,1,75,0
5762,135555,165_08_05,AUSTRALIA,0,TOTALS,AUSTRALIA,200,30,59,50.8,24,40,60.0,6,19,31.6,16,24,66.7,9,13,22,10,20,13,10,1,82,0
5763,135568,165_08_05,CROATIA,0,TOTALS,CROATIA,200,36,54,66.7,24,38,63.2,12,16,75.0,13,19,68.4,6,21,27,19,23,17,4,1,97,1
5764,135581,165_08_06,USA,0,TOTALS,USA,200,38,70,54.3,31,46,67.4,7,24,29.2,18,25,72.0,9,31,40,17,17,12,14,4,101,0
5765,135594,165_08_06,CHINA,0,TOTALS,CHINA,200,23,68,33.8,13,41,31.7,10,27,37.0,14,15,93.3,13,24,37,12,20,18,2,6,70,1
5766,135607,165_08_07,IRAN,0,TOTALS,IRAN,200,17,55,30.9,10,30,33.3,7,25,28.0,26,35,74.3,13,21,34,10,24,23,6,4,67,0
5767,135620,165_08_07,LITHUANIA,0,TOTALS,LITHUANIA,200,38,67,56.7,31,49,63.3,7,18,38.9,16,26,61.5,10,25,35,14,31,16,18,4,99,1
5768,135633,165_08_08,CROATIA,0,TOTALS,CROATIA,200,26,53,49.1,18,38,47.4,8,15,53.3,25,29,86.2,11,23,34,11,24,16,6,0,85,1
5769,135646,165_08_08,RUSSIA,0,TOTALS,RUSSIA,200,27,58,46.6,17,31,54.8,10,27,37.0,14,19,73.7,12,17,29,18,28,15,7,4,78,0
5770,135659,165_08_09,GREECE,0,TOTALS,GREECE,200,31,54,57.4,23,35,65.7,8,19,42.1,17,20,85.0,8,25,33,15,19,13,10,4,87,1
5771,135672,165_08_09,GERMANY,0,TOTALS,GERMANY,200,19,53,35.8,7,24,29.2,12,29,41.4,14,20,70.0,9,17,26,7,23,14,6,4,64,0
5772,135685,165_08_10,CHINA,0,TOTALS,CHINA,225,27,64,42.2,17,36,47.2,10,28,35.7,11,15,73.3,12,20,32,13,22,20,13,3,75,0
5773,135698,165_08_10,SPAIN,0,TOTALS,SPAIN,225,35,74,47.3,30,57,52.6,5,17,29.4,10,17,58.8,20,24,44,16,15,22,11,4,85,1
5774,135711,165_08_11,ANGOLA,0,TOTALS,ANGOLA,200,25,64,39.1,16,33,48.5,9,31,29.0,17,21,81.0,14,24,38,8,23,25,6,1,76,0
5775,135724,165_08_11,USA,0,TOTALS,USA,200,38,68,55.9,33,47,70.2,5,21,23.8,16,25,64.0,7,27,34,18,21,12,13,4,97,1
5776,135737,165_08_12,ARGENTINA,0,TOTALS,ARGENTINA,200,29,57,50.9,18,35,51.4,11,22,50.0,16,22,72.7,9,28,37,18,18,14,3,1,85,1
5777,135750,165_08_12,AUSTRALIA,0,TOTALS,AUSTRALIA,200,29,64,45.3,27,51,52.9,2,13,15.4,8,10,80.0,8,21,29,9,27,10,5,3,68,0
5778,135763,165_08_13,GERMANY,0,TOTALS,GERMANY,200,22,49,44.9,15,27,55.6,7,22,31.8,8,12,66.7,4,26,30,8,23,18,3,1,59,0
5779,135776,165_08_13,SPAIN,0,TOTALS,SPAIN,200,24,64,37.5,15,40,37.5,9,24,37.5,15,25,60.0,14,27,41,11,18,8,8,3,72,1
5780,135789,165_08_14,AUSTRALIA,0,TOTALS,AUSTRALIA,200,41,77,53.2,28,50,56.0,13,27,48.1,11,15,73.3,19,20,39,20,14,13,19,1,106,0
5781,135802,165_08_14,IRAN,0,TOTALS,IRAN,200,25,53,47.2,16,32,50.0,9,21,42.9,9,11,81.8,8,17,25,14,13,28,7,4,68,1
5782,135815,165_08_15,ANGOLA,0,TOTALS,ANGOLA,200,26,61,42.6,17,44,38.6,9,17,52.9,7,8,87.5,6,13,19,8,24,9,11,1,68,0
5783,135828,165_08_15,CHINA,0,TOTALS,CHINA,200,28,48,58.3,21,26,80.8,7,22,31.8,22,25,88.0,8,29,37,17,12,15,6,5,85,1
5784,135841,165_08_16,LITHUANIA,0,TOTALS,LITHUANIA,200,28,64,43.8,18,39,46.2,10,25,40.0,20,27,74.1,13,35,48,14,25,16,5,4,86,1
5785,135854,165_08_16,RUSSIA,0,TOTALS,RUSSIA,200,25,61,41.0,18,43,41.9,7,18,38.9,22,37,59.5,9,25,34,17,23,13,13,5,79,0
5786,135867,165_08_17,USA,0,TOTALS,USA,200,36,67,53.7,29,47,61.7,7,20,35.0,13,23,56.5,11,27,38,23,24,16,15,7,92,1
5787,135880,165_08_17,GREECE,0,TOTALS,GREECE,200,26,63,41.3,22,45,48.9,4,18,22.2,13,18,72.2,14,24,38,10,22,25,4,1,69,0
5788,135893,165_08_18,ARGENTINA,0,TOTALS,ARGENTINA,200,28,54,51.9,19,32,59.4,9,22,40.9,12,15,80.0,7,22,29,18,20,13,10,2,77,1
5789,135906,165_08_18,CROATIA,0,TOTALS,CROATIA,200,19,57,33.3,16,42,38.1,3,15,20.0,12,17,70.6,13,21,34,6,19,14,8,2,53,0
5790,135919,165_08_19,GREECE,0,TOTALS,GREECE,200,37,63,58.7,27,45,60.0,10,18,55.6,18,22,81.8,10,32,42,17,10,8,9,3,102,0
5791,135932,165_08_19,ANGOLA,0,TOTALS,ANGOLA,200,25,64,39.1,15,37,40.5,10,27,37.0,1,4,25.0,7,18,25,12,18,15,5,2,61,1
5792,135945,165_08_20,RUSSIA,0,TOTALS,RUSSIA,200,28,63,44.4,16,36,44.4,12,27,44.4,12,15,80.0,7,27,34,12,28,16,10,3,80,0
5793,135958,165_08_20,AUSTRALIA,0,TOTALS,AUSTRALIA,200,28,59,47.5,17,35,48.6,11,24,45.8,28,34,82.4,8,28,36,15,18,13,7,0,95,1
5794,135971,165_08_21,CROATIA,0,TOTALS,CROATIA,200,26,61,42.6,21,44,47.7,5,17,29.4,16,19,84.2,16,17,33,11,21,14,8,2,73,0
5795,135984,165_08_21,LITHUANIA,0,TOTALS,LITHUANIA,200,30,54,55.6,19,34,55.9,11,20,55.0,15,19,78.9,8,19,27,16,19,11,6,2,86,1
5796,135997,165_08_22,IRAN,0,TOTALS,IRAN,200,31,66,47.0,20,41,48.8,11,25,44.0,9,15,60.0,13,24,37,12,17,13,2,1,82,0
5797,136010,165_08_22,ARGENTINA,0,TOTALS,ARGENTINA,200,36,65,55.4,25,39,64.1,11,26,42.3,14,22,63.6,8,23,31,19,23,6,9,2,97,1
5798,136023,165_08_23,CHINA,0,TOTALS,CHINA,200,20,61,32.8,15,41,36.6,5,20,25.0,14,21,66.7,10,32,42,8,14,9,6,4,59,1
5799,136036,165_08_23,GERMANY,0,TOTALS,GERMANY,200,18,62,29.0,12,40,30.0,6,22,27.3,13,13,100.0,12,35,47,4,20,14,7,1,55,0
5800,136049,165_08_24,SPAIN,0,TOTALS,SPAIN,200,28,71,39.4,22,43,51.2,6,28,21.4,20,24,83.3,14,25,39,12,19,28,6,3,82,1
5801,136062,165_08_24,USA,0,TOTALS,USA,200,44,76,57.9,32,51,62.7,12,25,48.0,19,24,79.2,8,28,36,24,28,16,16,4,119,0
5802,136075,165_08_25,IRAN,0,TOTALS,IRAN,200,24,67,35.8,21,41,51.2,3,26,11.5,6,14,42.9,10,21,31,9,12,11,6,4,57,0
5803,136088,165_08_25,CROATIA,0,TOTALS,CROATIA,200,39,70,55.7,29,53,54.7,10,17,58.8,3,3,100.0,8,35,43,20,21,10,4,4,91,1
5804,136101,165_08_26,AUSTRALIA,0,TOTALS,AUSTRALIA,200,35,61,57.4,19,36,52.8,16,25,64.0,20,23,87.0,7,17,24,21,21,16,13,2,106,0
5805,136114,165_08_26,LITHUANIA,0,TOTALS,LITHUANIA,200,25,52,48.1,18,28,64.3,7,24,29.2,18,20,90.0,6,20,26,12,24,25,6,2,75,1
5806,136127,165_08_27,GREECE,0,TOTALS,GREECE,200,36,66,54.5,29,44,65.9,7,22,31.8,12,20,60.0,14,22,36,19,14,8,7,3,91,1
5807,136140,165_08_27,CHINA,0,TOTALS,CHINA,200,28,59,47.5,19,29,65.5,9,30,30.0,12,15,80.0,9,20,29,11,16,12,5,3,77,0
5808,136153,165_08_28,ANGOLA,0,TOTALS,ANGOLA,200,18,49,36.7,14,30,46.7,4,19,21.1,10,14,71.4,5,19,24,10,21,25,6,0,50,0
5809,136166,165_08_28,SPAIN,0,TOTALS,SPAIN,200,38,73,52.1,30,45,66.7,8,28,28.6,14,20,70.0,17,28,45,23,15,9,17,0,98,1
5810,136179,165_08_29,USA,0,TOTALS,USA,200,42,77,54.5,31,51,60.8,11,26,42.3,11,18,61.1,17,36,53,20,15,13,14,2,106,0
5811,136192,165_08_29,GERMANY,0,TOTALS,GERMANY,200,22,73,30.1,15,43,34.9,7,30,23.3,6,9,66.7,15,23,38,9,14,18,6,3,57,1
5812,136205,165_08_30,ARGENTINA,0,TOTALS,ARGENTINA,200,31,57,54.4,22,38,57.9,9,19,47.4,20,27,74.1,9,19,28,22,18,13,10,3,91,1
5813,136218,165_08_30,RUSSIA,0,TOTALS,RUSSIA,200,29,60,48.3,22,40,55.0,7,20,35.0,14,17,82.4,10,19,29,11,23,16,8,1,79,0
5814,136231,165_08_31,SPAIN,0,TOTALS,SPAIN,200,26,53,49.1,20,33,60.6,6,20,30.0,14,22,63.6,11,25,36,9,20,16,4,3,72,1
5815,136244,165_08_31,CROATIA,0,TOTALS,CROATIA,200,20,53,37.7,15,34,44.1,5,19,26.3,14,20,70.0,8,21,29,7,25,14,12,3,59,0
5816,136257,165_08_32,LITHUANIA,0,TOTALS,LITHUANIA,200,34,63,54.0,21,32,65.6,13,31,41.9,13,13,100.0,9,22,31,15,25,10,12,5,94,1
5817,136270,165_08_32,CHINA,0,TOTALS,CHINA,200,20,55,36.4,16,34,47.1,4,21,19.0,24,27,88.9,11,20,31,9,15,15,3,0,68,0
5818,136283,165_08_33,USA,0,TOTALS,USA,200,43,76,56.6,31,47,66.0,12,29,41.4,18,31,58.1,19,38,57,16,23,13,10,3,116,0
5819,136296,165_08_33,AUSTRALIA,0,TOTALS,AUSTRALIA,200,30,70,42.9,20,43,46.5,10,27,37.0,15,25,60.0,8,20,28,11,28,11,6,1,85,1
5820,136309,165_08_34,ARGENTINA,0,TOTALS,ARGENTINA,200,31,63,49.2,17,31,54.8,14,32,43.8,4,5,80.0,9,19,28,11,17,13,9,6,80,1
5821,136322,165_08_34,GREECE,0,TOTALS,GREECE,200,28,56,50.0,20,37,54.1,8,19,42.1,14,18,77.8,10,23,33,14,13,13,9,0,78,0
5822,136335,165_08_35,SPAIN,0,TOTALS,SPAIN,200,26,61,42.6,22,45,48.9,4,16,25.0,35,44,79.5,14,19,33,14,22,11,7,1,91,1
5823,136348,165_08_35,LITHUANIA,0,TOTALS,LITHUANIA,200,26,57,45.6,14,26,53.8,12,31,38.7,22,26,84.6,12,22,34,15,34,18,7,2,86,0
5824,136361,165_08_36,ARGENTINA,0,TOTALS,ARGENTINA,200,30,68,44.1,24,45,53.3,6,23,26.1,15,16,93.8,9,23,32,7,29,16,7,3,81,1
5825,136374,165_08_36,USA,0,TOTALS,USA,200,32,68,47.1,22,37,59.5,10,31,32.3,27,36,75.0,16,27,43,15,21,15,8,4,101,0
5826,136387,165_08_37,LITHUANIA,0,TOTALS,LITHUANIA,200,26,62,41.9,20,39,51.3,6,23,26.1,17,25,68.0,11,25,36,8,18,16,4,1,75,0
5827,136400,165_08_37,ARGENTINA,0,TOTALS,ARGENTINA,200,32,63,50.8,21,40,52.5,11,23,47.8,12,16,75.0,6,27,33,19,23,13,12,3,87,1
5828,136413,165_08_38,SPAIN,0,TOTALS,SPAIN,200,38,74,51.4,30,57,52.6,8,17,47.1,23,28,82.1,15,22,37,16,28,14,7,1,107,0
5829,136426,165_08_38,USA,0,TOTALS,USA,200,39,65,60.0,26,37,70.3,13,28,46.4,27,37,73.0,8,23,31,17,26,13,10,3,118,1
5830,137427,167_08_01,NEW ZEALAND,0,TOTALS,NEW ZEALAND,200,23,49,46.9,16,27,59.3,7,22,31.8,24,29,82.8,5,42,47,15,16,21,4,2,77,1
5831,137440,167_08_01,CAPE VERDE,0,TOTALS,CAPE VERDE,200,18,71,25.4,13,40,32.5,5,31,16.1,9,16,56.2,11,22,33,6,24,9,9,3,50,0
5832,137453,167_08_02,KOREA,0,TOTALS,KOREA,200,28,54,51.9,17,33,51.5,11,21,52.4,9,13,69.2,5,15,20,15,23,14,6,3,76,0
5833,137466,167_08_02,SLOVENIA,0,TOTALS,SLOVENIA,200,34,62,54.8,30,46,65.2,4,16,25.0,16,23,69.6,16,21,37,17,21,15,8,2,88,1
5834,137479,167_08_03,CROATIA,0,TOTALS,CROATIA,200,31,52,59.6,23,36,63.9,8,16,50.0,23,32,71.9,2,23,25,19,21,15,8,1,93,1
5835,137492,167_08_03,CAMEROON,0,TOTALS,CAMEROON,200,28,72,38.9,18,45,40.0,10,27,37.0,13,16,81.2,16,20,36,13,27,18,2,0,79,0
5836,137505,167_08_04,GREECE,0,TOTALS,GREECE,200,49,67,73.1,42,54,77.8,7,13,53.8,14,20,70.0,8,28,36,27,18,11,13,4,119,0
5837,137518,167_08_04,LEBANON,0,TOTALS,LEBANON,200,22,54,40.7,16,35,45.7,6,19,31.6,12,14,85.7,4,12,16,14,22,19,1,1,62,1
5838,137531,167_08_05,SLOVENIA,0,TOTALS,SLOVENIA,200,27,54,50.0,19,33,57.6,8,21,38.1,24,27,88.9,5,25,30,16,21,13,10,8,86,1
5839,137544,167_08_05,CANADA,0,TOTALS,CANADA,200,24,60,40.0,20,47,42.6,4,13,30.8,18,22,81.8,5,22,27,5,22,14,6,4,70,0
5840,137557,167_08_06,CAPE VERDE,0,TOTALS,CAPE VERDE,200,22,76,28.9,13,46,28.3,9,30,30.0,15,21,71.4,17,14,31,9,18,18,12,1,68,1
5841,137570,167_08_06,GERMANY,0,TOTALS,GERMANY,200,38,57,66.7,25,34,73.5,13,23,56.5,15,16,93.8,4,25,29,20,23,20,9,4,104,0
5842,137583,167_08_07,CAMEROON,0,TOTALS,CAMEROON,200,27,72,37.5,21,49,42.9,6,23,26.1,12,20,60.0,7,34,41,10,29,14,7,0,72,0
5843,137596,167_08_07,PUERTO RICO,0,TOTALS,PUERTO RICO,200,23,63,36.5,10,36,27.8,13,27,48.1,22,29,75.9,8,33,41,13,20,15,7,3,81,1
5844,137609,167_08_08,LEBANON,0,TOTALS,LEBANON,200,20,50,40.0,9,24,37.5,11,26,42.3,3,5,60.0,7,16,23,10,12,31,5,4,54,0
5845,137622,167_08_08,BRAZIL,0,TOTALS,BRAZIL,200,40,66,60.6,34,49,69.4,6,17,35.3,8,12,66.7,11,22,33,26,13,17,19,2,94,1
5846,137635,167_08_09,CANADA,0,TOTALS,CANADA,200,29,66,43.9,19,45,42.2,10,21,47.6,11,18,61.1,18,25,43,7,21,18,10,3,79,1
5847,137648,167_08_09,KOREA,0,TOTALS,KOREA,200,24,55,43.6,11,30,36.7,13,25,52.0,16,22,72.7,5,19,24,16,18,13,11,1,77,0
5848,137661,167_08_10,PUERTO RICO,0,TOTALS,PUERTO RICO,200,29,60,48.3,18,36,50.0,11,24,45.8,12,20,60.0,7,18,25,9,25,12,7,1,81,0
5849,137674,167_08_10,CROATIA,0,TOTALS,CROATIA,200,31,55,56.4,23,38,60.5,8,17,47.1,25,28,89.3,7,22,29,17,23,11,4,0,95,1
5850,137687,167_08_11,GERMANY,0,TOTALS,GERMANY,200,35,68,51.5,28,42,66.7,7,26,26.9,12,15,80.0,10,23,33,17,21,7,1,6,89,1
5851,137700,167_08_11,NEW ZEALAND,0,TOTALS,NEW ZEALAND,200,24,62,38.7,14,33,42.4,10,29,34.5,13,17,76.5,9,17,26,9,20,7,2,1,71,0
5852,137713,167_08_12,BRAZIL,0,TOTALS,BRAZIL,200,17,40,42.5,12,21,57.1,5,19,26.3,30,44,68.2,5,23,28,3,20,15,3,3,69,0
5853,137726,167_08_12,GREECE,0,TOTALS,GREECE,200,32,65,49.2,23,42,54.8,9,23,39.1,16,21,76.2,12,19,31,18,32,7,6,0,89,1
5854,137739,167_08_13,CROATIA,0,TOTALS,CROATIA,200,30,57,52.6,21,34,61.8,9,23,39.1,14,22,63.6,9,24,33,15,32,10,7,2,83,1
5855,137752,167_08_13,CANADA,0,TOTALS,CANADA,200,16,59,27.1,9,35,25.7,7,24,29.2,23,30,76.7,19,21,40,7,22,15,1,1,62,0
5856,137765,167_08_14,SLOVENIA,0,TOTALS,SLOVENIA,200,26,60,43.3,19,36,52.8,7,24,29.2,11,15,73.3,14,20,34,13,23,14,4,1,70,0
5857,137778,167_08_14,PUERTO RICO,0,TOTALS,PUERTO RICO,200,26,55,47.3,16,37,43.2,10,18,55.6,19,23,82.6,7,21,28,13,18,11,5,2,81,1
5858,137791,167_08_15,GERMANY,0,TOTALS,GERMANY,200,26,58,44.8,13,32,40.6,13,26,50.0,13,14,92.9,7,29,36,14,20,16,1,3,78,1
5859,137804,167_08_15,BRAZIL,0,TOTALS,BRAZIL,200,26,66,39.4,23,47,48.9,3,19,15.8,10,16,62.5,8,18,26,13,18,8,12,0,65,0
5860,137817,167_08_16,GREECE,0,TOTALS,GREECE,200,28,62,45.2,24,41,58.5,4,21,19.0,15,18,83.3,11,28,39,8,17,10,8,1,75,1
5861,137830,167_08_16,NEW ZEALAND,0,TOTALS,NEW ZEALAND,200,14,46,30.4,8,18,44.4,6,28,21.4,14,20,70.0,5,18,23,5,20,17,4,1,48,0
5862,137843,167_08_17,CROATIA,0,TOTALS,CROATIA,200,25,61,41.0,20,41,48.8,5,20,25.0,21,28,75.0,11,26,37,10,28,6,3,4,76,1
5863,137856,167_08_17,GERMANY,0,TOTALS,GERMANY,200,20,51,39.2,16,35,45.7,4,16,25.0,26,29,89.7,4,27,31,3,27,9,2,1,70,0
5864,137869,167_08_18,PUERTO RICO,0,TOTALS,PUERTO RICO,200,20,58,34.5,15,39,38.5,5,19,26.3,18,27,66.7,8,28,36,9,22,12,6,3,63,0
5865,137882,167_08_18,GREECE,0,TOTALS,GREECE,200,32,61,52.5,22,37,59.5,10,24,41.7,14,24,58.3,6,31,37,18,23,9,7,5,88,1
5866,137895,167_08_19,GERMANY,0,TOTALS,GERMANY,200,30,57,52.6,18,34,52.9,12,23,52.2,24,27,88.9,5,26,31,13,16,11,1,2,96,1
5867,137908,167_08_19,PUERTO RICO,0,TOTALS,PUERTO RICO,200,31,74,41.9,24,49,49.0,7,25,28.0,13,14,92.9,9,21,30,9,24,7,5,1,82,0
5868,138413,169_08_01,ARGENTINA,0,TOTALS,ARGENTINA,200,32,61,52.5,26,43,60.5,6,18,33.3,11,16,68.8,3,18,21,20,21,17,13,0,81,1
5869,138426,169_08_01,IRAN,0,TOTALS,IRAN,200,25,50,50.0,20,33,60.6,5,17,29.4,16,25,64.0,6,23,29,12,16,24,10,1,71,0
5870,138439,169_08_02,CHINA,0,TOTALS,CHINA,200,33,56,58.9,26,40,65.0,7,16,43.8,10,13,76.9,7,20,27,17,17,21,6,2,83,1
5871,138452,169_08_02,ANGOLA,0,TOTALS,ANGOLA,200,30,62,48.4,25,45,55.6,5,17,29.4,9,16,56.2,9,15,24,7,15,13,12,0,74,0
5872,138465,169_08_03,AUSTRALIA,0,TOTALS,AUSTRALIA,200,25,59,42.4,18,39,46.2,7,20,35.0,10,16,62.5,5,24,29,3,22,14,15,3,67,1
5873,138478,169_08_03,CHINA,0,TOTALS,CHINA,200,15,45,33.3,8,26,30.8,7,19,36.8,18,22,81.8,4,25,29,4,21,24,7,3,55,0
5874,138491,169_08_04,IRAN,0,TOTALS,IRAN,200,25,55,45.5,21,43,48.8,4,12,33.3,18,26,69.2,11,29,40,4,21,24,8,6,72,1
5875,138504,169_08_04,SERBIA,0,TOTALS,SERBIA,200,27,75,36.0,22,50,44.0,5,25,20.0,11,18,61.1,13,23,36,5,25,12,8,5,70,0
5876,138517,169_08_05,ANGOLA,0,TOTALS,ANGOLA,200,29,61,47.5,22,37,59.5,7,24,29.2,13,17,76.5,15,13,28,7,20,10,4,1,78,0
5877,138530,169_08_05,AUSTRALIA,0,TOTALS,AUSTRALIA,200,30,54,55.6,23,35,65.7,7,19,36.8,14,20,70.0,10,16,26,12,23,11,8,0,81,1
5878,138543,169_08_06,SERBIA,0,TOTALS,SERBIA,200,22,53,41.5,16,32,50.0,6,21,28.6,10,23,43.5,6,22,28,12,25,14,9,2,60,0
5879,138556,169_08_06,ARGENTINA,0,TOTALS,ARGENTINA,200,25,52,48.1,19,34,55.9,6,18,33.3,19,25,76.0,4,26,30,11,16,13,6,1,75,1
5880,138569,169_08_07,ANGOLA,0,TOTALS,ANGOLA,200,21,54,38.9,16,34,47.1,5,20,25.0,15,20,75.0,6,16,22,3,19,17,3,1,62,0
5881,138582,169_08_07,SERBIA,0,TOTALS,SERBIA,200,35,54,64.8,21,30,70.0,14,24,58.3,15,22,68.2,3,24,27,20,23,12,8,1,99,1
5882,138595,169_08_08,CHINA,0,TOTALS,CHINA,200,29,60,48.3,20,36,55.6,9,24,37.5,8,14,57.1,4,29,33,16,17,12,6,2,75,1
5883,138608,169_08_08,IRAN,0,TOTALS,IRAN,200,17,63,27.0,15,46,32.6,2,17,11.8,10,20,50.0,14,25,39,4,12,16,5,4,46,0
5884,138621,169_08_09,AUSTRALIA,0,TOTALS,AUSTRALIA,200,34,68,50.0,23,40,57.5,11,28,39.3,12,17,70.6,4,20,24,12,32,14,10,1,91,0
5885,138634,169_08_09,ARGENTINA,0,TOTALS,ARGENTINA,200,26,51,51.0,17,31,54.8,9,20,45.0,34,39,87.2,6,22,28,12,24,14,10,3,95,1
5886,138881,172_08_01,MALI,0,TOTALS,MALI,200,35,70,50.0,31,52,59.6,4,18,22.2,17,30,56.7,18,30,48,14,16,19,19,7,91,1
5887,138894,172_08_01,MOZAMBIQUE,0,TOTALS,MOZAMBIQUE,200,14,62,22.6,12,47,25.5,2,15,13.3,7,12,58.3,11,12,23,5,22,30,15,1,37,0
5888,138907,172_08_02,REPUBLIC OF CONGO,0,TOTALS,REPUBLIC OF CONGO,200,27,82,32.9,21,55,38.2,6,27,22.2,7,14,50.0,20,27,47,7,22,24,9,1,67,0
5889,138920,172_08_02,ALGERIA,0,TOTALS,ALGERIA,200,28,61,45.9,24,39,61.5,4,22,18.2,13,28,46.4,10,24,34,14,17,22,10,2,73,1
5890,138933,172_08_03,SENEGAL,0,TOTALS,SENEGAL,200,23,49,46.9,18,30,60.0,5,19,26.3,15,28,53.6,5,28,33,10,35,17,9,2,66,1
5891,138946,172_08_03,CAF,0,TOTALS,CAF,200,17,56,30.4,12,44,27.3,5,12,41.7,26,46,56.5,14,21,35,6,24,21,19,0,65,0
5892,138959,172_08_04,NIGERIA,0,TOTALS,NIGERIA,200,23,50,46.0,18,35,51.4,5,15,33.3,15,26,57.7,8,23,31,10,22,29,19,2,66,1
5893,138972,172_08_04,COTE D'IVOIRE,0,TOTALS,COTE D'IVOIRE,200,20,56,35.7,17,41,41.5,3,15,20.0,10,21,47.6,6,22,28,7,22,23,15,3,53,0
5894,138985,172_08_05,EGYPT,0,TOTALS,EGYPT,200,26,50,52.0,20,30,66.7,6,20,30.0,14,22,63.6,9,21,30,13,23,22,12,3,72,1
5895,138998,172_08_05,MOROCCO,0,TOTALS,MOROCCO,200,17,62,27.4,13,40,32.5,4,22,18.2,14,25,56.0,17,14,31,5,19,20,9,2,52,0
5896,139011,172_08_06,MALI,0,TOTALS,MALI,200,23,56,41.1,20,42,47.6,3,14,21.4,7,9,77.8,7,33,40,9,22,19,11,2,56,1
5897,139024,172_08_06,SENEGAL,0,TOTALS,SENEGAL,200,14,55,25.5,10,31,32.3,4,24,16.7,10,31,32.3,8,18,26,4,8,15,8,3,42,0
5898,139037,172_08_07,COTE D'IVOIRE,0,TOTALS,COTE D'IVOIRE,200,13,55,23.6,12,42,28.6,1,13,7.7,22,38,57.9,16,20,36,4,22,23,15,0,49,0
5899,139050,172_08_07,ALGERIA,0,TOTALS,ALGERIA,200,24,55,43.6,20,39,51.3,4,16,25.0,6,19,31.6,10,26,36,8,26,25,13,3,58,1
5900,139063,172_08_08,MOROCCO,0,TOTALS,MOROCCO,200,19,50,38.0,14,32,43.8,5,18,27.8,15,23,65.2,4,30,34,11,21,19,5,2,58,1
5901,139076,172_08_08,CAF,0,TOTALS,CAF,200,13,53,24.5,12,35,34.3,1,18,5.6,15,32,46.9,10,20,30,5,21,18,9,1,42,0
5902,139089,172_08_09,ANGOLA,0,TOTALS,ANGOLA,200,24,60,40.0,20,48,41.7,4,12,33.3,15,28,53.6,14,29,43,14,17,20,9,1,67,1
5903,139102,172_08_09,REPUBLIC OF CONGO,0,TOTALS,REPUBLIC OF CONGO,200,17,58,29.3,15,31,48.4,2,27,7.4,6,16,37.5,9,23,32,3,26,22,7,0,42,0
5904,139115,172_08_10,MOZAMBIQUE,0,TOTALS,MOZAMBIQUE,200,24,72,33.3,17,51,33.3,7,21,33.3,12,24,50.0,21,17,38,5,29,25,13,1,67,1
5905,139128,172_08_10,EGYPT,0,TOTALS,EGYPT,200,37,64,57.8,33,44,75.0,4,20,20.0,27,44,61.4,11,30,41,22,20,20,21,5,105,0
5906,139139,172_08_11,KENYA,0,TOTALS,KENYA,200,22,58,37.9,22,52,42.3,0,6,0.0,5,12,41.7,11,17,28,10,13,36,15,1,49,0
5907,139152,172_08_11,NIGERIA,0,TOTALS,NIGERIA,200,34,80,42.5,28,57,49.1,6,23,26.1,7,10,70.0,20,25,45,14,11,25,17,3,81,1
5908,139165,172_08_12,MOROCCO,0,TOTALS,MOROCCO,200,18,53,34.0,11,25,44.0,7,28,25.0,8,11,72.7,6,22,28,4,13,32,9,2,51,0
5909,139178,172_08_12,MALI,0,TOTALS,MALI,200,25,62,40.3,22,46,47.8,3,16,18.8,9,14,64.3,14,21,35,10,19,25,22,3,62,1
5910,139191,172_08_13,NIGERIA,0,TOTALS,NIGERIA,200,27,64,42.2,20,49,40.8,7,15,46.7,8,17,47.1,15,32,47,9,30,29,8,1,69,1
5911,139204,172_08_13,ALGERIA,0,TOTALS,ALGERIA,200,22,58,37.9,19,36,52.8,3,22,13.6,16,41,39.0,6,19,25,6,17,15,13,3,63,0
5912,139217,172_08_14,MOZAMBIQUE,0,TOTALS,MOZAMBIQUE,200,21,65,32.3,19,51,37.3,2,14,14.3,14,32,43.8,17,18,35,5,30,21,12,2,58,0
5913,139230,172_08_14,SENEGAL,0,TOTALS,SENEGAL,200,24,60,40.0,21,45,46.7,3,15,20.0,25,41,61.0,18,32,50,11,28,24,12,8,76,1
5914,139243,172_08_15,COTE D'IVOIRE,0,TOTALS,COTE D'IVOIRE,200,23,57,40.4,19,45,42.2,4,12,33.3,29,40,72.5,11,19,30,6,24,25,20,3,79,1
5915,139256,172_08_15,ANGOLA,0,TOTALS,ANGOLA,200,19,49,38.8,13,34,38.2,6,15,40.0,21,34,61.8,11,20,31,10,30,33,15,0,65,0
5916,139269,172_08_16,EGYPT,0,TOTALS,EGYPT,200,27,64,42.2,24,43,55.8,3,21,14.3,10,18,55.6,5,25,30,14,29,19,13,7,67,1
5917,139282,172_08_16,CAF,0,TOTALS,CAF,200,23,68,33.8,22,56,39.3,1,12,8.3,15,33,45.5,15,21,36,11,21,23,13,2,62,0
5918,139293,172_08_17,KENYA,0,TOTALS,KENYA,200,18,53,34.0,14,39,35.9,4,14,28.6,18,33,54.5,12,28,40,9,16,25,6,1,58,0
5919,139306,172_08_17,REPUBLIC OF CONGO,0,TOTALS,REPUBLIC OF CONGO,200,31,85,36.5,28,59,47.5,3,26,11.5,7,17,41.2,23,20,43,7,26,14,11,5,72,1
5920,139319,172_08_18,ANGOLA,0,TOTALS,ANGOLA,200,24,66,36.4,22,48,45.8,2,18,11.1,12,22,54.5,10,25,35,11,24,21,21,3,62,1
5921,139330,172_08_18,KENYA,0,TOTALS,KENYA,200,15,53,28.3,14,37,37.8,1,16,6.2,12,38,31.6,14,17,31,5,16,34,8,1,43,0
5922,139343,172_08_19,CAF,0,TOTALS,CAF,200,18,55,32.7,11,33,33.3,7,22,31.8,23,32,71.9,17,20,37,12,18,26,8,1,66,0
5923,139356,172_08_19,MALI,0,TOTALS,MALI,200,31,68,45.6,27,51,52.9,4,17,23.5,11,18,61.1,13,19,32,17,22,24,16,7,77,1
5924,139369,172_08_20,REPUBLIC OF CONGO,0,TOTALS,REPUBLIC OF CONGO,200,21,69,30.4,13,43,30.2,8,26,30.8,4,9,44.4,12,13,25,4,17,11,4,2,54,0
5925,139382,172_08_20,NIGERIA,0,TOTALS,NIGERIA,200,31,62,50.0,26,47,55.3,5,15,33.3,10,16,62.5,12,25,37,14,11,12,5,4,77,1
5926,139395,172_08_21,MOZAMBIQUE,0,TOTALS,MOZAMBIQUE,225,24,77,31.2,14,49,28.6,10,28,35.7,15,22,68.2,11,18,29,1,28,14,14,2,73,0
5927,139408,172_08_21,MOROCCO,0,TOTALS,MOROCCO,225,24,61,39.3,19,39,48.7,5,22,22.7,21,37,56.8,16,36,52,10,21,27,10,3,74,1
5928,139421,172_08_22,ALGERIA,0,TOTALS,ALGERIA,200,21,61,34.4,18,46,39.1,3,15,20.0,8,18,44.4,12,24,36,6,25,27,9,0,53,0
5929,139434,172_08_22,ANGOLA,0,TOTALS,ANGOLA,200,26,64,40.6,22,49,44.9,4,15,26.7,14,30,46.7,19,20,39,9,14,20,18,3,70,1
5930,139447,172_08_23,SENEGAL,0,TOTALS,SENEGAL,200,26,70,37.1,23,54,42.6,3,16,18.8,10,21,47.6,10,23,33,5,23,19,16,6,65,0
5931,139460,172_08_23,EGYPT,0,TOTALS,EGYPT,200,31,68,45.6,25,51,49.0,6,17,35.3,16,24,66.7,10,26,36,16,17,17,13,2,84,1
5932,139471,172_08_24,KENYA,0,TOTALS,KENYA,200,13,62,21.0,8,45,17.8,5,17,29.4,8,13,61.5,11,25,36,6,11,27,12,2,39,0
5933,139484,172_08_24,COTE D'IVOIRE,0,TOTALS,COTE D'IVOIRE,200,31,70,44.3,25,50,50.0,6,20,30.0,7,9,77.8,14,21,35,9,13,18,11,5,75,1
5934,139497,172_08_25,CAF,0,TOTALS,CAF,200,33,71,46.5,32,60,53.3,1,11,9.1,17,25,68.0,17,28,45,9,33,24,20,1,84,1
5935,139510,172_08_25,MOZAMBIQUE,0,TOTALS,MOZAMBIQUE,200,12,48,25.0,9,30,30.0,3,18,16.7,30,45,66.7,7,17,24,8,23,28,9,2,57,0
5936,139523,172_08_26,REPUBLIC OF CONGO,0,TOTALS,REPUBLIC OF CONGO,200,15,70,21.4,9,44,20.5,6,26,23.1,11,18,61.1,16,26,42,8,23,17,9,2,47,0
5937,139536,172_08_26,COTE D'IVOIRE,0,TOTALS,COTE D'IVOIRE,200,22,62,35.5,19,43,44.2,3,19,15.8,20,30,66.7,14,28,42,4,13,20,12,2,67,1
5938,139549,172_08_27,SENEGAL,0,TOTALS,SENEGAL,200,21,61,34.4,18,47,38.3,3,14,21.4,11,19,57.9,14,24,38,7,21,26,18,1,56,1
5939,139562,172_08_27,MOROCCO,0,TOTALS,MOROCCO,200,20,51,39.2,18,37,48.6,2,14,14.3,5,12,41.7,6,21,27,8,14,31,13,0,47,0
5940,139575,172_08_28,NIGERIA,0,TOTALS,NIGERIA,200,18,62,29.0,13,48,27.1,5,14,35.7,10,20,50.0,13,31,44,6,16,14,5,7,51,1
5941,139588,172_08_28,ANGOLA,0,TOTALS,ANGOLA,200,16,65,24.6,12,50,24.0,4,15,26.7,8,12,66.7,12,26,38,5,17,15,7,2,44,0
5942,139601,172_08_29,EGYPT,0,TOTALS,EGYPT,200,29,59,49.2,22,37,59.5,7,22,31.8,19,25,76.0,11,28,39,18,17,25,17,3,84,1
5943,139614,172_08_29,MALI,0,TOTALS,MALI,200,22,80,27.5,20,55,36.4,2,25,8.0,17,25,68.0,26,16,42,9,21,18,17,3,63,0
5944,139627,172_08_30,ALGERIA,0,TOTALS,ALGERIA,200,22,66,33.3,19,48,39.6,3,18,16.7,12,17,70.6,14,26,40,7,15,18,12,1,59,1
5945,139638,172_08_30,KENYA,0,TOTALS,KENYA,200,18,66,27.3,18,54,33.3,0,12,0.0,13,19,68.4,17,28,45,6,20,22,12,2,49,0
5946,139651,172_08_31,MOROCCO,0,TOTALS,MOROCCO,200,17,56,30.4,15,39,38.5,2,17,11.8,5,8,62.5,6,14,20,5,17,22,11,1,41,0
5947,139664,172_08_31,NIGERIA,0,TOTALS,NIGERIA,200,24,57,42.1,21,44,47.7,3,13,23.1,13,20,65.0,14,31,45,15,9,21,13,6,64,1
5948,139677,172_08_32,CAF,0,TOTALS,CAF,200,30,60,50.0,27,49,55.1,3,11,27.3,16,30,53.3,11,22,33,16,14,23,17,3,79,1
5949,139690,172_08_32,REPUBLIC OF CONGO,0,TOTALS,REPUBLIC OF CONGO,200,24,79,30.4,23,62,37.1,1,17,5.9,9,13,69.2,22,20,42,4,22,25,14,6,58,0
5950,139703,172_08_33,SENEGAL,0,TOTALS,SENEGAL,200,23,64,35.9,20,42,47.6,3,22,13.6,9,21,42.9,14,27,41,6,23,19,17,5,58,1
5951,139716,172_08_33,COTE D'IVOIRE,0,TOTALS,COTE D'IVOIRE,200,15,48,31.2,12,36,33.3,3,12,25.0,12,21,57.1,7,22,29,9,15,29,12,1,45,0
5952,139727,172_08_34,KENYA,0,TOTALS,KENYA,225,26,59,44.1,26,52,50.0,0,7,0.0,15,37,40.5,19,37,56,11,19,46,13,5,67,0
5953,139740,172_08_34,MOZAMBIQUE,0,TOTALS,MOZAMBIQUE,225,25,79,31.6,20,59,33.9,5,20,25.0,14,28,50.0,18,12,30,5,25,24,32,3,69,1
5954,139753,172_08_35,ANGOLA,0,TOTALS,ANGOLA,200,24,55,43.6,20,37,54.1,4,18,22.2,17,28,60.7,17,24,41,5,16,21,14,2,69,1
5955,139766,172_08_35,MALI,0,TOTALS,MALI,200,15,57,26.3,9,35,25.7,6,22,27.3,15,21,71.4,10,22,32,7,26,16,14,5,51,0
5956,139779,172_08_36,ALGERIA,0,TOTALS,ALGERIA,200,23,61,37.7,20,48,41.7,3,13,23.1,16,34,47.1,14,18,32,9,23,18,6,2,65,0
5957,139792,172_08_36,EGYPT,0,TOTALS,EGYPT,200,23,63,36.5,21,40,52.5,2,23,8.7,22,31,71.0,18,26,44,14,29,19,12,6,70,1
5958,139805,172_08_37,REPUBLIC OF CONGO,0,TOTALS,REPUBLIC OF CONGO,200,36,79,45.6,31,58,53.4,5,21,23.8,6,12,50.0,18,23,41,10,11,18,15,5,83,1
5959,139816,172_08_37,KENYA,0,TOTALS,KENYA,200,29,66,43.9,26,53,49.1,3,13,23.1,7,11,63.6,10,21,31,9,15,20,7,1,68,0
5960,139829,172_08_38,CAF,0,TOTALS,CAF,200,30,57,52.6,22,40,55.0,8,17,47.1,12,19,63.2,8,29,37,9,22,23,9,5,80,1
5961,139842,172_08_38,MOZAMBIQUE,0,TOTALS,MOZAMBIQUE,200,22,68,32.4,20,50,40.0,2,18,11.1,13,21,61.9,10,12,22,9,17,13,9,1,59,0
5962,139855,172_08_39,ALGERIA,0,TOTALS,ALGERIA,200,16,51,31.4,14,29,48.3,2,22,9.1,6,10,60.0,3,23,26,7,20,19,10,1,40,0
5963,139868,172_08_39,COTE D'IVOIRE,0,TOTALS,COTE D'IVOIRE,200,16,53,30.2,13,34,38.2,3,19,15.8,6,11,54.5,8,24,32,3,15,20,11,2,41,1
5964,139881,172_08_40,EGYPT,0,TOTALS,EGYPT,200,24,50,48.0,19,38,50.0,5,12,41.7,22,37,59.5,9,26,35,16,20,18,6,2,75,1
5965,139894,172_08_40,SENEGAL,0,TOTALS,SENEGAL,200,25,66,37.9,21,46,45.7,4,20,20.0,8,16,50.0,14,18,32,9,30,17,11,2,62,0
5966,139907,172_08_41,MOROCCO,0,TOTALS,MOROCCO,200,15,49,30.6,12,29,41.4,3,20,15.0,15,31,48.4,6,24,30,5,21,17,14,4,48,0
5967,139920,172_08_41,MALI,0,TOTALS,MALI,200,14,48,29.2,9,30,30.0,5,18,27.8,20,31,64.5,8,27,35,8,23,27,9,0,53,1
5968,139933,172_08_42,NIGERIA,0,TOTALS,NIGERIA,200,23,61,37.7,17,43,39.5,6,18,33.3,13,18,72.2,15,20,35,5,18,15,7,4,65,0
5969,139946,172_08_42,ANGOLA,0,TOTALS,ANGOLA,200,26,56,46.4,20,41,48.8,6,15,40.0,13,22,59.1,13,18,31,4,19,13,9,5,71,1
5970,139959,172_08_43,ALGERIA,0,TOTALS,ALGERIA,200,26,51,51.0,17,26,65.4,9,25,36.0,4,10,40.0,6,31,37,6,14,11,6,1,65,1
5971,139972,172_08_43,MOROCCO,0,TOTALS,MOROCCO,200,9,46,19.6,4,28,14.3,5,18,27.8,11,17,64.7,6,17,23,1,19,14,5,1,34,0
5972,139985,172_08_44,COTE D'IVOIRE,0,TOTALS,COTE D'IVOIRE,200,12,50,24.0,10,30,33.3,2,20,10.0,10,19,52.6,7,13,20,4,10,14,12,1,36,0
5973,139998,172_08_44,MALI,0,TOTALS,MALI,200,21,58,36.2,14,35,40.0,7,23,30.4,5,8,62.5,10,31,41,14,17,18,7,4,54,1
5974,140011,172_08_45,SENEGAL,0,TOTALS,SENEGAL,200,24,69,34.8,20,47,42.6,4,22,18.2,5,8,62.5,9,22,31,9,23,12,9,3,57,0
5975,140024,172_08_45,NIGERIA,0,TOTALS,NIGERIA,200,24,59,40.7,20,47,42.6,4,12,33.3,16,27,59.3,15,28,43,7,13,17,7,2,68,1
5976,140037,172_08_46,EGYPT,0,TOTALS,EGYPT,200,35,68,51.5,27,42,64.3,8,26,30.8,7,13,53.8,10,22,32,15,25,17,9,4,85,1
5977,140050,172_08_46,ANGOLA,0,TOTALS,ANGOLA,200,30,67,44.8,25,46,54.3,5,21,23.8,19,30,63.3,17,14,31,2,14,12,9,7,84,0
5978,140063,173_08_01,GUINEA,0,TOTALS,GUINEA,200,11,38,28.9,9,20,45.0,2,18,11.1,13,18,72.2,6,26,32,10,14,15,6,4,37,0
5979,140076,173_08_01,MALI,0,TOTALS,MALI,200,21,51,41.2,19,37,51.4,2,14,14.3,11,16,68.8,12,20,32,17,14,13,9,0,55,1
5980,140089,173_08_02,MAURITANIA,0,TOTALS,MAURITANIA,200,19,64,29.7,18,45,40.0,1,19,5.3,3,10,30.0,10,22,32,8,16,13,6,1,42,0
5981,140102,173_08_02,SENEGAL,0,TOTALS,SENEGAL,200,17,50,34.0,14,31,45.2,3,19,15.8,14,23,60.9,13,37,50,13,15,20,7,0,51,1
5982,140115,173_08_03,GUINEA,0,TOTALS,GUINEA,200,18,44,40.9,14,25,56.0,4,19,21.1,11,17,64.7,7,34,41,13,22,14,9,5,51,1
5983,140128,173_08_03,MAURITANIA,0,TOTALS,MAURITANIA,200,16,47,34.0,13,33,39.4,3,14,21.4,8,23,34.8,6,22,28,12,16,12,6,2,43,0
5984,140141,173_08_04,SENEGAL,0,TOTALS,SENEGAL,200,11,30,36.7,10,24,41.7,1,6,16.7,13,33,39.4,9,22,31,11,13,18,14,1,36,0
5985,140154,173_08_04,MALI,0,TOTALS,MALI,200,21,52,40.4,12,29,41.4,9,23,39.1,8,22,36.4,19,20,39,20,28,20,14,1,59,1
5986,140167,173_08_05,ZIMBABWE,0,TOTALS,ZIMBABWE,200,32,50,64.0,27,43,62.8,5,7,71.4,13,25,52.0,9,14,23,8,32,23,8,0,82,1
5987,140180,173_08_05,MOZAMBIQUE,0,TOTALS,MOZAMBIQUE,200,36,52,69.2,30,42,71.4,6,10,60.0,26,44,59.1,14,11,25,15,17,20,12,1,104,0
5988,140193,173_08_06,MOZAMBIQUE,0,TOTALS,MOZAMBIQUE,200,34,75,45.3,32,63,50.8,2,12,16.7,11,26,42.3,23,31,54,20,13,21,17,6,81,1
5989,140206,173_08_06,ZIMBABWE,0,TOTALS,ZIMBABWE,200,23,59,39.0,22,50,44.0,1,9,11.1,8,16,50.0,13,28,41,5,19,33,11,4,55,0
5990,140219,173_08_07,SUDAN,0,TOTALS,SUDAN,200,25,73,34.2,19,50,38.0,6,23,26.1,10,14,71.4,18,33,51,15,14,18,12,4,66,0
5991,140232,173_08_07,KENYA,0,TOTALS,KENYA,200,25,76,32.9,18,50,36.0,7,26,26.9,10,17,58.8,18,25,43,12,12,19,5,2,67,1
5992,140245,173_08_08,BURUNDI,0,TOTALS,BURUNDI,200,31,90,34.4,28,66,42.4,3,24,12.5,23,50,46.0,28,35,63,5,30,21,11,1,88,1
5993,140258,173_08_08,UGANDA,0,TOTALS,UGANDA,200,30,67,44.8,28,56,50.0,2,11,18.2,22,47,46.8,12,37,49,10,42,21,10,1,84,0
5994,140271,173_08_09,SUDAN,0,TOTALS,SUDAN,200,23,52,44.2,21,38,55.3,2,14,14.3,18,37,48.6,15,39,54,9,16,35,7,3,66,1
5995,140284,173_08_09,BURUNDI,0,TOTALS,BURUNDI,200,24,79,30.4,17,45,37.8,7,34,20.6,6,14,42.9,16,20,36,11,31,20,18,1,61,0
5996,140296,173_08_10,RWANDA,0,TOTALS,RWANDA,200,41,83,49.4,34,54,63.0,7,29,24.1,11,23,47.8,30,19,49,16,27,18,3,6,100,0
5997,140309,173_08_10,UGANDA,0,TOTALS,UGANDA,200,25,63,39.7,19,45,42.2,6,18,33.3,27,48,56.2,17,16,33,4,23,22,4,2,83,1
5998,140322,173_08_11,KENYA,0,TOTALS,KENYA,200,37,72,51.4,32,56,57.1,5,16,31.2,21,35,60.0,20,27,47,16,14,23,12,6,100,0
5999,140335,173_08_11,BURUNDI,0,TOTALS,BURUNDI,200,28,74,37.8,24,54,44.4,4,20,20.0,9,19,47.4,20,21,41,13,29,27,13,2,69,1
6000,140347,173_08_12,RWANDA,0,TOTALS,RWANDA,200,29,72,40.3,19,41,46.3,10,31,32.3,8,18,44.4,18,25,43,21,16,14,12,6,76,1
6001,140360,173_08_12,SUDAN,0,TOTALS,SUDAN,200,24,69,34.8,20,48,41.7,4,21,19.0,11,22,50.0,22,31,53,18,15,17,11,3,63,0
6002,140373,173_08_13,KENYA,0,TOTALS,KENYA,200,24,66,36.4,23,57,40.4,1,9,11.1,17,24,70.8,13,33,46,11,16,16,7,8,66,1
6003,140385,173_08_13,RWANDA,0,TOTALS,RWANDA,200,19,72,26.4,15,40,37.5,4,32,12.5,9,21,42.9,14,23,37,6,19,13,12,7,51,0
6004,140398,173_08_14,UGANDA,0,TOTALS,UGANDA,225,31,75,41.3,25,50,50.0,6,25,24.0,24,40,60.0,9,33,42,16,37,32,16,1,92,0
6005,140411,173_08_14,SUDAN,0,TOTALS,SUDAN,225,30,77,39.0,25,58,43.1,5,19,26.3,30,60,50.0,21,21,42,11,28,31,14,6,95,1
6006,140424,173_08_15,BURUNDI,0,TOTALS,BURUNDI,200,18,67,26.9,16,48,33.3,2,19,10.5,11,21,52.4,8,21,29,7,19,19,12,0,49,0
6007,140436,173_08_15,RWANDA,0,TOTALS,RWANDA,200,22,59,37.3,20,40,50.0,2,19,10.5,12,26,46.2,17,22,39,8,22,21,2,2,58,1
6008,140449,173_08_16,KENYA,0,TOTALS,KENYA,200,33,72,45.8,30,65,46.2,3,7,42.9,20,40,50.0,35,32,67,28,20,30,17,2,89,1
6009,140462,173_08_16,UGANDA,0,TOTALS,UGANDA,200,23,60,38.3,19,48,39.6,4,12,33.3,5,16,31.2,8,18,26,16,29,29,9,1,55,0
6010,140475,173_08_17,CAF,0,TOTALS,CAF,200,18,50,36.0,16,43,37.2,2,7,28.6,16,28,57.1,13,15,28,10,12,16,6,4,54,1
6011,140488,173_08_17,CAMEROON,0,TOTALS,CAMEROON,200,24,57,42.1,22,45,48.9,2,12,16.7,0,5,0.0,3,17,20,6,26,21,5,3,50,0
6012,140501,173_08_18,CAMEROON,0,TOTALS,CAMEROON,200,19,55,34.5,12,28,42.9,7,27,25.9,6,16,37.5,12,20,32,8,43,26,11,3,51,0
6013,140514,173_08_18,CAF,0,TOTALS,CAF,200,15,45,33.3,12,29,41.4,3,16,18.8,25,52,48.1,29,17,46,20,17,35,13,4,58,1
6014,140526,174_08_01,SENEGAL,0,TOTALS,SENEGAL,8,7,7,100.0,6,6,100.0,1,1,100.0,9,9,100.0,0,2,2,1,11,0,2,0,24,0
6015,140539,174_08_01,MALI,0,TOTALS,MALI,11,10,10,100.0,7,7,100.0,3,3,100.0,3,3,100.0,4,6,10,2,18,16,0,0,26,1
6016,140551,174_08_02,SENEGAL,0,TOTALS,SENEGAL,9,15,28,53.6,13,24,54.2,2,4,50.0,9,22,40.9,6,11,17,3,14,9,0,0,41,1
6017,140564,174_08_02,GUINEA,0,TOTALS,GUINEA,11,5,24,20.8,3,18,16.7,2,6,33.3,9,16,56.2,1,7,8,1,16,6,2,1,21,0
6018,140577,174_08_03,MALI,0,TOTALS,MALI,11,10,22,45.5,8,14,57.1,2,8,25.0,4,10,40.0,2,6,8,1,14,9,2,1,26,0
6019,140590,174_08_03,GUINEA-BISSAU,0,TOTALS,GUINEA-BISSAU,10,10,34,29.4,6,20,30.0,4,14,28.6,5,8,62.5,6,5,11,5,15,8,4,1,29,1
6020,140603,174_08_04,GUINEA-BISSAU,0,TOTALS,GUINEA-BISSAU,8,13,37,35.1,9,18,50.0,4,19,21.1,3,7,42.9,4,5,9,3,17,8,2,0,33,1
6021,140616,174_08_04,GUINEA,0,TOTALS,GUINEA,10,10,32,31.2,9,24,37.5,1,8,12.5,3,10,30.0,9,6,15,0,13,8,1,1,24,0
6022,140629,174_08_05,GUINEA,0,TOTALS,GUINEA,12,4,25,16.0,4,20,20.0,0,5,0.0,7,14,50.0,7,7,14,1,17,9,1,0,15,0
6023,140642,174_08_05,MALI,0,TOTALS,MALI,10,7,25,28.0,6,18,33.3,1,7,14.3,5,20,25.0,5,9,14,1,21,10,2,2,20,1
6024,140655,174_08_06,GUINEA-BISSAU,0,TOTALS,GUINEA-BISSAU,10,14,40,35.0,12,28,42.9,2,12,16.7,3,12,25.0,2,9,11,1,17,4,3,2,33,1
6025,140667,174_08_06,SENEGAL,0,TOTALS,SENEGAL,10,12,36,33.3,11,32,34.4,1,4,25.0,5,20,25.0,5,20,25,0,17,7,4,1,30,0
6026,140806,176_08_01,BRAZIL,0,TOTALS,BRAZIL,200,29,61,47.5,21,39,53.8,8,22,36.4,17,22,77.3,5,33,38,17,23,18,12,4,83,1
6027,140817,176_08_01,COLOMBIA,0,TOTALS,COLOMBIA,200,24,66,36.4,19,51,37.3,5,15,33.3,22,29,75.9,10,29,39,7,19,14,13,2,75,0
6028,140828,176_08_02,ARGENTINA,0,TOTALS,ARGENTINA,200,22,57,38.6,19,34,55.9,3,23,13.0,32,42,76.2,7,21,28,8,31,12,9,6,79,1
6029,140840,176_08_02,VENEZUELA,0,TOTALS,VENEZUELA,200,25,59,42.4,22,42,52.4,3,17,17.6,24,32,75.0,11,31,42,6,36,20,6,2,77,0
6030,140852,176_08_03,CHILE,0,TOTALS,CHILE,200,25,63,39.7,22,42,52.4,3,21,14.3,13,16,81.2,9,21,30,10,29,24,9,3,66,0
6031,140864,176_08_03,URUGUAY,0,TOTALS,URUGUAY,200,26,56,46.4,20,36,55.6,6,20,30.0,23,27,85.2,8,27,35,13,24,24,13,4,81,1
6032,140876,176_08_04,ARGENTINA,0,TOTALS,ARGENTINA,200,37,61,60.7,26,42,61.9,11,19,57.9,19,28,67.9,4,34,38,22,24,16,6,4,104,0
6033,140888,176_08_04,COLOMBIA,0,TOTALS,COLOMBIA,200,23,65,35.4,15,45,33.3,8,20,40.0,21,28,75.0,7,22,29,8,25,15,9,2,75,1
6034,140899,176_08_05,BRAZIL,0,TOTALS,BRAZIL,200,26,57,45.6,21,44,47.7,5,13,38.5,13,21,61.9,8,32,40,16,20,21,6,4,70,1
6035,140912,176_08_05,CHILE,0,TOTALS,CHILE,200,20,60,33.3,12,35,34.3,8,25,32.0,21,23,91.3,7,24,31,8,23,15,14,4,69,0
6036,140924,176_08_06,VENEZUELA,0,TOTALS,VENEZUELA,200,26,62,41.9,20,38,52.6,6,24,25.0,12,23,52.2,12,14,26,15,30,21,10,3,70,0
6037,140937,176_08_06,URUGUAY,0,TOTALS,URUGUAY,200,26,55,47.3,15,30,50.0,11,25,44.0,25,30,83.3,6,25,31,13,23,20,10,2,88,1
6038,140948,176_08_07,URUGUAY,0,TOTALS,URUGUAY,200,28,50,56.0,16,30,53.3,12,20,60.0,20,21,95.2,3,27,30,20,15,16,7,3,88,1
6039,140959,176_08_07,COLOMBIA,0,TOTALS,COLOMBIA,200,32,74,43.2,26,56,46.4,6,18,33.3,8,14,57.1,15,17,32,12,25,9,9,1,78,0
6040,140972,176_08_08,BRAZIL,0,TOTALS,BRAZIL,200,25,58,43.1,22,40,55.0,3,18,16.7,15,26,57.7,10,22,32,10,19,20,5,1,68,1
6041,140985,176_08_08,ARGENTINA,0,TOTALS,ARGENTINA,200,40,73,54.8,33,52,63.5,7,21,33.3,15,18,83.3,11,27,38,26,21,10,10,6,102,0
6042,140997,176_08_09,CHILE,0,TOTALS,CHILE,200,23,55,41.8,15,36,41.7,8,19,42.1,22,26,84.6,5,22,27,13,27,16,7,4,76,0
6043,141008,176_08_09,VENEZUELA,0,TOTALS,VENEZUELA,200,32,62,51.6,26,45,57.8,6,17,35.3,24,30,80.0,10,24,34,16,21,13,8,3,94,1
6044,141019,176_08_10,URUGUAY,0,TOTALS,URUGUAY,200,33,59,55.9,24,42,57.1,9,17,52.9,27,37,73.0,9,21,30,15,29,20,6,2,102,0
6045,141030,176_08_10,ARGENTINA,0,TOTALS,ARGENTINA,200,31,66,47.0,25,42,59.5,6,24,25.0,25,32,78.1,15,18,33,13,24,16,4,0,93,1
6046,141041,176_08_11,BRAZIL,0,TOTALS,BRAZIL,200,33,58,56.9,28,46,60.9,5,12,41.7,23,28,82.1,13,27,40,18,25,17,6,2,94,1
6047,141054,176_08_11,VENEZUELA,0,TOTALS,VENEZUELA,200,32,70,45.7,27,56,48.2,5,14,35.7,15,19,78.9,11,11,22,8,22,10,8,1,84,0
6048,141065,176_08_12,CHILE,0,TOTALS,CHILE,200,25,61,41.0,17,37,45.9,8,24,33.3,10,14,71.4,8,31,39,11,20,18,2,2,68,0
6049,141074,176_08_12,COLOMBIA,0,TOTALS,COLOMBIA,200,29,65,44.6,23,51,45.1,6,14,42.9,7,19,36.8,7,27,34,14,15,10,9,2,71,1
6050,141084,176_08_13,COLOMBIA,0,TOTALS,COLOMBIA,200,30,64,46.9,23,41,56.1,7,23,30.4,8,12,66.7,8,20,28,12,12,13,14,1,75,0
6051,141096,176_08_13,VENEZUELA,0,TOTALS,VENEZUELA,200,32,62,51.6,23,44,52.3,9,18,50.0,9,15,60.0,11,21,32,17,9,14,5,3,82,1
6052,141108,176_08_14,CHILE,0,TOTALS,CHILE,200,25,62,40.3,19,46,41.3,6,16,37.5,14,17,82.4,6,25,31,15,27,15,6,0,70,0
6053,141121,176_08_14,ARGENTINA,0,TOTALS,ARGENTINA,200,29,57,50.9,25,43,58.1,4,14,28.6,25,35,71.4,8,29,37,14,18,11,6,3,87,1
6054,141132,176_08_15,BRAZIL,0,TOTALS,BRAZIL,200,37,71,52.1,34,61,55.7,3,10,30.0,9,15,60.0,14,25,39,22,28,16,4,4,86,1
6055,141143,176_08_15,URUGUAY,0,TOTALS,URUGUAY,200,24,59,40.7,18,40,45.0,6,19,31.6,23,27,85.2,8,20,28,9,17,13,5,1,77,0
6056,141152,176_08_16,BRAZIL,0,TOTALS,BRAZIL,200,31,69,44.9,28,58,48.3,3,11,27.3,7,9,77.8,15,22,37,16,14,10,5,4,72,0
6057,141162,176_08_16,VENEZUELA,0,TOTALS,VENEZUELA,200,35,70,50.0,29,54,53.7,6,16,37.5,11,13,84.6,11,26,37,14,11,7,4,3,87,1
6058,141173,176_08_17,ARGENTINA,0,TOTALS,ARGENTINA,200,35,58,60.3,26,39,66.7,9,19,47.4,21,29,72.4,5,17,22,13,27,10,10,3,100,0
6059,141184,176_08_17,URUGUAY,0,TOTALS,URUGUAY,200,29,51,56.9,22,35,62.9,7,16,43.8,30,35,85.7,5,20,25,10,27,16,3,1,95,1
6060,141633,178_08_01,CUBA,0,TOTALS,CUBA,200,35,75,46.7,27,51,52.9,8,24,33.3,23,28,82.1,7,22,29,18,21,13,9,2,101,0
6061,141644,178_08_01,PANAMA,0,TOTALS,PANAMA,200,28,66,42.4,23,48,47.9,5,18,27.8,24,31,77.4,8,16,24,9,23,14,6,5,85,1
6062,141656,178_08_02,MEXICO,0,TOTALS,MEXICO,200,35,60,58.3,28,40,70.0,7,20,35.0,15,23,65.2,18,21,39,13,13,8,7,0,92,1
6063,141669,178_08_02,EL SALVADOR,0,TOTALS,EL SALVADOR,200,14,57,24.6,10,32,31.2,4,25,16.0,4,11,36.4,15,6,21,4,17,13,2,0,36,0
6064,141682,178_08_03,PUERTO RICO,0,TOTALS,PUERTO RICO,200,33,72,45.8,22,44,50.0,11,28,39.3,8,16,50.0,8,33,41,19,11,15,11,4,85,1
6065,141695,178_08_03,COSTA RICA,0,TOTALS,COSTA RICA,200,26,73,35.6,18,49,36.7,8,24,33.3,8,14,57.1,12,30,42,6,18,19,4,1,68,0
6066,141707,178_08_04,VIRGIN ISLANDS,0,TOTALS,VIRGIN ISLANDS,200,28,68,41.2,18,44,40.9,10,24,41.7,17,27,63.0,15,10,25,8,20,5,5,2,83,1
6067,141720,178_08_04,DOMINICAN REPUBLIC,0,TOTALS,DOMINICAN REPUBLIC,200,28,54,51.9,22,40,55.0,6,14,42.9,12,21,57.1,20,9,29,8,26,9,2,3,74,0
6068,141733,178_08_05,DOMINICAN REPUBLIC,0,TOTALS,DOMINICAN REPUBLIC,200,42,69,60.9,36,48,75.0,6,21,28.6,16,22,72.7,9,32,41,12,6,14,8,2,106,0
6069,141745,178_08_05,EL SALVADOR,0,TOTALS,EL SALVADOR,200,16,62,25.8,9,32,28.1,7,30,23.3,2,2,100.0,3,16,19,5,19,18,6,0,41,1
6070,141758,178_08_06,PANAMA,0,TOTALS,PANAMA,200,37,79,46.8,25,49,51.0,12,30,40.0,5,13,38.5,18,28,46,17,20,16,7,9,91,1
6071,141771,178_08_06,COSTA RICA,0,TOTALS,COSTA RICA,200,20,75,26.7,16,61,26.2,4,14,28.6,17,28,60.7,12,21,33,9,20,20,9,3,61,0
6072,141782,178_08_07,VIRGIN ISLANDS,0,TOTALS,VIRGIN ISLANDS,200,24,59,40.7,20,45,44.4,4,14,28.6,19,27,70.4,10,19,29,5,24,13,7,1,71,0
6073,141794,178_08_07,MEXICO,0,TOTALS,MEXICO,200,24,55,43.6,15,32,46.9,9,23,39.1,18,29,62.1,12,21,33,14,26,9,8,2,75,1
6074,141806,178_08_08,CUBA,0,TOTALS,CUBA,200,34,68,50.0,29,47,61.7,5,21,23.8,17,28,60.7,10,20,30,12,22,15,5,2,90,1
6075,141819,178_08_08,PUERTO RICO,0,TOTALS,PUERTO RICO,200,38,70,54.3,28,50,56.0,10,20,50.0,17,25,68.0,6,21,27,24,21,12,8,1,103,0
6076,141832,178_08_09,EL SALVADOR,0,TOTALS,EL SALVADOR,200,23,56,41.1,13,26,50.0,10,30,33.3,10,14,71.4,9,12,21,8,21,14,7,0,66,0
6077,141845,178_08_09,VIRGIN ISLANDS,0,TOTALS,VIRGIN ISLANDS,200,31,57,54.4,21,31,67.7,10,26,38.5,14,25,56.0,11,20,31,11,19,10,9,1,86,1
6078,141858,178_08_10,COSTA RICA,0,TOTALS,COSTA RICA,200,28,69,40.6,23,54,42.6,5,15,33.3,16,21,76.2,9,21,30,10,23,19,9,0,77,0
6079,141870,178_08_10,CUBA,0,TOTALS,CUBA,200,33,67,49.3,27,49,55.1,6,18,33.3,22,33,66.7,10,23,33,11,17,16,11,1,94,1
6080,141880,178_08_11,PUERTO RICO,0,TOTALS,PUERTO RICO,200,33,67,49.3,20,39,51.3,13,28,46.4,28,37,75.7,4,20,24,19,15,11,7,1,107,1
6081,141890,178_08_11,PANAMA,0,TOTALS,PANAMA,200,39,73,53.4,29,51,56.9,10,22,45.5,14,19,73.7,4,22,26,19,26,14,7,2,102,0
6082,141902,178_08_12,MEXICO,0,TOTALS,MEXICO,200,29,58,50.0,24,36,66.7,5,22,22.7,7,14,50.0,8,20,28,10,22,10,7,6,70,0
6083,141912,178_08_12,DOMINICAN REPUBLIC,0,TOTALS,DOMINICAN REPUBLIC,200,28,59,47.5,23,44,52.3,5,15,33.3,17,22,77.3,11,21,32,8,14,11,8,3,78,1
6084,141922,178_08_13,VIRGIN ISLANDS,0,TOTALS,VIRGIN ISLANDS,200,32,73,43.8,29,60,48.3,3,13,23.1,11,18,61.1,17,23,40,11,15,20,4,2,78,1
6085,141934,178_08_13,CUBA,0,TOTALS,CUBA,200,24,61,39.3,20,46,43.5,4,15,26.7,9,12,75.0,8,12,20,11,21,14,14,1,61,0
6086,141946,178_08_14,MEXICO,0,TOTALS,MEXICO,200,34,59,57.6,25,40,62.5,9,19,47.4,13,21,61.9,7,21,28,16,16,12,10,6,90,1
6087,141959,178_08_14,COSTA RICA,0,TOTALS,COSTA RICA,200,28,75,37.3,20,52,38.5,8,23,34.8,9,14,64.3,16,14,30,3,23,15,8,2,73,0
6088,141971,178_08_15,PANAMA,0,TOTALS,PANAMA,200,37,57,64.9,25,34,73.5,12,23,52.2,14,28,50.0,9,26,35,22,21,14,8,1,100,0
6089,141984,178_08_15,EL SALVADOR,0,TOTALS,EL SALVADOR,200,20,66,30.3,14,37,37.8,6,29,20.7,13,19,68.4,14,12,26,7,20,19,4,0,59,1
6090,141994,178_08_16,PUERTO RICO,0,TOTALS,PUERTO RICO,200,29,67,43.3,20,42,47.6,9,25,36.0,9,14,64.3,8,24,32,11,21,9,4,1,76,1
6091,142005,178_08_16,DOMINICAN REPUBLIC,0,TOTALS,DOMINICAN REPUBLIC,200,28,68,41.2,25,51,49.0,3,17,17.6,15,21,71.4,10,27,37,12,19,9,3,2,74,0
6092,142016,178_08_17,COSTA RICA,0,TOTALS,COSTA RICA,200,27,59,45.8,22,35,62.9,5,24,20.8,17,24,70.8,12,23,35,8,21,19,8,1,76,0
6093,142028,178_08_17,EL SALVADOR,0,TOTALS,EL SALVADOR,200,28,65,43.1,20,39,51.3,8,26,30.8,15,21,71.4,10,9,19,11,21,18,10,1,79,1
6094,142040,178_08_18,CUBA,0,TOTALS,CUBA,200,26,60,43.3,19,41,46.3,7,19,36.8,15,24,62.5,3,17,20,12,21,10,3,2,74,1
6095,142052,178_08_18,DOMINICAN REPUBLIC,0,TOTALS,DOMINICAN REPUBLIC,200,41,66,62.1,32,49,65.3,9,17,52.9,11,16,68.8,4,25,29,17,20,10,4,5,102,0
6096,142065,178_08_19,MEXICO,0,TOTALS,MEXICO,200,30,51,58.8,23,32,71.9,7,19,36.8,37,44,84.1,9,22,31,15,24,12,8,6,104,0
6097,142077,178_08_19,PANAMA,0,TOTALS,PANAMA,200,24,63,38.1,20,44,45.5,4,19,21.1,15,20,75.0,10,14,24,3,28,13,7,0,67,1
6098,142087,178_08_20,VIRGIN ISLANDS,0,TOTALS,VIRGIN ISLANDS,200,25,83,30.1,21,67,31.3,4,16,25.0,16,20,80.0,24,18,42,9,14,11,7,0,70,0
6099,142097,178_08_20,PUERTO RICO,0,TOTALS,PUERTO RICO,200,33,61,54.1,18,34,52.9,15,27,55.6,6,7,85.7,7,24,31,15,18,16,5,5,87,1
6100,142488,180_08_01,USA,0,TOTALS,USA,200,30,67,44.8,29,51,56.9,1,16,6.2,21,28,75.0,13,31,44,16,22,19,11,7,82,1
6101,142501,180_08_01,VENEZUELA,0,TOTALS,VENEZUELA,200,22,64,34.4,14,48,29.2,8,16,50.0,21,32,65.6,11,23,34,12,18,20,10,4,73,0
6102,142514,180_08_02,PUERTO RICO,0,TOTALS,PUERTO RICO,200,32,69,46.4,26,46,56.5,6,23,26.1,27,42,64.3,18,34,52,21,14,11,10,7,97,1
6103,142527,180_08_02,BAHAMAS,0,TOTALS,BAHAMAS,200,27,80,33.8,23,55,41.8,4,25,16.0,7,14,50.0,19,23,42,13,30,18,5,3,65,0
6104,142540,180_08_03,CANADA,0,TOTALS,CANADA,200,29,62,46.8,25,46,54.3,4,16,25.0,16,23,69.6,14,44,58,15,12,22,5,4,78,1
6105,142551,180_08_03,MEXICO,0,TOTALS,MEXICO,200,25,76,32.9,15,43,34.9,10,33,30.3,5,12,41.7,8,18,26,14,16,8,16,4,65,0
6106,142564,180_08_04,ARGENTINA,0,TOTALS,ARGENTINA,200,35,64,54.7,28,45,62.2,7,19,36.8,9,22,40.9,9,28,37,20,23,14,10,0,86,1
6107,142577,180_08_04,URUGUAY,0,TOTALS,URUGUAY,200,16,47,34.0,15,37,40.5,1,10,10.0,19,33,57.6,6,23,29,7,25,20,7,0,52,0
6108,142589,180_08_05,BAHAMAS,0,TOTALS,BAHAMAS,200,16,61,26.2,11,47,23.4,5,14,35.7,14,26,53.8,11,17,28,7,26,29,9,6,51,1
6109,142602,180_08_05,USA,0,TOTALS,USA,200,44,91,48.4,38,71,53.5,6,20,30.0,21,34,61.8,30,28,58,21,21,22,19,14,115,0
6110,142615,180_08_06,URUGUAY,0,TOTALS,URUGUAY,200,18,62,29.0,13,41,31.7,5,21,23.8,15,27,55.6,14,19,33,9,25,17,7,2,56,0
6111,142627,180_08_06,CANADA,0,TOTALS,CANADA,200,25,60,41.7,18,40,45.0,7,20,35.0,19,27,70.4,13,32,45,11,22,19,12,7,76,1
6112,142640,180_08_07,VENEZUELA,0,TOTALS,VENEZUELA,200,28,60,46.7,24,43,55.8,4,17,23.5,16,31,51.6,11,41,52,20,31,38,11,7,76,0
6113,142651,180_08_07,PUERTO RICO,0,TOTALS,PUERTO RICO,200,36,92,39.1,29,62,46.8,7,30,23.3,15,25,60.0,18,20,38,20,23,21,18,6,94,1
6114,142664,180_08_08,MEXICO,0,TOTALS,MEXICO,200,27,69,39.1,17,43,39.5,10,26,38.5,5,6,83.3,4,19,23,15,22,16,10,6,69,1
6115,142677,180_08_08,ARGENTINA,0,TOTALS,ARGENTINA,200,39,76,51.3,29,57,50.9,10,19,52.6,20,30,66.7,20,34,54,24,10,18,11,5,108,0
6116,142687,180_08_09,MEXICO,0,TOTALS,MEXICO,200,18,63,28.6,14,37,37.8,4,26,15.4,11,18,61.1,9,28,37,9,28,18,11,7,51,0
6117,142699,180_08_09,URUGUAY,0,TOTALS,URUGUAY,200,22,65,33.8,19,52,36.5,3,13,23.1,16,33,48.5,20,35,55,10,19,21,8,8,63,1
6118,142712,180_08_10,BAHAMAS,0,TOTALS,BAHAMAS,200,24,81,29.6,13,50,26.0,11,31,35.5,5,13,38.5,17,23,40,16,31,19,14,4,64,0
6119,142722,180_08_10,VENEZUELA,0,TOTALS,VENEZUELA,200,28,55,50.9,25,40,62.5,3,15,20.0,26,47,55.3,13,37,50,13,15,24,10,8,85,1
6120,142735,180_08_11,PUERTO RICO,0,TOTALS,PUERTO RICO,200,21,76,27.6,13,47,27.7,8,29,27.6,14,21,66.7,14,21,35,10,19,13,6,3,64,1
6121,142748,180_08_11,USA,0,TOTALS,USA,200,39,82,47.6,28,50,56.0,11,32,34.4,17,23,73.9,20,39,59,23,20,12,6,8,106,0
6122,142759,180_08_12,ARGENTINA,0,TOTALS,ARGENTINA,200,27,62,43.5,22,48,45.8,5,14,35.7,15,21,71.4,11,27,38,16,24,24,9,9,74,1
6123,142770,180_08_12,CANADA,0,TOTALS,CANADA,200,21,69,30.4,14,46,30.4,7,23,30.4,15,20,75.0,11,17,28,10,23,18,9,6,64,0
6124,142782,180_08_13,URUGUAY,0,TOTALS,URUGUAY,200,30,67,44.8,27,55,49.1,3,12,25.0,13,32,40.6,19,29,48,16,17,26,11,4,76,1
6125,142794,180_08_13,BAHAMAS,0,TOTALS,BAHAMAS,200,26,70,37.1,20,50,40.0,6,20,30.0,11,16,68.8,12,24,36,12,25,19,12,8,69,0
6126,142807,180_08_14,VENEZUELA,0,TOTALS,VENEZUELA,200,35,73,47.9,31,50,62.0,4,23,17.4,16,31,51.6,25,33,58,11,19,22,11,8,90,1
6127,142820,180_08_14,MEXICO,0,TOTALS,MEXICO,200,29,77,37.7,14,33,42.4,15,44,34.1,5,11,45.5,13,16,29,17,26,15,8,6,78,0
6128,142833,180_08_15,USA,0,TOTALS,USA,200,36,81,44.4,33,66,50.0,3,15,20.0,7,13,53.8,19,32,51,14,20,12,9,4,82,1
6129,142844,180_08_15,CANADA,0,TOTALS,CANADA,200,26,65,40.0,21,48,43.8,5,17,29.4,9,17,52.9,9,27,36,7,15,18,5,4,66,0
6130,142857,180_08_16,ARGENTINA,0,TOTALS,ARGENTINA,200,28,65,43.1,16,36,44.4,12,29,41.4,15,31,48.4,16,34,50,17,17,14,4,2,83,1
6131,142869,180_08_16,PUERTO RICO,0,TOTALS,PUERTO RICO,200,26,67,38.8,17,44,38.6,9,23,39.1,7,15,46.7,4,21,25,14,25,8,6,5,68,0
6132,142880,180_08_17,URUGUAY,0,TOTALS,URUGUAY,200,22,64,34.4,15,44,34.1,7,20,35.0,12,24,50.0,15,21,36,13,27,26,16,0,63,0
6133,142892,180_08_17,VENEZUELA,0,TOTALS,VENEZUELA,200,21,53,39.6,15,33,45.5,6,20,30.0,26,30,86.7,8,26,34,14,24,27,17,3,74,1
6134,142904,180_08_18,CANADA,0,TOTALS,CANADA,200,36,64,56.2,32,55,58.2,4,9,44.4,7,11,63.6,16,33,49,17,16,20,5,11,83,1
6135,142914,180_08_18,PUERTO RICO,0,TOTALS,PUERTO RICO,200,25,74,33.8,17,50,34.0,8,24,33.3,10,15,66.7,17,12,29,11,12,10,10,1,68,0
6136,143305,182_08_01,URUGUAY,0,TOTALS,URUGUAY,200,13,46,28.3,12,32,37.5,1,14,7.1,8,22,36.4,6,12,18,7,22,32,26,0,35,0
6137,143318,182_08_01,ARGENTINA,0,TOTALS,ARGENTINA,200,29,61,47.5,25,44,56.8,4,17,23.5,10,31,32.3,5,12,17,21,18,27,23,1,72,1
6138,143331,182_08_02,VENEZUELA,0,TOTALS,VENEZUELA,200,37,68,54.4,30,50,60.0,7,18,38.9,12,24,50.0,8,17,25,18,21,19,28,2,93,1
6139,143344,182_08_02,PERU,0,TOTALS,PERU,200,17,50,34.0,14,38,36.8,3,12,25.0,4,6,66.7,1,10,11,13,10,35,18,0,41,0
6140,143357,182_08_03,PERU,0,TOTALS,PERU,200,22,53,41.5,20,45,44.4,2,8,25.0,6,20,30.0,3,7,10,6,19,27,25,0,52,0
6141,143370,182_08_03,BRAZIL,0,TOTALS,BRAZIL,200,27,61,44.3,23,46,50.0,4,15,26.7,14,22,63.6,8,12,20,17,13,22,28,0,72,1
6142,143383,182_08_04,VENEZUELA,0,TOTALS,VENEZUELA,200,24,61,39.3,21,48,43.8,3,13,23.1,13,35,37.1,9,14,23,19,14,12,27,1,64,1
6143,143396,182_08_04,URUGUAY,0,TOTALS,URUGUAY,200,20,51,39.2,17,39,43.6,3,12,25.0,7,13,53.8,1,13,14,14,30,27,18,5,50,0
6144,143409,182_08_05,URUGUAY,0,TOTALS,URUGUAY,200,22,55,40.0,16,39,41.0,6,16,37.5,14,28,50.0,4,17,21,21,22,25,34,5,64,1
6145,143422,182_08_05,PERU,0,TOTALS,PERU,200,11,40,27.5,10,29,34.5,1,11,9.1,13,21,61.9,3,10,13,6,23,36,25,0,36,0
6146,143435,182_08_06,ARGENTINA,0,TOTALS,ARGENTINA,200,24,48,50.0,22,35,62.9,2,13,15.4,14,32,43.8,1,13,14,12,26,21,27,6,64,1
6147,143448,182_08_06,BRAZIL,0,TOTALS,BRAZIL,200,10,43,23.3,9,32,28.1,1,11,9.1,23,32,71.9,2,14,16,8,22,21,20,4,44,0
6148,143461,182_08_07,PERU,0,TOTALS,PERU,200,9,30,30.0,8,26,30.8,1,4,25.0,5,19,26.3,2,5,7,6,24,25,16,2,24,1
6149,143474,182_08_07,ARGENTINA,0,TOTALS,ARGENTINA,200,41,76,53.9,36,53,67.9,5,23,21.7,13,30,43.3,22,15,37,16,17,13,21,6,100,0
6150,143487,182_08_08,VENEZUELA,0,TOTALS,VENEZUELA,200,23,51,45.1,15,33,45.5,8,18,44.4,14,24,58.3,1,16,17,9,13,21,19,6,68,1
6151,143500,182_08_08,BRAZIL,0,TOTALS,BRAZIL,200,23,43,53.5,22,36,61.1,1,7,14.3,5,10,50.0,1,8,9,7,16,17,16,7,52,0
6152,143513,182_08_09,BRAZIL,0,TOTALS,BRAZIL,200,21,54,38.9,17,37,45.9,4,17,23.5,19,38,50.0,6,10,16,16,30,24,29,0,65,1
6153,143526,182_08_09,URUGUAY,0,TOTALS,URUGUAY,200,20,46,43.5,18,32,56.2,2,14,14.3,20,33,60.6,7,20,27,13,30,28,15,0,62,0
6154,143539,182_08_10,VENEZUELA,0,TOTALS,VENEZUELA,200,20,50,40.0,17,39,43.6,3,11,27.3,15,28,53.6,6,12,18,18,14,26,11,0,58,0
6155,143552,182_08_10,ARGENTINA,0,TOTALS,ARGENTINA,200,30,58,51.7,24,37,64.9,6,21,28.6,7,13,53.8,12,17,29,7,18,17,18,0,73,1
6156,144029,186_08_01,ANDORRA,0,TOTALS,ANDORRA,200,25,54,46.3,20,36,55.6,5,18,27.8,23,33,69.7,5,36,41,13,18,18,11,1,78,1
6157,144042,186_08_01,WALES,0,TOTALS,WALES,200,21,61,34.4,17,46,37.0,4,15,26.7,6,15,40.0,14,24,38,14,28,23,13,0,52,0
6158,144055,186_08_02,MOLDOVA,0,TOTALS,MOLDOVA,200,32,65,49.2,25,54,46.3,7,11,63.6,14,23,60.9,20,28,48,15,22,19,5,6,85,1
6159,144068,186_08_02,SAN MARINO,0,TOTALS,SAN MARINO,200,17,58,29.3,7,33,21.2,10,25,40.0,20,24,83.3,14,20,34,6,19,14,5,0,64,0
6160,144081,186_08_03,AZERBAIJAN,0,TOTALS,AZERBAIJAN,200,38,79,48.1,24,33,72.7,14,46,30.4,6,8,75.0,10,27,37,23,19,8,20,1,96,1
6161,144094,186_08_03,GIBRALTAR,0,TOTALS,GIBRALTAR,200,24,55,43.6,20,42,47.6,4,13,30.8,9,17,52.9,8,28,36,15,14,33,5,0,61,0
6162,144107,186_08_04,SCOTLAND,0,TOTALS,SCOTLAND,200,19,56,33.9,14,32,43.8,5,24,20.8,15,25,60.0,11,35,46,11,23,16,5,3,58,1
6163,144120,186_08_04,MALTA,0,TOTALS,MALTA,200,17,54,31.5,15,37,40.5,2,17,11.8,13,27,48.1,11,33,44,9,21,17,6,1,49,0
6164,144133,186_08_05,GIBRALTAR,0,TOTALS,GIBRALTAR,200,23,59,39.0,22,53,41.5,1,6,16.7,7,12,58.3,7,23,30,11,12,16,7,1,54,0
6165,144146,186_08_05,MOLDOVA,0,TOTALS,MOLDOVA,200,37,78,47.4,24,45,53.3,13,33,39.4,10,13,76.9,20,26,46,25,14,16,8,3,97,1
6166,144159,186_08_06,SAN MARINO,0,TOTALS,SAN MARINO,200,26,63,41.3,17,32,53.1,9,31,29.0,8,14,57.1,15,23,38,13,27,18,10,0,69,0
6167,144172,186_08_06,AZERBAIJAN,0,TOTALS,AZERBAIJAN,200,28,60,46.7,20,36,55.6,8,24,33.3,11,23,47.8,14,23,37,11,19,20,8,1,75,1
6168,144185,186_08_07,MALTA,0,TOTALS,MALTA,200,22,66,33.3,18,46,39.1,4,20,20.0,4,10,40.0,9,32,41,8,29,25,16,2,52,0
6169,144198,186_08_07,ANDORRA,0,TOTALS,ANDORRA,200,15,59,25.4,14,40,35.0,1,19,5.3,24,43,55.8,18,36,54,4,15,25,13,1,55,1
6170,144211,186_08_08,WALES,0,TOTALS,WALES,200,15,66,22.7,13,43,30.2,2,23,8.7,13,31,41.9,14,29,43,10,24,19,8,0,45,0
6171,144224,186_08_08,SCOTLAND,0,TOTALS,SCOTLAND,200,25,69,36.2,21,46,45.7,4,23,17.4,17,23,73.9,19,48,67,15,24,23,13,5,71,1
6172,144237,186_08_09,AZERBAIJAN,0,TOTALS,AZERBAIJAN,200,25,67,37.3,18,43,41.9,7,24,29.2,4,12,33.3,9,32,41,14,24,22,9,1,61,0
6173,144250,186_08_09,MOLDOVA,0,TOTALS,MOLDOVA,200,23,62,37.1,19,44,43.2,4,18,22.2,20,34,58.8,8,32,40,9,17,20,9,1,70,1
6174,144263,186_08_10,WALES,0,TOTALS,WALES,200,20,62,32.3,16,49,32.7,4,13,30.8,12,25,48.0,19,30,49,11,18,21,8,2,56,1
6175,144276,186_08_10,MALTA,0,TOTALS,MALTA,200,20,66,30.3,18,55,32.7,2,11,18.2,8,14,57.1,17,28,45,5,19,20,7,5,50,0
6176,144289,186_08_11,SAN MARINO,0,TOTALS,SAN MARINO,200,32,70,45.7,21,36,58.3,11,34,32.4,16,21,76.2,20,13,33,18,23,14,12,0,91,1
6177,144302,186_08_11,GIBRALTAR,0,TOTALS,GIBRALTAR,200,30,50,60.0,25,39,64.1,5,11,45.5,15,20,75.0,7,19,26,21,19,19,5,0,80,0
6178,144315,186_08_12,SCOTLAND,0,TOTALS,SCOTLAND,200,32,66,48.5,24,41,58.5,8,25,32.0,12,26,46.2,15,31,46,22,21,17,7,3,84,1
6179,144328,186_08_12,ANDORRA,0,TOTALS,ANDORRA,200,30,72,41.7,21,44,47.7,9,28,32.1,12,18,66.7,15,24,39,16,24,18,9,1,81,0
6180,144341,186_08_13,SAN MARINO,0,TOTALS,SAN MARINO,200,25,61,41.0,21,43,48.8,4,18,22.2,19,29,65.5,9,27,36,13,18,17,9,3,73,1
6181,144354,186_08_13,MALTA,0,TOTALS,MALTA,200,21,58,36.2,18,39,46.2,3,19,15.8,12,22,54.5,13,27,40,8,29,22,6,3,57,0
6182,144367,186_08_14,WALES,0,TOTALS,WALES,200,35,84,41.7,31,62,50.0,4,22,18.2,3,4,75.0,17,18,35,21,35,21,12,2,77,0
6183,144380,186_08_14,GIBRALTAR,0,TOTALS,GIBRALTAR,200,32,57,56.1,28,49,57.1,4,8,50.0,25,38,65.8,12,32,44,17,17,31,7,0,93,1
6184,144393,186_08_15,MOLDOVA,0,TOTALS,MOLDOVA,200,30,57,52.6,26,46,56.5,4,11,36.4,21,38,55.3,9,35,44,20,28,19,9,1,85,1
6185,144406,186_08_15,ANDORRA,0,TOTALS,ANDORRA,200,26,75,34.7,16,44,36.4,10,31,32.3,12,29,41.4,18,26,44,11,27,19,10,1,74,0
6186,144419,186_08_16,SCOTLAND,0,TOTALS,SCOTLAND,200,28,69,40.6,19,42,45.2,9,27,33.3,15,22,68.2,11,34,45,17,24,16,1,1,80,0
6187,144432,186_08_16,AZERBAIJAN,0,TOTALS,AZERBAIJAN,200,29,63,46.0,13,24,54.2,16,39,41.0,17,28,60.7,5,28,33,17,18,7,10,1,91,1
6188,144445,186_08_17,MALTA,0,TOTALS,MALTA,200,33,67,49.3,24,50,48.0,9,17,52.9,9,17,52.9,11,27,38,12,26,17,10,2,84,1
6189,144458,186_08_17,WALES,0,TOTALS,WALES,200,23,62,37.1,18,46,39.1,5,16,31.2,16,33,48.5,20,26,46,15,14,20,8,4,67,0
6190,144471,186_08_18,SAN MARINO,0,TOTALS,SAN MARINO,200,31,61,50.8,22,37,59.5,9,24,37.5,6,9,66.7,9,22,31,19,18,17,12,3,77,1
6191,144484,186_08_18,GIBRALTAR,0,TOTALS,GIBRALTAR,200,25,55,45.5,22,38,57.9,3,17,17.6,11,15,73.3,4,23,27,16,12,17,7,1,64,0
6192,144497,186_08_19,ANDORRA,0,TOTALS,ANDORRA,200,27,72,37.5,18,43,41.9,9,29,31.0,13,21,61.9,16,25,41,12,22,19,9,1,76,0
6193,144510,186_08_19,SCOTLAND,0,TOTALS,SCOTLAND,200,28,67,41.8,14,33,42.4,14,34,41.2,20,30,66.7,16,32,48,20,17,18,13,5,90,1
6194,144523,186_08_20,MOLDOVA,0,TOTALS,MOLDOVA,200,30,65,46.2,20,49,40.8,10,16,62.5,8,13,61.5,10,31,41,15,13,19,11,1,78,0
6195,144536,186_08_20,AZERBAIJAN,0,TOTALS,AZERBAIJAN,200,31,66,47.0,17,36,47.2,14,30,46.7,4,9,44.4,6,29,35,12,16,14,8,2,80,1
6196,145039,188_08_01,UKRAINE,0,TOTALS,UKRAINE,200,29,64,45.3,10,23,43.5,19,41,46.3,14,20,70.0,10,21,31,22,28,13,5,2,91,0
6197,145052,188_08_01,LITHUANIA,0,TOTALS,LITHUANIA,200,32,72,44.4,24,50,48.0,8,22,36.4,21,27,77.8,14,25,39,16,23,8,6,1,93,1
6198,145065,188_08_02,GEORGIA,0,TOTALS,GEORGIA,200,18,56,32.1,14,33,42.4,4,23,17.4,11,21,52.4,12,29,41,11,22,17,8,2,51,0
6199,145078,188_08_02,TURKEY,0,TOTALS,TURKEY,200,27,67,40.3,22,42,52.4,5,25,20.0,10,13,76.9,11,31,42,14,22,13,9,0,69,1
6200,145091,188_08_03,CROATIA,0,TOTALS,CROATIA,225,25,63,39.7,17,36,47.2,8,27,29.6,16,28,57.1,10,30,40,11,25,21,8,0,74,1
6201,145104,188_08_03,GREECE,0,TOTALS,GREECE,225,22,75,29.3,18,51,35.3,4,24,16.7,19,27,70.4,16,25,41,12,26,12,16,3,67,0
6202,145117,188_08_04,ISRAEL,0,TOTALS,ISRAEL,200,25,51,49.0,22,35,62.9,3,16,18.8,14,22,63.6,5,25,30,7,22,18,5,3,67,0
6203,145130,188_08_04,ITALY,0,TOTALS,ITALY,200,25,62,40.3,16,36,44.4,9,26,34.6,10,18,55.6,9,21,30,8,19,10,7,2,69,1
6204,145143,188_08_05,MONTENEGRO,0,TOTALS,MONTENEGRO,200,27,68,39.7,18,41,43.9,9,27,33.3,11,21,52.4,10,25,35,12,19,13,9,2,74,1
6205,145156,188_08_05,SPAIN,0,TOTALS,SPAIN,200,26,61,42.6,23,41,56.1,3,20,15.0,10,14,71.4,9,22,31,13,21,17,9,7,65,0
6206,145169,188_08_06,RUSSIA,0,TOTALS,RUSSIA,200,26,67,38.8,14,38,36.8,12,29,41.4,11,16,68.8,7,24,31,15,24,10,3,6,75,0
6207,145182,188_08_06,SERBIA,0,TOTALS,SERBIA,200,31,60,51.7,27,47,57.4,4,13,30.8,18,27,66.7,11,35,46,14,21,16,5,4,84,1
6208,145195,188_08_07,LATVIA,0,TOTALS,LATVIA,200,37,68,54.4,23,37,62.2,14,31,45.2,7,9,77.8,11,20,31,24,17,10,10,4,95,1
6209,145208,188_08_07,BULGARIA,0,TOTALS,BULGARIA,200,24,55,43.6,18,41,43.9,6,14,42.9,13,21,61.9,11,15,26,10,12,16,4,0,67,0
6210,145221,188_08_08,SLOVENIA,0,TOTALS,SLOVENIA,200,16,61,26.2,11,36,30.6,5,25,20.0,9,19,47.4,12,28,40,8,19,18,5,2,46,0
6211,145234,188_08_08,FRANCE,0,TOTALS,FRANCE,200,38,80,47.5,32,62,51.6,6,18,33.3,9,15,60.0,19,36,55,17,20,10,14,6,91,1
6212,145247,188_08_09,LITHUANIA,0,TOTALS,LITHUANIA,200,34,65,52.3,25,42,59.5,9,23,39.1,11,16,68.8,12,22,34,19,20,19,13,2,88,1
6213,145260,188_08_09,CROATIA,0,TOTALS,CROATIA,200,29,63,46.0,26,45,57.8,3,18,16.7,8,21,38.1,9,17,26,15,21,18,10,3,69,0
6214,145273,188_08_10,TURKEY,0,TOTALS,TURKEY,200,26,61,42.6,20,34,58.8,6,27,22.2,17,24,70.8,14,35,49,17,21,19,6,3,75,1
6215,145286,188_08_10,ISRAEL,0,TOTALS,ISRAEL,200,21,62,33.9,14,37,37.8,7,25,28.0,16,24,66.7,8,24,32,11,22,12,7,0,65,0
6216,145299,188_08_11,BULGARIA,0,TOTALS,BULGARIA,200,20,49,40.8,15,33,45.5,5,16,31.2,23,28,82.1,9,29,38,13,20,30,5,1,68,0
6217,145312,188_08_11,MONTENEGRO,0,TOTALS,MONTENEGRO,200,29,70,41.4,22,40,55.0,7,30,23.3,11,14,78.6,13,20,33,9,24,17,14,2,76,1
6218,145325,188_08_12,SERBIA,0,TOTALS,SERBIA,200,33,56,58.9,29,45,64.4,4,11,36.4,20,27,74.1,4,28,32,22,16,12,6,8,90,1
6219,145338,188_08_12,SLOVENIA,0,TOTALS,SLOVENIA,200,30,72,41.7,23,53,43.4,7,19,36.8,11,12,91.7,14,22,36,18,27,12,9,1,78,0
6220,145351,188_08_13,GREECE,0,TOTALS,GREECE,200,31,71,43.7,26,52,50.0,5,19,26.3,7,14,50.0,15,30,45,18,21,15,7,3,74,1
6221,145364,188_08_13,UKRAINE,0,TOTALS,UKRAINE,200,26,64,40.6,18,33,54.5,8,31,25.8,11,15,73.3,8,29,37,18,20,16,6,4,71,0
6222,145377,188_08_14,FRANCE,0,TOTALS,FRANCE,200,34,56,60.7,26,41,63.4,8,15,53.3,12,18,66.7,8,26,34,20,25,20,7,4,88,1
6223,145390,188_08_14,RUSSIA,0,TOTALS,RUSSIA,200,31,70,44.3,23,44,52.3,8,26,30.8,12,18,66.7,15,15,30,18,15,15,6,2,82,0
6224,145403,188_08_15,ITALY,0,TOTALS,ITALY,200,23,66,34.8,15,36,41.7,8,30,26.7,9,9,100.0,10,17,27,8,22,8,11,0,63,0
6225,145416,188_08_15,GEORGIA,0,TOTALS,GEORGIA,200,26,56,46.4,20,36,55.6,6,20,30.0,12,20,60.0,13,34,47,13,17,17,4,6,70,1
6226,145429,188_08_16,SPAIN,0,TOTALS,SPAIN,200,24,61,39.3,17,38,44.7,7,23,30.4,5,10,50.0,10,31,41,14,16,10,7,4,60,1
6227,145442,188_08_16,LATVIA,0,TOTALS,LATVIA,200,17,57,29.8,12,38,31.6,5,19,26.3,7,16,43.8,12,28,40,7,13,13,3,2,46,0
6228,145455,188_08_17,CROATIA,0,TOTALS,CROATIA,200,31,60,51.7,20,41,48.8,11,19,57.9,18,22,81.8,11,21,32,14,32,21,4,2,91,1
6229,145468,188_08_17,UKRAINE,0,TOTALS,UKRAINE,200,31,61,50.8,18,29,62.1,13,32,40.6,26,32,81.2,12,18,30,16,21,12,10,3,101,0
6230,145481,188_08_18,RUSSIA,0,TOTALS,RUSSIA,200,28,65,43.1,25,41,61.0,3,24,12.5,18,29,62.1,15,25,40,9,18,8,9,2,77,1
6231,145494,188_08_18,SLOVENIA,0,TOTALS,SLOVENIA,200,27,65,41.5,21,40,52.5,6,25,24.0,9,16,56.2,15,27,42,8,28,16,3,2,69,0
6232,145507,188_08_19,TURKEY,0,TOTALS,TURKEY,200,23,58,39.7,19,41,46.3,4,17,23.5,13,19,68.4,10,27,37,11,20,18,6,1,63,0
6233,145520,188_08_19,ITALY,0,TOTALS,ITALY,200,21,55,38.2,11,27,40.7,10,28,35.7,14,19,73.7,8,28,36,9,27,20,8,1,66,1
6234,145533,188_08_20,SPAIN,0,TOTALS,SPAIN,200,39,72,54.2,35,54,64.8,4,18,22.2,15,21,71.4,14,24,38,17,22,10,13,1,97,1
6235,145546,188_08_20,BULGARIA,0,TOTALS,BULGARIA,200,28,56,50.0,14,32,43.8,14,24,58.3,14,25,56.0,10,20,30,18,20,18,5,4,84,0
6236,145559,188_08_21,LITHUANIA,0,TOTALS,LITHUANIA,200,27,59,45.8,22,41,53.7,5,18,27.8,31,39,79.5,18,33,51,11,19,21,6,3,90,1
6237,145572,188_08_21,GREECE,0,TOTALS,GREECE,200,30,70,42.9,22,44,50.0,8,26,30.8,9,14,64.3,11,17,28,18,28,13,14,5,77,0
6238,145585,188_08_22,ISRAEL,0,TOTALS,ISRAEL,200,31,76,40.8,23,56,41.1,8,20,40.0,14,16,87.5,14,28,42,15,32,14,7,0,84,1
6239,145598,188_08_22,GEORGIA,0,TOTALS,GEORGIA,200,26,62,41.9,22,39,56.4,4,23,17.4,24,43,55.8,13,33,46,11,20,15,7,8,80,0
6240,145611,188_08_23,LATVIA,0,TOTALS,LATVIA,200,23,61,37.7,15,34,44.1,8,27,29.6,10,19,52.6,11,20,31,14,24,16,10,2,64,0
6241,145624,188_08_23,MONTENEGRO,0,TOTALS,MONTENEGRO,200,27,51,52.9,20,33,60.6,7,18,38.9,16,23,69.6,6,31,37,14,21,19,8,1,77,1
6242,145637,188_08_24,FRANCE,0,TOTALS,FRANCE,200,31,66,47.0,23,43,53.5,8,23,34.8,13,19,68.4,13,31,44,13,22,14,5,3,83,1
6243,145650,188_08_24,SERBIA,0,TOTALS,SERBIA,200,25,60,41.7,17,33,51.5,8,27,29.6,11,18,61.1,7,24,31,15,22,13,7,0,69,0
6244,145663,188_08_25,GREECE,0,TOTALS,GREECE,200,29,73,39.7,26,58,44.8,3,15,20.0,9,13,69.2,24,26,50,14,22,18,5,4,70,0
6245,145676,188_08_25,SLOVENIA,0,TOTALS,SLOVENIA,200,27,63,42.9,20,40,50.0,7,23,30.4,16,20,80.0,11,22,33,14,22,11,5,2,77,1
6246,145688,188_08_26,GEORGIA,0,TOTALS,GEORGIA,200,28,67,41.8,25,49,51.0,3,18,16.7,16,22,72.7,15,25,40,15,23,18,9,6,75,0
6247,145701,188_08_26,BULGARIA,0,TOTALS,BULGARIA,200,34,65,52.3,28,49,57.1,6,16,37.5,16,22,72.7,8,26,34,24,22,12,8,3,90,1
6248,145714,188_08_27,TURKEY,0,TOTALS,TURKEY,200,31,67,46.3,19,40,47.5,12,27,44.4,12,18,66.7,19,29,48,15,21,22,10,1,86,1
6249,145727,188_08_27,UKRAINE,0,TOTALS,UKRAINE,200,25,59,42.4,14,30,46.7,11,29,37.9,12,18,66.7,8,22,30,15,16,17,10,2,73,0
6250,145740,188_08_28,RUSSIA,0,TOTALS,RUSSIA,200,22,55,40.0,17,37,45.9,5,18,27.8,14,24,58.3,13,21,34,15,16,19,6,3,63,0
6251,145753,188_08_28,MONTENEGRO,0,TOTALS,MONTENEGRO,200,30,64,46.9,19,37,51.4,11,27,40.7,10,14,71.4,14,25,39,12,26,13,14,1,81,1
6252,145765,188_08_29,ISRAEL,0,TOTALS,ISRAEL,200,27,65,41.5,23,46,50.0,4,19,21.1,12,17,70.6,7,24,31,14,30,14,6,2,70,0
6253,145778,188_08_29,LITHUANIA,0,TOTALS,LITHUANIA,200,24,67,35.8,19,43,44.2,5,24,20.8,24,38,63.2,25,34,59,8,22,16,3,6,77,1
6254,145791,188_08_30,SERBIA,0,TOTALS,SERBIA,200,22,48,45.8,15,30,50.0,7,18,38.9,29,32,90.6,9,29,38,16,21,20,10,1,80,1
6255,145804,188_08_30,SPAIN,0,TOTALS,SPAIN,200,30,61,49.2,24,39,61.5,6,22,27.3,7,16,43.8,6,18,24,9,26,14,12,3,73,0
6256,145817,188_08_31,CROATIA,0,TOTALS,CROATIA,200,16,51,31.4,12,33,36.4,4,18,22.2,16,24,66.7,12,17,29,9,20,18,9,1,52,0
6257,145830,188_08_31,ITALY,0,TOTALS,ITALY,200,29,51,56.9,14,21,66.7,15,30,50.0,15,19,78.9,6,27,33,16,25,13,7,2,88,1
6258,145843,188_08_32,LATVIA,0,TOTALS,LATVIA,200,31,68,45.6,15,31,48.4,16,37,43.2,18,25,72.0,9,27,36,21,22,11,11,2,96,1
6259,145856,188_08_32,FRANCE,0,TOTALS,FRANCE,200,25,64,39.1,17,40,42.5,8,24,33.3,15,23,65.2,18,31,49,14,23,23,7,5,73,0
6260,145869,188_08_33,LITHUANIA,0,TOTALS,LITHUANIA,200,28,61,45.9,23,42,54.8,5,19,26.3,19,26,73.1,9,30,39,13,19,13,4,4,80,0
6261,145882,188_08_33,TURKEY,0,TOTALS,TURKEY,200,31,62,50.0,24,39,61.5,7,23,30.4,15,23,65.2,5,27,32,16,22,10,9,2,84,1
6262,145895,188_08_34,MONTENEGRO,0,TOTALS,MONTENEGRO,200,27,60,45.0,15,26,57.7,12,34,35.3,4,10,40.0,8,17,25,12,27,12,5,1,70,0
6263,145908,188_08_34,SERBIA,0,TOTALS,SERBIA,200,24,51,47.1,20,39,51.3,4,12,33.3,23,29,79.3,14,30,44,16,18,16,8,2,75,1
6264,145921,188_08_35,UKRAINE,0,TOTALS,UKRAINE,200,20,49,40.8,11,20,55.0,9,29,31.0,11,14,78.6,9,22,31,16,16,25,4,2,60,0
6265,145934,188_08_35,ITALY,0,TOTALS,ITALY,200,38,65,58.5,26,37,70.3,12,28,42.9,11,15,73.3,7,21,28,20,19,6,12,1,99,1
6266,145947,188_08_36,SPAIN,0,TOTALS,SPAIN,200,31,64,48.4,20,33,60.6,11,31,35.5,19,23,82.6,12,26,38,21,20,13,6,4,92,1
6267,145960,188_08_36,FRANCE,0,TOTALS,FRANCE,200,28,74,37.8,21,45,46.7,7,29,24.1,9,14,64.3,23,23,46,11,23,13,10,1,72,0
6268,145972,188_08_37,ISRAEL,0,TOTALS,ISRAEL,200,22,65,33.8,17,41,41.5,5,24,20.8,13,17,76.5,11,21,32,9,25,14,6,2,62,0
6269,145985,188_08_37,CROATIA,0,TOTALS,CROATIA,200,27,62,43.5,18,38,47.4,9,24,37.5,17,24,70.8,19,32,51,20,22,19,7,5,80,1
6270,145998,188_08_38,RUSSIA,0,TOTALS,RUSSIA,200,20,56,35.7,18,42,42.9,2,14,14.3,13,25,52.0,15,31,46,5,17,18,4,0,55,0
6271,146011,188_08_38,LATVIA,0,TOTALS,LATVIA,200,26,66,39.4,23,45,51.1,3,21,14.3,13,15,86.7,10,27,37,16,21,7,7,6,68,1
6272,146024,188_08_39,BULGARIA,0,TOTALS,BULGARIA,200,18,51,35.3,12,30,40.0,6,21,28.6,15,19,78.9,9,15,24,13,18,24,4,3,57,0
6273,146037,188_08_39,GREECE,0,TOTALS,GREECE,200,38,65,58.5,28,46,60.9,10,19,52.6,12,17,70.6,14,24,38,22,25,13,16,2,98,1
6274,146050,188_08_40,SLOVENIA,0,TOTALS,SLOVENIA,225,32,77,41.6,24,51,47.1,8,26,30.8,19,25,76.0,19,29,48,18,27,21,11,3,91,1
6275,146063,188_08_40,GEORGIA,0,TOTALS,GEORGIA,225,27,69,39.1,21,47,44.7,6,22,27.3,22,33,66.7,17,29,46,15,25,22,13,3,82,0
6276,146076,188_08_41,TURKEY,0,TOTALS,TURKEY,200,23,62,37.1,16,34,47.1,7,28,25.0,10,16,62.5,10,27,37,13,20,15,9,3,63,1
6277,146089,188_08_41,CROATIA,0,TOTALS,CROATIA,200,20,62,32.3,14,37,37.8,6,25,24.0,14,17,82.4,14,30,44,14,20,18,8,0,60,0
6278,146102,188_08_42,SPAIN,0,TOTALS,SPAIN,200,28,63,44.4,23,45,51.1,5,18,27.8,17,21,81.0,13,28,41,7,26,14,6,5,78,1
6279,146115,188_08_42,RUSSIA,0,TOTALS,RUSSIA,200,22,60,36.7,16,40,40.0,6,20,30.0,21,30,70.0,14,24,38,10,20,11,8,6,71,0
6280,146128,188_08_43,UKRAINE,0,TOTALS,UKRAINE,200,26,64,40.6,11,27,40.7,15,37,40.5,17,23,73.9,12,34,46,13,17,11,2,10,84,1
6281,146140,188_08_43,ISRAEL,0,TOTALS,ISRAEL,200,27,73,37.0,21,53,39.6,6,20,30.0,8,12,66.7,13,26,39,8,25,8,5,3,68,0
6282,146153,188_08_44,FRANCE,0,TOTALS,FRANCE,200,24,59,40.7,21,42,50.0,3,17,17.6,15,21,71.4,17,27,44,12,16,21,13,3,66,1
6283,146166,188_08_44,MONTENEGRO,0,TOTALS,MONTENEGRO,200,21,60,35.0,10,24,41.7,11,36,30.6,9,15,60.0,13,20,33,13,18,20,13,1,62,0
6284,146179,188_08_45,ITALY,0,TOTALS,ITALY,200,26,62,41.9,15,36,41.7,11,26,42.3,16,23,69.6,6,24,30,11,34,14,7,0,79,0
6285,146192,188_08_45,LITHUANIA,0,TOTALS,LITHUANIA,200,29,58,50.0,20,37,54.1,9,21,42.9,22,33,66.7,8,31,39,13,22,16,6,2,89,1
6286,146205,188_08_46,SERBIA,0,TOTALS,SERBIA,200,31,61,50.8,20,42,47.6,11,19,57.9,24,31,77.4,14,26,40,22,19,9,7,3,97,1
6287,146218,188_08_46,LATVIA,0,TOTALS,LATVIA,200,22,61,36.1,9,31,29.0,13,30,43.3,13,19,68.4,12,16,28,11,25,13,2,2,70,0
6288,146231,188_08_47,GREECE,0,TOTALS,GREECE,200,40,75,53.3,32,58,55.2,8,17,47.1,9,11,81.8,12,21,33,30,21,12,16,3,97,1
6289,146244,188_08_47,GEORGIA,0,TOTALS,GEORGIA,200,25,55,45.5,24,44,54.5,1,11,9.1,16,23,69.6,13,24,37,11,15,25,7,1,67,0
6290,146257,188_08_48,BULGARIA,0,TOTALS,BULGARIA,200,27,64,42.2,18,39,46.2,9,25,36.0,17,19,89.5,10,23,33,16,14,12,9,2,80,1
6291,146270,188_08_48,SLOVENIA,0,TOTALS,SLOVENIA,200,29,64,45.3,21,41,51.2,8,23,34.8,12,14,85.7,12,28,40,15,20,18,7,4,78,0
6292,146283,188_08_49,MONTENEGRO,0,TOTALS,MONTENEGRO,200,36,69,52.2,29,46,63.0,7,23,30.4,11,17,64.7,12,22,34,21,22,9,18,0,90,1
6293,146296,188_08_49,UKRAINE,0,TOTALS,UKRAINE,200,17,55,30.9,10,29,34.5,7,26,26.9,12,16,75.0,16,24,40,13,15,27,3,3,53,0
6294,146309,188_08_50,ITALY,0,TOTALS,ITALY,200,26,65,40.0,14,35,40.0,12,30,40.0,7,8,87.5,7,36,43,18,17,19,7,2,71,1
6295,146322,188_08_50,FRANCE,0,TOTALS,FRANCE,200,22,74,29.7,19,48,39.6,3,26,11.5,9,16,56.2,20,31,51,11,15,18,11,3,56,0
6296,146335,188_08_51,CROATIA,0,TOTALS,CROATIA,200,22,72,30.6,14,47,29.8,8,25,32.0,17,20,85.0,18,30,48,13,22,10,4,1,69,0
6297,146348,188_08_51,RUSSIA,0,TOTALS,RUSSIA,200,29,70,41.4,23,50,46.0,6,20,30.0,15,21,71.4,17,34,51,14,17,11,6,5,79,1
6298,146361,188_08_52,SERBIA,0,TOTALS,SERBIA,200,32,57,56.1,24,37,64.9,8,20,40.0,18,26,69.2,9,30,39,16,21,13,4,5,90,1
6299,146374,188_08_52,TURKEY,0,TOTALS,TURKEY,200,26,62,41.9,21,39,53.8,5,23,21.7,12,15,80.0,4,19,23,9,21,9,4,1,69,0
6300,146387,188_08_53,LATVIA,0,TOTALS,LATVIA,225,31,69,44.9,23,39,59.0,8,30,26.7,13,29,44.8,12,36,48,18,30,16,9,3,83,0
6301,146400,188_08_53,ISRAEL,0,TOTALS,ISRAEL,225,27,73,37.0,17,48,35.4,10,25,40.0,22,32,68.8,14,34,48,18,24,18,7,4,86,1
6302,146413,188_08_54,LITHUANIA,0,TOTALS,LITHUANIA,200,32,63,50.8,23,40,57.5,9,23,39.1,23,28,82.1,8,25,33,16,14,8,5,3,96,1
6303,146426,188_08_54,SPAIN,0,TOTALS,SPAIN,200,34,71,47.9,28,48,58.3,6,23,26.1,5,9,55.6,11,25,36,16,26,14,7,1,79,0
6304,146439,188_08_55,CROATIA,0,TOTALS,CROATIA,200,26,51,51.0,18,34,52.9,8,17,47.1,10,16,62.5,6,23,29,11,14,18,5,4,70,0
6305,146452,188_08_55,LATVIA,0,TOTALS,LATVIA,200,33,66,50.0,19,27,70.4,14,39,35.9,14,18,77.8,11,23,34,23,15,11,12,1,94,1
6306,146465,188_08_56,FRANCE,0,TOTALS,FRANCE,200,37,80,46.2,24,52,46.2,13,28,46.4,9,16,56.2,21,31,52,20,22,12,10,5,96,1
6307,146478,188_08_56,UKRAINE,0,TOTALS,UKRAINE,200,28,62,45.2,18,33,54.5,10,29,34.5,12,22,54.5,9,26,35,15,15,17,4,0,78,0
6308,146491,188_08_57,RUSSIA,0,TOTALS,RUSSIA,200,28,56,50.0,17,31,54.8,11,25,44.0,16,23,69.6,10,30,40,16,18,23,8,7,83,1
6309,146504,188_08_57,ISRAEL,0,TOTALS,ISRAEL,200,24,63,38.1,21,50,42.0,3,13,23.1,16,20,80.0,9,21,30,11,22,16,14,4,67,0
6310,146517,188_08_58,ITALY,0,TOTALS,ITALY,200,22,52,42.3,15,27,55.6,7,25,28.0,12,12,100.0,11,20,31,8,17,24,4,1,63,0
6311,146530,188_08_58,MONTENEGRO,0,TOTALS,MONTENEGRO,200,30,61,49.2,22,41,53.7,8,20,40.0,11,13,84.6,12,19,31,14,18,17,14,1,79,1
6312,146543,188_08_59,SPAIN,0,TOTALS,SPAIN,200,27,53,50.9,20,35,57.1,7,18,38.9,30,36,83.3,8,27,35,17,18,18,11,0,91,1
6313,146556,188_08_59,TURKEY,0,TOTALS,TURKEY,200,24,66,36.4,17,37,45.9,7,29,24.1,17,21,81.0,14,20,34,8,26,16,12,4,72,0
6314,146569,188_08_60,LITHUANIA,0,TOTALS,LITHUANIA,200,33,68,48.5,26,50,52.0,7,18,38.9,16,22,72.7,12,10,22,14,27,7,5,2,89,0
6315,146582,188_08_60,SERBIA,0,TOTALS,SERBIA,200,34,57,59.6,26,38,68.4,8,19,42.1,20,24,83.3,14,22,36,21,26,16,2,3,96,1
6316,146595,189_08_01,NETHERLANDS,0,TOTALS,NETHERLANDS,200,29,64,45.3,22,49,44.9,7,15,46.7,17,24,70.8,14,25,39,12,22,21,11,3,82,1
6317,146608,189_08_01,HUNGARY,0,TOTALS,HUNGARY,200,23,54,42.6,17,32,53.1,6,22,27.3,14,22,63.6,12,23,35,12,22,26,11,2,66,0
6318,146621,189_08_02,GERMANY,0,TOTALS,GERMANY,200,46,76,60.5,39,55,70.9,7,21,33.3,25,29,86.2,21,31,52,23,16,16,22,4,124,0
6319,146634,189_08_02,AZERBAIJAN,0,TOTALS,AZERBAIJAN,200,14,52,26.9,9,29,31.0,5,23,21.7,5,9,55.6,9,10,19,5,22,33,5,2,38,1
6320,146647,189_08_03,PORTUGAL,0,TOTALS,PORTUGAL,200,25,59,42.4,16,38,42.1,9,21,42.9,17,20,85.0,9,23,32,14,14,9,6,4,76,1
6321,146660,189_08_03,MKD,0,TOTALS,MKD,200,26,58,44.8,18,32,56.2,8,26,30.8,11,17,64.7,11,22,33,15,21,11,4,3,71,0
6322,146673,189_08_04,ESTONIA,0,TOTALS,ESTONIA,200,33,62,53.2,29,43,67.4,4,19,21.1,17,25,68.0,14,35,49,16,16,17,4,4,87,1
6323,146686,189_08_04,SWITZERLAND,0,TOTALS,SWITZERLAND,200,22,69,31.9,17,45,37.8,5,24,20.8,12,21,57.1,10,19,29,3,27,11,10,1,61,0
6324,146699,189_08_05,CZECH REPUBLIC,0,TOTALS,CZECH REPUBLIC,200,28,60,46.7,18,30,60.0,10,30,33.3,22,30,73.3,14,23,37,11,29,20,5,0,88,0
6325,146712,189_08_05,SWEDEN,0,TOTALS,SWEDEN,200,30,62,48.4,20,36,55.6,10,26,38.5,23,35,65.7,13,20,33,18,28,18,7,2,93,1
6326,146724,189_08_06,BELGIUM,0,TOTALS,BELGIUM,200,33,80,41.2,19,39,48.7,14,41,34.1,11,16,68.8,22,24,46,19,17,13,17,2,91,1
6327,146737,189_08_06,AUSTRIA,0,TOTALS,AUSTRIA,200,21,52,40.4,14,32,43.8,7,20,35.0,11,15,73.3,6,22,28,6,18,23,7,1,60,0
6328,146749,189_08_07,FINLAND,0,TOTALS,FINLAND,200,29,72,40.3,20,41,48.8,9,31,29.0,6,13,46.2,9,17,26,14,17,15,8,0,73,0
6329,146762,189_08_07,GREAT BRITAIN,0,TOTALS,GREAT BRITAIN,200,38,64,59.4,35,52,67.3,3,12,25.0,11,21,52.4,11,39,50,12,13,23,9,1,90,1
6330,146775,189_08_08,ROMANIA,0,TOTALS,ROMANIA,200,29,51,56.9,23,38,60.5,6,13,46.2,18,23,78.3,12,22,34,16,14,15,10,5,82,1
6331,146788,189_08_08,POLAND,0,TOTALS,POLAND,200,29,61,47.5,17,37,45.9,12,24,50.0,6,8,75.0,8,14,22,13,22,16,10,1,76,0
6332,146801,189_08_09,SLOVAK REPUBLIC,0,TOTALS,SLOVAK REPUBLIC,200,18,50,36.0,16,37,43.2,2,13,15.4,9,15,60.0,9,20,29,5,14,21,6,0,47,0
6333,146813,189_08_09,BELGIUM,0,TOTALS,BELGIUM,200,29,64,45.3,23,43,53.5,6,21,28.6,11,14,78.6,15,26,41,12,17,17,9,3,75,1
6334,146826,189_08_10,AUSTRIA,0,TOTALS,AUSTRIA,200,33,74,44.6,20,46,43.5,13,28,46.4,7,9,77.8,10,21,31,14,26,16,9,1,86,0
6335,146839,189_08_10,ESTONIA,0,TOTALS,ESTONIA,200,33,60,55.0,24,40,60.0,9,20,45.0,18,29,62.1,7,30,37,18,14,15,9,2,93,1
6336,146852,189_08_11,NORWAY,0,TOTALS,NORWAY,200,28,57,49.1,22,33,66.7,6,24,25.0,25,38,65.8,9,25,34,8,22,19,8,0,87,0
6337,146864,189_08_11,FINLAND,0,TOTALS,FINLAND,200,37,69,53.6,25,40,62.5,12,29,41.4,13,19,68.4,11,23,34,21,29,15,8,1,99,1
6338,146877,189_08_12,IRELAND,0,TOTALS,IRELAND,200,18,53,34.0,17,40,42.5,1,13,7.7,5,10,50.0,9,15,24,6,21,14,8,0,42,0
6339,146890,189_08_12,CZECH REPUBLIC,0,TOTALS,CZECH REPUBLIC,200,36,63,57.1,24,36,66.7,12,27,44.4,14,24,58.3,16,29,45,15,17,15,10,1,98,1
6340,146903,189_08_13,GREAT BRITAIN,0,TOTALS,GREAT BRITAIN,200,25,66,37.9,22,50,44.0,3,16,18.8,9,20,45.0,19,23,42,7,22,19,5,4,62,0
6341,146916,189_08_13,PORTUGAL,0,TOTALS,PORTUGAL,200,24,54,44.4,18,32,56.2,6,22,27.3,19,22,86.4,9,23,32,6,18,17,8,2,73,1
6342,146929,189_08_14,SWEDEN,0,TOTALS,SWEDEN,200,24,69,34.8,18,48,37.5,6,21,28.6,10,21,47.6,17,18,35,12,15,17,7,3,64,0
6343,146942,189_08_14,GERMANY,0,TOTALS,GERMANY,200,36,71,50.7,29,51,56.9,7,20,35.0,11,14,78.6,15,28,43,12,20,17,12,5,90,1
6344,146955,189_08_15,SWITZERLAND,0,TOTALS,SWITZERLAND,200,20,64,31.2,13,37,35.1,7,27,25.9,13,18,72.2,9,17,26,7,16,17,8,2,60,0
6345,146968,189_08_15,AUSTRIA,0,TOTALS,AUSTRIA,200,27,59,45.8,22,50,44.0,5,9,55.6,18,22,81.8,15,34,49,6,16,21,10,2,77,1
6346,146981,189_08_16,POLAND,0,TOTALS,POLAND,200,29,64,45.3,22,36,61.1,7,28,25.0,11,18,61.1,11,26,37,15,20,19,11,2,76,1
6347,146994,189_08_16,NETHERLANDS,0,TOTALS,NETHERLANDS,200,22,55,40.0,17,38,44.7,5,17,29.4,15,25,60.0,11,24,35,13,20,22,14,2,64,0
6348,147007,189_08_17,PORTUGAL,0,TOTALS,PORTUGAL,200,27,52,51.9,14,29,48.3,13,23,56.5,17,28,60.7,8,22,30,14,15,14,4,1,84,1
6349,147020,189_08_17,NORWAY,0,TOTALS,NORWAY,200,30,68,44.1,15,33,45.5,15,35,42.9,6,10,60.0,11,20,31,14,23,9,5,0,81,0
6350,147033,189_08_18,AZERBAIJAN,0,TOTALS,AZERBAIJAN,200,14,54,25.9,6,29,20.7,8,25,32.0,8,15,53.3,11,24,35,7,14,30,8,4,44,1
6351,147046,189_08_18,SWEDEN,0,TOTALS,SWEDEN,200,37,82,45.1,22,49,44.9,15,33,45.5,11,18,61.1,23,33,56,28,12,13,15,4,100,0
6352,147059,189_08_19,MKD,0,TOTALS,MKD,200,28,58,48.3,20,35,57.1,8,23,34.8,16,25,64.0,7,29,36,18,24,14,5,2,80,1
6353,147072,189_08_19,GREAT BRITAIN,0,TOTALS,GREAT BRITAIN,200,28,77,36.4,23,58,39.7,5,19,26.3,14,20,70.0,20,27,47,12,23,13,6,3,75,0
6354,147085,189_08_20,GERMANY,0,TOTALS,GERMANY,200,41,70,58.6,33,47,70.2,8,23,34.8,22,28,78.6,20,33,53,16,15,16,12,3,112,0
6355,147098,189_08_20,IRELAND,0,TOTALS,IRELAND,200,15,57,26.3,12,39,30.8,3,18,16.7,7,15,46.7,11,12,23,7,22,22,7,0,40,1
6356,147111,189_08_21,ESTONIA,0,TOTALS,ESTONIA,200,32,65,49.2,25,39,64.1,7,26,26.9,8,17,47.1,12,27,39,17,15,12,7,5,79,1
6357,147124,189_08_21,SLOVAK REPUBLIC,0,TOTALS,SLOVAK REPUBLIC,200,28,67,41.8,21,41,51.2,7,26,26.9,4,8,50.0,13,24,37,10,18,17,5,2,67,0
6358,147137,189_08_22,HUNGARY,0,TOTALS,HUNGARY,200,21,56,37.5,15,28,53.6,6,28,21.4,10,19,52.6,10,20,30,7,22,18,10,1,58,0
6359,147150,189_08_22,ROMANIA,0,TOTALS,ROMANIA,200,23,54,42.6,14,30,46.7,9,24,37.5,7,17,41.2,16,29,45,15,21,26,11,2,62,1
6360,147163,189_08_23,IRELAND,0,TOTALS,IRELAND,200,31,75,41.3,25,63,39.7,6,12,50.0,12,19,63.2,11,31,42,15,16,9,11,1,80,1
6361,147176,189_08_23,AZERBAIJAN,0,TOTALS,AZERBAIJAN,200,19,63,30.2,17,35,48.6,2,28,7.1,11,18,61.1,14,32,46,7,19,19,3,9,51,0
6362,147189,189_08_24,SLOVAK REPUBLIC,0,TOTALS,SLOVAK REPUBLIC,200,23,57,40.4,17,39,43.6,6,18,33.3,19,24,79.2,13,36,49,11,21,19,5,6,71,1
6363,147202,189_08_24,SWITZERLAND,0,TOTALS,SWITZERLAND,200,20,66,30.3,17,51,33.3,3,15,20.0,15,23,65.2,13,23,36,6,21,13,13,3,58,0
6364,147214,189_08_25,FINLAND,0,TOTALS,FINLAND,200,24,60,40.0,13,26,50.0,11,34,32.4,4,6,66.7,10,19,29,15,20,20,8,0,63,0
6365,147227,189_08_25,PORTUGAL,0,TOTALS,PORTUGAL,200,27,57,47.4,16,36,44.4,11,21,52.4,11,14,78.6,11,27,38,14,14,20,8,3,76,1
6366,147240,189_08_26,CZECH REPUBLIC,0,TOTALS,CZECH REPUBLIC,200,19,62,30.6,14,39,35.9,5,23,21.7,14,20,70.0,6,21,27,8,28,16,5,1,57,1
6367,147253,189_08_26,GERMANY,0,TOTALS,GERMANY,200,33,64,51.6,24,41,58.5,9,23,39.1,25,31,80.6,15,35,50,17,21,11,8,5,100,0
6368,147266,189_08_27,NORWAY,0,TOTALS,NORWAY,200,28,65,43.1,18,31,58.1,10,34,29.4,17,27,63.0,9,18,27,7,21,7,11,0,83,0
6369,147279,189_08_27,MKD,0,TOTALS,MKD,200,30,54,55.6,16,24,66.7,14,30,46.7,17,23,73.9,8,32,40,23,24,17,1,1,91,1
6370,147291,189_08_28,BELGIUM,0,TOTALS,BELGIUM,200,30,62,48.4,18,29,62.1,12,33,36.4,14,17,82.4,11,31,42,20,18,18,4,5,86,1
6371,147304,189_08_28,ESTONIA,0,TOTALS,ESTONIA,200,31,68,45.6,20,38,52.6,11,30,36.7,8,14,57.1,7,23,30,17,19,12,8,2,81,0
6372,147317,189_08_29,SWEDEN,0,TOTALS,SWEDEN,200,42,75,56.0,32,50,64.0,10,25,40.0,11,22,50.0,22,29,51,20,19,21,15,5,105,0
6373,147330,189_08_29,IRELAND,0,TOTALS,IRELAND,200,25,54,46.3,20,41,48.8,5,13,38.5,7,17,41.2,4,20,24,11,17,26,9,0,62,1
6374,147343,189_08_30,POLAND,0,TOTALS,POLAND,200,21,71,29.6,13,46,28.3,8,25,32.0,8,18,44.4,15,34,49,13,21,15,4,3,58,0
6375,147356,189_08_30,HUNGARY,0,TOTALS,HUNGARY,200,22,60,36.7,17,37,45.9,5,23,21.7,13,23,56.5,8,33,41,10,21,13,8,5,62,1
6376,147369,189_08_31,MKD,0,TOTALS,MKD,200,35,67,52.2,28,45,62.2,7,22,31.8,2,7,28.6,13,31,44,18,18,18,7,7,79,1
6377,147381,189_08_31,FINLAND,0,TOTALS,FINLAND,200,23,69,33.3,17,45,37.8,6,24,25.0,11,16,68.8,15,21,36,12,15,12,3,1,63,0
6378,147394,189_08_32,SWITZERLAND,0,TOTALS,SWITZERLAND,200,22,67,32.8,17,48,35.4,5,19,26.3,11,17,64.7,11,22,33,11,22,20,10,1,60,0
6379,147406,189_08_32,BELGIUM,0,TOTALS,BELGIUM,200,31,62,50.0,20,33,60.6,11,29,37.9,16,24,66.7,12,35,47,17,16,22,10,1,89,1
6380,147419,189_08_33,GREAT BRITAIN,0,TOTALS,GREAT BRITAIN,200,23,58,39.7,10,33,30.3,13,25,52.0,16,31,51.6,17,27,44,12,20,22,10,2,75,0
6381,147432,189_08_33,NORWAY,0,TOTALS,NORWAY,200,31,70,44.3,21,44,47.7,10,26,38.5,16,20,80.0,14,24,38,13,26,15,13,0,88,1
6382,147445,189_08_34,AUSTRIA,0,TOTALS,AUSTRIA,200,30,64,46.9,19,40,47.5,11,24,45.8,4,9,44.4,9,25,34,17,19,18,13,3,75,1
6383,147458,189_08_34,SLOVAK REPUBLIC,0,TOTALS,SLOVAK REPUBLIC,200,22,63,34.9,19,40,47.5,3,23,13.0,11,13,84.6,15,27,42,7,15,24,8,2,58,0
6384,147471,189_08_35,AZERBAIJAN,0,TOTALS,AZERBAIJAN,200,23,61,37.7,14,32,43.8,9,29,31.0,14,21,66.7,17,15,32,12,16,23,7,2,69,1
6385,147484,189_08_35,CZECH REPUBLIC,0,TOTALS,CZECH REPUBLIC,200,42,71,59.2,36,56,64.3,6,15,40.0,14,19,73.7,15,24,39,19,21,13,15,2,104,0
6386,147497,189_08_36,NETHERLANDS,0,TOTALS,NETHERLANDS,200,26,63,41.3,20,37,54.1,6,26,23.1,7,14,50.0,21,23,44,12,19,11,6,2,65,1
6387,147510,189_08_36,ROMANIA,0,TOTALS,ROMANIA,200,19,59,32.2,16,40,40.0,3,19,15.8,17,21,81.0,16,25,41,8,16,11,8,1,58,0
6388,147523,189_08_37,GREAT BRITAIN,0,TOTALS,GREAT BRITAIN,200,28,62,45.2,20,43,46.5,8,19,42.1,20,30,66.7,15,32,47,19,13,25,12,5,84,1
6389,147536,189_08_37,IRELAND,0,TOTALS,IRELAND,200,28,69,40.6,23,52,44.2,5,17,29.4,5,8,62.5,10,22,32,19,23,21,4,0,66,0
6390,147549,189_08_38,PORTUGAL,0,TOTALS,PORTUGAL,200,25,56,44.6,19,41,46.3,6,15,40.0,10,18,55.6,7,21,28,8,17,16,5,3,66,0
6391,147562,189_08_38,SWEDEN,0,TOTALS,SWEDEN,200,30,58,51.7,22,39,56.4,8,19,42.1,12,18,66.7,9,28,37,16,20,15,11,6,80,1
6392,147574,189_08_39,FINLAND,0,TOTALS,FINLAND,200,45,89,50.6,25,45,55.6,20,44,45.5,8,9,88.9,19,26,45,28,14,6,19,0,118,0
6393,147587,189_08_39,AZERBAIJAN,0,TOTALS,AZERBAIJAN,200,22,55,40.0,16,33,48.5,6,22,27.3,6,11,54.5,11,24,35,10,16,28,4,8,56,1
6394,147600,189_08_40,MKD,0,TOTALS,MKD,200,30,44,68.2,21,28,75.0,9,16,56.2,6,9,66.7,3,24,27,13,22,26,4,3,75,0
6395,147613,189_08_40,GERMANY,0,TOTALS,GERMANY,200,31,65,47.7,25,46,54.3,6,19,31.6,13,20,65.0,13,13,26,11,18,8,14,1,81,1
6396,147626,189_08_41,NORWAY,0,TOTALS,NORWAY,200,27,51,52.9,17,25,68.0,10,26,38.5,16,31,51.6,7,21,28,10,30,19,7,2,80,0
6397,147639,189_08_41,CZECH REPUBLIC,0,TOTALS,CZECH REPUBLIC,200,32,73,43.8,22,42,52.4,10,31,32.3,17,31,54.8,20,22,42,21,24,9,12,1,91,1
6398,147652,189_08_42,ESTONIA,0,TOTALS,ESTONIA,200,27,62,43.5,22,48,45.8,5,14,35.7,10,13,76.9,6,24,30,15,15,9,7,9,69,1
6399,147665,189_08_42,NETHERLANDS,0,TOTALS,NETHERLANDS,200,26,72,36.1,21,52,40.4,5,20,25.0,8,11,72.7,17,30,47,8,16,12,2,3,65,0
6400,147678,189_08_43,AUSTRIA,0,TOTALS,AUSTRIA,200,23,60,38.3,14,40,35.0,9,20,45.0,13,21,61.9,6,29,35,15,19,11,9,0,68,0
6401,147691,189_08_43,POLAND,0,TOTALS,POLAND,200,24,64,37.5,16,34,47.1,8,30,26.7,18,22,81.8,12,36,48,12,16,14,7,6,74,1
6402,147703,189_08_44,BELGIUM,0,TOTALS,BELGIUM,200,27,63,42.9,18,31,58.1,9,32,28.1,22,30,73.3,7,18,25,11,22,9,11,0,85,1
6403,147716,189_08_44,ROMANIA,0,TOTALS,ROMANIA,200,27,52,51.9,18,34,52.9,9,18,50.0,16,23,69.6,12,34,46,18,26,21,4,2,79,0
6404,147729,189_08_45,SLOVAK REPUBLIC,0,TOTALS,SLOVAK REPUBLIC,200,22,74,29.7,16,50,32.0,6,24,25.0,9,11,81.8,19,27,46,9,19,11,7,3,59,0
6405,147742,189_08_45,HUNGARY,0,TOTALS,HUNGARY,200,26,57,45.6,20,35,57.1,6,22,27.3,14,19,73.7,7,31,38,15,14,14,5,11,72,1
6406,147755,189_08_46,GERMANY,0,TOTALS,GERMANY,200,31,54,57.4,28,42,66.7,3,12,25.0,6,10,60.0,7,24,31,20,22,14,10,1,71,1
6407,147768,189_08_46,PORTUGAL,0,TOTALS,PORTUGAL,200,22,51,43.1,16,30,53.3,6,21,28.6,12,14,85.7,5,17,22,10,12,14,5,1,62,0
6408,147781,189_08_47,CZECH REPUBLIC,0,TOTALS,CZECH REPUBLIC,200,37,72,51.4,21,37,56.8,16,35,45.7,14,22,63.6,15,18,33,21,27,12,6,2,104,0
6409,147794,189_08_47,GREAT BRITAIN,0,TOTALS,GREAT BRITAIN,200,37,69,53.6,35,56,62.5,2,13,15.4,17,26,65.4,18,25,43,11,22,16,8,5,93,1
6410,147807,189_08_48,SWEDEN,0,TOTALS,SWEDEN,200,27,62,43.5,22,43,51.2,5,19,26.3,8,12,66.7,7,24,31,16,18,13,5,2,67,0
6411,147820,189_08_48,MKD,0,TOTALS,MKD,200,31,57,54.4,24,42,57.1,7,15,46.7,6,14,42.9,6,28,34,19,16,13,9,0,75,1
6412,147833,189_08_49,IRELAND,0,TOTALS,IRELAND,200,24,67,35.8,23,53,43.4,1,14,7.1,8,11,72.7,14,22,36,9,13,13,8,1,57,0
6413,147846,189_08_49,NORWAY,0,TOTALS,NORWAY,200,38,68,55.9,27,43,62.8,11,25,44.0,7,9,77.8,9,31,40,19,10,14,11,4,94,1
6414,147859,189_08_50,NETHERLANDS,0,TOTALS,NETHERLANDS,200,27,57,47.4,20,41,48.8,7,16,43.8,11,16,68.8,10,18,28,11,16,21,7,7,72,0
6415,147871,189_08_50,BELGIUM,0,TOTALS,BELGIUM,200,32,75,42.7,22,45,48.9,10,30,33.3,10,12,83.3,20,15,35,13,18,15,14,2,84,1
6416,147884,189_08_51,HUNGARY,0,TOTALS,HUNGARY,200,30,62,48.4,22,40,55.0,8,22,36.4,4,5,80.0,8,31,39,14,21,17,3,3,72,0
6417,147897,189_08_51,AUSTRIA,0,TOTALS,AUSTRIA,200,29,69,42.0,17,39,43.6,12,30,40.0,15,20,75.0,9,23,32,10,10,7,8,1,85,1
6418,147910,189_08_52,ROMANIA,0,TOTALS,ROMANIA,250,32,88,36.4,22,59,37.3,10,29,34.5,12,14,85.7,20,36,56,14,22,12,6,1,86,0
6419,147923,189_08_52,ESTONIA,0,TOTALS,ESTONIA,250,34,71,47.9,27,40,67.5,7,31,22.6,14,21,66.7,8,30,38,5,20,14,6,3,89,1
6420,147936,189_08_53,POLAND,0,TOTALS,POLAND,200,26,56,46.4,18,38,47.4,8,18,44.4,6,9,66.7,9,23,32,14,23,19,8,6,66,0
6421,147949,189_08_53,SLOVAK REPUBLIC,0,TOTALS,SLOVAK REPUBLIC,200,26,62,41.9,22,46,47.8,4,16,25.0,12,23,52.2,17,21,38,16,12,13,10,1,68,1
6422,147962,189_08_54,AZERBAIJAN,0,TOTALS,AZERBAIJAN,200,19,60,31.7,13,32,40.6,6,28,21.4,6,13,46.2,10,30,40,9,24,26,5,3,50,0
6423,147975,189_08_54,SWITZERLAND,0,TOTALS,SWITZERLAND,200,31,76,40.8,22,42,52.4,9,34,26.5,12,21,57.1,18,34,52,10,19,14,16,3,83,1
6424,147988,189_08_55,SWITZERLAND,0,TOTALS,SWITZERLAND,200,28,58,48.3,23,45,51.1,5,13,38.5,21,29,72.4,8,29,37,2,24,17,13,1,82,1
6425,148000,189_08_55,FINLAND,0,TOTALS,FINLAND,200,29,59,49.2,20,36,55.6,9,23,39.1,13,29,44.8,9,28,37,10,25,16,4,2,80,0
6426,148013,189_08_56,GREAT BRITAIN,0,TOTALS,GREAT BRITAIN,200,22,63,34.9,17,50,34.0,5,13,38.5,9,17,52.9,17,25,42,7,15,23,9,2,58,0
6427,148026,189_08_56,POLAND,0,TOTALS,POLAND,200,31,68,45.6,24,40,60.0,7,28,25.0,10,12,83.3,11,27,38,13,16,15,13,6,79,1
6428,148039,189_08_57,NETHERLANDS,0,TOTALS,NETHERLANDS,200,26,60,43.3,20,41,48.8,6,19,31.6,9,11,81.8,10,26,36,13,16,18,7,1,67,0
6429,148052,189_08_57,PORTUGAL,0,TOTALS,PORTUGAL,200,25,61,41.0,19,39,48.7,6,22,27.3,14,20,70.0,11,22,33,12,12,14,11,5,70,1
6430,148065,189_08_58,SLOVAK REPUBLIC,0,TOTALS,SLOVAK REPUBLIC,200,38,73,52.1,27,47,57.4,11,26,42.3,8,13,61.5,20,31,51,20,22,18,8,4,95,1
6431,148078,189_08_58,IRELAND,0,TOTALS,IRELAND,200,20,63,31.7,15,48,31.2,5,15,33.3,20,28,71.4,16,18,34,11,17,13,6,0,65,0
6432,148091,189_08_59,GERMANY,0,TOTALS,GERMANY,200,25,60,41.7,19,38,50.0,6,22,27.3,21,27,77.8,14,24,38,10,28,19,14,5,77,1
6433,148104,189_08_59,ESTONIA,0,TOTALS,ESTONIA,200,21,47,44.7,15,34,44.1,6,13,46.2,17,24,70.8,2,23,25,13,22,23,6,5,65,0
6434,148117,189_08_60,CZECH REPUBLIC,0,TOTALS,CZECH REPUBLIC,200,30,62,48.4,23,42,54.8,7,20,35.0,4,9,44.4,12,30,42,14,13,17,7,3,71,1
6435,148130,189_08_60,HUNGARY,0,TOTALS,HUNGARY,200,20,62,32.3,11,32,34.4,9,30,30.0,8,10,80.0,12,24,36,14,14,17,10,1,57,0
6436,148142,189_08_61,BELGIUM,0,TOTALS,BELGIUM,200,27,57,47.4,17,30,56.7,10,27,37.0,6,10,60.0,6,22,28,6,16,14,6,2,70,1
6437,148155,189_08_61,SWEDEN,0,TOTALS,SWEDEN,200,27,62,43.5,21,40,52.5,6,22,27.3,7,7,100.0,12,25,37,7,14,16,2,2,67,0
6438,148168,189_08_62,AUSTRIA,0,TOTALS,AUSTRIA,200,30,58,51.7,18,30,60.0,12,28,42.9,23,31,74.2,7,28,35,17,18,12,11,1,95,1
6439,148181,189_08_62,NORWAY,0,TOTALS,NORWAY,200,26,64,40.6,13,33,39.4,13,31,41.9,18,26,69.2,13,24,37,17,23,15,3,2,83,0
6440,148194,189_08_63,MKD,0,TOTALS,MKD,200,25,62,40.3,17,36,47.2,8,26,30.8,1,1,100.0,11,19,30,12,19,13,8,8,59,0
6441,148207,189_08_63,ROMANIA,0,TOTALS,ROMANIA,200,29,61,47.5,28,51,54.9,1,10,10.0,13,23,56.5,17,25,42,14,7,10,11,4,72,1
6442,148220,189_08_64,GREAT BRITAIN,0,TOTALS,GREAT BRITAIN,200,39,61,63.9,34,49,69.4,5,12,41.7,5,11,45.5,11,29,40,18,9,18,13,8,88,1
6443,148233,189_08_64,IRELAND,0,TOTALS,IRELAND,200,22,58,37.9,16,39,41.0,6,19,31.6,5,8,62.5,7,16,23,9,11,21,6,1,55,0
6444,148246,189_08_65,MKD,0,TOTALS,MKD,200,18,47,38.3,15,29,51.7,3,18,16.7,13,15,86.7,6,21,27,9,12,20,12,0,52,0
6445,148259,189_08_65,NETHERLANDS,0,TOTALS,NETHERLANDS,200,28,59,47.5,20,41,48.8,8,18,44.4,5,10,50.0,13,25,38,16,13,16,13,2,69,1
6446,148272,189_08_66,POLAND,0,TOTALS,POLAND,200,31,56,55.4,22,35,62.9,9,21,42.9,11,15,73.3,6,26,32,17,13,14,9,8,82,1
6447,148285,189_08_66,SLOVAK REPUBLIC,0,TOTALS,SLOVAK REPUBLIC,200,24,60,40.0,20,48,41.7,4,12,33.3,6,14,42.9,13,21,34,13,16,15,8,2,58,0
6448,148298,189_08_67,ROMANIA,0,TOTALS,ROMANIA,200,34,58,58.6,25,40,62.5,9,18,50.0,9,9,100.0,15,22,37,15,14,14,3,1,86,1
6449,148311,189_08_67,PORTUGAL,0,TOTALS,PORTUGAL,200,31,62,50.0,17,35,48.6,14,27,51.9,7,8,87.5,9,10,19,9,15,7,5,2,83,0
6450,148324,189_08_68,HUNGARY,0,TOTALS,HUNGARY,200,30,67,44.8,21,42,50.0,9,25,36.0,8,19,42.1,21,19,40,14,13,17,5,0,77,0
6451,148337,189_08_68,NORWAY,0,TOTALS,NORWAY,200,39,64,60.9,24,36,66.7,15,28,53.6,3,5,60.0,7,21,28,14,17,12,9,0,96,1
6452,148350,189_08_69,ESTONIA,0,TOTALS,ESTONIA,200,26,59,44.1,25,48,52.1,1,11,9.1,18,23,78.3,10,26,36,4,17,18,2,2,71,0
6453,148363,189_08_69,SWEDEN,0,TOTALS,SWEDEN,200,32,67,47.8,24,44,54.5,8,23,34.8,8,18,44.4,12,26,38,12,19,8,14,1,80,1
6454,148376,189_08_70,CZECH REPUBLIC,0,TOTALS,CZECH REPUBLIC,200,30,69,43.5,25,45,55.6,5,24,20.8,17,22,77.3,16,39,55,16,15,17,5,2,82,1
6455,148389,189_08_70,AUSTRIA,0,TOTALS,AUSTRIA,200,20,66,30.3,13,36,36.1,7,30,23.3,10,13,76.9,5,21,26,11,23,12,9,1,57,0
6456,148402,189_08_71,GERMANY,0,TOTALS,GERMANY,250,39,79,49.4,25,46,54.3,14,33,42.4,18,23,78.3,16,35,51,15,26,14,6,4,110,1
6457,148414,189_08_71,BELGIUM,0,TOTALS,BELGIUM,250,33,77,42.9,19,36,52.8,14,41,34.1,22,28,78.6,11,23,34,19,19,11,9,6,102,0
6458,150868,192_08_01,ESTONIA,0,TOTALS,ESTONIA,200,20,55,36.4,16,37,43.2,4,18,22.2,16,28,57.1,10,20,30,9,24,19,9,3,60,0
6459,150881,192_08_01,ITALY,0,TOTALS,ITALY,200,22,64,34.4,17,36,47.2,5,28,17.9,16,23,69.6,21,31,52,10,29,22,8,2,65,1
6460,150894,192_08_02,LATVIA,0,TOTALS,LATVIA,200,24,67,35.8,20,51,39.2,4,16,25.0,18,24,75.0,12,27,39,8,22,13,5,4,70,0
6461,150907,192_08_02,CROATIA,0,TOTALS,CROATIA,200,31,61,50.8,25,42,59.5,6,19,31.6,19,27,70.4,4,28,32,12,22,11,7,2,87,1
6462,150920,192_08_03,BELGIUM,0,TOTALS,BELGIUM,200,24,56,42.9,18,35,51.4,6,21,28.6,4,9,44.4,12,39,51,11,21,26,3,1,58,0
6463,150933,192_08_03,ISRAEL,0,TOTALS,ISRAEL,200,24,71,33.8,19,48,39.6,5,23,21.7,11,20,55.0,13,23,36,9,15,8,11,4,64,1
6464,150946,192_08_04,GERMANY,0,TOTALS,GERMANY,200,31,59,52.5,28,51,54.9,3,8,37.5,16,23,69.6,13,30,43,8,16,26,8,2,81,1
6465,150959,192_08_04,FRANCE,0,TOTALS,FRANCE,200,28,61,45.9,18,36,50.0,10,25,40.0,7,16,43.8,6,15,21,15,20,16,16,2,73,0
6466,150972,192_08_05,GREECE,0,TOTALS,GREECE,200,30,66,45.5,24,48,50.0,6,18,33.3,11,23,47.8,15,26,41,17,21,10,7,6,77,1
6467,150985,192_08_05,SPAIN,0,TOTALS,SPAIN,200,24,60,40.0,12,36,33.3,12,24,50.0,13,17,76.5,12,26,38,8,20,17,4,1,73,0
6468,150998,192_08_06,UKRAINE,0,TOTALS,UKRAINE,200,23,71,32.4,17,40,42.5,6,31,19.4,12,18,66.7,13,28,41,14,28,19,7,2,64,0
6469,151011,192_08_06,RUSSIA,0,TOTALS,RUSSIA,200,31,61,50.8,24,46,52.2,7,15,46.7,17,32,53.1,12,36,48,11,17,19,11,0,86,1
6470,151024,192_08_07,LITHUANIA,0,TOTALS,LITHUANIA,200,31,63,49.2,21,42,50.0,10,21,47.6,11,16,68.8,12,33,45,10,34,20,8,8,83,1
6471,151037,192_08_07,SERBIA,0,TOTALS,SERBIA,200,17,59,28.8,12,37,32.4,5,22,22.7,29,45,64.4,14,21,35,7,21,14,11,1,68,0
6472,151050,192_08_08,BULGARIA,0,TOTALS,BULGARIA,200,32,64,50.0,26,45,57.8,6,19,31.6,12,16,75.0,14,18,32,11,17,22,10,2,82,0
6473,151063,192_08_08,TURKEY,0,TOTALS,TURKEY,200,32,61,52.5,28,42,66.7,4,19,21.1,18,24,75.0,13,20,33,15,20,21,15,3,86,1
6474,151076,192_08_09,SPAIN,0,TOTALS,SPAIN,200,31,67,46.3,21,38,55.3,10,29,34.5,16,17,94.1,16,26,42,15,17,17,8,1,88,1
6475,151089,192_08_09,BELGIUM,0,TOTALS,BELGIUM,200,27,61,44.3,20,44,45.5,7,17,41.2,8,12,66.7,11,20,31,11,19,16,8,0,69,0
6476,151102,192_08_10,RUSSIA,0,TOTALS,RUSSIA,200,32,69,46.4,25,47,53.2,7,22,31.8,12,18,66.7,12,21,33,10,18,15,16,2,83,1
6477,151115,192_08_10,GERMANY,0,TOTALS,GERMANY,200,28,57,49.1,23,42,54.8,5,15,33.3,12,18,66.7,12,25,37,16,20,24,9,3,73,0
6478,151128,192_08_11,SERBIA,0,TOTALS,SERBIA,200,26,61,42.6,21,40,52.5,5,21,23.8,19,28,67.9,15,31,46,12,13,17,19,0,76,1
6479,151140,192_08_11,ESTONIA,0,TOTALS,ESTONIA,200,13,58,22.4,10,35,28.6,3,23,13.0,12,15,80.0,15,25,40,2,22,22,9,4,41,0
6480,151153,192_08_12,TURKEY,0,TOTALS,TURKEY,200,26,57,45.6,22,43,51.2,4,14,28.6,15,19,78.9,13,24,37,10,20,17,10,4,71,1
6481,151166,192_08_12,LATVIA,0,TOTALS,LATVIA,200,27,60,45.0,22,42,52.4,5,18,27.8,9,19,47.4,13,20,33,11,18,17,5,2,68,0
6482,151179,192_08_13,ISRAEL,0,TOTALS,ISRAEL,200,24,61,39.3,21,50,42.0,3,11,27.3,16,28,57.1,9,25,34,6,30,10,9,2,67,0
6483,151192,192_08_13,GREECE,0,TOTALS,GREECE,200,32,63,50.8,29,45,64.4,3,18,16.7,22,32,68.8,14,33,47,16,22,12,8,5,89,1
6484,151205,192_08_14,CROATIA,0,TOTALS,CROATIA,200,27,55,49.1,21,37,56.8,6,18,33.3,11,12,91.7,11,23,34,10,19,15,10,4,71,1
6485,151218,192_08_14,BULGARIA,0,TOTALS,BULGARIA,200,23,57,40.4,15,31,48.4,8,26,30.8,13,18,72.2,14,18,32,14,18,13,8,3,67,0
6486,151231,192_08_15,ITALY,0,TOTALS,ITALY,200,22,62,35.5,19,49,38.8,3,13,23.1,26,37,70.3,13,24,37,2,29,10,10,2,73,0
6487,151244,192_08_15,LITHUANIA,0,TOTALS,LITHUANIA,200,24,54,44.4,22,40,55.0,2,14,14.3,26,39,66.7,14,32,46,13,26,19,6,5,76,1
6488,151257,192_08_16,FRANCE,0,TOTALS,FRANCE,200,27,70,38.6,21,41,51.2,6,29,20.7,10,17,58.8,13,36,49,13,12,13,10,2,70,1
6489,151270,192_08_16,UKRAINE,0,TOTALS,UKRAINE,200,20,64,31.2,15,42,35.7,5,22,22.7,5,7,71.4,10,30,40,11,17,19,7,2,50,0
6490,151283,192_08_17,ISRAEL,0,TOTALS,ISRAEL,200,22,64,34.4,13,38,34.2,9,26,34.6,12,19,63.2,9,21,30,15,26,14,10,3,65,0
6491,151296,192_08_17,SPAIN,0,TOTALS,SPAIN,200,30,69,43.5,20,44,45.5,10,25,40.0,17,32,53.1,23,33,56,14,16,16,9,4,87,1
6492,151309,192_08_18,LATVIA,0,TOTALS,LATVIA,200,28,67,41.8,22,49,44.9,6,18,33.3,18,28,64.3,12,30,42,13,23,11,5,5,80,1
6493,151322,192_08_18,BULGARIA,0,TOTALS,BULGARIA,200,24,69,34.8,16,35,45.7,8,34,23.5,19,22,86.4,15,31,46,16,27,15,7,6,75,0
6494,151335,192_08_19,LITHUANIA,0,TOTALS,LITHUANIA,200,24,57,42.1,15,27,55.6,9,30,30.0,15,34,44.1,18,29,47,8,28,21,9,6,72,1
6495,151347,192_08_19,ESTONIA,0,TOTALS,ESTONIA,200,18,60,30.0,13,34,38.2,5,26,19.2,23,32,71.9,15,22,37,8,26,15,10,4,64,0
6496,151360,192_08_20,UKRAINE,0,TOTALS,UKRAINE,200,28,60,46.7,21,42,50.0,7,18,38.9,13,18,72.2,12,31,43,11,18,18,12,1,76,1
6497,151373,192_08_20,GERMANY,0,TOTALS,GERMANY,200,22,67,32.8,18,41,43.9,4,26,15.4,5,11,45.5,18,22,40,4,18,17,10,1,53,0
6498,151386,192_08_21,GREECE,0,TOTALS,GREECE,200,25,62,40.3,21,38,55.3,4,24,16.7,12,24,50.0,17,28,45,16,12,9,8,5,66,1
6499,151399,192_08_21,BELGIUM,0,TOTALS,BELGIUM,200,21,64,32.8,13,36,36.1,8,28,28.6,5,9,55.6,17,24,41,16,22,16,2,1,55,0
6500,151412,192_08_22,TURKEY,0,TOTALS,TURKEY,200,32,64,50.0,29,48,60.4,3,16,18.8,14,21,66.7,8,18,26,6,19,10,9,0,81,0
6501,151425,192_08_22,CROATIA,0,TOTALS,CROATIA,200,33,61,54.1,22,37,59.5,11,24,45.8,14,21,66.7,13,26,39,20,22,18,7,0,91,1
6502,151438,192_08_23,ITALY,0,TOTALS,ITALY,200,22,67,32.8,17,48,35.4,5,19,26.3,5,9,55.6,15,20,35,10,20,19,8,2,54,0
6503,151451,192_08_23,SERBIA,0,TOTALS,SERBIA,200,29,56,51.8,18,33,54.5,11,23,47.8,14,22,63.6,11,30,41,16,16,20,12,2,83,1
6504,151464,192_08_24,FRANCE,0,TOTALS,FRANCE,200,25,52,48.1,16,29,55.2,9,23,39.1,11,13,84.6,5,27,32,16,15,21,12,0,70,1
6505,151477,192_08_24,RUSSIA,0,TOTALS,RUSSIA,200,24,66,36.4,20,49,40.8,4,17,23.5,9,11,81.8,15,21,36,7,16,21,7,3,61,0
6506,151490,192_08_25,BELGIUM,0,TOTALS,BELGIUM,200,22,71,31.0,19,50,38.0,3,21,14.3,3,6,50.0,19,24,43,13,15,11,6,3,50,0
6507,151503,192_08_25,BULGARIA,0,TOTALS,BULGARIA,200,32,68,47.1,21,37,56.8,11,31,35.5,8,14,57.1,16,31,47,19,12,10,4,7,83,1
6508,151515,192_08_26,ESTONIA,0,TOTALS,ESTONIA,200,17,44,38.6,11,24,45.8,6,20,30.0,17,28,60.7,8,17,25,12,21,21,6,3,57,0
6509,151528,192_08_26,GERMANY,0,TOTALS,GERMANY,200,34,70,48.6,25,47,53.2,9,23,39.1,10,24,41.7,20,27,47,20,22,16,13,1,87,1
6510,151541,192_08_27,ISRAEL,0,TOTALS,ISRAEL,200,31,76,40.8,26,62,41.9,5,14,35.7,5,11,45.5,13,26,39,10,19,9,9,2,72,1
6511,151554,192_08_27,LITHUANIA,0,TOTALS,LITHUANIA,200,22,62,35.5,15,37,40.5,7,25,28.0,10,16,62.5,12,35,47,14,19,22,5,8,61,0
6512,151567,192_08_28,LATVIA,0,TOTALS,LATVIA,200,33,62,53.2,26,41,63.4,7,21,33.3,10,17,58.8,12,32,44,14,21,19,7,5,83,1
6513,151580,192_08_28,FRANCE,0,TOTALS,FRANCE,200,22,63,34.9,18,45,40.0,4,18,22.2,14,26,53.8,12,21,33,8,21,14,13,3,62,0
6514,151593,192_08_29,ITALY,0,TOTALS,ITALY,200,23,54,42.6,17,34,50.0,6,20,30.0,11,16,68.8,8,24,32,11,26,17,10,1,63,0
6515,151605,192_08_29,GREECE,0,TOTALS,GREECE,200,23,60,38.3,17,39,43.6,6,21,28.6,16,28,57.1,20,23,43,14,15,16,13,1,68,1
6516,151618,192_08_30,TURKEY,0,TOTALS,TURKEY,200,30,69,43.5,27,53,50.9,3,16,18.8,9,14,64.3,21,22,43,10,21,21,5,1,72,0
6517,151631,192_08_30,RUSSIA,0,TOTALS,RUSSIA,200,33,61,54.1,26,45,57.8,7,16,43.8,9,19,47.4,10,17,27,16,21,12,8,0,82,1
6518,151644,192_08_31,SERBIA,0,TOTALS,SERBIA,200,32,69,46.4,23,42,54.8,9,27,33.3,20,31,64.5,17,25,42,15,30,17,8,2,93,1
6519,151657,192_08_31,SPAIN,0,TOTALS,SPAIN,200,29,65,44.6,25,46,54.3,4,19,21.1,25,34,73.5,12,24,36,13,27,15,9,1,87,0
6520,151670,192_08_32,UKRAINE,0,TOTALS,UKRAINE,200,29,63,46.0,18,38,47.4,11,25,44.0,7,9,77.8,8,19,27,13,17,15,7,1,76,0
6521,151683,192_08_32,CROATIA,0,TOTALS,CROATIA,200,35,68,51.5,28,41,68.3,7,27,25.9,11,15,73.3,14,26,40,15,17,15,6,1,88,1
6522,151696,192_08_33,ITALY,0,TOTALS,ITALY,200,28,56,50.0,16,32,50.0,12,24,50.0,25,29,86.2,10,31,41,15,24,20,14,4,93,1
6523,151709,192_08_33,ISRAEL,0,TOTALS,ISRAEL,200,18,51,35.3,17,46,37.0,1,5,20.0,20,33,60.6,8,18,26,5,25,18,8,2,57,0
6524,151722,192_08_34,FRANCE,0,TOTALS,FRANCE,200,34,62,54.8,31,48,64.6,3,14,21.4,12,17,70.6,9,35,44,21,11,20,10,3,83,1
6525,151735,192_08_34,TURKEY,0,TOTALS,TURKEY,200,24,67,35.8,19,47,40.4,5,20,25.0,11,14,78.6,10,21,31,9,15,16,13,1,64,0
6526,151747,192_08_35,GREECE,0,TOTALS,GREECE,200,30,60,50.0,22,40,55.0,8,20,40.0,4,8,50.0,9,30,39,11,25,16,8,5,72,1
6527,151760,192_08_35,SERBIA,0,TOTALS,SERBIA,200,19,60,31.7,15,38,39.5,4,22,18.2,17,25,68.0,17,20,37,5,17,11,9,1,59,0
6528,151773,192_08_36,LATVIA,0,TOTALS,LATVIA,200,37,77,48.1,33,56,58.9,4,21,19.0,8,14,57.1,19,34,53,16,11,20,13,4,86,1
6529,151786,192_08_36,UKRAINE,0,TOTALS,UKRAINE,200,23,68,33.8,17,51,33.3,6,17,35.3,2,4,50.0,12,22,34,4,14,23,14,4,54,0
6530,151799,192_08_37,SPAIN,0,TOTALS,SPAIN,200,24,70,34.3,22,56,39.3,2,14,14.3,16,22,72.7,12,23,35,5,23,8,8,0,66,0
6531,151812,192_08_37,LITHUANIA,0,TOTALS,LITHUANIA,200,28,54,51.9,23,37,62.2,5,17,29.4,21,27,77.8,7,34,41,19,20,16,7,3,82,1
6532,151825,192_08_38,RUSSIA,0,TOTALS,RUSSIA,200,27,59,45.8,23,39,59.0,4,20,20.0,27,35,77.1,13,23,36,11,23,14,10,3,85,1
6533,151838,192_08_38,CROATIA,0,TOTALS,CROATIA,200,26,58,44.8,21,40,52.5,5,18,27.8,19,24,79.2,12,23,35,9,28,19,8,1,76,0
6534,151851,192_08_39,GERMANY,0,TOTALS,GERMANY,200,24,65,36.9,21,41,51.2,3,24,12.5,11,15,73.3,15,19,34,8,14,14,9,1,62,0
6535,151864,192_08_39,BELGIUM,0,TOTALS,BELGIUM,200,30,56,53.6,21,36,58.3,9,20,45.0,4,8,50.0,10,27,37,14,16,19,6,2,73,1
6536,151877,192_08_40,BULGARIA,0,TOTALS,BULGARIA,200,23,54,42.6,11,27,40.7,12,27,44.4,21,31,67.7,10,24,34,15,15,18,9,4,79,1
6537,151889,192_08_40,ESTONIA,0,TOTALS,ESTONIA,200,28,69,40.6,24,52,46.2,4,17,23.5,9,12,75.0,14,24,38,11,24,15,11,2,69,0
6538,151902,192_08_41,SERBIA,0,TOTALS,SERBIA,200,21,55,38.2,15,32,46.9,6,23,26.1,13,19,68.4,9,30,39,10,17,20,3,5,61,0
6539,151915,192_08_41,ISRAEL,0,TOTALS,ISRAEL,200,26,60,43.3,23,47,48.9,3,13,23.1,10,16,62.5,7,23,30,9,17,12,11,4,65,1
6540,151928,192_08_42,TURKEY,0,TOTALS,TURKEY,200,34,63,54.0,28,38,73.7,6,25,24.0,11,16,68.8,8,36,44,13,20,18,8,4,85,1
6541,151941,192_08_42,UKRAINE,0,TOTALS,UKRAINE,200,25,74,33.8,22,55,40.0,3,19,15.8,16,22,72.7,14,25,39,9,15,13,8,1,69,0
6542,151954,192_08_43,LITHUANIA,0,TOTALS,LITHUANIA,200,23,46,50.0,18,34,52.9,5,12,41.7,3,12,25.0,7,27,34,12,16,25,6,3,54,0
6543,151966,192_08_43,GREECE,0,TOTALS,GREECE,200,30,69,43.5,24,48,50.0,6,21,28.6,6,14,42.9,16,20,36,10,15,13,17,1,72,1
6544,151979,192_08_44,CROATIA,0,TOTALS,CROATIA,200,27,60,45.0,18,33,54.5,9,27,33.3,10,16,62.5,14,16,30,14,17,10,11,0,73,0
6545,151992,192_08_44,FRANCE,0,TOTALS,FRANCE,200,28,51,54.9,20,34,58.8,8,17,47.1,10,14,71.4,10,21,31,13,16,17,6,2,74,1
6546,152005,192_08_45,SPAIN,0,TOTALS,SPAIN,200,27,69,39.1,23,49,46.9,4,20,20.0,25,34,73.5,16,19,35,12,21,12,20,1,83,1
6547,152018,192_08_45,ITALY,0,TOTALS,ITALY,200,30,53,56.6,22,31,71.0,8,22,36.4,12,18,66.7,7,33,40,18,27,25,6,1,80,0
6548,152031,192_08_46,RUSSIA,0,TOTALS,RUSSIA,200,27,67,40.3,21,49,42.9,6,18,33.3,15,20,75.0,12,19,31,10,22,6,9,2,75,0
6549,152044,192_08_46,LATVIA,0,TOTALS,LATVIA,200,28,64,43.8,23,47,48.9,5,17,29.4,18,19,94.7,18,30,48,11,23,19,4,3,79,1
6550,152057,192_08_47,BELGIUM,0,TOTALS,BELGIUM,200,34,72,47.2,29,53,54.7,5,19,26.3,11,12,91.7,20,34,54,18,17,18,11,2,84,1
6551,152069,192_08_47,ESTONIA,0,TOTALS,ESTONIA,200,26,70,37.1,21,36,58.3,5,34,14.7,13,19,68.4,16,17,33,6,16,12,13,1,70,0
6552,152082,192_08_48,GERMANY,0,TOTALS,GERMANY,200,37,66,56.1,29,46,63.0,8,20,40.0,5,7,71.4,9,22,31,13,16,11,7,2,87,1
6553,152095,192_08_48,BULGARIA,0,TOTALS,BULGARIA,200,26,56,46.4,18,33,54.5,8,23,34.8,13,15,86.7,9,21,30,12,15,10,5,5,73,0
6554,152108,192_08_49,TURKEY,0,TOTALS,TURKEY,200,27,57,47.4,22,44,50.0,5,13,38.5,21,28,75.0,7,33,40,11,22,16,8,3,80,1
6555,152121,192_08_49,ITALY,0,TOTALS,ITALY,200,28,68,41.2,24,53,45.3,4,15,26.7,13,17,76.5,9,23,32,8,24,11,10,2,73,0
6556,152134,192_08_50,ISRAEL,0,TOTALS,ISRAEL,200,31,66,47.0,26,53,49.1,5,13,38.5,9,12,75.0,5,20,25,17,23,10,10,2,76,1
6557,152147,192_08_50,UKRAINE,0,TOTALS,UKRAINE,200,25,53,47.2,20,37,54.1,5,16,31.2,20,25,80.0,11,31,42,9,18,24,3,2,75,0
6558,152159,192_08_51,GREECE,0,TOTALS,GREECE,200,33,56,58.9,23,34,67.6,10,22,45.5,6,15,40.0,10,29,39,25,20,19,6,7,82,1
6559,152172,192_08_51,CROATIA,0,TOTALS,CROATIA,200,21,66,31.8,12,39,30.8,9,27,33.3,11,14,78.6,18,18,36,10,20,12,10,1,62,0
6560,152185,192_08_52,RUSSIA,0,TOTALS,RUSSIA,200,25,69,36.2,20,51,39.2,5,18,27.8,8,14,57.1,10,20,30,11,15,12,9,1,63,0
6561,152198,192_08_52,SERBIA,0,TOTALS,SERBIA,200,37,68,54.4,31,50,62.0,6,18,33.3,5,8,62.5,15,32,47,16,22,17,5,4,85,1
6562,152211,192_08_53,SPAIN,0,TOTALS,SPAIN,200,38,74,51.4,26,54,48.1,12,20,60.0,19,30,63.3,15,25,40,19,23,12,15,3,107,0
6563,152224,192_08_53,LATVIA,0,TOTALS,LATVIA,200,34,74,45.9,26,46,56.5,8,28,28.6,15,24,62.5,18,29,47,11,21,18,9,2,91,1
6564,152237,192_08_54,FRANCE,0,TOTALS,FRANCE,200,21,64,32.8,20,45,44.4,1,19,5.3,12,24,50.0,13,15,28,6,18,17,15,2,55,0
6565,152250,192_08_54,LITHUANIA,0,TOTALS,LITHUANIA,200,31,52,59.6,27,39,69.2,4,13,30.8,13,19,68.4,8,34,42,17,25,24,11,5,79,1
6566,152263,192_08_55,UKRAINE,0,TOTALS,UKRAINE,200,21,60,35.0,15,37,40.5,6,23,26.1,20,26,76.9,10,23,33,6,11,18,10,2,68,0
6567,152276,192_08_55,ITALY,0,TOTALS,ITALY,200,34,71,47.9,27,46,58.7,7,25,28.0,9,13,69.2,14,32,46,15,23,16,8,2,84,1
6568,152289,192_08_56,LATVIA,0,TOTALS,LATVIA,200,24,58,41.4,17,37,45.9,7,21,33.3,16,23,69.6,12,26,38,10,20,15,7,8,71,1
6569,152302,192_08_56,RUSSIA,0,TOTALS,RUSSIA,200,26,65,40.0,19,48,39.6,7,17,41.2,10,14,71.4,15,21,36,12,24,13,8,5,69,0
6570,152315,192_08_57,ISRAEL,0,TOTALS,ISRAEL,200,29,66,43.9,23,53,43.4,6,13,46.2,8,12,66.7,6,20,26,19,18,14,18,0,72,0
6571,152328,192_08_57,TURKEY,0,TOTALS,TURKEY,200,35,66,53.0,19,35,54.3,16,31,51.6,9,16,56.2,16,34,50,20,13,23,6,4,95,1
6572,152341,192_08_58,SPAIN,0,TOTALS,SPAIN,200,32,60,53.3,23,41,56.1,9,19,47.4,16,25,64.0,8,26,34,19,18,16,10,3,89,1
6573,152354,192_08_58,SERBIA,0,TOTALS,SERBIA,200,33,71,46.5,23,43,53.5,10,28,35.7,9,14,64.3,13,25,38,17,24,14,9,0,85,0
6574,152367,192_08_59,CROATIA,0,TOTALS,CROATIA,200,27,62,43.5,21,38,55.3,6,24,25.0,13,21,61.9,15,32,47,13,15,17,5,4,73,1
6575,152380,192_08_59,FRANCE,0,TOTALS,FRANCE,200,27,70,38.6,20,50,40.0,7,20,35.0,7,10,70.0,12,25,37,19,19,10,14,0,68,0
6576,152392,192_08_60,GREECE,0,TOTALS,GREECE,200,20,59,33.9,16,41,39.0,4,18,22.2,13,22,59.1,10,34,44,6,14,11,6,5,57,1
6577,152405,192_08_60,LITHUANIA,0,TOTALS,LITHUANIA,200,22,65,33.8,20,44,45.5,2,21,9.5,4,9,44.4,13,30,43,6,21,12,5,3,50,0
6578,152418,193_08_01,MONTENEGRO,0,TOTALS,MONTENEGRO,200,28,54,51.9,22,41,53.7,6,13,46.2,8,19,42.1,10,16,26,8,19,19,8,1,70,1
6579,152431,193_08_01,NORWAY,0,TOTALS,NORWAY,200,24,52,46.2,18,36,50.0,6,16,37.5,12,18,66.7,11,17,28,8,26,19,7,0,66,0
6580,152444,193_08_02,ENGLAND,0,TOTALS,ENGLAND,200,29,69,42.0,20,47,42.6,9,22,40.9,14,22,63.6,14,19,33,10,27,21,15,3,81,0
6581,152457,193_08_02,POLAND,0,TOTALS,POLAND,200,31,59,52.5,22,39,56.4,9,20,45.0,17,29,58.6,11,26,37,7,23,25,8,1,88,1
6582,152470,193_08_03,NETHERLANDS,0,TOTALS,NETHERLANDS,200,28,64,43.8,21,42,50.0,7,22,31.8,19,25,76.0,9,20,29,11,30,23,7,0,82,0
6583,152483,193_08_03,AUSTRIA,0,TOTALS,AUSTRIA,200,33,64,51.6,32,55,58.2,1,9,11.1,22,37,59.5,16,26,42,7,24,20,10,1,89,1
6584,152496,193_08_04,DENMARK,0,TOTALS,DENMARK,200,24,66,36.4,22,58,37.9,2,8,25.0,17,39,43.6,20,14,34,1,14,7,4,0,67,0
6585,152509,193_08_04,SLOVAK REPUBLIC,0,TOTALS,SLOVAK REPUBLIC,200,40,61,65.6,31,44,70.5,9,17,52.9,9,17,52.9,9,19,28,10,28,9,7,4,98,1
6586,152522,193_08_05,SWEDEN,0,TOTALS,SWEDEN,200,28,70,40.0,20,54,37.0,8,16,50.0,10,16,62.5,10,29,39,9,18,17,9,0,74,1
6587,152535,193_08_05,BOSNIA AND HERZEGOVINA,0,TOTALS,BOSNIA AND HERZEGOVINA,200,21,53,39.6,17,33,51.5,4,20,20.0,14,23,60.9,5,26,31,6,21,22,12,0,60,0
6588,152548,193_08_06,HUNGARY,0,TOTALS,HUNGARY,200,27,57,47.4,23,38,60.5,4,19,21.1,12,15,80.0,5,27,32,6,24,11,5,2,70,0
6589,152561,193_08_06,FINLAND,0,TOTALS,FINLAND,200,27,70,38.6,15,32,46.9,12,38,31.6,16,23,69.6,11,18,29,3,17,4,3,0,82,1
6590,152574,193_08_07,SWITZERLAND,0,TOTALS,SWITZERLAND,200,27,57,47.4,23,39,59.0,4,18,22.2,14,27,51.9,8,23,31,9,18,14,7,0,72,1
6591,152587,193_08_07,IRELAND,0,TOTALS,IRELAND,200,25,65,38.5,16,40,40.0,9,25,36.0,9,13,69.2,12,20,32,5,24,14,3,0,68,0
6592,152600,193_08_08,BELARUS,0,TOTALS,BELARUS,200,23,53,43.4,19,42,45.2,4,11,36.4,12,20,60.0,2,18,20,1,27,6,7,2,62,0
6593,152613,193_08_08,ROMANIA,0,TOTALS,ROMANIA,200,23,58,39.7,18,45,40.0,5,13,38.5,18,35,51.4,9,22,31,1,18,4,8,0,69,1
6594,152626,193_08_09,SLOVENIA,0,TOTALS,SLOVENIA,200,33,64,51.6,25,43,58.1,8,21,38.1,11,17,64.7,12,22,34,15,24,18,5,4,85,1
6595,152639,193_08_09,SWEDEN,0,TOTALS,SWEDEN,200,19,53,35.8,14,37,37.8,5,16,31.2,20,28,71.4,9,18,27,7,23,21,11,1,63,0
6596,152652,193_08_10,FINLAND,0,TOTALS,FINLAND,200,18,61,29.5,14,39,35.9,4,22,18.2,15,17,88.2,9,17,26,4,21,12,7,0,55,0
6597,152665,193_08_10,DENMARK,0,TOTALS,DENMARK,200,22,48,45.8,14,26,53.8,8,22,36.4,13,27,48.1,9,27,36,7,20,17,8,0,65,1
6598,152678,193_08_11,PORTUGAL,0,TOTALS,PORTUGAL,200,28,69,40.6,25,50,50.0,3,19,15.8,10,22,45.5,9,19,28,6,17,17,21,0,69,0
6599,152691,193_08_11,ENGLAND,0,TOTALS,ENGLAND,200,28,61,45.9,19,38,50.0,9,23,39.1,17,24,70.8,12,32,44,15,20,30,9,0,82,1
6600,152704,193_08_12,BOSNIA AND HERZEGOVINA,0,TOTALS,BOSNIA AND HERZEGOVINA,200,25,65,38.5,24,47,51.1,1,18,5.6,18,26,69.2,14,19,33,1,18,19,4,0,69,0
6601,152717,193_08_12,SWITZERLAND,0,TOTALS,SWITZERLAND,200,27,58,46.6,19,36,52.8,8,22,36.4,13,20,65.0,8,24,32,7,24,16,13,3,75,1
6602,152730,193_08_13,CZECH REPUBLIC,0,TOTALS,CZECH REPUBLIC,200,38,75,50.7,28,53,52.8,10,22,45.5,21,31,67.7,20,27,47,21,12,16,12,5,107,0
6603,152743,193_08_13,NETHERLANDS,0,TOTALS,NETHERLANDS,200,27,69,39.1,22,54,40.7,5,15,33.3,12,16,75.0,17,21,38,12,24,24,8,5,71,1
6604,152756,193_08_14,POLAND,0,TOTALS,POLAND,200,31,57,54.4,26,41,63.4,5,16,31.2,29,41,70.7,13,29,42,14,21,20,20,0,96,1
6605,152769,193_08_14,BELARUS,0,TOTALS,BELARUS,200,18,54,33.3,16,44,36.4,2,10,20.0,12,16,75.0,6,19,25,8,32,27,7,0,50,0
6606,152782,193_08_15,AUSTRIA,0,TOTALS,AUSTRIA,200,23,54,42.6,19,39,48.7,4,15,26.7,21,24,87.5,9,27,36,11,29,21,7,3,71,1
6607,152795,193_08_15,MONTENEGRO,0,TOTALS,MONTENEGRO,200,26,62,41.9,24,46,52.2,2,16,12.5,11,19,57.9,11,22,33,16,23,19,10,4,65,0
6608,152808,193_08_16,GEORGIA,0,TOTALS,GEORGIA,200,24,50,48.0,20,36,55.6,4,14,28.6,21,30,70.0,12,38,50,13,16,24,4,3,73,1
6609,152821,193_08_16,HUNGARY,0,TOTALS,HUNGARY,200,27,78,34.6,20,41,48.8,7,37,18.9,2,3,66.7,13,17,30,11,26,12,10,0,63,0
6610,152834,193_08_17,IRELAND,0,TOTALS,IRELAND,200,27,80,33.8,19,45,42.2,8,35,22.9,8,25,32.0,24,21,45,13,21,21,5,0,70,0
6611,152847,193_08_17,BOSNIA AND HERZEGOVINA,0,TOTALS,BOSNIA AND HERZEGOVINA,200,34,61,55.7,32,46,69.6,2,15,13.3,9,15,60.0,8,32,40,2,27,25,6,0,79,1
6612,152860,193_08_18,BELARUS,0,TOTALS,BELARUS,200,27,67,40.3,23,55,41.8,4,12,33.3,9,14,64.3,13,32,45,11,24,41,9,3,67,1
6613,152873,193_08_18,PORTUGAL,0,TOTALS,PORTUGAL,200,39,87,44.8,32,67,47.8,7,20,35.0,21,25,84.0,16,30,46,12,18,21,30,6,106,0
6614,152886,193_08_19,DENMARK,0,TOTALS,DENMARK,200,29,58,50.0,21,36,58.3,8,22,36.4,15,25,60.0,8,22,30,15,21,19,8,1,81,1
6615,152899,193_08_19,GEORGIA,0,TOTALS,GEORGIA,200,30,60,50.0,24,41,58.5,6,19,31.6,9,18,50.0,11,24,35,5,25,21,6,2,75,0
6616,152912,193_08_20,NORWAY,0,TOTALS,NORWAY,200,23,60,38.3,16,42,38.1,7,18,38.9,10,19,52.6,10,18,28,9,20,14,9,1,63,0
6617,152925,193_08_20,AUSTRIA,0,TOTALS,AUSTRIA,200,29,61,47.5,21,37,56.8,8,24,33.3,12,18,66.7,16,27,43,16,23,14,7,2,78,1
6618,152938,193_08_21,SLOVAK REPUBLIC,0,TOTALS,SLOVAK REPUBLIC,200,28,58,48.3,19,37,51.4,9,21,42.9,12,18,66.7,6,18,24,5,16,7,12,4,77,1
6619,152951,193_08_21,FINLAND,0,TOTALS,FINLAND,200,29,61,47.5,22,42,52.4,7,19,36.8,9,14,64.3,5,20,25,9,18,4,5,0,74,0
6620,152964,193_08_22,SWITZERLAND,0,TOTALS,SWITZERLAND,200,20,58,34.5,13,35,37.1,7,23,30.4,9,21,42.9,11,11,22,7,27,24,8,0,56,0
6621,152977,193_08_22,SLOVENIA,0,TOTALS,SLOVENIA,200,34,54,63.0,26,41,63.4,8,13,61.5,10,20,50.0,10,22,32,22,22,25,14,0,86,1
6622,152990,193_08_23,ROMANIA,0,TOTALS,ROMANIA,200,17,56,30.4,13,42,31.0,4,14,28.6,9,13,69.2,6,17,23,2,19,8,1,2,47,0
6623,153003,193_08_23,POLAND,0,TOTALS,POLAND,200,29,60,48.3,23,37,62.2,6,23,26.1,15,22,68.2,9,29,38,9,18,4,5,4,79,1
6624,153016,193_08_24,MONTENEGRO,0,TOTALS,MONTENEGRO,200,24,69,34.8,13,36,36.1,11,33,33.3,22,28,78.6,11,18,29,14,23,10,8,0,81,1
6625,153029,193_08_24,CZECH REPUBLIC,0,TOTALS,CZECH REPUBLIC,200,27,49,55.1,20,31,64.5,7,18,38.9,18,23,78.3,3,28,31,20,26,14,5,1,79,0
6626,153042,193_08_25,SWEDEN,0,TOTALS,SWEDEN,200,31,67,46.3,29,54,53.7,2,13,15.4,15,20,75.0,16,27,43,12,16,25,14,2,79,1
6627,153055,193_08_25,SWITZERLAND,0,TOTALS,SWITZERLAND,200,23,56,41.1,16,32,50.0,7,24,29.2,15,20,75.0,8,15,23,10,21,24,12,1,68,0
6628,153068,193_08_26,GEORGIA,0,TOTALS,GEORGIA,200,27,60,45.0,23,41,56.1,4,19,21.1,27,39,69.2,14,26,40,14,24,17,7,3,85,1
6629,153081,193_08_26,SLOVAK REPUBLIC,0,TOTALS,SLOVAK REPUBLIC,200,25,64,39.1,9,26,34.6,16,38,42.1,13,27,48.1,12,19,31,9,29,20,4,2,79,0
6630,153094,193_08_27,SLOVENIA,0,TOTALS,SLOVENIA,200,37,69,53.6,31,49,63.3,6,20,30.0,14,20,70.0,16,31,47,19,13,17,13,7,94,1
6631,153107,193_08_27,IRELAND,0,TOTALS,IRELAND,200,15,63,23.8,8,38,21.1,7,25,28.0,5,10,50.0,14,15,29,9,17,22,7,2,42,0
6632,153120,193_08_28,PORTUGAL,0,TOTALS,PORTUGAL,200,32,79,40.5,23,58,39.7,9,21,42.9,15,22,68.2,10,29,39,19,18,16,16,2,88,1
6633,153133,193_08_28,ROMANIA,0,TOTALS,ROMANIA,200,24,65,36.9,20,48,41.7,4,17,23.5,11,18,61.1,13,25,38,7,20,30,8,1,63,0
6634,153146,193_08_29,CZECH REPUBLIC,0,TOTALS,CZECH REPUBLIC,200,33,64,51.6,23,43,53.5,10,21,47.6,25,34,73.5,10,32,42,22,23,17,9,4,101,0
6635,153159,193_08_29,NORWAY,0,TOTALS,NORWAY,200,18,55,32.7,14,42,33.3,4,13,30.8,23,29,79.3,6,24,30,8,23,27,7,0,63,1
6636,153172,193_08_30,HUNGARY,0,TOTALS,HUNGARY,200,25,62,40.3,19,45,42.2,6,17,35.3,20,26,76.9,10,34,44,11,20,12,9,2,76,1
6637,153185,193_08_30,DENMARK,0,TOTALS,DENMARK,200,23,70,32.9,18,46,39.1,5,24,20.8,13,23,56.5,15,28,43,7,22,13,7,0,64,0
6638,153198,193_08_31,NETHERLANDS,0,TOTALS,NETHERLANDS,200,37,77,48.1,30,58,51.7,7,19,36.8,7,9,77.8,20,24,44,12,27,17,15,1,88,1
6639,153211,193_08_31,MONTENEGRO,0,TOTALS,MONTENEGRO,200,22,50,44.0,19,37,51.4,3,13,23.1,18,29,62.1,9,16,25,10,16,22,8,2,65,0
6640,153224,193_08_32,ENGLAND,0,TOTALS,ENGLAND,200,20,59,33.9,14,47,29.8,6,12,50.0,21,31,67.7,16,22,38,9,27,17,7,0,67,0
6641,153237,193_08_32,BELARUS,0,TOTALS,BELARUS,200,26,54,48.1,22,39,56.4,4,15,26.7,16,30,53.3,10,26,36,15,24,13,8,3,72,1
6642,153250,193_08_33,AUSTRIA,0,TOTALS,AUSTRIA,200,29,60,48.3,22,45,48.9,7,15,46.7,8,10,80.0,7,28,35,13,20,16,8,1,73,0
6643,153263,193_08_33,CZECH REPUBLIC,0,TOTALS,CZECH REPUBLIC,200,24,65,36.9,13,40,32.5,11,25,44.0,18,26,69.2,14,26,40,15,15,14,11,2,77,1
6644,153276,193_08_34,POLAND,0,TOTALS,POLAND,200,36,66,54.5,29,46,63.0,7,20,35.0,7,11,63.6,12,32,44,8,17,18,8,2,86,1
6645,153289,193_08_34,PORTUGAL,0,TOTALS,PORTUGAL,200,24,74,32.4,21,55,38.2,3,19,15.8,9,12,75.0,15,17,32,2,16,16,7,0,60,0
6646,153302,193_08_35,NORWAY,0,TOTALS,NORWAY,200,26,59,44.1,22,41,53.7,4,18,22.2,18,27,66.7,10,20,30,9,18,20,12,0,74,0
6647,153315,193_08_35,NETHERLANDS,0,TOTALS,NETHERLANDS,200,31,64,48.4,20,36,55.6,11,28,39.3,14,20,70.0,13,25,38,19,25,20,13,0,87,1
6648,153328,193_08_36,ROMANIA,0,TOTALS,ROMANIA,225,28,62,45.2,25,48,52.1,3,14,21.4,27,37,73.0,12,26,38,5,18,21,11,2,86,1
6649,153341,193_08_36,ENGLAND,0,TOTALS,ENGLAND,225,31,79,39.2,26,62,41.9,5,17,29.4,10,12,83.3,16,24,40,2,29,24,10,2,77,0
6650,153354,193_08_37,BOSNIA AND HERZEGOVINA,0,TOTALS,BOSNIA AND HERZEGOVINA,200,32,60,53.3,27,44,61.4,5,16,31.2,18,26,69.2,4,22,26,10,21,9,7,2,87,1
6651,153367,193_08_37,SLOVENIA,0,TOTALS,SLOVENIA,200,19,52,36.5,14,40,35.0,5,12,41.7,20,30,66.7,10,23,33,12,23,18,5,2,63,0
6652,153380,193_08_38,SLOVAK REPUBLIC,0,TOTALS,SLOVAK REPUBLIC,200,31,59,52.5,17,36,47.2,14,23,60.9,19,25,76.0,8,11,19,0,28,4,2,3,95,1
6653,153393,193_08_38,HUNGARY,0,TOTALS,HUNGARY,200,31,57,54.4,27,44,61.4,4,13,30.8,26,42,61.9,12,20,32,8,21,5,6,2,92,0
6654,153406,193_08_39,IRELAND,0,TOTALS,IRELAND,200,19,62,30.6,16,41,39.0,3,21,14.3,15,24,62.5,16,20,36,5,19,13,7,1,56,0
6655,153419,193_08_39,SWEDEN,0,TOTALS,SWEDEN,200,23,71,32.4,16,40,40.0,7,31,22.6,10,17,58.8,23,23,46,10,19,13,6,4,63,1
6656,153430,193_08_40,FINLAND,0,TOTALS,FINLAND,200,33,58,56.9,20,32,62.5,13,26,50.0,5,7,71.4,9,16,25,3,17,4,6,1,84,1
6657,153443,193_08_40,GEORGIA,0,TOTALS,GEORGIA,200,17,47,36.2,13,30,43.3,4,17,23.5,14,22,63.6,8,13,21,1,13,5,1,7,52,0
6658,153456,193_08_41,ROMANIA,0,TOTALS,ROMANIA,200,27,51,52.9,21,38,55.3,6,13,46.2,16,24,66.7,9,21,30,12,20,18,9,1,76,1
6659,153469,193_08_41,GEORGIA,0,TOTALS,GEORGIA,200,22,60,36.7,15,39,38.5,7,21,33.3,20,26,76.9,16,19,35,11,26,19,10,7,71,0
6660,153482,193_08_42,IRELAND,0,TOTALS,IRELAND,200,21,60,35.0,17,48,35.4,4,12,33.3,15,20,75.0,13,16,29,9,12,18,12,1,61,0
6661,153495,193_08_42,ENGLAND,0,TOTALS,ENGLAND,200,35,67,52.2,29,48,60.4,6,19,31.6,7,11,63.6,12,21,33,19,15,15,10,4,83,1
6662,153508,193_08_43,BELARUS,0,TOTALS,BELARUS,200,15,47,31.9,14,40,35.0,1,7,14.3,13,25,52.0,10,22,32,4,19,11,7,1,44,0
6663,153519,193_08_43,FINLAND,0,TOTALS,FINLAND,200,25,61,41.0,18,38,47.4,7,23,30.4,14,19,73.7,14,20,34,9,22,7,10,1,71,1
6664,153532,193_08_44,CZECH REPUBLIC,0,TOTALS,CZECH REPUBLIC,200,35,69,50.7,31,57,54.4,4,12,33.3,20,25,80.0,12,29,41,23,15,12,12,1,94,1
6665,153545,193_08_44,SWEDEN,0,TOTALS,SWEDEN,200,27,63,42.9,14,33,42.4,13,30,43.3,9,16,56.2,9,24,33,16,20,17,4,3,76,0
6666,153558,193_08_45,NORWAY,0,TOTALS,NORWAY,225,21,56,37.5,19,31,61.3,2,25,8.0,30,44,68.2,6,16,22,0,24,13,15,0,74,0
6667,153571,193_08_45,HUNGARY,0,TOTALS,HUNGARY,225,30,66,45.5,22,41,53.7,8,25,32.0,19,23,82.6,16,22,38,12,34,21,9,1,87,1
6668,153584,193_08_46,AUSTRIA,0,TOTALS,AUSTRIA,200,25,55,45.5,19,39,48.7,6,16,37.5,18,27,66.7,10,22,32,8,24,22,10,5,74,0
6669,153597,193_08_46,SLOVENIA,0,TOTALS,SLOVENIA,200,31,65,47.7,25,51,49.0,6,14,42.9,12,18,66.7,13,21,34,15,24,20,8,1,80,1
6670,153610,193_08_47,MONTENEGRO,0,TOTALS,MONTENEGRO,200,30,50,60.0,29,44,65.9,1,6,16.7,12,19,63.2,5,22,27,9,17,15,7,2,73,1
6671,153623,193_08_47,SWITZERLAND,0,TOTALS,SWITZERLAND,200,21,56,37.5,13,31,41.9,8,25,32.0,7,12,58.3,10,16,26,3,21,17,6,1,57,0
6672,153636,193_08_48,POLAND,0,TOTALS,POLAND,200,32,70,45.7,21,42,50.0,11,28,39.3,8,11,72.7,17,27,44,14,15,20,13,5,83,1
6673,153649,193_08_48,DENMARK,0,TOTALS,DENMARK,200,17,56,30.4,14,48,29.2,3,8,37.5,4,11,36.4,9,22,31,8,15,27,7,1,41,0
6674,153662,193_08_49,NETHERLANDS,0,TOTALS,NETHERLANDS,200,34,75,45.3,25,47,53.2,9,28,32.1,9,14,64.3,16,20,36,9,17,17,18,1,86,1
6675,153675,193_08_49,BOSNIA AND HERZEGOVINA,0,TOTALS,BOSNIA AND HERZEGOVINA,200,26,59,44.1,24,46,52.2,2,13,15.4,7,13,53.8,12,23,35,4,12,30,9,0,61,0
6676,153688,193_08_50,PORTUGAL,0,TOTALS,PORTUGAL,200,31,73,42.5,27,53,50.9,4,20,20.0,20,31,64.5,21,26,47,8,22,18,14,2,86,1
6677,153701,193_08_50,SLOVAK REPUBLIC,0,TOTALS,SLOVAK REPUBLIC,200,26,64,40.6,19,37,51.4,7,27,25.9,14,18,77.8,13,20,33,7,27,20,10,3,73,0
6678,153714,193_08_51,GEORGIA,0,TOTALS,GEORGIA,200,33,70,47.1,32,57,56.1,1,13,7.7,8,16,50.0,16,28,44,13,22,12,7,2,75,1
6679,153727,193_08_51,BELARUS,0,TOTALS,BELARUS,200,25,57,43.9,22,45,48.9,3,12,25.0,16,26,61.5,8,24,32,11,15,15,6,1,69,0
6680,153740,193_08_52,ENGLAND,0,TOTALS,ENGLAND,200,29,59,49.2,20,41,48.8,9,18,50.0,17,19,89.5,3,20,23,6,19,13,8,6,84,1
6681,153753,193_08_52,NORWAY,0,TOTALS,NORWAY,200,29,61,47.5,23,42,54.8,6,19,31.6,7,12,58.3,7,22,29,9,17,18,4,0,71,0
6682,153766,193_08_53,SLOVENIA,0,TOTALS,SLOVENIA,225,30,65,46.2,24,49,49.0,6,16,37.5,12,15,80.0,11,25,36,14,20,20,8,4,78,1
6683,153779,193_08_53,CZECH REPUBLIC,0,TOTALS,CZECH REPUBLIC,225,29,64,45.3,21,46,45.7,8,18,44.4,11,18,61.1,6,20,26,14,17,14,11,4,77,0
6684,153792,193_08_54,FINLAND,0,TOTALS,FINLAND,200,30,69,43.5,24,36,66.7,6,33,18.2,7,11,63.6,11,25,36,9,23,13,17,1,73,1
6685,153805,193_08_54,ROMANIA,0,TOTALS,ROMANIA,200,21,47,44.7,17,34,50.0,4,13,30.8,15,26,57.7,8,27,35,10,14,24,5,1,61,0
6686,153818,193_08_55,SWEDEN,0,TOTALS,SWEDEN,200,22,50,44.0,15,35,42.9,7,15,46.7,18,21,85.7,5,21,26,5,17,23,8,8,69,0
6687,153831,193_08_55,AUSTRIA,0,TOTALS,AUSTRIA,200,27,58,46.6,22,37,59.5,5,21,23.8,12,18,66.7,9,20,29,13,25,23,9,6,71,1
6688,153844,193_08_56,HUNGARY,0,TOTALS,HUNGARY,200,40,66,60.6,29,46,63.0,11,20,55.0,15,24,62.5,14,36,50,24,16,17,9,3,106,0
6689,153857,193_08_56,IRELAND,0,TOTALS,IRELAND,200,23,78,29.5,16,55,29.1,7,23,30.4,7,11,63.6,20,17,37,11,20,18,7,2,60,1
6690,153870,193_08_57,SLOVAK REPUBLIC,0,TOTALS,SLOVAK REPUBLIC,200,25,74,33.8,14,50,28.0,11,24,45.8,13,19,68.4,20,19,39,9,25,11,5,3,74,0
6691,153883,193_08_57,POLAND,0,TOTALS,POLAND,200,36,72,50.0,27,50,54.0,9,22,40.9,10,23,43.5,24,29,53,18,17,15,3,7,91,1
6692,153896,193_08_58,SWITZERLAND,0,TOTALS,SWITZERLAND,200,27,49,55.1,19,35,54.3,8,14,57.1,9,15,60.0,5,11,16,1,17,12,2,0,71,1
6693,153909,193_08_58,NETHERLANDS,0,TOTALS,NETHERLANDS,200,40,61,65.6,27,40,67.5,13,21,61.9,12,16,75.0,4,11,15,4,20,5,7,1,105,0
6694,153922,193_08_59,DENMARK,0,TOTALS,DENMARK,200,26,73,35.6,18,42,42.9,8,31,25.8,4,5,80.0,17,25,42,13,19,13,2,0,64,1
6695,153935,193_08_59,PORTUGAL,0,TOTALS,PORTUGAL,200,20,54,37.0,18,37,48.6,2,17,11.8,18,32,56.2,13,29,42,5,9,17,8,1,60,0
6696,153948,193_08_60,BOSNIA AND HERZEGOVINA,0,TOTALS,BOSNIA AND HERZEGOVINA,200,22,50,44.0,20,44,45.5,2,6,33.3,8,17,47.1,5,10,15,0,21,13,6,2,54,0
6697,153961,193_08_60,MONTENEGRO,0,TOTALS,MONTENEGRO,200,26,49,53.1,22,38,57.9,4,11,36.4,13,17,76.5,4,15,19,6,19,16,13,0,69,1
6698,153974,193_08_61,NORWAY,0,TOTALS,NORWAY,200,29,59,49.2,23,47,48.9,6,12,50.0,13,18,72.2,5,22,27,4,14,11,7,0,77,1
6699,153987,193_08_61,IRELAND,0,TOTALS,IRELAND,200,24,60,40.0,18,49,36.7,6,11,54.5,6,8,75.0,6,21,27,4,19,9,4,1,60,0
6700,154000,193_08_62,PORTUGAL,0,TOTALS,PORTUGAL,200,28,63,44.4,22,43,51.2,6,20,30.0,6,9,66.7,5,14,19,15,11,16,13,1,68,0
6701,154013,193_08_62,SWEDEN,0,TOTALS,SWEDEN,200,35,66,53.0,23,42,54.8,12,24,50.0,4,6,66.7,14,26,40,17,8,21,5,4,86,1
6702,154026,193_08_63,SWITZERLAND,0,TOTALS,SWITZERLAND,225,31,68,45.6,24,43,55.8,7,25,28.0,12,26,46.2,8,12,20,8,30,14,8,2,81,0
6703,154039,193_08_63,BELARUS,0,TOTALS,BELARUS,225,28,54,51.9,25,45,55.6,3,9,33.3,30,45,66.7,8,20,28,6,25,22,5,4,89,1
6704,154052,193_08_64,AUSTRIA,0,TOTALS,AUSTRIA,200,31,68,45.6,25,44,56.8,6,24,25.0,14,23,60.9,16,23,39,14,19,12,6,2,82,1
6705,154065,193_08_64,DENMARK,0,TOTALS,DENMARK,200,25,54,46.3,13,33,39.4,12,21,57.1,13,25,52.0,10,23,33,15,20,19,3,0,75,0
6706,154078,193_08_65,ENGLAND,0,TOTALS,ENGLAND,200,27,68,39.7,20,45,44.4,7,23,30.4,7,11,63.6,15,26,41,12,16,15,10,1,68,0
6707,154091,193_08_65,HUNGARY,0,TOTALS,HUNGARY,200,27,62,43.5,17,39,43.6,10,23,43.5,14,21,66.7,13,27,40,17,12,18,7,2,78,1
6708,154104,193_08_66,GEORGIA,0,TOTALS,GEORGIA,200,29,64,45.3,27,52,51.9,2,12,16.7,24,31,77.4,13,28,41,14,19,21,16,2,84,1
6709,154117,193_08_66,BOSNIA AND HERZEGOVINA,0,TOTALS,BOSNIA AND HERZEGOVINA,200,34,70,48.6,34,58,58.6,0,12,0.0,10,19,52.6,14,24,38,7,25,22,9,3,78,0
6710,154130,193_08_67,NETHERLANDS,0,TOTALS,NETHERLANDS,200,41,76,53.9,28,49,57.1,13,27,48.1,9,13,69.2,12,22,34,22,14,15,16,3,104,0
6711,154143,193_08_67,ROMANIA,0,TOTALS,ROMANIA,200,31,62,50.0,28,43,65.1,3,19,15.8,6,8,75.0,7,25,32,12,11,25,6,1,71,1
6712,154156,193_08_68,SLOVENIA,0,TOTALS,SLOVENIA,200,29,62,46.8,17,42,40.5,12,20,60.0,11,20,55.0,17,30,47,21,23,19,9,3,81,1
6713,154169,193_08_68,SLOVAK REPUBLIC,0,TOTALS,SLOVAK REPUBLIC,200,19,55,34.5,18,37,48.6,1,18,5.6,14,21,66.7,7,19,26,7,22,16,12,0,53,0
6714,154182,193_08_69,FINLAND,0,TOTALS,FINLAND,200,26,65,40.0,16,35,45.7,10,30,33.3,8,11,72.7,11,17,28,8,22,16,9,0,70,0
6715,154195,193_08_69,MONTENEGRO,0,TOTALS,MONTENEGRO,200,30,52,57.7,25,36,69.4,5,16,31.2,22,27,81.5,6,30,36,18,19,21,9,3,87,1
6716,154208,193_08_70,POLAND,0,TOTALS,POLAND,200,15,48,31.2,12,31,38.7,3,17,17.6,14,20,70.0,5,22,27,6,21,20,6,5,47,0
6717,154221,193_08_70,CZECH REPUBLIC,0,TOTALS,CZECH REPUBLIC,200,23,62,37.1,19,51,37.3,4,11,36.4,21,25,84.0,14,26,40,13,20,17,8,1,71,1
6718,154234,193_08_71,SWITZERLAND,0,TOTALS,SWITZERLAND,200,30,57,52.6,25,46,54.3,5,11,45.5,7,15,46.7,8,19,27,7,18,21,8,1,72,0
6719,154247,193_08_71,BOSNIA AND HERZEGOVINA,0,TOTALS,BOSNIA AND HERZEGOVINA,200,31,63,49.2,27,42,64.3,4,21,19.0,14,18,77.8,13,24,37,17,17,18,13,6,80,1
6720,154260,193_08_72,BELARUS,0,TOTALS,BELARUS,200,26,62,41.9,26,60,43.3,0,2,0.0,14,22,63.6,12,22,34,7,18,26,10,7,66,0
6721,154273,193_08_72,GEORGIA,0,TOTALS,GEORGIA,200,37,69,53.6,34,55,61.8,3,14,21.4,9,20,45.0,15,30,45,12,20,27,16,5,86,1
6722,154286,193_08_73,ROMANIA,0,TOTALS,ROMANIA,200,23,50,46.0,21,37,56.8,2,13,15.4,10,15,66.7,5,39,44,11,20,21,4,2,58,0
6723,154299,193_08_73,FINLAND,0,TOTALS,FINLAND,200,24,68,35.3,17,34,50.0,7,34,20.6,9,15,60.0,7,25,32,8,13,7,13,0,64,1
6724,154312,193_08_74,DENMARK,0,TOTALS,DENMARK,200,22,63,34.9,16,40,40.0,6,23,26.1,6,13,46.2,15,28,43,10,8,17,6,2,56,0
6725,154325,193_08_74,PORTUGAL,0,TOTALS,PORTUGAL,200,29,64,45.3,23,45,51.1,6,19,31.6,5,6,83.3,7,27,34,15,16,13,12,1,69,1
6726,154338,193_08_75,NETHERLANDS,0,TOTALS,NETHERLANDS,200,29,61,47.5,20,34,58.8,9,27,33.3,11,17,64.7,10,19,29,20,14,19,7,2,78,1
6727,154351,193_08_75,MONTENEGRO,0,TOTALS,MONTENEGRO,200,27,55,49.1,18,33,54.5,9,22,40.9,11,13,84.6,8,21,29,16,16,22,11,5,74,0
6728,154364,193_08_76,AUSTRIA,0,TOTALS,AUSTRIA,200,27,56,48.2,23,40,57.5,4,16,25.0,22,27,81.5,12,30,42,16,19,21,4,4,80,1
6729,154377,193_08_76,SWEDEN,0,TOTALS,SWEDEN,200,27,74,36.5,24,62,38.7,3,12,25.0,10,16,62.5,18,17,35,11,25,13,13,2,67,0
6730,154390,193_08_77,SLOVAK REPUBLIC,0,TOTALS,SLOVAK REPUBLIC,200,22,68,32.4,15,49,30.6,7,19,36.8,9,15,60.0,14,18,32,10,22,10,9,1,60,0
6731,154403,193_08_77,POLAND,0,TOTALS,POLAND,200,24,51,47.1,18,33,54.5,6,18,33.3,16,21,76.2,11,33,44,10,18,20,1,2,70,1
6732,154416,193_08_78,SLOVENIA,0,TOTALS,SLOVENIA,200,27,65,41.5,23,51,45.1,4,14,28.6,10,21,47.6,16,23,39,11,22,15,8,4,68,1
6733,154429,193_08_78,CZECH REPUBLIC,0,TOTALS,CZECH REPUBLIC,200,22,54,40.7,17,37,45.9,5,17,29.4,11,24,45.8,10,24,34,12,19,17,7,6,60,0
6734,158010,196_08_01,CZECH REPUBLIC,0,TOTALS,CZECH REPUBLIC,200,25,62,40.3,21,37,56.8,4,25,16.0,13,30,43.3,14,32,46,6,20,15,8,1,67,1
6735,158023,196_08_01,GREECE,0,TOTALS,GREECE,200,21,55,38.2,14,30,46.7,7,25,28.0,15,25,60.0,6,26,32,3,24,15,9,1,64,0
6736,158036,196_08_02,GEORGIA,0,TOTALS,GEORGIA,200,20,60,33.3,16,28,57.1,4,32,12.5,11,25,44.0,17,19,36,1,20,19,7,3,55,0
6737,158049,196_08_02,ISRAEL,0,TOTALS,ISRAEL,200,31,62,50.0,30,57,52.6,1,5,20.0,8,14,57.1,7,28,35,5,22,15,13,1,71,1
6738,158062,196_08_03,LITHUANIA,0,TOTALS,LITHUANIA,200,24,62,38.7,18,34,52.9,6,28,21.4,11,20,55.0,16,34,50,7,28,19,7,0,65,1
6739,158075,196_08_03,SPAIN,0,TOTALS,SPAIN,200,16,55,29.1,10,35,28.6,6,20,30.0,17,30,56.7,8,24,32,2,20,14,11,0,55,0
6740,158088,196_08_04,POLAND,0,TOTALS,POLAND,200,20,66,30.3,14,48,29.2,6,18,33.3,10,16,62.5,15,19,34,3,20,22,13,4,56,0
6741,158101,196_08_04,LATVIA,0,TOTALS,LATVIA,200,30,58,51.7,24,37,64.9,6,21,28.6,8,14,57.1,8,26,34,8,17,22,9,2,74,1
6742,158114,196_08_05,HUNGARY,0,TOTALS,HUNGARY,200,22,66,33.3,20,54,37.0,2,12,16.7,3,11,27.3,15,25,40,6,22,13,6,2,49,0
6743,158127,196_08_05,UKRAINE,0,TOTALS,UKRAINE,200,25,53,47.2,21,41,51.2,4,12,33.3,14,26,53.8,9,28,37,11,10,15,9,8,68,1
6744,158140,196_08_06,RUSSIA,0,TOTALS,RUSSIA,200,24,58,41.4,19,40,47.5,5,18,27.8,10,22,45.5,11,20,31,2,21,13,8,1,63,1
6745,158153,196_08_06,FRANCE,0,TOTALS,FRANCE,200,16,56,28.6,8,33,24.2,8,23,34.8,15,24,62.5,20,21,41,3,22,20,4,2,55,0
6746,158166,196_08_07,ITALY,0,TOTALS,ITALY,200,22,67,32.8,19,48,39.6,3,19,15.8,15,24,62.5,14,17,31,7,25,8,16,1,62,0
6747,158179,196_08_07,SERBIA,0,TOTALS,SERBIA,200,24,57,42.1,19,45,42.2,5,12,41.7,17,29,58.6,19,32,51,3,19,21,3,2,70,1
6748,158192,196_08_08,CROATIA,0,TOTALS,CROATIA,200,24,62,38.7,19,35,54.3,5,27,18.5,10,13,76.9,6,23,29,1,25,10,3,4,63,0
6749,158205,196_08_08,TURKEY,0,TOTALS,TURKEY,200,32,70,45.7,25,44,56.8,7,26,26.9,12,28,42.9,17,31,48,6,18,9,6,2,83,1
6750,158218,196_08_09,SPAIN,0,TOTALS,SPAIN,200,39,74,52.7,33,54,61.1,6,20,30.0,15,31,48.4,14,23,37,8,15,7,14,5,99,1
6751,158231,196_08_09,HUNGARY,0,TOTALS,HUNGARY,200,20,57,35.1,18,47,38.3,2,10,20.0,6,16,37.5,15,21,36,5,26,20,3,0,48,0
6752,158244,196_08_10,ISRAEL,0,TOTALS,ISRAEL,200,15,55,27.3,14,44,31.8,1,11,9.1,13,26,50.0,15,23,38,1,28,20,13,2,44,0
6753,158257,196_08_10,RUSSIA,0,TOTALS,RUSSIA,200,26,60,43.3,17,34,50.0,9,26,34.6,15,34,44.1,19,31,50,2,22,22,4,0,76,1
6754,158270,196_08_11,SERBIA,0,TOTALS,SERBIA,200,15,51,29.4,11,37,29.7,4,14,28.6,18,24,75.0,11,25,36,2,20,14,4,0,52,0
6755,158283,196_08_11,CZECH REPUBLIC,0,TOTALS,CZECH REPUBLIC,200,22,58,37.9,18,39,46.2,4,19,21.1,9,17,52.9,9,23,32,8,22,9,3,1,57,1
6756,158296,196_08_12,TURKEY,0,TOTALS,TURKEY,200,23,60,38.3,19,42,45.2,4,18,22.2,9,14,64.3,9,35,44,5,14,15,3,2,59,0
6757,158309,196_08_12,POLAND,0,TOTALS,POLAND,200,24,67,35.8,18,46,39.1,6,21,28.6,6,10,60.0,8,30,38,8,17,10,6,0,60,1
6758,158322,196_08_13,UKRAINE,0,TOTALS,UKRAINE,200,24,68,35.3,20,53,37.7,4,15,26.7,11,17,64.7,14,19,33,3,23,16,10,2,63,0
6759,158335,196_08_13,LITHUANIA,0,TOTALS,LITHUANIA,200,28,55,50.9,22,40,55.0,6,15,40.0,16,35,45.7,14,28,42,5,19,19,11,2,78,1
6760,158348,196_08_14,LATVIA,0,TOTALS,LATVIA,200,23,65,35.4,15,36,41.7,8,29,27.6,21,26,80.8,12,17,29,4,21,19,8,2,75,0
6761,158361,196_08_14,CROATIA,0,TOTALS,CROATIA,200,38,65,58.5,30,47,63.8,8,18,44.4,13,19,68.4,10,32,42,4,23,21,5,0,97,1
6762,158374,196_08_15,GREECE,0,TOTALS,GREECE,200,25,48,52.1,17,27,63.0,8,21,38.1,16,24,66.7,2,27,29,6,23,21,6,3,74,1
6763,158387,196_08_15,ITALY,0,TOTALS,ITALY,200,24,68,35.3,16,44,36.4,8,24,33.3,16,27,59.3,23,22,45,2,23,13,12,2,72,0
6764,158400,196_08_16,FRANCE,0,TOTALS,FRANCE,200,22,58,37.9,17,35,48.6,5,23,21.7,20,33,60.6,18,29,47,8,26,21,7,0,69,1
6765,158413,196_08_16,GEORGIA,0,TOTALS,GEORGIA,200,13,48,27.1,7,24,29.2,6,24,25.0,15,26,57.7,10,19,29,0,23,22,9,0,47,0
6766,158426,196_08_17,LITHUANIA,0,TOTALS,LITHUANIA,200,32,58,55.2,25,38,65.8,7,20,35.0,15,25,60.0,15,33,48,4,21,22,9,5,86,1
6767,158439,196_08_17,HUNGARY,0,TOTALS,HUNGARY,200,20,52,38.5,14,40,35.0,6,12,50.0,2,10,20.0,7,12,19,2,20,15,7,1,48,0
6768,158452,196_08_18,LATVIA,0,TOTALS,LATVIA,200,22,57,38.6,18,42,42.9,4,15,26.7,15,24,62.5,10,25,35,4,23,18,9,0,63,0
6769,158465,196_08_18,TURKEY,0,TOTALS,TURKEY,200,27,58,46.6,20,35,57.1,7,23,30.4,13,27,48.1,12,28,40,10,23,18,8,2,74,1
6770,158478,196_08_19,GREECE,0,TOTALS,GREECE,200,28,62,45.2,21,40,52.5,7,22,31.8,10,14,71.4,6,23,29,7,27,7,7,1,73,0
6771,158491,196_08_19,SERBIA,0,TOTALS,SERBIA,200,26,65,40.0,20,47,42.6,6,18,33.3,19,31,61.3,16,30,46,2,16,11,3,3,77,1
6772,158504,196_08_20,ISRAEL,0,TOTALS,ISRAEL,200,18,51,35.3,10,31,32.3,8,20,40.0,19,26,73.1,5,17,22,6,23,16,7,0,63,0
6773,158517,196_08_20,FRANCE,0,TOTALS,FRANCE,200,22,54,40.7,17,29,58.6,5,25,20.0,18,25,72.0,14,31,45,7,21,22,3,2,67,1
6774,158530,196_08_21,UKRAINE,0,TOTALS,UKRAINE,200,21,56,37.5,13,42,31.0,8,14,57.1,6,13,46.2,13,31,44,2,20,33,5,2,56,0
6775,158543,196_08_21,SPAIN,0,TOTALS,SPAIN,200,36,81,44.4,31,67,46.3,5,14,35.7,5,16,31.2,17,21,38,14,17,11,23,4,82,1
6776,158556,196_08_22,RUSSIA,0,TOTALS,RUSSIA,200,24,57,42.1,21,36,58.3,3,21,14.3,18,39,46.2,16,31,47,5,24,20,8,4,69,1
6777,158569,196_08_22,GEORGIA,0,TOTALS,GEORGIA,200,20,56,35.7,15,38,39.5,5,18,27.8,15,28,53.6,8,25,33,3,31,20,6,1,60,0
6778,158582,196_08_23,ITALY,0,TOTALS,ITALY,200,19,57,33.3,14,42,33.3,5,15,33.3,14,20,70.0,7,24,31,3,23,16,10,1,57,0
6779,158595,196_08_23,CZECH REPUBLIC,0,TOTALS,CZECH REPUBLIC,200,19,50,38.0,15,34,44.1,4,16,25.0,16,30,53.3,11,31,42,4,26,23,8,1,58,1
6780,158608,196_08_24,CROATIA,0,TOTALS,CROATIA,200,22,58,37.9,19,45,42.2,3,13,23.1,16,21,76.2,12,32,44,5,22,16,5,2,63,1
6781,158621,196_08_24,POLAND,0,TOTALS,POLAND,200,19,67,28.4,12,34,35.3,7,33,21.2,9,20,45.0,15,28,43,2,24,12,6,3,54,0
6782,158634,196_08_25,FRANCE,0,TOTALS,FRANCE,200,25,62,40.3,21,43,48.8,4,19,21.1,10,11,90.9,10,37,47,6,8,12,5,2,64,1
6783,158647,196_08_25,CROATIA,0,TOTALS,CROATIA,200,16,64,25.0,11,38,28.9,5,26,19.2,4,4,100.0,9,24,33,5,17,13,5,0,41,0
6784,158660,196_08_26,ITALY,0,TOTALS,ITALY,200,39,76,51.3,34,56,60.7,5,20,25.0,21,26,80.8,15,27,42,8,20,14,20,4,104,0
6785,158673,196_08_26,GEORGIA,0,TOTALS,GEORGIA,200,17,53,32.1,11,29,37.9,6,24,25.0,9,17,52.9,9,19,28,2,21,30,4,2,49,1
6786,158686,196_08_27,SPAIN,0,TOTALS,SPAIN,200,19,69,27.5,17,55,30.9,2,14,14.3,10,19,52.6,14,24,38,4,20,13,12,7,50,1
6787,158699,196_08_27,SERBIA,0,TOTALS,SERBIA,200,15,56,26.8,13,43,30.2,2,13,15.4,16,22,72.7,17,34,51,0,18,25,5,1,48,0
6788,158712,196_08_28,GREECE,0,TOTALS,GREECE,200,27,71,38.0,23,52,44.2,4,19,21.1,9,17,52.9,8,13,21,8,22,11,9,3,67,0
6789,158725,196_08_28,LITHUANIA,0,TOTALS,LITHUANIA,200,35,75,46.7,27,52,51.9,8,23,34.8,19,23,82.6,23,38,61,9,22,17,6,3,97,1
6790,158738,196_08_29,LATVIA,0,TOTALS,LATVIA,200,26,70,37.1,17,44,38.6,9,26,34.6,11,22,50.0,10,25,35,3,22,16,9,4,72,0
6791,158751,196_08_29,RUSSIA,0,TOTALS,RUSSIA,200,27,58,46.6,22,39,56.4,5,19,26.3,15,26,57.7,10,38,48,3,22,22,10,4,74,1
6792,158764,196_08_30,HUNGARY,0,TOTALS,HUNGARY,200,27,58,46.6,24,50,48.0,3,8,37.5,11,18,61.1,12,26,38,9,24,28,5,3,68,0
6793,158777,196_08_30,POLAND,0,TOTALS,POLAND,200,35,67,52.2,24,45,53.3,11,22,50.0,14,22,63.6,10,19,29,6,17,13,16,5,95,1
6794,158790,196_08_31,UKRAINE,0,TOTALS,UKRAINE,200,17,58,29.3,14,45,31.1,3,13,23.1,12,23,52.2,8,24,32,0,15,20,8,0,49,0
6795,158803,196_08_31,CZECH REPUBLIC,0,TOTALS,CZECH REPUBLIC,200,28,60,46.7,24,47,51.1,4,13,30.8,12,20,60.0,13,34,47,14,21,21,10,0,72,1
6796,158816,196_08_32,ISRAEL,0,TOTALS,ISRAEL,200,26,64,40.6,24,52,46.2,2,12,16.7,1,6,16.7,13,28,41,9,18,22,7,0,55,0
6797,158829,196_08_32,TURKEY,0,TOTALS,TURKEY,200,29,65,44.6,20,39,51.3,9,26,34.6,5,15,33.3,10,27,37,9,12,13,7,8,72,1
6798,158842,196_08_33,UKRAINE,0,TOTALS,UKRAINE,200,21,57,36.8,17,44,38.6,4,13,30.8,15,31,48.4,13,36,49,2,17,26,6,3,61,0
6799,158855,196_08_33,GREECE,0,TOTALS,GREECE,200,38,86,44.2,30,68,44.1,8,18,44.4,6,15,40.0,11,27,38,8,25,9,18,3,90,1
6800,158868,196_08_34,ISRAEL,0,TOTALS,ISRAEL,200,27,64,42.2,19,53,35.8,8,11,72.7,21,24,87.5,5,24,29,6,26,11,12,2,83,1
6801,158881,196_08_34,LATVIA,0,TOTALS,LATVIA,200,25,59,42.4,19,37,51.4,6,22,27.3,17,28,60.7,12,33,45,8,21,19,5,2,73,0
6802,158894,196_08_35,SERBIA,0,TOTALS,SERBIA,200,18,66,27.3,16,48,33.3,2,18,11.1,14,15,93.3,11,21,32,8,20,10,4,5,52,0
6803,158907,196_08_35,LITHUANIA,0,TOTALS,LITHUANIA,200,22,61,36.1,20,43,46.5,2,18,11.1,20,32,62.5,11,34,45,3,18,11,6,6,66,1
6804,158920,196_08_36,CROATIA,0,TOTALS,CROATIA,200,23,52,44.2,18,37,48.6,5,15,33.3,11,16,68.8,6,27,33,1,31,18,9,3,62,0
6805,158933,196_08_36,RUSSIA,0,TOTALS,RUSSIA,200,23,55,41.8,16,35,45.7,7,20,35.0,22,41,53.7,14,25,39,2,13,16,9,0,75,1
6806,158946,196_08_37,CZECH REPUBLIC,0,TOTALS,CZECH REPUBLIC,200,23,61,37.7,15,37,40.5,8,24,33.3,12,22,54.5,12,29,41,4,16,14,8,0,66,1
6807,158959,196_08_37,SPAIN,0,TOTALS,SPAIN,200,25,65,38.5,21,44,47.7,4,21,19.0,7,21,33.3,13,27,40,5,19,12,6,4,61,0
6808,158972,196_08_38,TURKEY,0,TOTALS,TURKEY,200,23,59,39.0,17,35,48.6,6,24,25.0,8,12,66.7,6,24,30,7,21,16,9,1,60,0
6809,158985,196_08_38,FRANCE,0,TOTALS,FRANCE,200,25,61,41.0,21,50,42.0,4,11,36.4,13,16,81.2,10,29,39,8,16,15,7,0,67,1
6810,158998,196_08_39,SPAIN,0,TOTALS,SPAIN,200,27,63,42.9,18,42,42.9,9,21,42.9,6,19,31.6,8,29,37,5,18,22,16,4,69,1
6811,159011,196_08_39,GREECE,0,TOTALS,GREECE,200,25,70,35.7,23,55,41.8,2,15,13.3,13,20,65.0,15,33,48,8,18,25,15,3,65,0
6812,159024,196_08_40,FRANCE,0,TOTALS,FRANCE,200,32,69,46.4,28,55,50.9,4,14,28.6,20,30,66.7,16,34,50,7,11,12,10,3,88,1
6813,159037,196_08_40,LATVIA,0,TOTALS,LATVIA,200,26,69,37.7,17,41,41.5,9,28,32.1,4,5,80.0,10,23,33,1,27,16,8,1,65,0
6814,159050,196_08_41,POLAND,0,TOTALS,POLAND,200,21,58,36.2,20,38,52.6,1,20,5.0,18,30,60.0,13,24,37,4,20,24,10,2,61,0
6815,159063,196_08_41,ITALY,0,TOTALS,ITALY,200,34,72,47.2,25,54,46.3,9,18,50.0,12,23,52.2,16,23,39,10,27,16,13,4,89,1
6816,159076,196_08_42,SERBIA,0,TOTALS,SERBIA,200,30,62,48.4,28,53,52.8,2,9,22.2,18,26,69.2,15,30,45,10,21,20,4,3,80,1
6817,159089,196_08_42,UKRAINE,0,TOTALS,UKRAINE,200,20,56,35.7,18,42,42.9,2,14,14.3,15,29,51.7,7,15,22,6,23,11,6,5,57,0
6818,159102,196_08_43,ISRAEL,0,TOTALS,ISRAEL,200,22,58,37.9,17,38,44.7,5,20,25.0,11,17,64.7,6,27,33,7,24,20,9,3,60,0
6819,159115,196_08_43,CROATIA,0,TOTALS,CROATIA,200,25,69,36.2,16,46,34.8,9,23,39.1,19,28,67.9,17,33,50,2,17,15,7,1,78,1
6820,159128,196_08_44,GEORGIA,0,TOTALS,GEORGIA,200,20,75,26.7,14,49,28.6,6,26,23.1,14,20,70.0,20,23,43,3,27,11,10,3,60,0
6821,159141,196_08_44,HUNGARY,0,TOTALS,HUNGARY,200,29,62,46.8,23,49,46.9,6,13,46.2,17,29,58.6,11,37,48,7,21,17,4,6,81,1
6822,159154,196_08_45,LITHUANIA,0,TOTALS,LITHUANIA,200,28,57,49.1,23,42,54.8,5,15,33.3,15,35,42.9,16,38,54,9,19,24,5,8,76,1
6823,159167,196_08_45,CZECH REPUBLIC,0,TOTALS,CZECH REPUBLIC,200,17,67,25.4,11,47,23.4,6,20,30.0,8,16,50.0,12,17,29,2,30,13,14,6,48,0
6824,159180,196_08_46,RUSSIA,0,TOTALS,RUSSIA,200,22,64,34.4,19,51,37.3,3,13,23.1,8,14,57.1,16,18,34,3,28,19,8,2,55,0
6825,159193,196_08_46,TURKEY,0,TOTALS,TURKEY,200,22,51,43.1,19,38,50.0,3,13,23.1,20,37,54.1,12,25,37,4,17,18,10,5,67,1
6826,159206,196_08_47,GREECE,0,TOTALS,GREECE,200,31,64,48.4,27,49,55.1,4,15,26.7,14,19,73.7,4,24,28,8,23,15,8,4,80,0
6827,159219,196_08_47,LATVIA,0,TOTALS,LATVIA,200,29,66,43.9,23,42,54.8,6,24,25.0,18,31,58.1,16,25,41,5,17,19,9,1,82,1
6828,159232,196_08_48,SPAIN,0,TOTALS,SPAIN,200,20,60,33.3,17,48,35.4,3,12,25.0,19,33,57.6,13,33,46,5,16,16,12,2,62,1
6829,159245,196_08_48,CROATIA,0,TOTALS,CROATIA,200,21,56,37.5,16,41,39.0,5,15,33.3,9,16,56.2,5,30,35,3,25,15,8,2,56,0
6830,159258,196_08_49,ISRAEL,0,TOTALS,ISRAEL,200,26,74,35.1,19,51,37.3,7,23,30.4,4,9,44.4,13,25,38,7,29,17,9,2,63,0
6831,159271,196_08_49,UKRAINE,0,TOTALS,UKRAINE,200,24,63,38.1,19,48,39.6,5,15,33.3,25,40,62.5,18,34,52,4,10,18,7,5,78,1
6832,159284,196_08_50,RUSSIA,0,TOTALS,RUSSIA,200,21,59,35.6,19,45,42.2,2,14,14.3,10,19,52.6,8,26,34,3,29,20,5,2,54,0
6833,159297,196_08_50,SERBIA,0,TOTALS,SERBIA,200,17,49,34.7,15,37,40.5,2,12,16.7,27,38,71.1,10,30,40,6,22,16,10,4,63,1
6834,159310,196_08_51,ITALY,0,TOTALS,ITALY,200,37,74,50.0,32,57,56.1,5,17,29.4,19,31,61.3,14,40,54,8,22,19,13,0,98,1
6835,159323,196_08_51,HUNGARY,0,TOTALS,HUNGARY,200,27,65,41.5,25,54,46.3,2,11,18.2,11,24,45.8,5,26,31,6,25,19,8,1,67,0
6836,159336,196_08_52,TURKEY,0,TOTALS,TURKEY,225,28,64,43.8,25,49,51.0,3,15,20.0,5,16,31.2,10,25,35,2,19,13,3,1,64,0
6837,159349,196_08_52,CZECH REPUBLIC,0,TOTALS,CZECH REPUBLIC,225,25,63,39.7,20,41,48.8,5,22,22.7,14,17,82.4,8,28,36,5,19,17,6,3,69,1
6838,159362,196_08_53,POLAND,0,TOTALS,POLAND,200,31,67,46.3,25,48,52.1,6,19,31.6,18,28,64.3,18,32,50,3,20,16,11,2,86,1
6839,159375,196_08_53,GEORGIA,0,TOTALS,GEORGIA,200,21,68,30.9,14,37,37.8,7,31,22.6,8,15,53.3,15,21,36,1,18,21,10,1,57,0
6840,159388,196_08_54,LITHUANIA,0,TOTALS,LITHUANIA,200,25,58,43.1,19,32,59.4,6,26,23.1,17,34,50.0,15,34,49,5,17,24,18,5,73,1
6841,159401,196_08_54,FRANCE,0,TOTALS,FRANCE,200,18,68,26.5,13,42,31.0,5,26,19.2,6,8,75.0,12,22,34,5,25,22,8,3,47,0
6842,159414,196_08_55,GREECE,0,TOTALS,GREECE,200,25,60,41.7,21,42,50.0,4,18,22.2,11,20,55.0,9,23,32,8,9,17,11,6,65,0
6843,159427,196_08_55,ISRAEL,0,TOTALS,ISRAEL,200,28,67,41.8,23,50,46.0,5,17,29.4,6,11,54.5,12,23,35,13,19,15,9,2,67,1
6844,159440,196_08_56,CROATIA,0,TOTALS,CROATIA,200,27,55,49.1,18,37,48.6,9,18,50.0,20,28,71.4,4,22,26,0,28,12,5,1,83,1
6845,159453,196_08_56,RUSSIA,0,TOTALS,RUSSIA,200,25,56,44.6,15,34,44.1,10,22,45.5,17,28,60.7,9,26,35,1,24,12,5,1,77,0
6846,159466,196_08_57,LATVIA,0,TOTALS,LATVIA,200,26,80,32.5,18,47,38.3,8,33,24.2,8,17,47.1,19,26,45,5,26,16,11,5,68,0
6847,159479,196_08_57,UKRAINE,0,TOTALS,UKRAINE,200,25,64,39.1,19,43,44.2,6,21,28.6,17,33,51.5,13,30,43,5,17,21,9,4,73,1
6848,159492,196_08_58,SPAIN,0,TOTALS,SPAIN,200,22,64,34.4,21,49,42.9,1,15,6.7,11,21,52.4,16,24,40,5,26,13,8,2,56,0
6849,159505,196_08_58,SERBIA,0,TOTALS,SERBIA,200,20,51,39.2,14,37,37.8,6,14,42.9,14,25,56.0,10,26,36,2,23,16,1,1,60,1
6850,159518,196_08_59,FRANCE,0,TOTALS,FRANCE,200,26,63,41.3,22,44,50.0,4,19,21.1,9,12,75.0,9,18,27,7,18,11,8,1,65,0
6851,159531,196_08_59,TURKEY,0,TOTALS,TURKEY,200,27,59,45.8,19,34,55.9,8,25,32.0,15,18,83.3,12,27,39,3,18,14,6,3,77,1
6852,159544,196_08_60,LITHUANIA,0,TOTALS,LITHUANIA,200,27,55,49.1,19,36,52.8,8,19,42.1,13,19,68.4,12,32,44,4,18,26,14,6,75,1
6853,159557,196_08_60,CZECH REPUBLIC,0,TOTALS,CZECH REPUBLIC,200,10,52,19.2,8,39,20.5,2,13,15.4,11,20,55.0,7,13,20,3,18,23,10,1,33,0
6854,159570,197_08_01,BELGIUM,0,TOTALS,BELGIUM,200,19,49,38.8,16,36,44.4,3,13,23.1,9,15,60.0,5,17,22,7,22,18,3,1,50,0
6855,159583,197_08_01,GERMANY,0,TOTALS,GERMANY,200,31,58,53.4,24,38,63.2,7,20,35.0,15,24,62.5,9,20,29,10,14,13,11,2,84,1
6856,159596,197_08_02,PORTUGAL,0,TOTALS,PORTUGAL,200,25,69,36.2,20,49,40.8,5,20,25.0,17,30,56.7,12,30,42,5,20,21,11,1,72,0
6857,159609,197_08_02,SWEDEN,0,TOTALS,SWEDEN,200,28,70,40.0,19,45,42.2,9,25,36.0,14,24,58.3,16,32,48,12,26,28,14,3,79,1
6858,159622,197_08_03,CYPRUS,0,TOTALS,CYPRUS,200,13,52,25.0,11,37,29.7,2,15,13.3,11,17,64.7,5,18,23,4,30,29,9,0,39,0
6859,159635,197_08_03,BULGARIA,0,TOTALS,BULGARIA,200,33,60,55.0,27,43,62.8,6,17,35.3,22,37,59.5,8,25,33,14,19,19,21,3,94,1
6860,159648,197_08_04,SLOVAK REPUBLIC,0,TOTALS,SLOVAK REPUBLIC,200,19,59,32.2,12,40,30.0,7,19,36.8,15,26,57.7,10,23,33,6,14,20,6,1,60,0
6861,159661,197_08_04,ESTONIA,0,TOTALS,ESTONIA,200,37,78,47.4,33,61,54.1,4,17,23.5,4,11,36.4,12,26,38,10,20,15,16,3,82,1
6862,159674,197_08_05,ENGLAND,0,TOTALS,ENGLAND,200,16,51,31.4,11,34,32.4,5,17,29.4,9,13,69.2,13,17,30,7,17,29,10,1,46,0
6863,159687,197_08_05,SLOVENIA,0,TOTALS,SLOVENIA,200,35,70,50.0,33,54,61.1,2,16,12.5,15,21,71.4,17,14,31,18,15,12,20,4,87,1
6864,159700,197_08_06,SWITZERLAND,0,TOTALS,SWITZERLAND,200,38,69,55.1,25,44,56.8,13,25,52.0,16,23,69.6,8,24,32,21,19,23,13,3,105,0
6865,159713,197_08_06,ROMANIA,0,TOTALS,ROMANIA,200,22,67,32.8,20,54,37.0,2,13,15.4,15,22,68.2,6,10,16,5,21,21,9,2,61,1
6866,159726,197_08_07,BELARUS,0,TOTALS,BELARUS,200,35,68,51.5,30,57,52.6,5,11,45.5,16,27,59.3,16,36,52,10,15,17,6,5,91,1
6867,159739,197_08_07,LUXEMBOURG,0,TOTALS,LUXEMBOURG,200,24,75,32.0,20,49,40.8,4,26,15.4,6,19,31.6,17,19,36,1,22,16,9,1,58,0
6868,159752,197_08_08,DENMARK,0,TOTALS,DENMARK,200,22,57,38.6,15,42,35.7,7,15,46.7,6,9,66.7,12,20,32,5,16,36,9,1,57,1
6869,159765,197_08_08,MONTENEGRO,0,TOTALS,MONTENEGRO,200,42,80,52.5,34,54,63.0,8,26,30.8,11,21,52.4,19,20,39,18,16,20,21,8,103,0
6870,159778,197_08_09,ICELAND,0,TOTALS,ICELAND,200,18,63,28.6,14,45,31.1,4,18,22.2,17,22,77.3,10,20,30,7,22,25,13,1,57,0
6871,159791,197_08_09,BOSNIA AND HERZEGOVINA,0,TOTALS,BOSNIA AND HERZEGOVINA,200,34,67,50.7,26,50,52.0,8,17,47.1,17,29,58.6,15,32,47,19,21,24,16,2,93,1
6872,159804,197_08_10,FINLAND,0,TOTALS,FINLAND,200,29,65,44.6,20,41,48.8,9,24,37.5,12,16,75.0,9,26,35,17,14,23,11,4,79,1
6873,159817,197_08_10,IRELAND,0,TOTALS,IRELAND,200,22,70,31.4,18,54,33.3,4,16,25.0,8,13,61.5,8,14,22,5,16,23,17,2,56,0
6874,159830,197_08_11,NETHERLANDS,0,TOTALS,NETHERLANDS,200,28,65,43.1,25,51,49.0,3,14,21.4,5,11,45.5,7,19,26,7,25,14,11,0,64,0
6875,159843,197_08_11,AUSTRIA,0,TOTALS,AUSTRIA,200,24,62,38.7,19,45,42.2,5,17,29.4,13,29,44.8,19,24,43,7,12,20,10,3,66,1
6876,159856,197_08_12,SLOVENIA,0,TOTALS,SLOVENIA,200,30,66,45.5,26,50,52.0,4,16,25.0,14,20,70.0,12,25,37,11,15,15,10,2,78,1
6877,159869,197_08_12,SWITZERLAND,0,TOTALS,SWITZERLAND,200,25,62,40.3,9,30,30.0,16,32,50.0,8,13,61.5,9,19,28,4,22,18,5,4,74,0
6878,159882,197_08_13,MONTENEGRO,0,TOTALS,MONTENEGRO,200,31,82,37.8,28,61,45.9,3,21,14.3,28,38,73.7,22,33,55,10,27,20,15,2,93,1
6879,159895,197_08_13,NETHERLANDS,0,TOTALS,NETHERLANDS,200,25,67,37.3,20,54,37.0,5,13,38.5,20,35,57.1,13,27,40,4,29,23,5,1,75,0
6880,159908,197_08_14,ESTONIA,0,TOTALS,ESTONIA,200,18,57,31.6,13,41,31.7,5,16,31.2,18,26,69.2,13,11,24,5,21,16,13,1,59,0
6881,159921,197_08_14,BELGIUM,0,TOTALS,BELGIUM,200,29,46,63.0,23,36,63.9,6,10,60.0,17,28,60.7,9,24,33,14,21,23,4,7,81,1
6882,159934,197_08_15,MKD,0,TOTALS,MKD,200,26,56,46.4,17,36,47.2,9,20,45.0,27,32,84.4,4,34,38,12,19,16,7,4,88,1
6883,159947,197_08_15,PORTUGAL,0,TOTALS,PORTUGAL,200,18,72,25.0,16,56,28.6,2,16,12.5,19,28,67.9,13,21,34,5,22,13,10,5,57,0
6884,159960,197_08_16,AUSTRIA,0,TOTALS,AUSTRIA,200,21,80,26.2,19,57,33.3,2,23,8.7,14,19,73.7,23,25,48,6,20,24,12,1,58,0
6885,159973,197_08_16,ICELAND,0,TOTALS,ICELAND,200,27,56,48.2,20,43,46.5,7,13,53.8,8,17,47.1,3,26,29,9,19,25,18,2,69,1
6886,159986,197_08_17,LUXEMBOURG,0,TOTALS,LUXEMBOURG,225,32,85,37.6,24,56,42.9,8,29,27.6,15,21,71.4,11,24,35,7,22,15,17,1,87,0
6887,159999,197_08_17,SLOVAK REPUBLIC,0,TOTALS,SLOVAK REPUBLIC,225,34,78,43.6,30,62,48.4,4,16,25.0,18,28,64.3,20,25,45,13,19,20,5,8,90,1
6888,160012,197_08_18,BULGARIA,0,TOTALS,BULGARIA,200,21,54,38.9,18,38,47.4,3,16,18.8,28,38,73.7,17,29,46,5,15,22,15,3,73,1
6889,160025,197_08_18,ENGLAND,0,TOTALS,ENGLAND,200,24,72,33.3,17,54,31.5,7,18,38.9,6,10,60.0,17,18,35,12,29,20,11,0,61,0
6890,160038,197_08_19,BOSNIA AND HERZEGOVINA,0,TOTALS,BOSNIA AND HERZEGOVINA,200,28,78,35.9,23,53,43.4,5,25,20.0,19,34,55.9,27,23,50,12,24,28,23,2,80,1
6891,160051,197_08_19,DENMARK,0,TOTALS,DENMARK,200,15,45,33.3,13,29,44.8,2,16,12.5,15,25,60.0,7,22,29,7,24,43,6,3,47,0
6892,160064,197_08_20,GERMANY,0,TOTALS,GERMANY,200,30,64,46.9,23,41,56.1,7,23,30.4,20,25,80.0,11,36,47,12,25,16,8,7,87,1
6893,160077,197_08_20,BELARUS,0,TOTALS,BELARUS,200,15,66,22.7,15,50,30.0,0,16,0.0,24,33,72.7,14,27,41,6,25,19,7,2,54,0
6894,160090,197_08_21,SWEDEN,0,TOTALS,SWEDEN,200,21,65,32.3,19,56,33.9,2,9,22.2,19,28,67.9,19,29,48,5,15,25,9,4,63,1
6895,160103,197_08_21,FINLAND,0,TOTALS,FINLAND,200,20,68,29.4,11,29,37.9,9,39,23.1,8,17,47.1,10,21,31,9,22,21,11,4,57,0
6896,160116,197_08_22,ROMANIA,0,TOTALS,ROMANIA,200,25,58,43.1,20,41,48.8,5,17,29.4,10,23,43.5,10,25,35,11,20,18,8,2,65,1
6897,160129,197_08_22,CYPRUS,0,TOTALS,CYPRUS,200,22,65,33.8,17,37,45.9,5,28,17.9,7,18,38.9,10,18,28,3,22,17,11,2,56,0
6898,160142,197_08_23,SWITZERLAND,0,TOTALS,SWITZERLAND,200,26,57,45.6,19,30,63.3,7,27,25.9,2,2,100.0,6,29,35,4,26,22,3,4,61,0
6899,160155,197_08_23,BULGARIA,0,TOTALS,BULGARIA,200,20,64,31.2,12,34,35.3,8,30,26.7,19,27,70.4,12,18,30,5,15,11,11,1,67,1
6900,160168,197_08_24,SLOVENIA,0,TOTALS,SLOVENIA,200,28,57,49.1,19,35,54.3,9,22,40.9,26,41,63.4,8,22,30,15,25,24,13,2,91,1
6901,160181,197_08_24,ROMANIA,0,TOTALS,ROMANIA,200,22,61,36.1,17,49,34.7,5,12,41.7,15,27,55.6,15,23,38,7,27,21,12,1,64,0
6902,160194,197_08_25,ICELAND,0,TOTALS,ICELAND,200,25,74,33.8,18,36,50.0,7,38,18.4,1,7,14.3,10,23,33,10,12,13,9,2,58,0
6903,160207,197_08_25,NETHERLANDS,0,TOTALS,NETHERLANDS,200,24,64,37.5,20,48,41.7,4,16,25.0,9,12,75.0,11,32,43,10,15,19,7,1,61,1
6904,160220,197_08_26,BELGIUM,0,TOTALS,BELGIUM,200,35,70,50.0,34,60,56.7,1,10,10.0,10,22,45.5,18,33,51,12,22,16,9,5,81,1
6905,160233,197_08_26,SLOVAK REPUBLIC,0,TOTALS,SLOVAK REPUBLIC,200,20,62,32.3,18,53,34.0,2,9,22.2,9,17,52.9,5,17,22,6,14,18,10,3,51,0
6906,160246,197_08_27,ENGLAND,0,TOTALS,ENGLAND,200,27,54,50.0,20,36,55.6,7,18,38.9,17,30,56.7,13,25,38,14,25,26,16,5,78,1
6907,160259,197_08_27,CYPRUS,0,TOTALS,CYPRUS,200,16,58,27.6,13,44,29.5,3,14,21.4,13,20,65.0,8,13,21,2,23,24,17,0,48,0
6908,160272,197_08_28,BOSNIA AND HERZEGOVINA,0,TOTALS,BOSNIA AND HERZEGOVINA,225,31,71,43.7,23,47,48.9,8,24,33.3,17,29,58.6,17,35,52,14,21,35,14,3,87,0
6909,160285,197_08_28,MONTENEGRO,0,TOTALS,MONTENEGRO,225,35,88,39.8,29,59,49.2,6,29,20.7,14,25,56.0,20,22,42,9,28,25,21,5,90,1
6910,160298,197_08_29,GERMANY,0,TOTALS,GERMANY,200,40,80,50.0,27,42,64.3,13,38,34.2,7,13,53.8,23,35,58,17,8,22,9,4,100,0
6911,160311,197_08_29,LUXEMBOURG,0,TOTALS,LUXEMBOURG,200,16,56,28.6,12,38,31.6,4,18,22.2,3,5,60.0,1,14,15,5,13,20,10,2,39,1
6912,160324,197_08_30,IRELAND,0,TOTALS,IRELAND,200,16,71,22.5,7,40,17.5,9,31,29.0,7,15,46.7,7,20,27,5,19,22,13,0,48,0
6913,160337,197_08_30,SWEDEN,0,TOTALS,SWEDEN,200,31,77,40.3,24,51,47.1,7,26,26.9,11,16,68.8,16,37,53,12,16,21,10,4,80,1
6914,160350,197_08_31,DENMARK,0,TOTALS,DENMARK,200,26,59,44.1,19,42,45.2,7,17,41.2,9,15,60.0,15,19,34,10,24,29,4,4,68,0
6915,160363,197_08_31,AUSTRIA,0,TOTALS,AUSTRIA,200,29,67,43.3,18,43,41.9,11,24,45.8,23,33,69.7,17,17,34,5,16,13,12,1,92,1
6916,160376,197_08_32,BELARUS,0,TOTALS,BELARUS,200,18,65,27.7,15,45,33.3,3,20,15.0,28,33,84.8,13,19,32,5,16,14,13,4,67,0
6917,160389,197_08_32,ESTONIA,0,TOTALS,ESTONIA,200,27,71,38.0,20,49,40.8,7,22,31.8,13,20,65.0,18,26,44,10,25,19,8,6,74,1
6918,160402,197_08_33,FINLAND,0,TOTALS,FINLAND,200,32,66,48.5,17,35,48.6,15,31,48.4,7,9,77.8,11,22,33,16,14,14,9,3,86,1
6919,160415,197_08_33,MKD,0,TOTALS,MKD,200,24,57,42.1,18,39,46.2,6,18,33.3,7,11,63.6,5,22,27,3,11,15,7,2,61,0
6920,160428,197_08_34,LUXEMBOURG,0,TOTALS,LUXEMBOURG,200,12,65,18.5,6,32,18.8,6,33,18.2,4,8,50.0,7,21,28,5,15,12,6,2,34,0
6921,160441,197_08_34,BELGIUM,0,TOTALS,BELGIUM,200,27,77,35.1,16,47,34.0,11,30,36.7,10,13,76.9,21,36,57,7,14,12,4,7,75,1
6922,160454,197_08_35,SLOVAK REPUBLIC,0,TOTALS,SLOVAK REPUBLIC,200,27,75,36.0,24,63,38.1,3,12,25.0,4,5,80.0,7,22,29,3,15,15,8,8,61,0
6923,160467,197_08_35,BELARUS,0,TOTALS,BELARUS,200,30,81,37.0,23,63,36.5,7,18,38.9,14,19,73.7,18,33,51,4,8,12,10,8,81,1
6924,160480,197_08_36,ROMANIA,0,TOTALS,ROMANIA,200,12,65,18.5,8,35,22.9,4,30,13.3,7,11,63.6,14,19,33,3,10,19,6,3,35,0
6925,160493,197_08_36,ENGLAND,0,TOTALS,ENGLAND,200,30,68,44.1,27,53,50.9,3,15,20.0,2,7,28.6,21,37,58,14,11,21,7,1,65,1
6926,160506,197_08_37,MONTENEGRO,0,TOTALS,MONTENEGRO,200,31,65,47.7,24,44,54.5,7,21,33.3,16,26,61.5,12,25,37,10,16,25,17,4,85,1
6927,160519,197_08_37,ICELAND,0,TOTALS,ICELAND,200,30,71,42.3,26,46,56.5,4,25,16.0,4,6,66.7,12,16,28,15,21,22,14,2,68,0
6928,160532,197_08_38,ESTONIA,0,TOTALS,ESTONIA,200,15,52,28.8,9,38,23.7,6,14,42.9,15,19,78.9,11,19,30,0,17,26,6,4,51,0
6929,160545,197_08_38,GERMANY,0,TOTALS,GERMANY,200,24,56,42.9,16,36,44.4,8,20,40.0,16,22,72.7,9,18,27,5,15,18,14,6,72,1
6930,160558,197_08_39,BULGARIA,0,TOTALS,BULGARIA,200,23,60,38.3,10,27,37.0,13,33,39.4,11,18,61.1,19,23,42,9,25,24,4,1,70,0
6931,160571,197_08_39,SLOVENIA,0,TOTALS,SLOVENIA,200,27,56,48.2,21,33,63.6,6,23,26.1,19,27,70.4,6,20,26,14,23,18,13,3,79,1
6932,160584,197_08_40,AUSTRIA,0,TOTALS,AUSTRIA,200,31,64,48.4,25,43,58.1,6,21,28.6,12,17,70.6,9,22,31,12,19,23,14,5,80,0
6933,160597,197_08_40,BOSNIA AND HERZEGOVINA,0,TOTALS,BOSNIA AND HERZEGOVINA,200,33,76,43.4,26,59,44.1,7,17,41.2,13,23,56.5,18,23,41,12,18,19,12,3,86,1
6934,160610,197_08_41,PORTUGAL,0,TOTALS,PORTUGAL,200,13,63,20.6,13,55,23.6,0,8,0.0,17,33,51.5,18,12,30,4,19,19,15,3,43,0
6935,160623,197_08_41,FINLAND,0,TOTALS,FINLAND,200,25,50,50.0,17,33,51.5,8,17,47.1,11,21,52.4,8,31,39,6,26,31,6,4,69,1
6936,160636,197_08_42,CYPRUS,0,TOTALS,CYPRUS,200,15,51,29.4,10,37,27.0,5,14,35.7,5,17,29.4,7,18,25,5,21,23,13,1,40,0
6937,160649,197_08_42,SWITZERLAND,0,TOTALS,SWITZERLAND,200,19,54,35.2,13,35,37.1,6,19,31.6,19,31,61.3,18,33,51,10,19,24,11,3,63,1
6938,160662,197_08_43,NETHERLANDS,0,TOTALS,NETHERLANDS,200,23,73,31.5,17,49,34.7,6,24,25.0,15,25,60.0,13,8,21,7,19,13,13,1,67,0
6939,160675,197_08_43,DENMARK,0,TOTALS,DENMARK,200,33,60,55.0,28,47,59.6,5,13,38.5,13,19,68.4,12,33,45,10,20,25,4,5,84,1
6940,160688,197_08_44,MKD,0,TOTALS,MKD,200,34,68,50.0,28,49,57.1,6,19,31.6,5,10,50.0,9,30,39,14,17,16,4,3,79,1
6941,160701,197_08_44,IRELAND,0,TOTALS,IRELAND,200,20,71,28.2,15,40,37.5,5,31,16.1,13,19,68.4,7,20,27,5,20,13,7,0,58,0
6942,160714,197_08_45,GERMANY,0,TOTALS,GERMANY,200,39,68,57.4,33,58,56.9,6,10,60.0,12,22,54.5,12,21,33,18,6,16,18,5,96,1
6943,160727,197_08_45,SLOVAK REPUBLIC,0,TOTALS,SLOVAK REPUBLIC,200,23,56,41.1,14,38,36.8,9,18,50.0,1,2,50.0,5,13,18,8,20,26,9,4,56,0
6944,160740,197_08_46,BELARUS,0,TOTALS,BELARUS,200,25,69,36.2,19,46,41.3,6,23,26.1,10,16,62.5,11,20,31,5,18,18,7,5,66,1
6945,160753,197_08_46,BELGIUM,0,TOTALS,BELGIUM,200,16,61,26.2,13,51,25.5,3,10,30.0,16,20,80.0,11,19,30,4,19,17,5,8,51,0
6946,160766,197_08_47,ESTONIA,0,TOTALS,ESTONIA,200,36,80,45.0,28,53,52.8,8,27,29.6,9,20,45.0,21,24,45,13,19,18,27,1,89,1
6947,160779,197_08_47,LUXEMBOURG,0,TOTALS,LUXEMBOURG,200,18,44,40.9,15,28,53.6,3,16,18.8,8,15,53.3,3,22,25,7,18,38,11,1,47,0
6948,160792,197_08_48,SLOVENIA,0,TOTALS,SLOVENIA,200,24,52,46.2,18,32,56.2,6,20,30.0,22,29,75.9,12,24,36,10,20,26,11,4,76,1
6949,160805,197_08_48,CYPRUS,0,TOTALS,CYPRUS,200,17,51,33.3,10,36,27.8,7,15,46.7,16,19,84.2,5,14,19,6,20,29,18,0,57,0
6950,160818,197_08_49,BOSNIA AND HERZEGOVINA,0,TOTALS,BOSNIA AND HERZEGOVINA,200,34,67,50.7,29,53,54.7,5,14,35.7,19,37,51.4,15,28,43,13,25,28,11,9,92,1
6951,160831,197_08_49,NETHERLANDS,0,TOTALS,NETHERLANDS,200,25,69,36.2,21,48,43.8,4,21,19.0,12,24,50.0,12,10,22,4,29,24,14,2,66,0
6952,160844,197_08_50,BULGARIA,0,TOTALS,BULGARIA,200,35,55,63.6,28,41,68.3,7,14,50.0,12,22,54.5,6,30,36,19,10,25,13,4,89,1
6953,160857,197_08_50,ROMANIA,0,TOTALS,ROMANIA,200,30,72,41.7,27,61,44.3,3,11,27.3,4,6,66.7,9,16,25,10,16,20,17,0,67,0
6954,160870,197_08_51,IRELAND,0,TOTALS,IRELAND,200,21,59,35.6,21,45,46.7,0,14,0.0,15,23,65.2,13,23,36,5,21,23,9,3,57,0
6955,160883,197_08_51,PORTUGAL,0,TOTALS,PORTUGAL,200,27,70,38.6,24,62,38.7,3,8,37.5,9,23,39.1,21,19,40,11,20,21,8,3,66,1
6956,160896,197_08_52,DENMARK,0,TOTALS,DENMARK,200,18,57,31.6,15,39,38.5,3,18,16.7,13,20,65.0,11,30,41,8,9,17,4,7,52,0
6957,160909,197_08_52,ICELAND,0,TOTALS,ICELAND,200,29,77,37.7,18,43,41.9,11,34,32.4,7,8,87.5,9,21,30,12,13,10,10,1,76,1
6958,160922,197_08_53,SWEDEN,0,TOTALS,SWEDEN,200,32,65,49.2,28,48,58.3,4,17,23.5,11,15,73.3,13,28,41,11,14,13,9,2,79,1
6959,160935,197_08_53,MKD,0,TOTALS,MKD,200,22,53,41.5,15,34,44.1,7,19,36.8,11,13,84.6,2,17,19,7,16,16,3,1,62,0
6960,160948,197_08_54,SWITZERLAND,0,TOTALS,SWITZERLAND,200,23,54,42.6,18,37,48.6,5,17,29.4,14,26,53.8,14,24,38,7,20,27,12,5,65,1
6961,160961,197_08_54,ENGLAND,0,TOTALS,ENGLAND,200,23,62,37.1,18,49,36.7,5,13,38.5,12,23,52.2,11,19,30,8,23,20,16,2,63,0
6962,160974,197_08_55,AUSTRIA,0,TOTALS,AUSTRIA,200,33,62,53.2,25,43,58.1,8,19,42.1,12,18,66.7,7,18,25,9,11,23,7,3,86,1
6963,160987,197_08_55,MONTENEGRO,0,TOTALS,MONTENEGRO,200,43,82,52.4,31,52,59.6,12,30,40.0,6,10,60.0,12,19,31,12,17,17,15,2,104,0
6964,161000,197_08_56,SLOVENIA,0,TOTALS,SLOVENIA,200,19,56,33.9,14,38,36.8,5,18,27.8,22,28,78.6,11,24,35,12,20,14,11,2,65,1
6965,161013,197_08_56,FINLAND,0,TOTALS,FINLAND,200,19,57,33.3,13,31,41.9,6,26,23.1,12,16,75.0,14,27,41,9,23,20,11,3,56,0
6966,161026,197_08_57,BELGIUM,0,TOTALS,BELGIUM,200,31,62,50.0,26,47,55.3,5,15,33.3,5,14,35.7,7,34,41,16,23,14,5,9,72,1
6967,161039,197_08_57,AUSTRIA,0,TOTALS,AUSTRIA,200,20,70,28.6,19,61,31.1,1,9,11.1,16,28,57.1,15,25,40,1,12,7,11,1,57,0
6968,161052,197_08_58,SLOVAK REPUBLIC,0,TOTALS,SLOVAK REPUBLIC,250,36,77,46.8,30,58,51.7,6,19,31.6,19,31,61.3,16,27,43,16,20,38,16,6,97,1
6969,161065,197_08_58,NETHERLANDS,0,TOTALS,NETHERLANDS,250,43,93,46.2,40,83,48.2,3,10,30.0,15,23,65.2,22,30,52,18,19,32,21,2,104,0
6970,161078,197_08_59,BULGARIA,0,TOTALS,BULGARIA,200,25,65,38.5,17,35,48.6,8,30,26.7,8,15,53.3,14,31,45,10,19,21,11,5,66,1
6971,161091,197_08_59,SWEDEN,0,TOTALS,SWEDEN,200,21,65,32.3,19,52,36.5,2,13,15.4,14,24,58.3,15,25,40,2,17,17,13,3,58,0
6972,161104,197_08_60,ESTONIA,0,TOTALS,ESTONIA,200,28,55,50.9,22,39,56.4,6,16,37.5,9,18,50.0,11,45,56,11,16,24,9,7,71,1
6973,161117,197_08_60,ICELAND,0,TOTALS,ICELAND,200,11,63,17.5,11,44,25.0,0,19,0.0,12,18,66.7,8,17,25,3,17,16,10,1,34,0
6974,161130,197_08_61,LUXEMBOURG,0,TOTALS,LUXEMBOURG,200,18,66,27.3,13,43,30.2,5,23,21.7,9,14,64.3,10,19,29,3,16,16,11,0,50,0
6975,161143,197_08_61,DENMARK,0,TOTALS,DENMARK,200,31,72,43.1,27,54,50.0,4,18,22.2,8,22,36.4,29,37,66,8,17,25,7,3,74,1
6976,161156,197_08_62,GERMANY,0,TOTALS,GERMANY,200,37,62,59.7,25,36,69.4,12,26,46.2,20,30,66.7,12,21,33,17,19,12,13,4,106,0
6977,161169,197_08_62,BOSNIA AND HERZEGOVINA,0,TOTALS,BOSNIA AND HERZEGOVINA,200,29,62,46.8,25,50,50.0,4,12,33.3,8,12,66.7,13,17,30,11,23,20,4,0,70,1
6978,161182,197_08_63,SWITZERLAND,0,TOTALS,SWITZERLAND,200,35,66,53.0,28,43,65.1,7,23,30.4,12,17,70.6,13,27,40,15,16,22,15,4,89,1
6979,161195,197_08_63,PORTUGAL,0,TOTALS,PORTUGAL,200,25,57,43.9,21,47,44.7,4,10,40.0,6,12,50.0,6,18,24,14,17,26,9,3,60,0
6980,161208,197_08_64,CYPRUS,0,TOTALS,CYPRUS,200,23,60,38.3,13,33,39.4,10,27,37.0,15,24,62.5,9,28,37,13,21,16,11,0,71,1
6981,161221,197_08_64,IRELAND,0,TOTALS,IRELAND,200,27,65,41.5,21,38,55.3,6,27,22.2,10,24,41.7,13,29,42,9,22,17,4,0,70,0
6982,161234,197_08_65,BELARUS,0,TOTALS,BELARUS,200,28,69,40.6,22,50,44.0,6,19,31.6,18,27,66.7,19,27,46,10,23,25,4,5,80,0
6983,161247,197_08_65,MONTENEGRO,0,TOTALS,MONTENEGRO,200,34,80,42.5,30,65,46.2,4,15,26.7,10,21,47.6,17,23,40,9,23,15,16,3,82,1
6984,161260,197_08_66,ENGLAND,0,TOTALS,ENGLAND,200,33,66,50.0,28,50,56.0,5,16,31.2,16,23,69.6,10,26,36,17,22,11,13,1,87,1
6985,161273,197_08_66,MKD,0,TOTALS,MKD,200,22,55,40.0,17,35,48.6,5,20,25.0,19,23,82.6,8,20,28,11,19,20,5,3,68,0
6986,161286,197_08_67,SWEDEN,0,TOTALS,SWEDEN,200,26,59,44.1,19,39,48.7,7,20,35.0,24,34,70.6,11,33,44,12,30,20,7,3,83,1
6987,161299,197_08_67,SLOVENIA,0,TOTALS,SLOVENIA,200,18,61,29.5,10,29,34.5,8,32,25.0,25,39,64.1,10,23,33,10,23,13,11,2,69,0
6988,161312,197_08_68,ICELAND,0,TOTALS,ICELAND,200,26,61,42.6,19,42,45.2,7,19,36.8,18,22,81.8,8,19,27,6,15,13,16,1,77,1
6989,161325,197_08_68,BELGIUM,0,TOTALS,BELGIUM,200,25,59,42.4,19,40,47.5,6,19,31.6,12,17,70.6,17,27,44,8,19,26,5,3,68,0
6990,161338,197_08_69,DENMARK,0,TOTALS,DENMARK,200,31,67,46.3,27,49,55.1,4,18,22.2,17,23,73.9,14,28,42,11,17,22,13,1,83,1
6991,161351,197_08_69,SLOVAK REPUBLIC,0,TOTALS,SLOVAK REPUBLIC,200,30,64,46.9,23,41,56.1,7,23,30.4,8,15,53.3,5,20,25,8,23,22,11,3,75,0
6992,161364,197_08_70,FINLAND,0,TOTALS,FINLAND,200,28,65,43.1,18,34,52.9,10,31,32.3,8,11,72.7,15,27,42,16,17,18,0,5,74,0
6993,161377,197_08_70,BULGARIA,0,TOTALS,BULGARIA,200,26,70,37.1,19,43,44.2,7,27,25.9,17,21,81.0,14,20,34,12,16,7,10,2,76,1
6994,161390,197_08_71,AUSTRIA,0,TOTALS,AUSTRIA,200,23,58,39.7,17,37,45.9,6,21,28.6,14,23,60.9,18,18,36,5,22,16,4,6,66,0
6995,161403,197_08_71,ESTONIA,0,TOTALS,ESTONIA,200,27,71,38.0,23,48,47.9,4,23,17.4,14,18,77.8,24,20,44,4,21,13,9,1,72,1
6996,161416,197_08_72,NETHERLANDS,0,TOTALS,NETHERLANDS,200,38,68,55.9,31,51,60.8,7,17,41.2,16,28,57.1,16,34,50,12,14,22,13,1,99,1
6997,161429,197_08_72,LUXEMBOURG,0,TOTALS,LUXEMBOURG,200,21,56,37.5,15,32,46.9,6,24,25.0,10,19,52.6,5,15,20,6,20,24,13,1,58,0
6998,161442,197_08_73,MONTENEGRO,0,TOTALS,MONTENEGRO,200,19,52,36.5,16,38,42.1,3,14,21.4,14,20,70.0,10,25,35,8,17,22,9,3,55,0
6999,161455,197_08_73,GERMANY,0,TOTALS,GERMANY,200,25,62,40.3,17,36,47.2,8,26,30.8,12,16,75.0,11,22,33,14,21,15,9,3,70,1
7000,161468,197_08_74,MKD,0,TOTALS,MKD,200,21,54,38.9,17,40,42.5,4,14,28.6,11,14,78.6,6,19,25,9,18,28,6,6,57,1
7001,161481,197_08_74,SWITZERLAND,0,TOTALS,SWITZERLAND,200,38,72,52.8,28,57,49.1,10,15,66.7,18,26,69.2,14,24,38,12,15,12,19,3,104,0
7002,161494,197_08_75,IRELAND,0,TOTALS,IRELAND,200,28,66,42.4,23,47,48.9,5,19,26.3,9,26,34.6,16,20,36,9,20,20,8,5,70,0
7003,161507,197_08_75,ROMANIA,0,TOTALS,ROMANIA,200,30,68,44.1,28,57,49.1,2,11,18.2,13,25,52.0,21,25,46,3,23,23,12,2,75,1
7004,161520,197_08_76,BOSNIA AND HERZEGOVINA,0,TOTALS,BOSNIA AND HERZEGOVINA,200,22,62,35.5,18,49,36.7,4,13,30.8,14,24,58.3,15,25,40,11,20,21,13,5,62,0
7005,161533,197_08_76,BELARUS,0,TOTALS,BELARUS,200,27,71,38.0,21,52,40.4,6,19,31.6,15,19,78.9,18,28,46,10,17,18,7,4,75,1
7006,161546,197_08_77,PORTUGAL,0,TOTALS,PORTUGAL,200,19,60,31.7,17,46,37.0,2,14,14.3,9,16,56.2,12,15,27,10,16,21,8,3,49,0
7007,161559,197_08_77,ENGLAND,0,TOTALS,ENGLAND,200,26,70,37.1,21,56,37.5,5,14,35.7,11,24,45.8,19,24,43,9,15,18,14,2,68,1
7008,161572,197_08_78,ICELAND,0,TOTALS,ICELAND,200,24,61,39.3,19,43,44.2,5,18,27.8,19,23,82.6,10,22,32,10,20,21,14,3,72,1
7009,161585,197_08_78,PORTUGAL,0,TOTALS,PORTUGAL,200,22,56,39.3,16,40,40.0,6,16,37.5,9,18,50.0,10,27,37,11,18,26,12,4,59,0
7010,161598,197_08_79,BELARUS,0,TOTALS,BELARUS,200,29,59,49.2,24,46,52.2,5,13,38.5,14,18,77.8,7,26,33,11,10,15,15,3,77,1
7011,161611,197_08_79,FINLAND,0,TOTALS,FINLAND,200,23,62,37.1,15,33,45.5,8,29,27.6,8,11,72.7,9,25,34,10,14,21,9,5,62,0
7012,161624,197_08_80,IRELAND,0,TOTALS,IRELAND,225,34,85,40.0,30,64,46.9,4,21,19.0,10,21,47.6,18,24,42,13,17,25,20,1,82,0
7013,161637,197_08_80,SLOVAK REPUBLIC,0,TOTALS,SLOVAK REPUBLIC,225,36,74,48.6,30,58,51.7,6,16,37.5,7,11,63.6,12,32,44,13,19,34,13,6,85,1
7014,161650,197_08_81,MKD,0,TOTALS,MKD,200,24,64,37.5,11,33,33.3,13,31,41.9,7,10,70.0,11,23,34,11,20,19,9,7,68,0
7015,161663,197_08_81,AUSTRIA,0,TOTALS,AUSTRIA,200,25,69,36.2,22,51,43.1,3,18,16.7,18,26,69.2,21,26,47,8,13,12,11,3,71,1
7016,161676,197_08_82,SLOVENIA,0,TOTALS,SLOVENIA,200,29,62,46.8,15,32,46.9,14,30,46.7,15,19,78.9,13,20,33,19,19,15,8,5,87,1
7017,161689,197_08_82,BOSNIA AND HERZEGOVINA,0,TOTALS,BOSNIA AND HERZEGOVINA,200,26,54,48.1,22,41,53.7,4,13,30.8,17,25,68.0,9,20,29,13,23,16,9,3,73,0
7018,161702,197_08_83,DENMARK,0,TOTALS,DENMARK,200,23,55,41.8,11,33,33.3,12,22,54.5,17,30,56.7,12,28,40,10,14,16,10,1,75,1
7019,161715,197_08_83,CYPRUS,0,TOTALS,CYPRUS,200,21,56,37.5,16,33,48.5,5,23,21.7,11,18,61.1,6,23,29,6,24,16,10,1,58,0
7020,161728,197_08_84,ESTONIA,0,TOTALS,ESTONIA,200,26,60,43.3,24,46,52.2,2,14,14.3,11,15,73.3,12,25,37,7,16,12,10,7,65,1
7021,161741,197_08_84,ENGLAND,0,TOTALS,ENGLAND,200,13,52,25.0,7,39,17.9,6,13,46.2,14,19,73.7,10,17,27,8,15,16,6,2,46,0
7022,161754,197_08_85,GERMANY,0,TOTALS,GERMANY,200,25,65,38.5,19,45,42.2,6,20,30.0,8,11,72.7,13,27,40,8,12,13,5,3,64,1
7023,161767,197_08_85,BULGARIA,0,TOTALS,BULGARIA,200,21,57,36.8,13,31,41.9,8,26,30.8,11,15,73.3,9,27,36,5,15,15,6,2,61,0
7024,161780,197_08_86,ROMANIA,0,TOTALS,ROMANIA,200,30,74,40.5,24,52,46.2,6,22,27.3,7,15,46.7,19,24,43,13,20,25,11,1,73,0
7025,161793,197_08_86,NETHERLANDS,0,TOTALS,NETHERLANDS,200,28,63,44.4,26,48,54.2,2,15,13.3,20,25,80.0,9,25,34,15,17,22,8,0,78,1
7026,161806,197_08_87,SWITZERLAND,0,TOTALS,SWITZERLAND,200,25,57,43.9,23,41,56.1,2,16,12.5,13,17,76.5,14,17,31,9,15,24,10,0,65,0
7027,161819,197_08_87,BELGIUM,0,TOTALS,BELGIUM,200,27,56,48.2,24,40,60.0,3,16,18.8,11,13,84.6,10,17,27,6,21,21,10,3,68,1
7028,161832,197_08_88,SWEDEN,0,TOTALS,SWEDEN,200,22,63,34.9,21,52,40.4,1,11,9.1,12,21,57.1,14,27,41,6,14,22,7,4,57,0
7029,161845,197_08_88,MONTENEGRO,0,TOTALS,MONTENEGRO,200,25,68,36.8,17,36,47.2,8,32,25.0,9,16,56.2,18,27,45,14,16,20,9,7,67,1
7030,161858,197_08_89,PORTUGAL,0,TOTALS,PORTUGAL,200,33,76,43.4,29,61,47.5,4,15,26.7,6,12,50.0,17,18,35,8,15,10,7,2,76,0
7031,161871,197_08_89,MKD,0,TOTALS,MKD,200,27,57,47.4,19,41,46.3,8,16,50.0,19,23,82.6,12,28,40,3,16,15,6,7,81,1
7032,161884,197_08_90,LUXEMBOURG,0,TOTALS,LUXEMBOURG,200,24,75,32.0,16,41,39.0,8,34,23.5,11,22,50.0,17,30,47,7,23,20,10,0,67,0
7033,161897,197_08_90,IRELAND,0,TOTALS,IRELAND,200,29,75,38.7,23,48,47.9,6,27,22.2,20,33,60.6,17,30,47,15,20,15,13,2,84,1
7034,161910,197_08_91,FINLAND,0,TOTALS,FINLAND,200,24,65,36.9,17,30,56.7,7,35,20.0,13,18,72.2,14,22,36,9,25,18,9,4,68,0
7035,161923,197_08_91,BOSNIA AND HERZEGOVINA,0,TOTALS,BOSNIA AND HERZEGOVINA,200,27,56,48.2,23,49,46.9,4,7,57.1,27,34,79.4,7,25,32,7,19,11,7,1,85,1
7036,161936,197_08_92,ICELAND,0,TOTALS,ICELAND,200,23,54,42.6,15,30,50.0,8,24,33.3,11,14,78.6,7,31,38,4,15,16,13,3,65,1
7037,161949,197_08_92,AUSTRIA,0,TOTALS,AUSTRIA,200,18,62,29.0,16,44,36.4,2,18,11.1,10,17,58.8,14,23,37,2,11,20,10,0,48,0
7038,161962,197_08_93,BELARUS,0,TOTALS,BELARUS,200,24,80,30.0,20,64,31.2,4,16,25.0,4,6,66.7,20,25,45,8,13,28,10,3,56,0
7039,161975,197_08_93,SLOVENIA,0,TOTALS,SLOVENIA,200,34,70,48.6,29,59,49.2,5,11,45.5,11,17,64.7,11,33,44,19,15,23,20,8,84,1
7040,161988,197_08_94,ENGLAND,0,TOTALS,ENGLAND,200,18,50,36.0,13,35,37.1,5,15,33.3,15,26,57.7,8,29,37,3,16,18,9,3,56,1
7041,162001,197_08_94,SWITZERLAND,0,TOTALS,SWITZERLAND,200,18,57,31.6,14,33,42.4,4,24,16.7,13,20,65.0,11,28,39,5,20,15,11,6,53,0
7042,162014,197_08_95,CYPRUS,0,TOTALS,CYPRUS,200,19,60,31.7,14,36,38.9,5,24,20.8,14,22,63.6,13,28,41,9,24,16,11,3,57,0
7043,162027,197_08_95,ROMANIA,0,TOTALS,ROMANIA,200,20,63,31.7,18,43,41.9,2,20,10.0,20,29,69.0,14,30,44,5,18,16,10,2,62,1
7044,162040,197_08_96,BULGARIA,0,TOTALS,BULGARIA,200,26,65,40.0,18,36,50.0,8,29,27.6,21,28,75.0,10,23,33,12,15,16,10,2,81,1
7045,162053,197_08_96,SWEDEN,0,TOTALS,SWEDEN,200,27,72,37.5,23,52,44.2,4,20,20.0,3,5,60.0,13,26,39,9,26,21,7,2,61,0
7046,162066,197_08_97,ESTONIA,0,TOTALS,ESTONIA,200,20,52,38.5,18,46,39.1,2,6,33.3,18,21,85.7,11,12,23,7,15,16,13,3,60,0
7047,162079,197_08_97,BELGIUM,0,TOTALS,BELGIUM,200,23,57,40.4,11,36,30.6,12,21,57.1,10,16,62.5,19,23,42,10,16,28,12,7,68,1
7048,162092,197_08_98,DENMARK,0,TOTALS,DENMARK,200,27,58,46.6,21,39,53.8,6,19,31.6,14,19,73.7,10,26,36,10,17,19,8,1,74,0
7049,162105,197_08_98,NETHERLANDS,0,TOTALS,NETHERLANDS,200,30,66,45.5,28,54,51.9,2,12,16.7,14,26,53.8,14,20,34,10,19,17,11,0,76,1
7050,162118,197_08_99,GERMANY,0,TOTALS,GERMANY,200,27,72,37.5,23,47,48.9,4,25,16.0,18,23,78.3,24,31,55,9,12,20,8,7,76,1
7051,162131,197_08_99,MONTENEGRO,0,TOTALS,MONTENEGRO,200,26,66,39.4,13,31,41.9,13,35,37.1,4,9,44.4,6,22,28,15,21,17,10,4,69,0
7052,162144,198_08_01,MOLDOVA,0,TOTALS,MOLDOVA,200,25,73,34.2,19,50,38.0,6,23,26.1,15,28,53.6,24,34,58,8,12,27,17,13,71,1
7053,162157,198_08_01,ANDORRA,0,TOTALS,ANDORRA,200,25,76,32.9,18,56,32.1,7,20,35.0,4,12,33.3,19,29,48,14,23,29,9,1,61,0
7054,162168,198_08_02,MALTA,0,TOTALS,MALTA,200,6,34,17.6,6,28,21.4,0,6,0.0,8,23,34.8,6,26,32,1,26,52,9,5,20,0
7055,162181,198_08_02,WALES,0,TOTALS,WALES,200,33,86,38.4,31,67,46.3,2,19,10.5,10,26,38.5,35,29,64,18,22,28,26,2,78,1
7056,162194,198_08_03,SCOTLAND,0,TOTALS,SCOTLAND,200,39,72,54.2,38,64,59.4,1,8,12.5,4,13,30.8,19,23,42,26,13,13,18,3,83,1
7057,162205,198_08_03,PRINCIPALITY OF MONACO,0,TOTALS,PRINCIPALITY OF MONACO,200,10,36,27.8,6,22,27.3,4,14,28.6,5,14,35.7,5,20,25,6,10,36,5,3,29,0
7058,162218,198_08_04,GIBRALTAR,0,TOTALS,GIBRALTAR,200,27,78,34.6,26,67,38.8,1,11,9.1,10,20,50.0,22,42,64,12,12,19,12,8,65,1
7059,162231,198_08_04,SAN MARINO,0,TOTALS,SAN MARINO,200,12,64,18.8,11,53,20.8,1,11,9.1,2,12,16.7,14,32,46,6,16,27,12,5,27,0
7060,162242,198_08_05,PRINCIPALITY OF MONACO,0,TOTALS,PRINCIPALITY OF MONACO,200,14,52,26.9,13,42,31.0,1,10,10.0,13,25,52.0,9,33,42,10,18,35,13,8,42,0
7061,162253,198_08_05,MALTA,0,TOTALS,MALTA,200,19,72,26.4,17,62,27.4,2,10,20.0,3,16,18.8,24,31,55,9,23,32,18,3,43,1
7062,162266,198_08_06,SAN MARINO,0,TOTALS,SAN MARINO,200,18,68,26.5,17,60,28.3,1,8,12.5,7,27,25.9,18,27,45,10,18,31,23,0,44,0
7063,162279,198_08_06,MOLDOVA,0,TOTALS,MOLDOVA,200,27,69,39.1,24,54,44.4,3,15,20.0,7,19,36.8,21,40,61,12,21,36,16,15,64,1
7064,162292,198_08_07,WALES,0,TOTALS,WALES,200,25,67,37.3,19,44,43.2,6,23,26.1,2,12,16.7,12,23,35,7,27,30,14,1,58,0
7065,162305,198_08_07,SCOTLAND,0,TOTALS,SCOTLAND,200,39,77,50.6,37,70,52.9,2,7,28.6,17,31,54.8,21,34,55,18,19,22,20,5,97,1
7066,162318,198_08_08,ANDORRA,0,TOTALS,ANDORRA,200,23,87,26.4,18,54,33.3,5,33,15.2,3,7,42.9,26,29,55,14,30,24,14,6,54,0
7067,162331,198_08_08,GIBRALTAR,0,TOTALS,GIBRALTAR,200,21,55,38.2,20,44,45.5,1,11,9.1,16,32,50.0,12,40,52,9,13,31,13,11,59,1
7068,162344,198_08_09,SCOTLAND,0,TOTALS,SCOTLAND,200,53,82,64.6,53,79,67.1,0,3,0.0,8,13,61.5,19,38,57,34,15,23,27,5,114,0
7069,162355,198_08_09,MALTA,0,TOTALS,MALTA,200,10,52,19.2,10,48,20.8,0,4,0.0,5,11,45.5,7,12,19,5,14,37,10,2,25,1
7070,162368,198_08_10,ANDORRA,0,TOTALS,ANDORRA,200,40,88,45.5,39,80,48.8,1,8,12.5,12,30,40.0,28,42,70,21,26,18,23,11,93,1
7071,162381,198_08_10,SAN MARINO,0,TOTALS,SAN MARINO,200,8,62,12.9,8,52,15.4,0,10,0.0,9,31,29.0,22,30,52,4,28,36,7,1,25,0
7072,162394,198_08_11,WALES,0,TOTALS,WALES,200,26,72,36.1,21,50,42.0,5,22,22.7,7,19,36.8,24,29,53,11,27,37,15,3,64,1
7073,162405,198_08_11,PRINCIPALITY OF MONACO,0,TOTALS,PRINCIPALITY OF MONACO,200,18,58,31.0,18,52,34.6,0,6,0.0,17,29,58.6,15,28,43,10,21,32,14,3,53,0
7074,162418,198_08_12,GIBRALTAR,0,TOTALS,GIBRALTAR,200,14,62,22.6,8,44,18.2,6,18,33.3,6,14,42.9,11,33,44,8,16,34,11,0,40,0
7075,162431,198_08_12,MOLDOVA,0,TOTALS,MOLDOVA,200,34,74,45.9,21,40,52.5,13,34,38.2,4,16,25.0,14,41,55,19,11,25,16,9,85,1
7076,162444,198_08_13,ANDORRA,0,TOTALS,ANDORRA,200,19,68,27.9,19,53,35.8,0,15,0.0,7,23,30.4,25,31,56,9,27,38,21,4,45,0
7077,162455,198_08_13,PRINCIPALITY OF MONACO,0,TOTALS,PRINCIPALITY OF MONACO,200,17,53,32.1,17,45,37.8,0,8,0.0,18,35,51.4,14,32,46,12,20,35,20,8,52,1
7078,162466,198_08_14,MALTA,0,TOTALS,MALTA,200,22,64,34.4,22,58,37.9,0,6,0.0,5,11,45.5,16,38,54,8,16,34,13,8,49,1
7079,162479,198_08_14,SAN MARINO,0,TOTALS,SAN MARINO,200,18,74,24.3,17,60,28.3,1,14,7.1,3,14,21.4,19,28,47,7,17,27,21,4,40,0
7080,162492,198_08_15,MOLDOVA,0,TOTALS,MOLDOVA,200,21,75,28.0,16,46,34.8,5,29,17.2,8,14,57.1,19,30,49,7,20,12,4,8,55,0
7081,162505,198_08_15,WALES,0,TOTALS,WALES,200,25,66,37.9,18,40,45.0,7,26,26.9,11,19,57.9,14,37,51,14,19,14,6,1,68,1
7082,162518,198_08_16,SCOTLAND,0,TOTALS,SCOTLAND,200,42,77,54.5,36,61,59.0,6,16,37.5,13,28,46.4,20,37,57,26,18,16,10,6,103,0
7083,162531,198_08_16,GIBRALTAR,0,TOTALS,GIBRALTAR,200,21,65,32.3,15,43,34.9,6,22,27.3,4,12,33.3,11,22,33,13,25,22,9,2,52,1
7084,162544,198_08_17,ANDORRA,0,TOTALS,ANDORRA,200,30,75,40.0,28,63,44.4,2,12,16.7,7,18,38.9,25,33,58,17,25,32,21,6,69,1
7085,162557,198_08_17,SAN MARINO,0,TOTALS,SAN MARINO,200,10,50,20.0,9,43,20.9,1,7,14.3,15,36,41.7,19,28,47,5,20,39,15,2,36,0
7086,162568,198_08_18,PRINCIPALITY OF MONACO,0,TOTALS,PRINCIPALITY OF MONACO,200,28,72,38.9,26,61,42.6,2,11,18.2,15,25,60.0,15,44,59,17,26,30,16,9,73,1
7087,162579,198_08_18,MALTA,0,TOTALS,MALTA,200,20,75,26.7,18,66,27.3,2,9,22.2,9,29,31.0,22,32,54,7,22,30,15,1,51,0
7088,162592,198_08_19,MOLDOVA,0,TOTALS,MOLDOVA,250,27,84,32.1,23,58,39.7,4,26,15.4,17,30,56.7,32,45,77,9,20,38,17,8,75,1
7089,162605,198_08_19,GIBRALTAR,0,TOTALS,GIBRALTAR,250,28,97,28.9,22,72,30.6,6,25,24.0,7,17,41.2,26,31,57,12,26,27,25,4,69,0
7090,162618,198_08_20,WALES,0,TOTALS,WALES,200,14,72,19.4,10,45,22.2,4,27,14.8,7,16,43.8,12,18,30,7,24,15,10,2,39,1
7091,162631,198_08_20,SCOTLAND,0,TOTALS,SCOTLAND,200,44,71,62.0,42,65,64.6,2,6,33.3,12,23,52.2,15,49,64,29,15,18,8,4,102,0
7092,166206,204_09_01,IRAN,0,TOTALS,IRAN,200,22,63,34.9,19,44,43.2,3,19,15.8,8,13,61.5,14,9,23,13,16,22,13,1,55,1
7093,166219,204_09_01,USA,0,TOTALS,USA,200,41,74,55.4,29,43,67.4,12,31,38.7,12,16,75.0,23,22,45,23,16,19,16,7,106,0
7094,166232,204_09_02,CROATIA,0,TOTALS,CROATIA,200,42,76,55.3,34,57,59.6,8,19,42.1,12,17,70.6,18,24,42,15,22,19,15,3,104,0
7095,166242,204_09_02,KAZAKHSTAN,0,TOTALS,KAZAKHSTAN,200,26,68,38.2,16,42,38.1,10,26,38.5,12,21,57.1,11,16,27,12,16,23,9,1,74,1
7096,166255,204_09_03,SPAIN,0,TOTALS,SPAIN,200,28,62,45.2,14,29,48.3,14,33,42.4,9,13,69.2,12,20,32,19,16,21,17,2,79,1
7097,166267,204_09_03,SYRIA,0,TOTALS,SYRIA,200,22,58,37.9,20,44,45.5,2,14,14.3,7,14,50.0,17,15,32,8,16,28,12,4,53,0
7098,166279,204_09_04,LITHUANIA,0,TOTALS,LITHUANIA,200,27,62,43.5,22,40,55.0,5,22,22.7,14,27,51.9,11,27,38,11,21,20,6,5,73,0
7099,166292,204_09_04,PUERTO RICO,0,TOTALS,PUERTO RICO,200,32,75,42.7,26,55,47.3,6,20,30.0,10,18,55.6,14,26,40,12,25,11,12,2,80,1
7100,166305,204_09_05,FRANCE,0,TOTALS,FRANCE,200,36,73,49.3,20,43,46.5,16,30,53.3,14,18,77.8,14,22,36,26,18,12,9,2,102,0
7101,166317,204_09_05,EGYPT,0,TOTALS,EGYPT,200,21,61,34.4,17,44,38.6,4,17,23.5,10,18,55.6,11,18,29,7,21,19,7,3,56,1
7102,166329,204_09_06,CANADA,0,TOTALS,CANADA,200,29,72,40.3,24,53,45.3,5,19,26.3,14,21,66.7,13,20,33,3,24,14,7,4,77,0
7103,166340,204_09_06,AUSTRALIA,0,TOTALS,AUSTRALIA,200,33,72,45.8,30,55,54.5,3,17,17.6,19,30,63.3,15,27,42,12,17,11,6,4,88,1
7104,166352,204_09_07,GREECE,0,TOTALS,GREECE,200,38,69,55.1,31,44,70.5,7,25,28.0,18,28,64.3,14,30,44,15,21,19,15,4,101,0
7105,166363,204_09_07,ANGOLA,0,TOTALS,ANGOLA,200,24,69,34.8,22,54,40.7,2,15,13.3,8,22,36.4,17,19,36,4,23,25,13,6,58,1
7106,166374,204_09_08,ARGENTINA,0,TOTALS,ARGENTINA,200,26,71,36.6,17,48,35.4,9,23,39.1,5,9,55.6,18,19,37,11,18,14,8,1,66,1
7107,166384,204_09_08,NEW ZEALAND,0,TOTALS,NEW ZEALAND,200,24,51,47.1,20,38,52.6,4,13,30.8,12,16,75.0,7,23,30,6,17,18,9,7,64,0
7108,166397,204_09_09,USA,0,TOTALS,USA,200,28,70,40.0,18,33,54.5,10,37,27.0,5,8,62.5,12,27,39,17,21,12,5,6,71,1
7109,166410,204_09_09,FRANCE,0,TOTALS,FRANCE,200,17,53,32.1,12,35,34.3,5,18,27.8,16,23,69.6,8,26,34,7,15,17,6,4,55,0
7110,166422,204_09_10,EGYPT,0,TOTALS,EGYPT,225,32,80,40.0,25,58,43.1,7,22,31.8,24,37,64.9,16,29,45,15,33,21,19,3,95,1
7111,166435,204_09_10,IRAN,0,TOTALS,IRAN,225,31,74,41.9,25,45,55.6,6,29,20.7,23,43,53.5,18,36,54,14,28,27,13,14,91,0
7112,166448,204_09_11,SYRIA,0,TOTALS,SYRIA,200,22,64,34.4,17,46,37.0,5,18,27.8,4,10,40.0,6,21,27,8,31,21,9,4,53,0
7113,166461,204_09_11,CANADA,0,TOTALS,CANADA,200,33,68,48.5,25,48,52.1,8,20,40.0,25,37,67.6,17,36,53,18,11,17,13,5,99,1
7114,166473,204_09_12,KAZAKHSTAN,0,TOTALS,KAZAKHSTAN,200,21,65,32.3,12,34,35.3,9,31,29.0,18,20,90.0,12,20,32,13,16,15,4,4,69,0
7115,166486,204_09_12,ARGENTINA,0,TOTALS,ARGENTINA,200,39,73,53.4,30,59,50.8,9,14,64.3,11,19,57.9,13,25,38,20,21,9,11,1,98,1
7116,166499,204_09_13,PUERTO RICO,0,TOTALS,PUERTO RICO,200,33,64,51.6,22,43,51.2,11,21,52.4,21,34,61.8,8,15,23,10,29,7,6,4,98,1
7117,166512,204_09_13,GREECE,0,TOTALS,GREECE,200,34,59,57.6,25,42,59.5,9,17,52.9,30,38,78.9,11,25,36,18,28,10,4,7,107,0
7118,166524,204_09_14,AUSTRALIA,0,TOTALS,AUSTRALIA,200,28,60,46.7,22,42,52.4,6,18,33.3,7,11,63.6,14,23,37,14,15,17,5,1,69,1
7119,166537,204_09_14,SPAIN,0,TOTALS,SPAIN,200,26,67,38.8,21,43,48.8,5,24,20.8,5,9,55.6,17,17,34,10,19,11,11,3,62,0
7120,166550,204_09_15,ANGOLA,0,TOTALS,ANGOLA,200,17,67,25.4,14,42,33.3,3,25,12.0,9,18,50.0,11,19,30,6,30,18,5,1,46,1
7121,166563,204_09_15,LITHUANIA,0,TOTALS,LITHUANIA,200,39,66,59.1,34,50,68.0,5,16,31.2,21,28,75.0,6,35,41,22,18,13,9,7,104,0
7122,166574,204_09_16,NEW ZEALAND,0,TOTALS,NEW ZEALAND,200,27,65,41.5,22,48,45.8,5,17,29.4,13,23,56.5,13,22,35,9,22,10,9,4,72,0
7123,166585,204_09_16,CROATIA,0,TOTALS,CROATIA,200,30,69,43.5,26,48,54.2,4,21,19.0,15,20,75.0,13,28,41,13,22,11,4,2,79,1
7124,166597,204_09_17,USA,0,TOTALS,USA,200,43,76,56.6,31,49,63.3,12,27,44.4,14,22,63.6,13,36,49,24,11,11,5,12,112,0
7125,166609,204_09_17,EGYPT,0,TOTALS,EGYPT,200,22,67,32.8,21,54,38.9,1,13,7.7,10,17,58.8,11,17,28,7,19,15,6,2,55,1
7126,166620,204_09_18,SYRIA,0,TOTALS,SYRIA,200,19,56,33.9,13,39,33.3,6,17,35.3,10,18,55.6,8,20,28,6,17,23,5,2,54,0
7127,166633,204_09_18,AUSTRALIA,0,TOTALS,AUSTRALIA,200,38,71,53.5,32,52,61.5,6,19,31.6,14,18,77.8,12,30,42,19,18,13,10,4,96,1
7128,166644,204_09_19,ANGOLA,0,TOTALS,ANGOLA,200,19,74,25.7,17,57,29.8,2,17,11.8,9,18,50.0,14,25,39,3,25,13,11,1,49,0
7129,166657,204_09_19,PUERTO RICO,0,TOTALS,PUERTO RICO,200,31,61,50.8,24,41,58.5,7,20,35.0,17,30,56.7,11,42,53,13,19,21,5,9,86,1
7130,166668,204_09_20,CROATIA,0,TOTALS,CROATIA,200,26,57,45.6,20,35,57.1,6,22,27.3,17,23,73.9,10,23,33,12,25,16,6,8,75,1
7131,166680,204_09_20,ARGENTINA,0,TOTALS,ARGENTINA,200,24,63,38.1,20,45,44.4,4,18,22.2,11,17,64.7,15,24,39,11,24,16,10,1,63,0
7132,166691,204_09_21,FRANCE,0,TOTALS,FRANCE,200,29,63,46.0,18,38,47.4,11,25,44.0,17,25,68.0,12,30,42,22,22,22,14,5,86,1
7133,166701,204_09_21,IRAN,0,TOTALS,IRAN,200,22,69,31.9,12,42,28.6,10,27,37.0,14,20,70.0,17,21,38,13,22,22,7,4,68,0
7134,166712,204_09_22,CANADA,0,TOTALS,CANADA,200,29,74,39.2,25,52,48.1,4,22,18.2,13,19,68.4,20,26,46,7,16,15,7,5,75,0
7135,166724,204_09_22,SPAIN,0,TOTALS,SPAIN,200,27,62,43.5,14,35,40.0,13,27,48.1,15,22,68.2,5,21,26,12,21,11,8,2,82,1
7136,166734,204_09_23,LITHUANIA,0,TOTALS,LITHUANIA,200,33,65,50.8,23,38,60.5,10,27,37.0,9,15,60.0,12,33,45,20,15,17,4,3,85,1
7137,166746,204_09_23,GREECE,0,TOTALS,GREECE,200,23,69,33.3,12,39,30.8,11,30,36.7,13,15,86.7,10,20,30,10,22,9,11,3,70,0
7138,166757,204_09_24,NEW ZEALAND,0,TOTALS,NEW ZEALAND,200,30,76,39.5,26,58,44.8,4,18,22.2,19,23,82.6,15,15,30,11,17,12,10,3,83,0
7139,166766,204_09_24,KAZAKHSTAN,0,TOTALS,KAZAKHSTAN,200,32,54,59.3,23,37,62.2,9,17,52.9,17,24,70.8,5,26,31,13,20,23,6,4,90,1
7140,166776,204_09_25,ANGOLA,0,TOTALS,ANGOLA,200,23,63,36.5,20,49,40.8,3,14,21.4,13,28,46.4,19,32,51,12,21,28,11,4,62,1
7141,166787,204_09_25,IRAN,0,TOTALS,IRAN,200,16,73,21.9,12,43,27.9,4,30,13.3,17,27,63.0,27,24,51,7,25,24,15,7,53,0
7142,166799,204_09_26,CROATIA,0,TOTALS,CROATIA,200,26,73,35.6,14,42,33.3,12,31,38.7,19,20,95.0,14,27,41,16,23,13,9,5,83,1
7143,166810,204_09_26,CANADA,0,TOTALS,CANADA,200,27,72,37.5,22,57,38.6,5,15,33.3,18,25,72.0,16,27,43,10,21,15,8,10,77,0
7144,166823,204_09_27,SYRIA,0,TOTALS,SYRIA,200,29,73,39.7,26,54,48.1,3,19,15.8,14,28,50.0,21,23,44,7,21,16,8,5,75,0
7145,166836,204_09_27,NEW ZEALAND,0,TOTALS,NEW ZEALAND,200,33,68,48.5,24,50,48.0,9,18,50.0,18,27,66.7,10,28,38,14,21,14,11,5,93,1
7146,166848,204_09_28,ARGENTINA,0,TOTALS,ARGENTINA,200,33,63,52.4,22,41,53.7,11,22,50.0,15,23,65.2,9,30,39,22,18,11,5,1,92,1
7147,166860,204_09_28,SPAIN,0,TOTALS,SPAIN,200,27,65,41.5,21,48,43.8,6,17,35.3,15,18,83.3,8,15,23,7,16,8,9,4,75,0
7148,166871,204_09_29,FRANCE,0,TOTALS,FRANCE,200,27,66,40.9,15,33,45.5,12,33,36.4,23,28,82.1,11,22,33,7,22,20,10,1,89,0
7149,166884,204_09_29,PUERTO RICO,0,TOTALS,PUERTO RICO,200,31,57,54.4,19,35,54.3,12,22,54.5,16,23,69.6,6,26,32,17,23,20,10,2,90,1
7150,166896,204_09_30,KAZAKHSTAN,0,TOTALS,KAZAKHSTAN,200,22,60,36.7,15,37,40.5,7,23,30.4,3,6,50.0,10,20,30,16,15,25,8,3,54,0
7151,166909,204_09_30,AUSTRALIA,0,TOTALS,AUSTRALIA,200,37,79,46.8,31,63,49.2,6,16,37.5,7,13,53.8,22,29,51,14,13,16,16,3,87,1
7152,166921,204_09_31,EGYPT,0,TOTALS,EGYPT,200,28,72,38.9,19,51,37.3,9,21,42.9,8,16,50.0,7,15,22,12,25,15,14,3,73,0
7153,166934,204_09_31,LITHUANIA,0,TOTALS,LITHUANIA,200,33,59,55.9,25,42,59.5,8,17,47.1,20,31,64.5,13,30,43,19,14,23,12,3,94,1
7154,166947,204_09_32,USA,0,TOTALS,USA,200,27,63,42.9,21,42,50.0,6,21,28.6,25,32,78.1,16,22,38,10,22,17,9,6,85,1
7155,166959,204_09_32,GREECE,0,TOTALS,GREECE,200,25,61,41.0,14,36,38.9,11,25,44.0,8,14,57.1,8,18,26,14,24,14,9,5,69,0
7156,166969,204_09_33,SPAIN,0,TOTALS,SPAIN,200,25,56,44.6,24,46,52.2,1,10,10.0,21,26,80.8,8,21,29,9,14,15,7,5,72,0
7157,166980,204_09_33,CROATIA,0,TOTALS,CROATIA,200,32,69,46.4,18,38,47.4,14,31,45.2,13,17,76.5,15,20,35,20,24,13,8,2,91,1
7158,166993,204_09_34,IRAN,0,TOTALS,IRAN,200,29,69,42.0,15,41,36.6,14,28,50.0,21,29,72.4,18,29,47,18,14,12,13,9,93,1
7159,167005,204_09_34,SYRIA,0,TOTALS,SYRIA,200,22,68,32.4,17,44,38.6,5,24,20.8,4,10,40.0,16,24,40,7,20,18,5,1,53,0
7160,167018,204_09_35,AUSTRALIA,0,TOTALS,AUSTRALIA,200,28,54,51.9,20,38,52.6,8,16,50.0,12,13,92.3,6,26,32,13,14,13,5,6,76,1
7161,167031,204_09_35,ARGENTINA,0,TOTALS,ARGENTINA,200,21,63,33.3,13,45,28.9,8,18,44.4,15,17,88.2,11,19,30,10,18,14,5,2,65,0
7162,167041,204_09_36,ANGOLA,0,TOTALS,ANGOLA,200,23,64,35.9,23,50,46.0,0,14,0.0,8,20,40.0,18,22,40,8,16,17,11,1,54,0
7163,167053,204_09_36,NEW ZEALAND,0,TOTALS,NEW ZEALAND,200,22,59,37.3,13,31,41.9,9,28,32.1,9,13,69.2,14,26,40,10,18,17,12,3,62,1
7164,167065,204_09_37,GREECE,0,TOTALS,GREECE,200,37,71,52.1,22,32,68.8,15,39,38.5,11,19,57.9,13,23,36,24,20,14,15,7,100,0
7165,167078,204_09_37,EGYPT,0,TOTALS,EGYPT,200,19,60,31.7,14,42,33.3,5,18,27.8,16,22,72.7,16,25,41,7,20,25,10,3,59,1
7166,167089,204_09_38,LITHUANIA,0,TOTALS,LITHUANIA,200,24,48,50.0,18,32,56.2,6,16,37.5,24,33,72.7,4,23,27,16,21,18,3,3,78,0
7167,167100,204_09_38,FRANCE,0,TOTALS,FRANCE,200,34,75,45.3,21,48,43.8,13,27,48.1,14,25,56.0,18,22,40,12,24,8,15,0,95,1
7168,167113,204_09_39,PUERTO RICO,0,TOTALS,PUERTO RICO,200,24,72,33.3,18,56,32.1,6,16,37.5,7,10,70.0,10,32,42,11,12,14,5,7,61,0
7169,167125,204_09_39,USA,0,TOTALS,USA,200,31,85,36.5,21,51,41.2,10,34,29.4,10,16,62.5,17,34,51,15,18,12,12,8,82,1
7170,167138,204_09_40,CANADA,0,TOTALS,CANADA,200,38,75,50.7,29,51,56.9,9,24,37.5,23,34,67.6,24,26,50,11,13,18,12,6,108,0
7171,167150,204_09_40,KAZAKHSTAN,0,TOTALS,KAZAKHSTAN,200,27,69,39.1,17,36,47.2,10,33,30.3,6,11,54.5,12,14,26,10,20,21,13,5,70,1
7172,167161,204_09_41,EGYPT,0,TOTALS,EGYPT,200,24,62,38.7,18,43,41.9,6,19,31.6,17,34,50.0,14,20,34,10,12,17,4,5,71,0
7173,167174,204_09_41,PUERTO RICO,0,TOTALS,PUERTO RICO,200,40,80,50.0,28,58,48.3,12,22,54.5,7,15,46.7,19,26,45,22,23,9,10,9,99,1
7174,167185,204_09_42,KAZAKHSTAN,0,TOTALS,KAZAKHSTAN,200,24,69,34.8,13,35,37.1,11,34,32.4,12,20,60.0,11,17,28,11,14,16,6,3,71,1
7175,167197,204_09_42,SPAIN,0,TOTALS,SPAIN,200,38,70,54.3,27,48,56.2,11,22,50.0,14,21,66.7,12,35,47,20,15,15,13,7,101,0
7176,167209,204_09_43,FRANCE,0,TOTALS,FRANCE,200,25,64,39.1,19,41,46.3,6,23,26.1,16,20,80.0,8,23,31,12,23,6,3,7,72,0
7177,167217,204_09_43,GREECE,0,TOTALS,GREECE,200,23,58,39.7,17,37,45.9,6,21,28.6,24,28,85.7,8,29,37,15,17,10,5,6,76,1
7178,167229,204_09_44,ARGENTINA,0,TOTALS,ARGENTINA,200,24,55,43.6,22,42,52.4,2,13,15.4,7,10,70.0,10,21,31,9,20,18,8,3,57,0
7179,167240,204_09_44,CANADA,0,TOTALS,CANADA,200,28,66,42.4,25,46,54.3,3,20,15.0,8,11,72.7,14,20,34,7,14,16,3,3,67,1
7180,167251,204_09_45,CROATIA,0,TOTALS,CROATIA,200,29,58,50.0,18,31,58.1,11,27,40.7,5,8,62.5,4,21,25,13,22,16,9,8,74,0
7181,167264,204_09_45,AUSTRALIA,0,TOTALS,AUSTRALIA,200,28,66,42.4,19,45,42.2,9,21,42.9,14,22,63.6,19,18,37,11,15,15,7,6,79,1
7182,167276,204_09_46,USA,0,TOTALS,USA,200,30,70,42.9,23,48,47.9,7,22,31.8,9,16,56.2,7,24,31,10,19,8,13,2,76,1
7183,167289,204_09_46,LITHUANIA,0,TOTALS,LITHUANIA,200,28,59,47.5,25,46,54.3,3,13,23.1,10,16,62.5,11,34,45,15,18,23,3,3,69,0
7184,167300,204_09_47,LITHUANIA,0,TOTALS,LITHUANIA,200,41,80,51.2,34,61,55.7,7,19,36.8,24,30,80.0,18,33,51,20,16,17,12,3,113,0
7185,167312,204_09_47,KAZAKHSTAN,0,TOTALS,KAZAKHSTAN,200,28,76,36.8,19,52,36.5,9,24,37.5,14,19,73.7,14,18,32,9,20,16,9,4,79,1
7186,167325,204_09_48,EGYPT,0,TOTALS,EGYPT,200,27,71,38.0,22,52,42.3,5,19,26.3,14,20,70.0,18,24,42,11,21,23,10,4,73,0
7187,167338,204_09_48,SPAIN,0,TOTALS,SPAIN,200,31,72,43.1,25,47,53.2,6,25,24.0,20,22,90.9,15,26,41,16,21,14,13,6,88,1
7188,167350,204_09_49,GREECE,0,TOTALS,GREECE,200,31,55,56.4,23,38,60.5,8,17,47.1,16,26,61.5,9,24,33,17,23,15,15,6,86,1
7189,167362,204_09_49,ARGENTINA,0,TOTALS,ARGENTINA,200,19,60,31.7,16,45,35.6,3,15,20.0,19,26,73.1,15,20,35,4,24,21,8,1,60,0
7190,167374,204_09_50,FRANCE,0,TOTALS,FRANCE,200,29,70,41.4,19,42,45.2,10,28,35.7,5,9,55.6,8,25,33,10,19,9,6,3,73,0
7191,167387,204_09_50,AUSTRALIA,0,TOTALS,AUSTRALIA,200,27,58,46.6,18,39,46.2,9,19,47.4,16,23,69.6,9,30,39,13,13,13,5,3,79,1
7192,167399,204_09_51,PUERTO RICO,0,TOTALS,PUERTO RICO,200,29,61,47.5,22,39,56.4,7,22,31.8,13,23,56.5,6,21,27,9,19,14,10,5,78,0
7193,167409,204_09_51,CROATIA,0,TOTALS,CROATIA,200,32,68,47.1,23,40,57.5,9,28,32.1,18,22,81.8,14,27,41,16,18,15,7,5,91,1
7194,167421,204_09_52,USA,0,TOTALS,USA,200,32,60,53.3,18,34,52.9,14,26,53.8,15,23,65.2,12,27,39,20,15,15,8,7,93,1
7195,167434,204_09_52,CANADA,0,TOTALS,CANADA,200,28,71,39.4,22,51,43.1,6,20,30.0,11,19,57.9,17,18,35,10,15,11,7,3,73,0
7196,167443,204_09_53,KAZAKHSTAN,0,TOTALS,KAZAKHSTAN,200,27,71,38.0,17,42,40.5,10,29,34.5,14,15,93.3,8,25,33,15,26,16,4,1,78,0
7197,167453,204_09_53,EGYPT,0,TOTALS,EGYPT,200,28,66,42.4,26,51,51.0,2,15,13.3,28,38,73.7,15,31,46,9,17,13,8,1,86,1
7198,167465,204_09_54,LITHUANIA,0,TOTALS,LITHUANIA,200,31,71,43.7,21,43,48.8,10,28,35.7,16,23,69.6,12,34,46,18,19,8,3,3,88,1
7199,167477,204_09_54,SPAIN,0,TOTALS,SPAIN,200,23,67,34.3,19,46,41.3,4,21,19.0,14,21,66.7,8,32,40,9,21,10,2,4,64,0
7200,167489,204_09_55,ARGENTINA,0,TOTALS,ARGENTINA,200,31,61,50.8,20,36,55.6,11,25,44.0,19,22,86.4,8,26,34,12,22,18,8,1,92,1
7201,167501,204_09_55,FRANCE,0,TOTALS,FRANCE,200,29,68,42.6,25,49,51.0,4,19,21.1,22,30,73.3,16,21,37,12,24,16,8,6,84,0
7202,167514,204_09_56,PUERTO RICO,0,TOTALS,PUERTO RICO,200,24,77,31.2,20,54,37.0,4,23,17.4,15,19,78.9,19,25,44,11,25,12,9,9,67,1
7203,167525,204_09_56,CANADA,0,TOTALS,CANADA,200,23,76,30.3,22,59,37.3,1,17,5.9,18,26,69.2,24,31,55,7,16,18,5,6,65,0
7204,167537,204_09_57,GREECE,0,TOTALS,GREECE,200,29,69,42.0,21,47,44.7,8,22,36.4,18,22,81.8,19,29,48,15,18,11,9,6,84,1
7205,167550,204_09_57,AUSTRALIA,0,TOTALS,AUSTRALIA,200,24,72,33.3,17,48,35.4,7,24,29.2,14,21,66.7,18,23,41,7,19,11,4,3,69,0
7206,167561,204_09_58,CROATIA,0,TOTALS,CROATIA,200,29,69,42.0,20,47,42.6,9,22,40.9,10,13,76.9,14,23,37,13,25,11,1,1,77,0
7207,167573,204_09_58,USA,0,TOTALS,USA,200,28,65,43.1,21,40,52.5,7,25,28.0,18,23,78.3,14,25,39,14,17,8,5,5,81,1
7208,167585,204_09_59,FRANCE,0,TOTALS,FRANCE,200,27,74,36.5,22,55,40.0,5,19,26.3,15,22,68.2,14,17,31,13,14,9,9,4,74,0
7209,167597,204_09_59,CANADA,0,TOTALS,CANADA,200,34,69,49.3,30,52,57.7,4,17,23.5,10,10,100.0,13,35,48,10,16,21,3,5,82,1
7210,167609,204_09_60,ARGENTINA,0,TOTALS,ARGENTINA,200,37,71,52.1,28,45,62.2,9,26,34.6,9,14,64.3,14,30,44,24,17,15,4,2,92,1
7211,167622,204_09_60,PUERTO RICO,0,TOTALS,PUERTO RICO,200,27,68,39.7,21,47,44.7,6,21,28.6,10,15,66.7,10,16,26,10,16,11,9,3,70,0
7212,167634,204_09_61,AUSTRALIA,0,TOTALS,AUSTRALIA,200,27,59,45.8,22,44,50.0,5,15,33.3,22,27,81.5,13,18,31,11,19,13,4,7,81,0
7213,167645,204_09_61,CROATIA,0,TOTALS,CROATIA,200,32,63,50.8,25,45,55.6,7,18,38.9,16,23,69.6,13,19,32,10,21,14,5,3,87,1
7214,167658,204_09_62,GREECE,0,TOTALS,GREECE,200,24,58,41.4,18,41,43.9,6,17,35.3,26,36,72.2,6,18,24,11,25,15,6,2,80,0
7215,167670,204_09_62,USA,0,TOTALS,USA,200,28,57,49.1,22,42,52.4,6,15,40.0,26,32,81.2,8,22,30,12,29,14,9,5,88,1
7216,169120,206_09_01,MOZAMBIQUE,0,TOTALS,MOZAMBIQUE,200,24,62,38.7,18,31,58.1,6,31,19.4,8,12,66.7,6,14,20,10,17,13,13,0,62,0
7217,169133,206_09_01,EGYPT,0,TOTALS,EGYPT,200,28,46,60.9,22,32,68.8,6,14,42.9,10,12,83.3,6,30,36,10,14,22,8,2,72,1
7218,169145,206_09_02,CAPE VERDE,0,TOTALS,CAPE VERDE,200,29,76,38.2,19,45,42.2,10,31,32.3,3,4,75.0,15,29,44,13,19,10,4,1,71,1
7219,169158,206_09_02,TUNISIA,0,TOTALS,TUNISIA,200,17,52,32.7,13,35,37.1,4,17,23.5,14,28,50.0,7,24,31,11,11,14,8,1,52,0
7220,169171,206_09_03,ANGOLA,0,TOTALS,ANGOLA,200,27,53,50.9,20,33,60.6,7,20,35.0,18,23,78.3,8,19,27,12,19,15,10,1,79,1
7221,169184,206_09_03,MALI,0,TOTALS,MALI,200,25,47,53.2,13,28,46.4,12,19,63.2,12,19,63.2,3,17,20,8,24,18,5,0,74,0
7222,169197,206_09_04,SENEGAL,0,TOTALS,SENEGAL,200,35,76,46.1,24,48,50.0,11,28,39.3,14,20,70.0,18,37,55,22,11,17,7,9,95,1
7223,169210,206_09_04,REPUBLIC OF CONGO,0,TOTALS,REPUBLIC OF CONGO,200,25,77,32.5,19,52,36.5,6,25,24.0,12,20,60.0,12,20,32,10,16,12,10,0,68,0
7224,169223,206_09_05,NIGERIA,0,TOTALS,NIGERIA,200,31,63,49.2,24,42,57.1,7,21,33.3,24,27,88.9,8,37,45,8,20,16,9,1,93,1
7225,169236,206_09_05,COTE D'IVOIRE,0,TOTALS,COTE D'IVOIRE,200,27,71,38.0,18,35,51.4,9,36,25.0,21,28,75.0,11,25,36,18,21,15,10,2,84,0
7226,169249,206_09_06,CAMEROON,0,TOTALS,CAMEROON,200,27,52,51.9,21,36,58.3,6,16,37.5,19,23,82.6,4,24,28,19,14,17,13,2,79,1
7227,169262,206_09_06,CAF,0,TOTALS,CAF,200,25,59,42.4,16,36,44.4,9,23,39.1,10,17,58.8,10,18,28,12,22,20,12,1,69,0
7228,169274,206_09_07,LIBYA,0,TOTALS,LIBYA,200,26,50,52.0,21,31,67.7,5,19,26.3,31,44,70.5,7,33,40,16,15,19,7,1,88,1
7229,169287,206_09_07,SOUTH AFRICA,0,TOTALS,SOUTH AFRICA,200,25,65,38.5,17,39,43.6,8,26,30.8,14,17,82.4,8,19,27,7,31,17,8,2,72,0
7230,169300,206_09_08,MOROCCO,0,TOTALS,MOROCCO,200,33,81,40.7,25,55,45.5,8,26,30.8,11,16,68.8,20,27,47,14,14,13,9,6,85,1
7231,169313,206_09_08,RWANDA,0,TOTALS,RWANDA,200,30,70,42.9,22,44,50.0,8,26,30.8,16,22,72.7,13,29,42,13,16,18,13,3,84,0
7232,169326,206_09_09,MALI,0,TOTALS,MALI,200,22,48,45.8,17,30,56.7,5,18,27.8,18,24,75.0,11,33,44,9,15,21,8,1,67,1
7233,169339,206_09_09,MOZAMBIQUE,0,TOTALS,MOZAMBIQUE,200,21,60,35.0,17,37,45.9,4,23,17.4,8,13,61.5,5,16,21,12,22,12,12,1,54,0
7234,169352,206_09_10,CAF,0,TOTALS,CAF,200,19,65,29.2,12,45,26.7,7,20,35.0,24,32,75.0,10,19,29,8,13,17,11,4,69,0
7235,169365,206_09_10,SENEGAL,0,TOTALS,SENEGAL,200,35,74,47.3,31,54,57.4,4,20,20.0,8,16,50.0,13,38,51,18,19,24,11,6,82,1
7236,169378,206_09_11,SOUTH AFRICA,0,TOTALS,SOUTH AFRICA,200,18,62,29.0,14,32,43.8,4,30,13.3,9,14,64.3,6,22,28,7,20,21,4,1,49,0
7237,169391,206_09_11,NIGERIA,0,TOTALS,NIGERIA,200,35,66,53.0,25,35,71.4,10,31,32.3,17,26,65.4,10,31,41,14,15,15,9,1,97,1
7238,169404,206_09_12,REPUBLIC OF CONGO,0,TOTALS,REPUBLIC OF CONGO,200,21,68,30.9,16,46,34.8,5,22,22.7,9,14,64.3,14,23,37,7,9,14,17,3,56,0
7239,169417,206_09_12,CAMEROON,0,TOTALS,CAMEROON,200,28,64,43.8,21,40,52.5,7,24,29.2,7,9,77.8,10,28,38,19,12,20,11,7,70,1
7240,169430,206_09_13,COTE D'IVOIRE,0,TOTALS,COTE D'IVOIRE,200,25,55,45.5,15,25,60.0,10,30,33.3,13,18,72.2,3,21,24,12,16,16,10,1,73,1
7241,169442,206_09_13,LIBYA,0,TOTALS,LIBYA,200,25,53,47.2,19,38,50.0,6,15,40.0,8,17,47.1,8,25,33,6,15,21,9,1,64,0
7242,169454,206_09_14,RWANDA,0,TOTALS,RWANDA,200,28,66,42.4,22,42,52.4,6,24,25.0,15,19,78.9,11,27,38,13,12,20,6,4,77,1
7243,169466,206_09_14,CAPE VERDE,0,TOTALS,CAPE VERDE,200,28,82,34.1,22,54,40.7,6,28,21.4,5,10,50.0,22,23,45,12,18,15,13,3,67,0
7244,169479,206_09_15,EGYPT,0,TOTALS,EGYPT,200,25,58,43.1,16,33,48.5,9,25,36.0,10,15,66.7,12,24,36,10,20,28,6,0,69,0
7245,169492,206_09_15,ANGOLA,0,TOTALS,ANGOLA,200,26,60,43.3,17,39,43.6,9,21,42.9,18,22,81.8,6,22,28,17,20,19,15,1,79,1
7246,169505,206_09_16,TUNISIA,0,TOTALS,TUNISIA,200,29,64,45.3,19,38,50.0,10,26,38.5,30,40,75.0,16,23,39,18,28,16,2,0,98,1
7247,169518,206_09_16,MOROCCO,0,TOTALS,MOROCCO,200,25,66,37.9,18,42,42.9,7,24,29.2,22,35,62.9,10,17,27,9,31,10,10,0,79,0
7248,169531,206_09_17,COTE D'IVOIRE,0,TOTALS,COTE D'IVOIRE,200,31,58,53.4,21,33,63.6,10,25,40.0,22,29,75.9,6,29,35,18,28,24,18,3,94,1
7249,169544,206_09_17,SOUTH AFRICA,0,TOTALS,SOUTH AFRICA,200,18,51,35.3,17,42,40.5,1,9,11.1,20,35,57.1,7,23,30,8,23,31,7,0,57,0
7250,169557,206_09_18,REPUBLIC OF CONGO,0,TOTALS,REPUBLIC OF CONGO,200,19,75,25.3,14,49,28.6,5,26,19.2,18,24,75.0,17,18,35,13,18,16,10,5,61,1
7251,169570,206_09_18,CAF,0,TOTALS,CAF,200,39,70,55.7,23,44,52.3,16,26,61.5,19,25,76.0,13,39,52,24,22,19,10,2,113,0
7252,169583,206_09_19,EGYPT,0,TOTALS,EGYPT,200,16,61,26.2,12,31,38.7,4,30,13.3,11,22,50.0,11,19,30,6,23,14,8,3,47,0
7253,169596,206_09_19,MALI,0,TOTALS,MALI,200,24,57,42.1,21,38,55.3,3,19,15.8,16,19,84.2,10,31,41,7,18,19,6,1,67,1
7254,169608,206_09_20,CAPE VERDE,0,TOTALS,CAPE VERDE,200,32,87,36.8,22,57,38.6,10,30,33.3,9,13,69.2,25,17,42,12,19,14,8,3,83,0
7255,169621,206_09_20,MOROCCO,0,TOTALS,MOROCCO,200,29,64,45.3,22,49,44.9,7,15,46.7,21,30,70.0,14,23,37,14,14,13,11,7,86,1
7256,169633,206_09_21,LIBYA,0,TOTALS,LIBYA,200,27,60,45.0,19,39,48.7,8,21,38.1,19,33,57.6,8,25,33,8,18,22,9,0,81,0
7257,169646,206_09_21,NIGERIA,0,TOTALS,NIGERIA,200,35,69,50.7,26,36,72.2,9,33,27.3,18,28,64.3,8,27,35,17,23,13,12,0,97,1
7258,169659,206_09_22,CAMEROON,0,TOTALS,CAMEROON,200,22,57,38.6,17,38,44.7,5,19,26.3,16,22,72.7,4,26,30,9,21,16,11,5,65,0
7259,169672,206_09_22,SENEGAL,0,TOTALS,SENEGAL,200,25,68,36.8,23,50,46.0,2,18,11.1,15,22,68.2,15,30,45,12,18,18,8,2,67,1
7260,169685,206_09_23,ANGOLA,0,TOTALS,ANGOLA,200,36,61,59.0,28,44,63.6,8,17,47.1,13,19,68.4,5,27,32,21,23,15,16,7,93,1
7261,169698,206_09_23,MOZAMBIQUE,0,TOTALS,MOZAMBIQUE,200,13,59,22.0,11,44,25.0,2,15,13.3,22,25,88.0,16,19,35,5,18,22,7,1,50,0
7262,169710,206_09_24,RWANDA,0,TOTALS,RWANDA,200,20,68,29.4,15,50,30.0,5,18,27.8,12,17,70.6,12,28,40,9,15,8,5,3,57,0
7263,169723,206_09_24,TUNISIA,0,TOTALS,TUNISIA,200,30,66,45.5,22,47,46.8,8,19,42.1,6,13,46.2,13,32,45,15,12,10,7,4,74,1
7264,169736,206_09_25,SOUTH AFRICA,0,TOTALS,SOUTH AFRICA,200,22,59,37.3,19,45,42.2,3,14,21.4,20,33,60.6,16,34,50,6,15,26,9,4,67,0
7265,169749,206_09_25,MOZAMBIQUE,0,TOTALS,MOZAMBIQUE,200,25,73,34.2,15,40,37.5,10,33,30.3,9,13,69.2,10,22,32,14,25,20,13,0,69,1
7266,169762,206_09_26,REPUBLIC OF CONGO,0,TOTALS,REPUBLIC OF CONGO,200,21,68,30.9,17,41,41.5,4,27,14.8,17,24,70.8,15,25,40,11,25,23,13,2,63,1
7267,169774,206_09_26,CAPE VERDE,0,TOTALS,CAPE VERDE,200,34,73,46.6,21,39,53.8,13,34,38.2,19,30,63.3,13,27,40,20,19,22,15,5,100,0
7268,169787,206_09_27,MALI,0,TOTALS,MALI,200,24,45,53.3,16,28,57.1,8,17,47.1,15,21,71.4,8,34,42,16,23,29,6,1,71,1
7269,169800,206_09_27,COTE D'IVOIRE,0,TOTALS,COTE D'IVOIRE,200,19,64,29.7,14,41,34.1,5,23,21.7,15,26,57.7,8,13,21,9,18,15,15,0,58,0
7270,169813,206_09_28,MOROCCO,0,TOTALS,MOROCCO,200,22,80,27.5,17,50,34.0,5,30,16.7,5,8,62.5,16,19,35,13,11,11,6,5,54,0
7271,169826,206_09_28,CAMEROON,0,TOTALS,CAMEROON,200,29,65,44.6,19,42,45.2,10,23,43.5,12,14,85.7,17,36,53,15,13,17,7,1,80,1
7272,169839,206_09_29,ANGOLA,0,TOTALS,ANGOLA,200,32,72,44.4,12,26,46.2,20,46,43.5,7,12,58.3,13,18,31,22,18,9,18,5,91,1
7273,169851,206_09_29,LIBYA,0,TOTALS,LIBYA,200,20,47,42.6,16,37,43.2,4,10,40.0,14,20,70.0,8,29,37,10,14,23,3,1,58,0
7274,169864,206_09_30,RWANDA,0,TOTALS,RWANDA,200,23,50,46.0,12,22,54.5,11,28,39.3,15,24,62.5,8,24,32,14,18,15,7,3,72,1
7275,169877,206_09_30,SENEGAL,0,TOTALS,SENEGAL,200,19,64,29.7,13,36,36.1,6,28,21.4,15,28,53.6,22,21,43,12,19,14,8,2,59,0
7276,169890,206_09_31,EGYPT,0,TOTALS,EGYPT,200,28,68,41.2,23,49,46.9,5,19,26.3,16,21,76.2,11,17,28,14,18,12,8,2,77,0
7277,169903,206_09_31,NIGERIA,0,TOTALS,NIGERIA,200,31,54,57.4,22,32,68.8,9,22,40.9,16,22,72.7,5,24,29,12,23,14,5,6,87,1
7278,169916,206_09_32,TUNISIA,0,TOTALS,TUNISIA,200,27,62,43.5,17,31,54.8,10,31,32.3,12,18,66.7,8,21,29,14,24,12,10,1,76,1
7279,169929,206_09_32,CAF,0,TOTALS,CAF,200,25,52,48.1,17,34,50.0,8,18,44.4,17,23,73.9,4,24,28,5,19,15,6,0,75,0
7280,169942,206_09_33,SOUTH AFRICA,0,TOTALS,SOUTH AFRICA,200,29,65,44.6,23,46,50.0,6,19,31.6,17,21,81.0,11,37,48,17,14,24,12,2,81,1
7281,169955,206_09_33,REPUBLIC OF CONGO,0,TOTALS,REPUBLIC OF CONGO,200,23,77,29.9,15,39,38.5,8,38,21.1,11,15,73.3,12,20,32,12,16,17,12,4,65,0
7282,169968,206_09_34,MOZAMBIQUE,0,TOTALS,MOZAMBIQUE,200,22,53,41.5,19,36,52.8,3,17,17.6,14,24,58.3,7,18,25,10,17,25,8,1,61,0
7283,169980,206_09_34,CAPE VERDE,0,TOTALS,CAPE VERDE,200,38,77,49.4,31,55,56.4,7,22,31.8,11,15,73.3,16,23,39,17,18,15,15,2,94,1
7284,169993,206_09_35,COTE D'IVOIRE,0,TOTALS,COTE D'IVOIRE,200,22,51,43.1,17,38,44.7,5,13,38.5,12,19,63.2,8,9,17,6,27,14,8,2,61,0
7285,170006,206_09_35,ANGOLA,0,TOTALS,ANGOLA,200,27,53,50.9,15,28,53.6,12,25,48.0,22,29,75.9,11,22,33,14,19,17,5,0,88,1
7286,170019,206_09_36,CAF,0,TOTALS,CAF,200,28,58,48.3,20,32,62.5,8,26,30.8,21,24,87.5,8,35,43,8,16,14,4,1,85,1
7287,170032,206_09_36,RWANDA,0,TOTALS,RWANDA,200,25,72,34.7,19,51,37.3,6,21,28.6,8,14,57.1,13,20,33,8,23,8,7,4,64,0
7288,170044,206_09_37,LIBYA,0,TOTALS,LIBYA,200,27,50,54.0,22,44,50.0,5,6,83.3,16,24,66.7,5,27,32,7,17,12,3,2,75,1
7289,170057,206_09_37,EGYPT,0,TOTALS,EGYPT,200,24,66,36.4,17,33,51.5,7,33,21.2,18,27,66.7,13,16,29,8,19,7,7,0,73,0
7290,170070,206_09_38,SENEGAL,0,TOTALS,SENEGAL,200,28,62,45.2,17,34,50.0,11,28,39.3,6,13,46.2,10,35,45,17,24,20,7,3,73,0
7291,170083,206_09_38,MOROCCO,0,TOTALS,MOROCCO,200,27,66,40.9,22,49,44.9,5,17,29.4,16,32,50.0,10,23,33,13,13,8,9,5,75,1
7292,170096,206_09_39,NIGERIA,0,TOTALS,NIGERIA,200,24,64,37.5,15,36,41.7,9,28,32.1,17,21,81.0,14,30,44,5,21,15,7,2,74,1
7293,170109,206_09_39,MALI,0,TOTALS,MALI,200,23,60,38.3,18,38,47.4,5,22,22.7,19,30,63.3,11,27,38,9,17,14,2,1,70,0
7294,170122,206_09_40,CAMEROON,0,TOTALS,CAMEROON,200,24,51,47.1,17,37,45.9,7,14,50.0,11,12,91.7,6,21,27,8,25,23,6,1,66,0
7295,170135,206_09_40,TUNISIA,0,TOTALS,TUNISIA,200,22,54,40.7,14,35,40.0,8,19,42.1,16,26,61.5,6,16,22,11,15,15,10,2,68,1
7296,170148,206_09_41,EGYPT,0,TOTALS,EGYPT,200,24,58,41.4,22,42,52.4,2,16,12.5,14,23,60.9,13,15,28,6,16,16,10,2,64,0
7297,170161,206_09_41,COTE D'IVOIRE,0,TOTALS,COTE D'IVOIRE,200,30,59,50.8,23,39,59.0,7,20,35.0,13,18,72.2,12,29,41,14,18,21,9,2,80,1
7298,170174,206_09_42,MOROCCO,0,TOTALS,MOROCCO,200,27,58,46.6,22,39,56.4,5,19,26.3,14,23,60.9,9,20,29,11,19,14,7,2,73,0
7299,170187,206_09_42,CAF,0,TOTALS,CAF,200,30,71,42.3,23,47,48.9,7,24,29.2,14,18,77.8,16,24,40,12,19,12,8,0,81,1
7300,170200,206_09_43,MALI,0,TOTALS,MALI,200,34,66,51.5,21,35,60.0,13,31,41.9,14,19,73.7,12,27,39,24,16,11,6,1,95,1
7301,170212,206_09_43,LIBYA,0,TOTALS,LIBYA,200,30,62,48.4,24,45,53.3,6,17,35.3,7,14,50.0,9,17,26,12,19,16,7,0,73,0
7302,170224,206_09_44,RWANDA,0,TOTALS,RWANDA,200,27,60,45.0,23,45,51.1,4,15,26.7,24,36,66.7,8,26,34,12,19,10,8,1,82,1
7303,170237,206_09_44,CAMEROON,0,TOTALS,CAMEROON,200,24,60,40.0,17,38,44.7,7,22,31.8,14,18,77.8,9,28,37,11,25,22,5,2,69,0
7304,170250,206_09_45,ANGOLA,0,TOTALS,ANGOLA,200,33,67,49.3,24,42,57.1,9,25,36.0,18,26,69.2,12,22,34,21,24,11,7,1,93,1
7305,170263,206_09_45,NIGERIA,0,TOTALS,NIGERIA,200,30,65,46.2,24,40,60.0,6,25,24.0,19,26,73.1,16,18,34,9,22,11,5,1,85,0
7306,170276,206_09_46,TUNISIA,0,TOTALS,TUNISIA,200,23,59,39.0,15,40,37.5,8,19,42.1,11,18,61.1,7,14,21,12,11,18,12,1,65,0
7307,170289,206_09_46,SENEGAL,0,TOTALS,SENEGAL,200,31,63,49.2,25,48,52.1,6,15,40.0,5,10,50.0,16,25,41,14,19,24,12,4,73,1
7308,170302,206_09_47,ANGOLA,0,TOTALS,ANGOLA,200,23,53,43.4,16,33,48.5,7,20,35.0,31,43,72.1,10,25,35,17,22,13,9,5,84,1
7309,170315,206_09_47,CAF,0,TOTALS,CAF,200,21,61,34.4,16,41,39.0,5,20,25.0,16,25,64.0,14,20,34,6,31,13,8,3,63,0
7310,170328,206_09_48,EGYPT,0,TOTALS,EGYPT,200,32,65,49.2,29,49,59.2,3,16,18.8,21,31,67.7,12,33,45,12,19,16,10,3,88,1
7311,170341,206_09_48,MOROCCO,0,TOTALS,MOROCCO,200,26,69,37.7,23,48,47.9,3,21,14.3,7,15,46.7,7,24,31,8,22,14,6,4,62,0
7312,170354,206_09_49,MALI,0,TOTALS,MALI,200,27,53,50.9,20,31,64.5,7,22,31.8,12,17,70.6,11,17,28,8,20,20,11,0,73,0
7313,170367,206_09_49,TUNISIA,0,TOTALS,TUNISIA,200,26,54,48.1,22,40,55.0,4,14,28.6,18,25,72.0,11,17,28,13,20,18,7,0,74,1
7314,170379,206_09_50,LIBYA,0,TOTALS,LIBYA,200,30,71,42.3,20,43,46.5,10,28,35.7,7,13,53.8,11,31,42,15,19,11,4,1,77,0
7315,170392,206_09_50,RWANDA,0,TOTALS,RWANDA,200,25,74,33.8,14,37,37.8,11,37,29.7,19,26,73.1,16,27,43,9,14,7,10,1,80,1
7316,170405,206_09_51,NIGERIA,0,TOTALS,NIGERIA,200,31,81,38.3,27,61,44.3,4,20,20.0,14,19,73.7,18,18,36,11,24,12,18,5,80,0
7317,170418,206_09_51,CAMEROON,0,TOTALS,CAMEROON,200,28,57,49.1,17,34,50.0,11,23,47.8,17,28,60.7,10,30,40,17,16,24,3,2,84,1
7318,170431,206_09_52,COTE D'IVOIRE,0,TOTALS,COTE D'IVOIRE,200,29,72,40.3,18,43,41.9,11,29,37.9,15,26,57.7,16,13,29,14,15,13,13,1,84,1
7319,170444,206_09_52,SENEGAL,0,TOTALS,SENEGAL,200,31,55,56.4,23,34,67.6,8,21,38.1,8,14,57.1,9,29,38,23,27,28,9,4,78,0
7320,170457,206_09_53,CAF,0,TOTALS,CAF,200,26,63,41.3,16,37,43.2,10,26,38.5,18,25,72.0,9,24,33,15,25,19,10,4,80,1
7321,170470,206_09_53,MALI,0,TOTALS,MALI,200,25,61,41.0,20,38,52.6,5,23,21.7,19,25,76.0,9,26,35,7,20,19,8,5,74,0
7322,170483,206_09_54,RWANDA,0,TOTALS,RWANDA,200,30,67,44.8,20,43,46.5,10,24,41.7,8,11,72.7,8,27,35,20,17,10,5,3,78,1
7323,170496,206_09_54,EGYPT,0,TOTALS,EGYPT,200,27,70,38.6,19,42,45.2,8,28,28.6,13,18,72.2,14,25,39,9,13,9,7,3,75,0
7324,170509,206_09_55,NIGERIA,0,TOTALS,NIGERIA,200,25,60,41.7,18,39,46.2,7,21,33.3,19,22,86.4,11,25,36,11,15,15,8,0,76,1
7325,170522,206_09_55,SENEGAL,0,TOTALS,SENEGAL,200,23,64,35.9,18,39,46.2,5,25,20.0,7,10,70.0,11,21,32,11,14,15,12,4,58,0
7326,170534,206_09_56,LIBYA,0,TOTALS,LIBYA,200,32,71,45.1,26,57,45.6,6,14,42.9,10,18,55.6,14,32,46,18,19,25,8,3,80,1
7327,170547,206_09_56,MOROCCO,0,TOTALS,MOROCCO,200,26,74,35.1,23,50,46.0,3,24,12.5,21,28,75.0,17,23,40,14,19,15,13,5,76,0
7328,170560,206_09_57,ANGOLA,0,TOTALS,ANGOLA,200,28,57,49.1,22,39,56.4,6,18,33.3,17,24,70.8,6,19,25,11,23,10,4,1,79,1
7329,170573,206_09_57,TUNISIA,0,TOTALS,TUNISIA,200,24,58,41.4,18,34,52.9,6,24,25.0,15,20,75.0,12,21,33,8,19,13,3,6,69,0
7330,170586,206_09_58,CAMEROON,0,TOTALS,CAMEROON,200,22,60,36.7,17,38,44.7,5,22,22.7,12,19,63.2,9,26,35,12,18,17,6,3,61,0
7331,170599,206_09_58,COTE D'IVOIRE,0,TOTALS,COTE D'IVOIRE,200,26,59,44.1,22,47,46.8,4,12,33.3,12,21,57.1,7,27,34,11,21,11,9,3,68,1
7332,170612,206_09_59,MALI,0,TOTALS,MALI,200,21,53,39.6,14,31,45.2,7,22,31.8,14,20,70.0,4,26,30,11,15,18,6,4,63,0
7333,170625,206_09_59,SENEGAL,0,TOTALS,SENEGAL,200,28,62,45.2,20,38,52.6,8,24,33.3,10,13,76.9,8,30,38,18,20,12,10,4,74,1
7334,170638,206_09_60,CAF,0,TOTALS,CAF,200,26,77,33.8,18,45,40.0,8,32,25.0,11,18,61.1,19,20,39,11,26,9,9,2,71,0
7335,170651,206_09_60,NIGERIA,0,TOTALS,NIGERIA,200,27,66,40.9,22,47,46.8,5,19,26.3,21,32,65.6,16,32,48,6,16,13,6,5,80,1
7336,170664,206_09_61,TUNISIA,0,TOTALS,TUNISIA,200,28,57,49.1,20,33,60.6,8,24,33.3,19,21,90.5,7,15,22,15,28,12,4,5,83,1
7337,170677,206_09_61,CAMEROON,0,TOTALS,CAMEROON,200,19,57,33.3,14,35,40.0,5,22,22.7,25,36,69.4,18,16,34,6,24,15,5,4,68,0
7338,170690,206_09_62,ANGOLA,0,TOTALS,ANGOLA,200,29,60,48.3,22,43,51.2,7,17,41.2,17,29,58.6,16,21,37,12,17,16,6,2,82,1
7339,170703,206_09_62,COTE D'IVOIRE,0,TOTALS,COTE D'IVOIRE,200,25,62,40.3,15,30,50.0,10,32,31.2,12,19,63.2,12,15,27,11,23,14,11,2,72,0
7340,170716,207_09_01,EGYPT,0,TOTALS,EGYPT,200,37,70,52.9,25,43,58.1,12,27,44.4,15,26,57.7,16,27,43,24,14,6,13,2,101,0
7341,170729,207_09_01,KENYA,0,TOTALS,KENYA,200,14,51,27.5,12,38,31.6,2,13,15.4,9,14,64.3,11,15,26,8,17,29,2,1,39,1
7342,170742,207_09_02,RWANDA,0,TOTALS,RWANDA,200,39,91,42.9,29,56,51.8,10,35,28.6,5,11,45.5,21,46,67,18,19,21,12,9,93,1
7343,170753,207_09_02,UGANDA,0,TOTALS,UGANDA,200,27,94,28.7,25,71,35.2,2,23,8.7,12,22,54.5,17,27,44,9,8,19,10,2,68,0
7344,170766,207_09_03,EGYPT,0,TOTALS,EGYPT,200,38,69,55.1,32,47,68.1,6,22,27.3,13,23,56.5,11,35,46,17,22,24,20,4,95,1
7345,170779,207_09_03,UGANDA,0,TOTALS,UGANDA,200,20,63,31.7,17,43,39.5,3,20,15.0,10,20,50.0,10,20,30,6,20,29,15,4,53,0
7346,170792,207_09_04,BURUNDI,0,TOTALS,BURUNDI,200,23,76,30.3,15,42,35.7,8,34,23.5,1,8,12.5,22,19,41,9,21,23,10,0,55,1
7347,170805,207_09_04,RWANDA,0,TOTALS,RWANDA,200,36,74,48.6,23,39,59.0,13,35,37.1,15,18,83.3,20,35,55,18,17,18,16,5,100,0
7348,170818,207_09_05,BURUNDI,0,TOTALS,BURUNDI,200,18,51,35.3,15,39,38.5,3,12,25.0,11,17,64.7,8,20,28,9,34,23,6,1,50,0
7349,170831,207_09_05,EGYPT,0,TOTALS,EGYPT,200,33,66,50.0,28,44,63.6,5,22,22.7,24,52,46.2,21,24,45,15,14,13,16,1,95,1
7350,170844,207_09_06,KENYA,0,TOTALS,KENYA,200,37,79,46.8,36,62,58.1,1,17,5.9,21,32,65.6,14,34,48,10,21,21,17,2,96,1
7351,170857,207_09_06,UGANDA,0,TOTALS,UGANDA,200,30,78,38.5,23,54,42.6,7,24,29.2,16,24,66.7,15,27,42,13,24,25,11,2,83,0
7352,170870,207_09_07,KENYA,0,TOTALS,KENYA,200,29,71,40.8,23,50,46.0,6,21,28.6,16,31,51.6,15,42,57,7,13,25,16,1,80,1
7353,170883,207_09_07,BURUNDI,0,TOTALS,BURUNDI,200,25,78,32.1,20,52,38.5,5,26,19.2,4,17,23.5,15,30,45,6,21,25,15,2,59,0
7354,170896,207_09_08,UGANDA,0,TOTALS,UGANDA,200,29,72,40.3,25,52,48.1,4,20,20.0,18,33,54.5,14,21,35,6,20,26,11,4,80,0
7355,170909,207_09_08,BURUNDI,0,TOTALS,BURUNDI,200,36,75,48.0,28,55,50.9,8,20,40.0,6,17,35.3,19,27,46,19,30,27,10,1,86,1
7356,170922,207_09_09,RWANDA,0,TOTALS,RWANDA,200,25,64,39.1,19,37,51.4,6,27,22.2,25,31,80.6,12,33,45,10,15,10,10,2,81,1
7357,170935,207_09_09,KENYA,0,TOTALS,KENYA,200,25,70,35.7,16,38,42.1,9,32,28.1,8,15,53.3,18,30,48,13,23,18,8,1,67,0
7358,170947,207_09_10,ZIMBABWE,0,TOTALS,ZIMBABWE,200,25,49,51.0,20,33,60.6,5,16,31.2,3,5,60.0,12,15,27,12,27,20,9,0,58,0
7359,170960,207_09_10,SOUTH AFRICA,0,TOTALS,SOUTH AFRICA,200,26,44,59.1,23,34,67.6,3,10,30.0,13,22,59.1,7,12,19,13,14,25,10,0,68,1
7360,170973,207_09_11,MOZAMBIQUE,0,TOTALS,MOZAMBIQUE,200,27,49,55.1,20,29,69.0,7,20,35.0,13,25,52.0,12,18,30,16,11,15,12,1,74,1
7361,170986,207_09_11,ZIMBABWE,0,TOTALS,ZIMBABWE,200,15,38,39.5,10,26,38.5,5,12,41.7,6,13,46.2,9,19,28,8,22,27,5,2,41,0
7362,170999,207_09_12,SOUTH AFRICA,0,TOTALS,SOUTH AFRICA,200,26,37,70.3,16,23,69.6,10,14,71.4,8,16,50.0,1,20,21,13,27,31,9,0,70,1
7363,171012,207_09_12,MOZAMBIQUE,0,TOTALS,MOZAMBIQUE,200,24,50,48.0,18,33,54.5,6,17,35.3,14,29,48.3,10,13,23,18,18,19,15,0,68,0
7364,171025,207_09_13,SOUTH AFRICA,0,TOTALS,SOUTH AFRICA,200,32,48,66.7,26,33,78.8,6,15,40.0,12,32,37.5,11,26,37,20,22,26,12,0,82,1
7365,171038,207_09_13,ZIMBABWE,0,TOTALS,ZIMBABWE,200,19,45,42.2,19,41,46.3,0,4,0.0,13,29,44.8,12,13,25,4,25,27,8,2,51,0
7366,171051,207_09_14,ZIMBABWE,0,TOTALS,ZIMBABWE,200,21,45,46.7,20,34,58.8,1,11,9.1,5,11,45.5,5,22,27,13,18,24,9,2,48,0
7367,171064,207_09_14,MOZAMBIQUE,0,TOTALS,MOZAMBIQUE,200,27,56,48.2,18,28,64.3,9,28,32.1,10,16,62.5,11,25,36,22,14,20,13,0,73,1
7368,171077,207_09_15,MOZAMBIQUE,0,TOTALS,MOZAMBIQUE,200,30,57,52.6,23,31,74.2,7,26,26.9,14,23,60.9,10,20,30,14,24,20,17,1,81,1
7369,171090,207_09_15,SOUTH AFRICA,0,TOTALS,SOUTH AFRICA,200,20,38,52.6,14,24,58.3,6,14,42.9,21,33,63.6,6,21,27,6,23,34,9,1,67,0
7370,171103,207_09_16,MALI,0,TOTALS,MALI,11,25,52,48.1,20,34,58.8,5,18,27.8,14,29,48.3,3,16,19,4,19,21,4,4,69,1
7371,171116,207_09_16,SENEGAL,0,TOTALS,SENEGAL,11,20,56,35.7,18,38,47.4,2,18,11.1,19,30,63.3,6,12,18,2,23,7,2,1,61,0
7372,171129,207_09_17,SENEGAL,0,TOTALS,SENEGAL,12,21,60,35.0,11,28,39.3,10,32,31.2,8,20,40.0,6,21,27,0,24,9,0,2,60,1
7373,171142,207_09_17,MALI,0,TOTALS,MALI,12,20,56,35.7,19,38,50.0,1,18,5.6,16,30,53.3,3,23,26,9,15,4,4,2,57,0
7374,171155,207_09_18,CAF,0,TOTALS,CAF,200,31,77,40.3,22,44,50.0,9,33,27.3,14,28,50.0,15,19,34,4,24,13,19,2,85,1
7375,171168,207_09_18,REPUBLIC OF CONGO,0,TOTALS,REPUBLIC OF CONGO,200,26,48,54.2,20,32,62.5,6,16,37.5,16,23,69.6,4,19,23,2,20,19,6,2,74,0
7376,171181,207_09_19,REPUBLIC OF CONGO,0,TOTALS,REPUBLIC OF CONGO,200,27,73,37.0,26,58,44.8,1,15,6.7,12,23,52.2,16,27,43,9,25,18,7,0,67,0
7377,171188,207_09_19,DEM.REP. OF CONGO,0,TOTALS,DEM.REP. OF CONGO,200,26,74,35.1,21,48,43.8,5,26,19.2,22,29,75.9,9,24,33,41,18,11,17,3,79,1
7378,171200,207_09_20,DEM.REP. OF CONGO,0,TOTALS,DEM.REP. OF CONGO,200,14,55,25.5,9,27,33.3,5,28,17.9,9,15,60.0,7,13,20,11,14,14,3,3,42,0
7379,171213,207_09_20,CAF,0,TOTALS,CAF,200,35,64,54.7,27,47,57.4,8,17,47.1,5,10,50.0,10,33,43,14,21,13,18,1,83,1
7380,171226,207_09_21,REPUBLIC OF CONGO,0,TOTALS,REPUBLIC OF CONGO,200,22,59,37.3,19,41,46.3,3,18,16.7,18,27,66.7,15,15,30,11,14,18,9,0,65,1
7381,171239,207_09_21,CAF,0,TOTALS,CAF,200,36,68,52.9,24,40,60.0,12,28,42.9,17,23,73.9,14,26,40,23,23,27,8,1,101,0
7382,171251,207_09_22,DEM.REP. OF CONGO,0,TOTALS,DEM.REP. OF CONGO,200,28,64,43.8,23,37,62.2,5,27,18.5,13,28,46.4,7,19,26,30,21,14,11,3,74,0
7383,171264,207_09_22,REPUBLIC OF CONGO,0,TOTALS,REPUBLIC OF CONGO,200,25,57,43.9,16,34,47.1,9,23,39.1,27,37,73.0,14,25,39,2,22,12,7,0,86,1
7384,172930,211_09_01,PHILIPPINES,0,TOTALS,PHILIPPINES,200,46,81,56.8,40,62,64.5,6,19,31.6,17,27,63.0,22,37,59,19,17,14,14,0,115,0
7385,172943,211_09_01,SRI LANKA,0,TOTALS,SRI LANKA,200,10,52,19.2,8,39,20.5,2,13,15.4,9,23,39.1,6,13,19,3,20,21,5,0,31,1
7386,172956,211_09_02,KAZAKHSTAN,0,TOTALS,KAZAKHSTAN,200,21,71,29.6,12,49,24.5,9,22,40.9,11,20,55.0,21,22,43,10,19,20,4,1,62,0
7387,172969,211_09_02,QATAR,0,TOTALS,QATAR,200,29,62,46.8,22,43,51.2,7,19,36.8,12,22,54.5,14,29,43,12,18,21,9,7,77,1
7388,172982,211_09_03,KOREA,0,TOTALS,KOREA,200,37,66,56.1,30,47,63.8,7,19,36.8,14,18,77.8,10,26,36,15,15,11,7,3,95,1
7389,172994,211_09_03,JAPAN,0,TOTALS,JAPAN,200,24,62,38.7,14,40,35.0,10,22,45.5,16,19,84.2,10,15,25,6,15,12,6,0,74,0
7390,173007,211_09_04,IRAN,0,TOTALS,IRAN,200,27,62,43.5,20,40,50.0,7,22,31.8,10,16,62.5,11,27,38,17,16,10,10,4,71,1
7391,173020,211_09_04,CHINESE TAIPEI,0,TOTALS,CHINESE TAIPEI,200,27,69,39.1,20,42,47.6,7,27,25.9,6,8,75.0,12,23,35,10,16,14,4,1,67,0
7392,173033,211_09_05,INDIA,0,TOTALS,INDIA,200,18,78,23.1,15,55,27.3,3,23,13.0,10,12,83.3,12,20,32,7,32,15,5,1,49,1
7393,173046,211_09_05,CHINA,0,TOTALS,CHINA,200,37,61,60.7,19,33,57.6,18,28,64.3,29,39,74.4,6,41,47,18,12,9,11,4,121,0
7394,173059,211_09_06,INDONESIA,0,TOTALS,INDONESIA,225,23,78,29.5,15,45,33.3,8,33,24.2,9,16,56.2,12,41,53,16,26,19,4,0,63,0
7395,173072,211_09_06,UNITED ARAB EMIRATES,0,TOTALS,UNITED ARAB EMIRATES,225,23,66,34.8,17,47,36.2,6,19,31.6,16,33,48.5,8,36,44,10,14,15,8,1,68,1
7396,173083,211_09_07,KUWAIT,0,TOTALS,KUWAIT,200,29,70,41.4,25,50,50.0,4,20,20.0,7,17,41.2,13,24,37,13,23,8,6,1,69,1
7397,173096,211_09_07,UZBEKISTAN,0,TOTALS,UZBEKISTAN,200,21,57,36.8,15,30,50.0,6,27,22.2,16,20,80.0,12,30,42,10,18,19,6,3,64,0
7398,173109,211_09_08,LEBANON,0,TOTALS,LEBANON,200,25,60,41.7,17,39,43.6,8,21,38.1,9,11,81.8,9,17,26,16,22,25,11,2,67,0
7399,173122,211_09_08,JORDAN,0,TOTALS,JORDAN,200,31,65,47.7,26,54,48.1,5,11,45.5,17,26,65.4,13,21,34,6,16,19,15,0,84,1
7400,173135,211_09_09,KOREA,0,TOTALS,KOREA,200,41,75,54.7,16,24,66.7,25,51,49.0,15,21,71.4,12,31,43,22,4,4,9,4,122,0
7401,173148,211_09_09,SRI LANKA,0,TOTALS,SRI LANKA,200,25,68,36.8,24,59,40.7,1,9,11.1,3,5,60.0,6,23,29,10,17,12,3,0,54,1
7402,173161,211_09_10,JORDAN,0,TOTALS,JORDAN,200,39,79,49.4,32,56,57.1,7,23,30.4,20,32,62.5,27,35,62,15,11,15,14,0,105,0
7403,173174,211_09_10,INDONESIA,0,TOTALS,INDONESIA,200,19,66,28.8,16,36,44.4,3,30,10.0,6,9,66.7,10,16,26,7,21,21,9,2,47,1
7404,173187,211_09_11,LEBANON,0,TOTALS,LEBANON,200,42,70,60.0,32,47,68.1,10,23,43.5,14,21,66.7,11,41,52,22,21,14,8,2,108,0
7405,173200,211_09_11,UNITED ARAB EMIRATES,0,TOTALS,UNITED ARAB EMIRATES,200,11,54,20.4,9,34,26.5,2,20,10.0,14,26,53.8,5,14,19,4,19,19,8,1,38,1
7406,173213,211_09_12,CHINESE TAIPEI,0,TOTALS,CHINESE TAIPEI,200,29,59,49.2,24,42,57.1,5,17,29.4,10,16,62.5,9,30,39,17,15,24,15,4,73,1
7407,173224,211_09_12,KUWAIT,0,TOTALS,KUWAIT,200,22,63,34.9,18,51,35.3,4,12,33.3,3,7,42.9,13,22,35,7,15,26,11,2,51,0
7408,173237,211_09_13,KAZAKHSTAN,0,TOTALS,KAZAKHSTAN,200,19,62,30.6,13,41,31.7,6,21,28.6,12,16,75.0,17,15,32,5,17,17,10,2,56,0
7409,173250,211_09_13,CHINA,0,TOTALS,CHINA,200,28,61,45.9,21,42,50.0,7,19,36.8,11,15,73.3,16,23,39,10,20,15,8,4,74,1
7410,173263,211_09_14,QATAR,0,TOTALS,QATAR,200,29,55,52.7,21,39,53.8,8,16,50.0,29,39,74.4,12,27,39,11,12,21,11,2,95,1
7411,173276,211_09_14,INDIA,0,TOTALS,INDIA,200,26,72,36.1,16,36,44.4,10,36,27.8,8,14,57.1,10,17,27,9,32,22,12,1,70,0
7412,173288,211_09_15,JAPAN,0,TOTALS,JAPAN,200,19,67,28.4,15,50,30.0,4,17,23.5,27,32,84.4,18,30,48,3,11,12,4,1,69,0
7413,173301,211_09_15,PHILIPPINES,0,TOTALS,PHILIPPINES,200,32,70,45.7,23,41,56.1,9,29,31.0,5,10,50.0,7,29,36,16,24,9,5,3,78,1
7414,173314,211_09_16,IRAN,0,TOTALS,IRAN,200,31,69,44.9,27,47,57.4,4,22,18.2,16,25,64.0,14,25,39,11,21,22,22,6,82,1
7415,173327,211_09_16,UZBEKISTAN,0,TOTALS,UZBEKISTAN,200,24,65,36.9,17,39,43.6,7,26,26.9,6,14,42.9,11,28,39,9,16,33,17,1,61,0
7416,173340,211_09_17,UNITED ARAB EMIRATES,0,TOTALS,UNITED ARAB EMIRATES,200,27,64,42.2,20,41,48.8,7,23,30.4,6,7,85.7,10,13,23,6,19,16,8,1,67,0
7417,173353,211_09_17,JORDAN,0,TOTALS,JORDAN,200,32,66,48.5,27,42,64.3,5,24,20.8,10,15,66.7,20,26,46,10,15,19,13,1,79,1
7418,173366,211_09_18,UZBEKISTAN,0,TOTALS,UZBEKISTAN,200,27,60,45.0,21,34,61.8,6,26,23.1,18,26,69.2,12,29,41,10,19,22,7,2,78,1
7419,173379,211_09_18,CHINESE TAIPEI,0,TOTALS,CHINESE TAIPEI,200,35,76,46.1,24,47,51.1,11,29,37.9,21,28,75.0,14,22,36,20,21,15,14,0,102,0
7420,173392,211_09_19,SRI LANKA,0,TOTALS,SRI LANKA,200,19,64,29.7,17,54,31.5,2,10,20.0,5,11,45.5,10,12,22,5,23,25,3,0,45,1
7421,173404,211_09_19,JAPAN,0,TOTALS,JAPAN,200,56,81,69.1,42,54,77.8,14,27,51.9,22,31,71.0,14,31,45,35,11,5,19,3,148,0
7422,173415,211_09_20,KUWAIT,0,TOTALS,KUWAIT,200,19,60,31.7,16,42,38.1,3,18,16.7,5,7,71.4,8,17,25,7,20,15,4,1,46,0
7423,173428,211_09_20,IRAN,0,TOTALS,IRAN,200,36,66,54.5,26,41,63.4,10,25,40.0,12,21,57.1,15,28,43,18,14,12,10,4,94,1
7424,173441,211_09_21,CHINA,0,TOTALS,CHINA,200,36,69,52.2,25,39,64.1,11,30,36.7,9,13,69.2,8,25,33,21,24,13,13,7,92,1
7425,173454,211_09_21,QATAR,0,TOTALS,QATAR,200,22,62,35.5,20,47,42.6,2,15,13.3,15,23,65.2,16,17,33,11,15,21,4,0,61,0
7426,173467,211_09_22,INDIA,0,TOTALS,INDIA,200,27,63,42.9,18,41,43.9,9,22,40.9,9,20,45.0,8,17,25,12,25,12,8,0,72,0
7427,173480,211_09_22,KAZAKHSTAN,0,TOTALS,KAZAKHSTAN,200,25,48,52.1,21,38,55.3,4,10,40.0,20,33,60.6,7,26,33,11,19,18,8,7,74,1
7428,173493,211_09_23,PHILIPPINES,0,TOTALS,PHILIPPINES,200,23,77,29.9,19,50,38.0,4,27,14.8,6,11,54.5,14,27,41,6,25,10,6,3,56,0
7429,173506,211_09_23,KOREA,0,TOTALS,KOREA,200,23,63,36.5,19,41,46.3,4,22,18.2,19,27,70.4,10,37,47,12,16,13,1,5,69,1
7430,173519,211_09_24,INDONESIA,0,TOTALS,INDONESIA,200,16,58,27.6,14,38,36.8,2,20,10.0,2,4,50.0,8,12,20,8,25,22,5,0,36,1
7431,173532,211_09_24,LEBANON,0,TOTALS,LEBANON,200,45,75,60.0,32,48,66.7,13,27,48.1,20,34,58.8,17,34,51,18,8,11,16,2,123,0
7432,173545,211_09_25,KOREA,0,TOTALS,KOREA,200,26,61,42.6,15,32,46.9,11,29,37.9,15,22,68.2,11,24,35,18,20,9,7,2,78,1
7433,173556,211_09_25,KUWAIT,0,TOTALS,KUWAIT,200,20,52,38.5,15,37,40.5,5,15,33.3,13,17,76.5,6,21,27,4,22,15,1,0,58,0
7434,173569,211_09_26,KAZAKHSTAN,0,TOTALS,KAZAKHSTAN,200,26,53,49.1,19,39,48.7,7,14,50.0,21,28,75.0,11,17,28,6,18,18,4,2,80,0
7435,173582,211_09_26,JORDAN,0,TOTALS,JORDAN,200,38,58,65.5,31,42,73.8,7,16,43.8,15,25,60.0,5,20,25,6,22,7,12,2,98,1
7436,173594,211_09_27,JAPAN,0,TOTALS,JAPAN,200,27,68,39.7,20,43,46.5,7,25,28.0,10,11,90.9,8,22,30,18,21,20,11,1,71,1
7437,173607,211_09_27,IRAN,0,TOTALS,IRAN,200,37,66,56.1,30,46,65.2,7,20,35.0,20,29,69.0,6,32,38,20,15,17,17,6,101,0
7438,173620,211_09_28,PHILIPPINES,0,TOTALS,PHILIPPINES,200,27,65,41.5,12,35,34.3,15,30,50.0,8,18,44.4,10,27,37,13,23,16,5,1,77,1
7439,173633,211_09_28,CHINESE TAIPEI,0,TOTALS,CHINESE TAIPEI,200,26,60,43.3,25,45,55.6,1,15,6.7,17,25,68.0,8,34,42,7,16,13,6,6,70,0
7440,173646,211_09_29,SRI LANKA,0,TOTALS,SRI LANKA,200,16,68,23.5,14,49,28.6,2,19,10.5,13,24,54.2,10,18,28,8,26,22,13,0,47,0
7441,173659,211_09_29,UZBEKISTAN,0,TOTALS,UZBEKISTAN,200,31,65,47.7,25,45,55.6,6,20,30.0,22,31,71.0,13,33,46,8,18,26,10,3,90,1
7442,173672,211_09_30,CHINA,0,TOTALS,CHINA,200,28,64,43.8,19,42,45.2,9,22,40.9,17,25,68.0,17,34,51,17,13,17,8,6,82,1
7443,173685,211_09_30,UNITED ARAB EMIRATES,0,TOTALS,UNITED ARAB EMIRATES,200,22,61,36.1,15,40,37.5,7,21,33.3,8,15,53.3,3,18,21,12,18,10,9,0,59,0
7444,173698,211_09_31,INDIA,0,TOTALS,INDIA,200,34,67,50.7,26,48,54.2,8,19,42.1,15,21,71.4,19,31,50,13,25,23,10,9,91,1
7445,173711,211_09_31,INDONESIA,0,TOTALS,INDONESIA,200,16,54,29.6,13,38,34.2,3,16,18.8,17,23,73.9,5,14,19,5,18,21,11,2,52,0
7446,173724,211_09_32,QATAR,0,TOTALS,QATAR,200,23,62,37.1,19,48,39.6,4,14,28.6,13,22,59.1,17,28,45,12,19,19,10,1,63,0
7447,173737,211_09_32,LEBANON,0,TOTALS,LEBANON,200,25,64,39.1,16,39,41.0,9,25,36.0,14,22,63.6,13,21,34,17,19,14,12,5,73,1
7448,173750,211_09_33,UNITED ARAB EMIRATES,0,TOTALS,UNITED ARAB EMIRATES,200,20,62,32.3,14,41,34.1,6,21,28.6,10,14,71.4,5,8,13,7,17,13,12,2,56,0
7449,173763,211_09_33,KAZAKHSTAN,0,TOTALS,KAZAKHSTAN,200,32,57,56.1,23,41,56.1,9,16,56.2,11,17,64.7,13,34,47,7,19,24,9,3,84,1
7450,173776,211_09_34,IRAN,0,TOTALS,IRAN,200,29,56,51.8,22,42,52.4,7,14,50.0,23,30,76.7,10,24,34,18,6,14,10,5,88,1
7451,173789,211_09_34,PHILIPPINES,0,TOTALS,PHILIPPINES,200,30,76,39.5,14,33,42.4,16,43,37.2,2,4,50.0,15,17,32,5,23,15,6,2,78,0
7452,173800,211_09_35,KUWAIT,0,TOTALS,KUWAIT,200,17,52,32.7,14,38,36.8,3,14,21.4,14,23,60.9,9,24,33,8,22,23,8,4,51,0
7453,173812,211_09_35,JAPAN,0,TOTALS,JAPAN,200,26,68,38.2,18,46,39.1,8,22,36.4,18,21,85.7,13,25,38,13,24,15,12,3,78,1
7454,173825,211_09_36,CHINESE TAIPEI,0,TOTALS,CHINESE TAIPEI,200,25,62,40.3,18,43,41.9,7,19,36.8,13,18,72.2,3,24,27,14,22,17,13,0,70,0
7455,173838,211_09_36,KOREA,0,TOTALS,KOREA,200,25,62,40.3,20,42,47.6,5,20,25.0,17,26,65.4,15,31,46,13,24,22,9,8,72,1
7456,173851,211_09_37,SRI LANKA,0,TOTALS,SRI LANKA,200,14,67,20.9,12,56,21.4,2,11,18.2,12,24,50.0,11,23,34,4,20,18,8,2,42,0
7457,173864,211_09_37,INDONESIA,0,TOTALS,INDONESIA,200,28,69,40.6,22,45,48.9,6,24,25.0,12,18,66.7,15,41,56,11,21,21,8,6,74,1
7458,173877,211_09_38,LEBANON,0,TOTALS,LEBANON,200,26,71,36.6,21,56,37.5,5,15,33.3,11,21,52.4,18,18,36,8,20,8,5,2,68,0
7459,173890,211_09_38,CHINA,0,TOTALS,CHINA,200,28,55,50.9,24,42,57.1,4,13,30.8,11,20,55.0,7,28,35,13,22,15,6,7,71,1
7460,173903,211_09_39,UZBEKISTAN,0,TOTALS,UZBEKISTAN,200,21,58,36.2,13,26,50.0,8,32,25.0,23,37,62.2,4,15,19,10,22,14,7,1,73,0
7461,173916,211_09_39,INDIA,0,TOTALS,INDIA,200,35,63,55.6,32,49,65.3,3,14,21.4,16,30,53.3,13,30,43,14,25,15,11,1,89,1
7462,173929,211_09_40,JORDAN,0,TOTALS,JORDAN,200,26,62,41.9,18,36,50.0,8,26,30.8,14,20,70.0,10,23,33,13,21,12,9,3,74,1
7463,173942,211_09_40,QATAR,0,TOTALS,QATAR,200,20,56,35.7,17,39,43.6,3,17,17.6,17,22,77.3,14,22,36,7,14,14,5,2,60,0
7464,173955,211_09_41,PHILIPPINES,0,TOTALS,PHILIPPINES,200,32,63,50.8,25,44,56.8,7,19,36.8,14,22,63.6,11,30,41,8,21,15,3,1,85,1
7465,173966,211_09_41,KUWAIT,0,TOTALS,KUWAIT,200,28,64,43.8,24,44,54.5,4,20,20.0,11,16,68.8,7,18,25,6,21,12,6,2,71,0
7466,173979,211_09_42,QATAR,0,TOTALS,QATAR,200,34,64,53.1,29,48,60.4,5,16,31.2,18,24,75.0,11,40,51,11,10,15,11,1,91,1
7467,173992,211_09_42,UNITED ARAB EMIRATES,0,TOTALS,UNITED ARAB EMIRATES,200,15,64,23.4,6,28,21.4,9,36,25.0,6,8,75.0,7,18,25,5,15,16,4,1,45,0
7468,174004,211_09_43,JAPAN,0,TOTALS,JAPAN,200,29,67,43.3,23,44,52.3,6,23,26.1,15,17,88.2,8,23,31,13,22,11,1,4,79,0
7469,174017,211_09_43,CHINESE TAIPEI,0,TOTALS,CHINESE TAIPEI,200,37,75,49.3,27,54,50.0,10,21,47.6,15,27,55.6,15,28,43,20,19,3,8,2,99,1
7470,174030,211_09_44,KAZAKHSTAN,0,TOTALS,KAZAKHSTAN,200,22,63,34.9,15,36,41.7,7,27,25.9,5,7,71.4,7,18,25,13,13,17,3,4,56,1
7471,174043,211_09_44,LEBANON,0,TOTALS,LEBANON,200,41,74,55.4,30,56,53.6,11,18,61.1,12,16,75.0,12,31,43,25,11,10,9,2,105,0
7472,174056,211_09_45,CHINA,0,TOTALS,CHINA,200,28,62,45.2,24,48,50.0,4,14,28.6,29,34,85.3,10,30,40,17,29,11,5,3,89,1
7473,174069,211_09_45,JORDAN,0,TOTALS,JORDAN,200,26,68,38.2,21,45,46.7,5,23,21.7,26,34,76.5,9,20,29,8,24,7,4,2,83,0
7474,174082,211_09_46,KOREA,0,TOTALS,KOREA,200,22,58,37.9,13,35,37.1,9,23,39.1,13,20,65.0,8,22,30,17,19,12,5,5,66,0
7475,174095,211_09_46,IRAN,0,TOTALS,IRAN,200,32,72,44.4,26,57,45.6,6,15,40.0,12,18,66.7,17,27,44,22,16,10,9,7,82,1
7476,174106,211_09_47,KUWAIT,0,TOTALS,KUWAIT,200,25,63,39.7,21,46,45.7,4,17,23.5,3,7,42.9,9,11,20,10,21,14,7,0,57,0
7477,174119,211_09_47,KAZAKHSTAN,0,TOTALS,KAZAKHSTAN,200,27,55,49.1,24,42,57.1,3,13,23.1,19,26,73.1,14,24,38,8,16,18,7,4,76,1
7478,174131,211_09_48,JAPAN,0,TOTALS,JAPAN,200,32,66,48.5,23,42,54.8,9,24,37.5,13,20,65.0,9,34,43,16,14,10,4,7,86,1
7479,174144,211_09_48,UNITED ARAB EMIRATES,0,TOTALS,UNITED ARAB EMIRATES,200,23,72,31.9,18,51,35.3,5,21,23.8,8,15,53.3,12,25,37,8,17,7,6,0,59,0
7480,174157,211_09_49,JORDAN,0,TOTALS,JORDAN,200,29,69,42.0,21,38,55.3,8,31,25.8,15,26,57.7,17,30,47,11,20,11,6,0,81,1
7481,174170,211_09_49,PHILIPPINES,0,TOTALS,PHILIPPINES,200,23,66,34.8,11,29,37.9,12,37,32.4,12,19,63.2,11,26,37,12,22,12,7,2,70,0
7482,174183,211_09_50,QATAR,0,TOTALS,QATAR,200,22,58,37.9,11,38,28.9,11,20,55.0,10,14,71.4,11,20,31,13,18,18,11,1,65,0
7483,174196,211_09_50,IRAN,0,TOTALS,IRAN,200,28,63,44.4,22,44,50.0,6,19,31.6,13,18,72.2,13,23,36,13,18,17,9,5,75,1
7484,174209,211_09_51,CHINESE TAIPEI,0,TOTALS,CHINESE TAIPEI,200,36,69,52.2,28,48,58.3,8,21,38.1,3,12,25.0,6,18,24,17,17,18,11,2,83,1
7485,174222,211_09_51,CHINA,0,TOTALS,CHINA,200,37,69,53.6,26,51,51.0,11,18,61.1,16,22,72.7,13,27,40,20,12,21,16,4,101,0
7486,174235,211_09_52,KOREA,0,TOTALS,KOREA,200,24,63,38.1,14,33,42.4,10,30,33.3,7,17,41.2,14,20,34,13,24,12,11,2,65,0
7487,174248,211_09_52,LEBANON,0,TOTALS,LEBANON,200,23,53,43.4,18,34,52.9,5,19,26.3,17,25,68.0,12,27,39,9,21,19,7,2,68,1
7488,174261,211_09_53,UNITED ARAB EMIRATES,0,TOTALS,UNITED ARAB EMIRATES,200,22,57,38.6,17,36,47.2,5,21,23.8,12,23,52.2,11,18,29,5,16,12,6,0,61,0
7489,174272,211_09_53,KUWAIT,0,TOTALS,KUWAIT,200,27,53,50.9,25,41,61.0,2,12,16.7,9,19,47.4,8,22,30,13,21,13,7,2,65,1
7490,174285,211_09_54,KAZAKHSTAN,0,TOTALS,KAZAKHSTAN,200,27,61,44.3,24,48,50.0,3,13,23.1,20,26,76.9,17,24,41,8,12,13,4,2,77,1
7491,174297,211_09_54,JAPAN,0,TOTALS,JAPAN,200,30,71,42.3,22,50,44.0,8,21,38.1,5,5,100.0,12,17,29,14,19,12,7,2,73,0
7492,174310,211_09_55,PHILIPPINES,0,TOTALS,PHILIPPINES,200,25,78,32.1,17,37,45.9,8,41,19.5,7,14,50.0,11,25,36,12,22,5,3,1,65,0
7493,174323,211_09_55,QATAR,0,TOTALS,QATAR,200,27,59,45.8,20,41,48.8,7,18,38.9,22,34,64.7,9,42,51,5,14,12,3,4,83,1
7494,174336,211_09_56,IRAN,0,TOTALS,IRAN,200,26,57,45.6,18,37,48.6,8,20,40.0,17,24,70.8,5,32,37,16,16,11,5,5,77,1
7495,174349,211_09_56,JORDAN,0,TOTALS,JORDAN,200,26,73,35.6,17,45,37.8,9,28,32.1,14,18,77.8,17,21,38,9,21,5,5,1,75,0
7496,174362,211_09_57,KOREA,0,TOTALS,KOREA,200,24,62,38.7,21,47,44.7,3,15,20.0,14,18,77.8,11,27,38,11,22,16,10,2,65,0
7497,174375,211_09_57,CHINESE TAIPEI,0,TOTALS,CHINESE TAIPEI,200,26,56,46.4,21,36,58.3,5,20,25.0,13,22,59.1,5,22,27,13,15,15,7,5,70,1
7498,174388,211_09_58,CHINA,0,TOTALS,CHINA,200,24,50,48.0,20,38,52.6,4,12,33.3,20,30,66.7,5,28,33,12,20,13,4,5,72,1
7499,174401,211_09_58,LEBANON,0,TOTALS,LEBANON,200,24,62,38.7,20,42,47.6,4,20,20.0,16,21,76.2,6,24,30,10,25,7,8,0,68,0
7500,174414,211_09_59,PHILIPPINES,0,TOTALS,PHILIPPINES,200,30,63,47.6,26,44,59.1,4,19,21.1,16,21,76.2,11,27,38,6,20,13,4,2,80,0
7501,174427,211_09_59,KOREA,0,TOTALS,KOREA,200,32,71,45.1,28,53,52.8,4,18,22.2,14,18,77.8,11,20,31,10,23,6,8,2,82,1
7502,174440,211_09_60,JORDAN,0,TOTALS,JORDAN,200,30,66,45.5,19,39,48.7,11,27,40.7,9,14,64.3,10,28,38,9,25,9,7,2,80,1
7503,174453,211_09_60,LEBANON,0,TOTALS,LEBANON,200,18,60,30.0,9,37,24.3,9,23,39.1,21,29,72.4,10,24,34,7,19,12,5,2,66,0
7504,174466,211_09_61,QATAR,0,TOTALS,QATAR,200,31,61,50.8,24,39,61.5,7,22,31.8,10,15,66.7,10,20,30,14,18,20,6,2,79,0
7505,174479,211_09_61,CHINESE TAIPEI,0,TOTALS,CHINESE TAIPEI,200,28,53,52.8,19,30,63.3,9,23,39.1,22,26,84.6,3,17,20,18,12,14,7,4,87,1
7506,174492,211_09_62,IRAN,0,TOTALS,IRAN,200,31,68,45.6,27,49,55.1,4,19,21.1,4,14,28.6,19,25,44,16,18,14,8,3,70,1
7507,174505,211_09_62,CHINA,0,TOTALS,CHINA,200,22,59,37.3,20,41,48.8,2,18,11.1,6,10,60.0,5,23,28,6,18,12,5,1,52,0
7508,175326,215_09_01,VIRGIN ISLANDS,0,TOTALS,VIRGIN ISLANDS,200,22,65,33.8,17,43,39.5,5,22,22.7,13,17,76.5,10,22,32,10,24,9,8,4,62,0
7509,175339,215_09_01,URUGUAY,0,TOTALS,URUGUAY,200,32,61,52.5,24,39,61.5,8,22,36.4,16,25,64.0,9,34,43,19,16,14,4,2,88,1
7510,175352,215_09_02,DOMINICAN REPUBLIC,0,TOTALS,DOMINICAN REPUBLIC,200,26,64,40.6,15,40,37.5,11,24,45.8,5,10,50.0,10,27,37,16,17,17,7,6,68,0
7511,175365,215_09_02,BRAZIL,0,TOTALS,BRAZIL,200,32,72,44.4,25,52,48.1,7,20,35.0,10,15,66.7,16,29,45,22,12,14,6,4,81,1
7512,175378,215_09_03,VENEZUELA,0,TOTALS,VENEZUELA,200,26,51,51.0,22,37,59.5,4,14,28.6,29,36,80.6,9,25,34,18,20,22,11,5,85,1
7513,175391,215_09_03,ARGENTINA,0,TOTALS,ARGENTINA,200,23,66,34.8,17,42,40.5,6,24,25.0,17,22,77.3,19,20,39,13,29,23,5,3,69,0
7514,175404,215_09_04,MEXICO,0,TOTALS,MEXICO,200,21,57,36.8,14,36,38.9,7,21,33.3,17,26,65.4,5,28,33,11,19,14,8,1,66,0
7515,175417,215_09_04,PUERTO RICO,0,TOTALS,PUERTO RICO,200,29,63,46.0,20,36,55.6,9,27,33.3,14,20,70.0,10,33,43,21,18,13,8,2,81,1
7516,175430,215_09_05,PANAMA,0,TOTALS,PANAMA,200,28,71,39.4,17,44,38.6,11,27,40.7,20,25,80.0,12,22,34,15,23,13,10,0,87,1
7517,175443,215_09_05,DOMINICAN REPUBLIC,0,TOTALS,DOMINICAN REPUBLIC,200,34,59,57.6,21,34,61.8,13,25,52.0,19,27,70.4,6,34,40,21,21,19,9,6,100,0
7518,175456,215_09_06,CANADA,0,TOTALS,CANADA,200,35,71,49.3,16,38,42.1,19,33,57.6,6,10,60.0,15,36,51,30,21,13,10,4,95,1
7519,175469,215_09_06,MEXICO,0,TOTALS,MEXICO,200,13,60,21.7,10,38,26.3,3,22,13.6,11,23,47.8,14,22,36,9,13,15,8,2,40,0
7520,175482,215_09_07,BRAZIL,0,TOTALS,BRAZIL,200,33,62,53.2,26,40,65.0,7,22,31.8,14,24,58.3,14,27,41,18,20,19,10,1,87,1
7521,175495,215_09_07,VENEZUELA,0,TOTALS,VENEZUELA,200,26,62,41.9,23,48,47.9,3,14,21.4,12,17,70.6,11,20,31,16,28,16,7,2,67,0
7522,175508,215_09_08,PUERTO RICO,0,TOTALS,PUERTO RICO,200,28,53,52.8,19,31,61.3,9,22,40.9,20,31,64.5,8,26,34,16,22,14,7,5,85,1
7523,175521,215_09_08,VIRGIN ISLANDS,0,TOTALS,VIRGIN ISLANDS,200,26,64,40.6,22,48,45.8,4,16,25.0,18,25,72.0,13,21,34,17,26,14,6,2,74,0
7524,175534,215_09_09,ARGENTINA,0,TOTALS,ARGENTINA,200,26,63,41.3,22,42,52.4,4,21,19.0,11,15,73.3,12,22,34,19,22,16,8,0,67,0
7525,175547,215_09_09,BRAZIL,0,TOTALS,BRAZIL,200,29,54,53.7,23,37,62.2,6,17,35.3,12,16,75.0,4,28,32,12,15,14,8,3,76,1
7526,175560,215_09_10,VIRGIN ISLANDS,0,TOTALS,VIRGIN ISLANDS,200,20,57,35.1,14,37,37.8,6,20,30.0,21,28,75.0,15,22,37,13,24,22,6,4,67,0
7527,175573,215_09_10,CANADA,0,TOTALS,CANADA,200,27,64,42.2,20,42,47.6,7,22,31.8,26,28,92.9,13,28,41,17,26,12,14,5,87,1
7528,175586,215_09_11,VENEZUELA,0,TOTALS,VENEZUELA,200,23,63,36.5,19,49,38.8,4,14,28.6,21,27,77.8,15,27,42,14,15,19,6,6,71,0
7529,175599,215_09_11,PANAMA,0,TOTALS,PANAMA,200,33,69,47.8,25,54,46.3,8,15,53.3,6,12,50.0,11,30,41,16,25,19,8,6,80,1
7530,175612,215_09_12,URUGUAY,0,TOTALS,URUGUAY,200,20,61,32.8,18,43,41.9,2,18,11.1,12,16,75.0,12,21,33,7,17,15,10,3,54,0
7531,175625,215_09_12,PUERTO RICO,0,TOTALS,PUERTO RICO,200,28,57,49.1,21,35,60.0,7,22,31.8,8,12,66.7,12,29,41,17,18,21,4,5,71,1
7532,175638,215_09_13,MEXICO,0,TOTALS,MEXICO,200,27,59,45.8,24,43,55.8,3,16,18.8,23,29,79.3,7,36,43,26,20,15,9,9,80,1
7533,175651,215_09_13,VIRGIN ISLANDS,0,TOTALS,VIRGIN ISLANDS,200,23,67,34.3,20,51,39.2,3,16,18.8,14,25,56.0,13,27,40,12,25,13,5,2,63,0
7534,175664,215_09_14,CANADA,0,TOTALS,CANADA,200,24,52,46.2,19,30,63.3,5,22,22.7,16,20,80.0,8,21,29,15,26,17,4,4,69,0
7535,175677,215_09_14,URUGUAY,0,TOTALS,URUGUAY,200,22,51,43.1,14,28,50.0,8,23,34.8,19,26,73.1,12,18,30,14,19,18,7,0,71,1
7536,175690,215_09_15,DOMINICAN REPUBLIC,0,TOTALS,DOMINICAN REPUBLIC,200,32,76,42.1,27,58,46.6,5,18,27.8,9,11,81.8,17,29,46,16,15,11,3,3,78,1
7537,175703,215_09_15,VENEZUELA,0,TOTALS,VENEZUELA,200,29,70,41.4,24,50,48.0,5,20,25.0,10,15,66.7,15,29,44,10,16,14,4,4,73,0
7538,175716,215_09_16,PANAMA,0,TOTALS,PANAMA,200,20,58,34.5,17,40,42.5,3,18,16.7,12,17,70.6,13,24,37,7,24,20,10,5,55,0
7539,175729,215_09_16,ARGENTINA,0,TOTALS,ARGENTINA,200,24,58,41.4,16,34,47.1,8,24,33.3,24,28,85.7,10,28,38,17,21,16,14,3,80,1
7540,175742,215_09_17,URUGUAY,0,TOTALS,URUGUAY,200,18,59,30.5,14,45,31.1,4,14,28.6,14,26,53.8,11,34,45,14,16,17,12,4,54,1
7541,175755,215_09_17,MEXICO,0,TOTALS,MEXICO,200,20,60,33.3,15,39,38.5,5,21,23.8,4,9,44.4,8,35,43,13,23,20,6,8,49,0
7542,175768,215_09_18,BRAZIL,0,TOTALS,BRAZIL,200,32,61,52.5,23,42,54.8,9,19,47.4,11,17,64.7,14,25,39,24,21,19,10,2,84,1
7543,175781,215_09_18,PANAMA,0,TOTALS,PANAMA,200,23,60,38.3,19,48,39.6,4,12,33.3,14,23,60.9,16,18,34,11,17,18,6,1,64,0
7544,175794,215_09_19,ARGENTINA,0,TOTALS,ARGENTINA,225,29,67,43.3,16,39,41.0,13,28,46.4,18,24,75.0,12,23,35,17,24,6,1,1,89,1
7545,175807,215_09_19,DOMINICAN REPUBLIC,0,TOTALS,DOMINICAN REPUBLIC,225,31,71,43.7,22,52,42.3,9,19,47.4,16,26,61.5,20,28,48,19,23,10,4,2,87,0
7546,175820,215_09_20,PUERTO RICO,0,TOTALS,PUERTO RICO,200,31,61,50.8,19,35,54.3,12,26,46.2,16,21,76.2,11,26,37,12,20,10,6,2,90,1
7547,175833,215_09_20,CANADA,0,TOTALS,CANADA,200,24,55,43.6,12,32,37.5,12,23,52.2,10,17,58.8,8,21,29,14,18,13,7,2,70,0
7548,175846,215_09_21,URUGUAY,0,TOTALS,URUGUAY,200,29,62,46.8,20,38,52.6,9,24,37.5,7,12,58.3,11,16,27,20,20,15,10,2,74,0
7549,175859,215_09_21,DOMINICAN REPUBLIC,0,TOTALS,DOMINICAN REPUBLIC,200,30,64,46.9,23,45,51.1,7,19,36.8,13,13,100.0,18,21,39,17,18,18,12,6,80,1
7550,175872,215_09_22,CANADA,0,TOTALS,CANADA,200,24,57,42.1,22,41,53.7,2,16,12.5,1,4,25.0,10,27,37,12,12,23,6,1,51,0
7551,175885,215_09_22,ARGENTINA,0,TOTALS,ARGENTINA,200,25,60,41.7,15,37,40.5,10,23,43.5,7,7,100.0,7,24,31,15,12,14,16,2,67,1
7552,175898,215_09_23,MEXICO,0,TOTALS,MEXICO,200,22,56,39.3,17,44,38.6,5,12,41.7,12,17,70.6,7,27,34,14,18,19,4,2,61,0
7553,175911,215_09_23,BRAZIL,0,TOTALS,BRAZIL,200,39,76,51.3,34,63,54.0,5,13,38.5,9,16,56.2,13,29,42,19,19,9,10,4,92,1
7554,175924,215_09_24,PUERTO RICO,0,TOTALS,PUERTO RICO,200,28,63,44.4,18,39,46.2,10,24,41.7,13,15,86.7,16,33,49,16,10,15,9,6,79,1
7555,175937,215_09_24,PANAMA,0,TOTALS,PANAMA,200,22,71,31.0,17,51,33.3,5,20,25.0,2,4,50.0,16,19,35,7,13,15,8,3,51,0
7556,175950,215_09_25,BRAZIL,0,TOTALS,BRAZIL,200,23,52,44.2,19,36,52.8,4,16,25.0,18,21,85.7,8,25,33,8,14,15,7,3,68,1
7557,175963,215_09_25,CANADA,0,TOTALS,CANADA,200,23,62,37.1,18,47,38.3,5,15,33.3,8,12,66.7,14,20,34,14,26,12,7,2,59,0
7558,175976,215_09_26,PANAMA,0,TOTALS,PANAMA,200,29,63,46.0,17,40,42.5,12,23,52.2,13,17,76.5,11,27,38,16,13,8,6,6,83,1
7559,175989,215_09_26,URUGUAY,0,TOTALS,URUGUAY,200,28,65,43.1,21,45,46.7,7,20,35.0,14,16,87.5,10,26,36,19,16,8,5,1,77,0
7560,176002,215_09_27,ARGENTINA,0,TOTALS,ARGENTINA,200,31,67,46.3,22,49,44.9,9,18,50.0,6,9,66.7,7,30,37,17,12,11,7,4,77,1
7561,176015,215_09_27,MEXICO,0,TOTALS,MEXICO,200,26,63,41.3,23,47,48.9,3,16,18.8,10,11,90.9,7,28,35,15,12,13,7,1,65,0
7562,176028,215_09_28,DOMINICAN REPUBLIC,0,TOTALS,DOMINICAN REPUBLIC,200,30,71,42.3,26,52,50.0,4,19,21.1,12,16,75.0,17,28,45,16,17,10,3,4,76,0
7563,176041,215_09_28,PUERTO RICO,0,TOTALS,PUERTO RICO,200,30,62,48.4,15,33,45.5,15,29,51.7,10,15,66.7,7,24,31,16,19,11,3,1,85,1
7564,176054,215_09_29,CANADA,0,TOTALS,CANADA,200,31,66,47.0,19,39,48.7,12,27,44.4,23,24,95.8,11,23,34,23,14,7,14,3,97,1
7565,176067,215_09_29,PANAMA,0,TOTALS,PANAMA,200,23,57,40.4,19,40,47.5,4,17,23.5,15,19,78.9,10,26,36,6,19,20,3,2,65,0
7566,176080,215_09_30,MEXICO,0,TOTALS,MEXICO,200,25,60,41.7,15,36,41.7,10,24,41.7,13,23,56.5,13,20,33,15,14,19,2,2,73,0
7567,176093,215_09_30,DOMINICAN REPUBLIC,0,TOTALS,DOMINICAN REPUBLIC,200,32,62,51.6,24,43,55.8,8,19,42.1,14,19,73.7,12,24,36,19,21,17,5,4,86,1
7568,176106,215_09_31,URUGUAY,0,TOTALS,URUGUAY,200,21,63,33.3,16,48,33.3,5,15,33.3,15,17,88.2,9,24,33,11,21,13,5,1,62,0
7569,176119,215_09_31,BRAZIL,0,TOTALS,BRAZIL,200,27,58,46.6,18,35,51.4,9,23,39.1,19,24,79.2,8,34,42,18,17,16,8,8,82,1
7570,176132,215_09_32,PUERTO RICO,0,TOTALS,PUERTO RICO,200,28,63,44.4,17,39,43.6,11,24,45.8,11,15,73.3,9,22,31,17,21,11,8,1,78,0
7571,176145,215_09_32,ARGENTINA,0,TOTALS,ARGENTINA,200,25,56,44.6,15,39,38.5,10,17,58.8,20,24,83.3,10,26,36,18,17,13,4,3,80,1
7572,176158,215_09_33,PANAMA,0,TOTALS,PANAMA,200,25,74,33.8,19,50,38.0,6,24,25.0,11,20,55.0,23,29,52,9,24,14,6,1,67,0
7573,176171,215_09_33,MEXICO,0,TOTALS,MEXICO,200,26,66,39.4,21,44,47.7,5,22,22.7,17,25,68.0,15,31,46,20,15,11,8,8,74,1
7574,176184,215_09_34,ARGENTINA,0,TOTALS,ARGENTINA,200,31,59,52.5,26,36,72.2,5,23,21.7,6,9,66.7,7,26,33,19,12,13,9,8,73,1
7575,176197,215_09_34,URUGUAY,0,TOTALS,URUGUAY,200,24,63,38.1,17,42,40.5,7,21,33.3,11,14,78.6,12,21,33,9,10,15,8,2,66,0
7576,176210,215_09_35,DOMINICAN REPUBLIC,0,TOTALS,DOMINICAN REPUBLIC,200,30,72,41.7,25,51,49.0,5,21,23.8,11,13,84.6,18,26,44,18,12,14,6,7,76,0
7577,176223,215_09_35,CANADA,0,TOTALS,CANADA,200,27,62,43.5,13,35,37.1,14,27,51.9,12,15,80.0,9,24,33,22,17,14,8,2,80,1
7578,176236,215_09_36,BRAZIL,0,TOTALS,BRAZIL,200,31,71,43.7,23,50,46.0,8,21,38.1,12,18,66.7,17,19,36,16,17,7,9,2,82,0
7579,176249,215_09_36,PUERTO RICO,0,TOTALS,PUERTO RICO,200,28,57,49.1,16,27,59.3,12,30,40.0,18,22,81.8,9,26,35,20,20,15,5,2,86,1
7580,176262,215_09_37,BRAZIL,0,TOTALS,BRAZIL,200,29,63,46.0,22,39,56.4,7,24,29.2,8,14,57.1,10,27,37,21,17,12,9,5,73,1
7581,176275,215_09_37,CANADA,0,TOTALS,CANADA,200,22,56,39.3,16,40,40.0,6,16,37.5,15,20,75.0,8,28,36,19,20,14,5,2,65,0
7582,176288,215_09_38,PUERTO RICO,0,TOTALS,PUERTO RICO,200,28,59,47.5,19,32,59.4,9,27,33.3,20,23,87.0,8,31,39,15,23,17,6,7,85,1
7583,176301,215_09_38,ARGENTINA,0,TOTALS,ARGENTINA,200,25,66,37.9,18,46,39.1,7,20,35.0,23,26,88.5,10,22,32,19,21,8,11,3,80,0
7584,176314,215_09_39,ARGENTINA,0,TOTALS,ARGENTINA,200,31,70,44.3,19,39,48.7,12,31,38.7,14,19,73.7,13,26,39,18,18,7,6,0,88,1
7585,176327,215_09_39,CANADA,0,TOTALS,CANADA,200,28,60,46.7,23,43,53.5,5,17,29.4,12,17,70.6,8,27,35,15,20,14,6,2,73,0
7586,176340,215_09_40,PUERTO RICO,0,TOTALS,PUERTO RICO,200,24,67,35.8,19,46,41.3,5,21,23.8,7,11,63.6,10,37,47,11,16,8,3,1,60,0
7587,176353,215_09_40,BRAZIL,0,TOTALS,BRAZIL,200,23,59,39.0,19,44,43.2,4,15,26.7,11,17,64.7,3,33,36,15,13,4,3,0,61,1
7588,176886,217_09_01,ARGENTINA,0,TOTALS,ARGENTINA,200,25,75,33.3,21,50,42.0,4,25,16.0,22,25,88.0,12,26,38,15,32,11,3,3,76,0
7589,176899,217_09_01,BRAZIL,0,TOTALS,BRAZIL,200,31,68,45.6,26,53,49.1,5,15,33.3,24,36,66.7,9,38,47,18,25,12,6,1,91,1
7590,176911,217_09_02,PUERTO RICO,0,TOTALS,PUERTO RICO,200,20,67,29.9,13,44,29.5,7,23,30.4,13,20,65.0,7,34,41,12,21,11,6,9,60,1
7591,176922,217_09_02,CANADA,0,TOTALS,CANADA,200,16,60,26.7,10,37,27.0,6,23,26.1,17,24,70.8,11,34,45,9,19,16,9,9,55,0
7592,176935,217_09_03,CANADA,0,TOTALS,CANADA,200,32,64,50.0,21,46,45.7,11,18,61.1,11,16,68.8,12,28,40,16,21,13,3,3,86,1
7593,176948,217_09_03,ARGENTINA,0,TOTALS,ARGENTINA,200,24,55,43.6,18,36,50.0,6,19,31.6,18,24,75.0,5,20,25,12,15,10,6,2,72,0
7594,176960,217_09_04,BRAZIL,0,TOTALS,BRAZIL,200,28,64,43.8,27,54,50.0,1,10,10.0,23,36,63.9,13,26,39,17,20,8,4,5,80,1
7595,176973,217_09_04,PUERTO RICO,0,TOTALS,PUERTO RICO,200,23,64,35.9,13,35,37.1,10,29,34.5,14,17,82.4,8,22,30,14,25,12,2,4,70,0
7596,176984,217_09_05,BRAZIL,0,TOTALS,BRAZIL,200,34,60,56.7,26,44,59.1,8,16,50.0,11,18,61.1,6,28,34,20,15,13,8,4,87,1
7597,176995,217_09_05,CANADA,0,TOTALS,CANADA,200,26,63,41.3,20,43,46.5,6,20,30.0,11,14,78.6,5,21,26,16,17,12,8,3,69,0
7598,177007,217_09_06,PUERTO RICO,0,TOTALS,PUERTO RICO,200,22,58,37.9,14,31,45.2,8,27,29.6,15,22,68.2,6,33,39,14,16,16,7,5,67,1
7599,177020,217_09_06,ARGENTINA,0,TOTALS,ARGENTINA,200,18,62,29.0,11,41,26.8,7,21,33.3,12,14,85.7,5,28,33,11,21,13,6,2,55,0
7600,177032,218_09_01,TRINIDAD AND TOBAGO,0,TOTALS,TRINIDAD AND TOBAGO,200,34,57,59.6,27,42,64.3,7,15,46.7,13,18,72.2,7,24,31,13,23,17,3,1,88,1
7601,177044,218_09_01,JAMAICA,0,TOTALS,JAMAICA,200,24,60,40.0,14,30,46.7,10,30,33.3,18,26,69.2,8,13,21,18,16,10,5,2,76,0
7602,177055,218_09_02,CUBA,0,TOTALS,CUBA,200,23,52,44.2,10,25,40.0,13,27,48.1,32,47,68.1,9,20,29,13,26,9,7,4,91,1
7603,177066,218_09_02,ANTIGUA,0,TOTALS,ANTIGUA,200,28,59,47.5,23,38,60.5,5,21,23.8,18,29,62.1,10,18,28,10,28,9,3,1,79,0
7604,177078,218_09_03,BAHAMAS,0,TOTALS,BAHAMAS,200,28,57,49.1,21,35,60.0,7,22,31.8,12,24,50.0,6,20,26,12,18,7,7,2,75,1
7605,177091,218_09_03,BARBADOS,0,TOTALS,BARBADOS,200,28,64,43.8,23,48,47.9,5,16,31.2,12,22,54.5,9,20,29,14,21,5,4,1,73,0
7606,177103,218_09_04,BRITISH VIRGIN ISLANDS,0,TOTALS,BRITISH VIRGIN ISLANDS,200,32,72,44.4,23,50,46.0,9,22,40.9,12,28,42.9,17,32,49,20,19,8,16,5,85,1
7607,177116,218_09_04,BERMUDA,0,TOTALS,BERMUDA,200,13,58,22.4,10,44,22.7,3,14,21.4,10,18,55.6,6,16,22,3,21,2,4,1,39,0
7608,177127,218_09_05,JAMAICA,0,TOTALS,JAMAICA,200,26,59,44.1,24,44,54.5,2,15,13.3,23,33,69.7,9,17,26,8,26,9,6,3,77,1
7609,177138,218_09_05,BAHAMAS,0,TOTALS,BAHAMAS,200,22,55,40.0,14,34,41.2,8,21,38.1,21,27,77.8,5,15,20,7,30,10,5,0,73,0
7610,177150,218_09_06,BERMUDA,0,TOTALS,BERMUDA,200,14,64,21.9,12,45,26.7,2,19,10.5,7,16,43.8,5,11,16,3,14,3,9,0,37,0
7611,177163,218_09_06,CUBA,0,TOTALS,CUBA,200,33,65,50.8,21,35,60.0,12,30,40.0,17,24,70.8,14,37,51,16,21,10,12,4,95,1
7612,177176,218_09_07,BARBADOS,0,TOTALS,BARBADOS,200,25,86,29.1,20,53,37.7,5,33,15.2,8,11,72.7,11,15,26,7,15,7,10,0,63,0
7613,177188,218_09_07,TRINIDAD AND TOBAGO,0,TOTALS,TRINIDAD AND TOBAGO,200,35,78,44.9,29,57,50.9,6,21,28.6,14,20,70.0,18,35,53,13,15,6,2,6,90,1
7614,177199,218_09_08,ANTIGUA,0,TOTALS,ANTIGUA,200,19,62,30.6,15,38,39.5,4,24,16.7,18,24,75.0,7,13,20,2,21,12,13,0,60,0
7615,177211,218_09_08,BRITISH VIRGIN ISLANDS,0,TOTALS,BRITISH VIRGIN ISLANDS,200,22,54,40.7,16,31,51.6,6,23,26.1,17,25,68.0,13,21,34,12,17,18,11,8,67,1
7616,177221,218_09_09,TRINIDAD AND TOBAGO,0,TOTALS,TRINIDAD AND TOBAGO,200,31,77,40.3,26,55,47.3,5,22,22.7,19,25,76.0,12,22,34,11,14,7,6,1,86,1
7617,177232,218_09_09,BAHAMAS,0,TOTALS,BAHAMAS,200,31,72,43.1,19,40,47.5,12,32,37.5,8,16,50.0,12,17,29,15,21,12,5,1,82,0
7618,177245,218_09_10,ANTIGUA,0,TOTALS,ANTIGUA,200,24,66,36.4,19,47,40.4,5,19,26.3,17,38,44.7,14,18,32,11,19,10,9,6,70,1
7619,177257,218_09_10,BERMUDA,0,TOTALS,BERMUDA,200,19,53,35.8,13,39,33.3,6,14,42.9,15,19,78.9,11,20,31,7,21,9,9,1,59,0
7620,177270,218_09_11,BARBADOS,0,TOTALS,BARBADOS,200,24,55,43.6,18,42,42.9,6,13,46.2,20,30,66.7,5,13,18,4,27,7,6,1,74,0
7621,177282,218_09_11,JAMAICA,0,TOTALS,JAMAICA,200,32,73,43.8,24,47,51.1,8,26,30.8,24,30,80.0,13,12,25,11,23,5,5,1,96,1
7622,177293,218_09_12,BRITISH VIRGIN ISLANDS,0,TOTALS,BRITISH VIRGIN ISLANDS,200,29,79,36.7,24,58,41.4,5,21,23.8,14,27,51.9,12,18,30,14,25,8,5,1,77,0
7623,177304,218_09_12,CUBA,0,TOTALS,CUBA,200,29,67,43.3,24,50,48.0,5,17,29.4,21,31,67.7,11,33,44,12,28,10,5,0,84,1
7624,177315,218_09_13,BAHAMAS,0,TOTALS,BAHAMAS,200,38,74,51.4,29,46,63.0,9,28,32.1,15,20,75.0,12,29,41,14,13,9,10,3,100,0
7625,177327,218_09_13,BERMUDA,0,TOTALS,BERMUDA,200,24,65,36.9,19,46,41.3,5,19,26.3,6,10,60.0,7,19,26,9,20,13,5,0,59,1
7626,177339,218_09_14,ANTIGUA,0,TOTALS,ANTIGUA,200,26,71,36.6,23,53,43.4,3,18,16.7,12,15,80.0,16,23,39,6,27,7,8,0,67,0
7627,177351,218_09_14,BARBADOS,0,TOTALS,BARBADOS,200,25,53,47.2,17,31,54.8,8,22,36.4,21,39,53.8,6,21,27,9,21,5,11,2,79,1
7628,177364,218_09_15,CUBA,0,TOTALS,CUBA,225,37,71,52.1,26,42,61.9,11,29,37.9,8,9,88.9,9,16,25,8,26,6,7,0,93,0
7629,177374,218_09_15,JAMAICA,0,TOTALS,JAMAICA,225,34,67,50.7,29,51,56.9,5,16,31.2,25,31,80.6,5,12,17,3,16,6,6,4,98,1
7630,177384,218_09_16,TRINIDAD AND TOBAGO,0,TOTALS,TRINIDAD AND TOBAGO,200,26,64,40.6,18,47,38.3,8,17,47.1,13,20,65.0,10,23,33,9,20,7,7,3,73,0
7631,177395,218_09_16,BRITISH VIRGIN ISLANDS,0,TOTALS,BRITISH VIRGIN ISLANDS,200,27,71,38.0,22,48,45.8,5,23,21.7,17,26,65.4,10,16,26,8,17,9,8,5,76,1
7632,177407,218_09_17,BERMUDA,0,TOTALS,BERMUDA,200,19,60,31.7,16,43,37.2,3,17,17.6,4,8,50.0,5,16,21,8,16,8,11,1,45,0
7633,177419,218_09_17,ANTIGUA,0,TOTALS,ANTIGUA,200,32,68,47.1,31,59,52.5,1,9,11.1,8,17,47.1,17,28,45,15,9,6,11,4,73,1
7634,177430,218_09_18,BAHAMAS,0,TOTALS,BAHAMAS,200,30,65,46.2,20,46,43.5,10,19,52.6,24,28,85.7,11,15,26,11,20,5,9,5,94,1
7635,177441,218_09_18,BARBADOS,0,TOTALS,BARBADOS,200,29,68,42.6,18,38,47.4,11,30,36.7,18,25,72.0,9,16,25,9,24,5,9,0,87,0
7636,177451,218_09_19,CUBA,0,TOTALS,CUBA,200,34,68,50.0,23,47,48.9,11,21,52.4,12,16,75.0,10,20,30,14,17,1,11,3,91,1
7637,177464,218_09_19,TRINIDAD AND TOBAGO,0,TOTALS,TRINIDAD AND TOBAGO,200,30,62,48.4,26,48,54.2,4,14,28.6,13,19,68.4,5,19,24,14,14,3,8,0,77,0
7638,177475,218_09_20,JAMAICA,0,TOTALS,JAMAICA,200,20,59,33.9,17,44,38.6,3,15,20.0,22,31,71.0,6,21,27,5,20,19,6,3,65,1
7639,177487,218_09_20,BRITISH VIRGIN ISLANDS,0,TOTALS,BRITISH VIRGIN ISLANDS,200,24,61,39.3,20,44,45.5,4,17,23.5,9,14,64.3,8,26,34,11,26,15,6,1,61,0
7640,177500,219_09_01,PUERTO RICO,0,TOTALS,PUERTO RICO,200,32,86,37.2,27,60,45.0,5,26,19.2,12,14,85.7,14,16,30,10,20,22,11,5,81,0
7641,177510,219_09_01,VENEZUELA,0,TOTALS,VENEZUELA,200,36,66,54.5,33,56,58.9,3,10,30.0,12,20,60.0,11,33,44,20,21,27,13,4,87,1
7642,177523,219_09_02,CANADA,0,TOTALS,CANADA,200,35,79,44.3,29,61,47.5,6,18,33.3,14,23,60.9,17,40,57,9,19,19,13,6,90,1
7643,177536,219_09_02,MEXICO,0,TOTALS,MEXICO,200,16,69,23.2,11,44,25.0,5,25,20.0,7,16,43.8,10,22,32,7,19,25,11,2,44,0
7644,177548,219_09_03,BRAZIL,0,TOTALS,BRAZIL,200,27,62,43.5,22,47,46.8,5,15,33.3,23,37,62.2,9,16,25,6,20,18,12,0,82,1
7645,177561,219_09_03,USA,0,TOTALS,USA,200,40,81,49.4,28,53,52.8,12,28,42.9,18,32,56.2,22,29,51,22,27,22,9,7,110,0
7646,177573,219_09_04,ARGENTINA,0,TOTALS,ARGENTINA,200,45,90,50.0,39,69,56.5,6,21,28.6,10,21,47.6,14,26,40,23,22,15,11,1,106,0
7647,177585,219_09_04,BAHAMAS,0,TOTALS,BAHAMAS,200,28,68,41.2,27,58,46.6,1,10,10.0,15,24,62.5,14,29,43,0,22,27,7,9,72,1
7648,177598,219_09_05,VENEZUELA,0,TOTALS,VENEZUELA,200,29,86,33.7,26,69,37.7,3,17,17.6,15,28,53.6,26,26,52,8,29,20,7,4,76,1
7649,177611,219_09_05,USA,0,TOTALS,USA,200,36,84,42.9,31,63,49.2,5,21,23.8,25,37,67.6,22,32,54,12,23,22,10,10,102,0
7650,177623,219_09_06,BAHAMAS,0,TOTALS,BAHAMAS,200,24,81,29.6,18,53,34.0,6,28,21.4,15,29,51.7,14,28,42,9,20,16,9,4,69,0
7651,177636,219_09_06,CANADA,0,TOTALS,CANADA,200,29,71,40.8,18,49,36.7,11,22,50.0,19,28,67.9,12,41,53,12,23,17,7,7,88,1
7652,177648,219_09_07,BRAZIL,0,TOTALS,BRAZIL,200,30,59,50.8,24,39,61.5,6,20,30.0,15,17,88.2,8,28,36,14,31,24,4,4,81,0
7653,177659,219_09_07,PUERTO RICO,0,TOTALS,PUERTO RICO,200,28,69,40.6,26,55,47.3,2,14,14.3,25,43,58.1,14,15,29,5,17,14,17,4,83,1
7654,177672,219_09_08,MEXICO,0,TOTALS,MEXICO,200,8,50,16.0,8,39,20.5,0,11,0.0,19,35,54.3,8,26,34,2,30,35,5,4,35,0
7655,177684,219_09_08,ARGENTINA,0,TOTALS,ARGENTINA,200,27,82,32.9,22,53,41.5,5,29,17.2,25,45,55.6,29,34,63,11,28,19,21,3,84,1
7656,177695,219_09_09,VENEZUELA,0,TOTALS,VENEZUELA,200,29,67,43.3,24,51,47.1,5,16,31.2,18,37,48.6,21,22,43,11,13,21,13,4,81,1
7657,177707,219_09_09,BRAZIL,0,TOTALS,BRAZIL,200,24,65,36.9,21,46,45.7,3,19,15.8,7,12,58.3,7,21,28,10,28,23,10,3,58,0
7658,177718,219_09_10,BAHAMAS,0,TOTALS,BAHAMAS,225,27,87,31.0,22,54,40.7,5,33,15.2,14,29,48.3,18,35,53,8,27,20,13,5,73,0
7659,177729,219_09_10,MEXICO,0,TOTALS,MEXICO,225,32,85,37.6,28,67,41.8,4,18,22.2,16,31,51.6,19,37,56,9,24,24,10,6,84,1
7660,177742,219_09_11,USA,0,TOTALS,USA,200,46,74,62.2,36,53,67.9,10,21,47.6,24,35,68.6,17,28,45,22,23,15,15,12,126,0
7661,177755,219_09_11,PUERTO RICO,0,TOTALS,PUERTO RICO,200,27,80,33.8,18,55,32.7,9,25,36.0,10,17,58.8,23,9,32,12,23,21,4,2,73,1
7662,177767,219_09_12,ARGENTINA,0,TOTALS,ARGENTINA,225,31,66,47.0,26,44,59.1,5,22,22.7,20,44,45.5,12,25,37,8,32,20,9,6,87,1
7663,177780,219_09_12,CANADA,0,TOTALS,CANADA,225,29,73,39.7,25,56,44.6,4,17,23.5,19,34,55.9,18,30,48,13,30,20,7,1,81,0
7664,177792,219_09_13,PUERTO RICO,0,TOTALS,PUERTO RICO,200,27,88,30.7,19,52,36.5,8,36,22.2,20,30,66.7,18,27,45,10,23,14,15,8,82,1
7665,177803,219_09_13,BAHAMAS,0,TOTALS,BAHAMAS,200,26,63,41.3,23,53,43.4,3,10,30.0,19,32,59.4,13,39,52,8,27,29,8,8,74,0
7666,177814,219_09_14,MEXICO,0,TOTALS,MEXICO,225,29,64,45.3,22,47,46.8,7,17,41.2,15,27,55.6,12,20,32,7,26,30,15,3,80,0
7667,177826,219_09_14,BRAZIL,0,TOTALS,BRAZIL,225,22,64,34.4,15,42,35.7,7,22,31.8,32,41,78.0,19,23,42,11,30,30,14,0,83,1
7668,177839,219_09_15,USA,0,TOTALS,USA,200,52,106,49.1,39,64,60.9,13,42,31.0,9,13,69.2,33,28,61,17,18,9,6,8,126,0
7669,177852,219_09_15,CANADA,0,TOTALS,CANADA,200,27,75,36.0,18,46,39.1,9,29,31.0,15,24,62.5,15,18,33,12,14,13,5,6,78,1
7670,177864,219_09_16,ARGENTINA,0,TOTALS,ARGENTINA,200,27,66,40.9,22,46,47.8,5,20,25.0,7,12,58.3,9,24,33,11,22,14,9,5,66,1
7671,177874,219_09_16,VENEZUELA,0,TOTALS,VENEZUELA,200,20,46,43.5,18,40,45.0,2,6,33.3,16,25,64.0,0,27,27,5,17,21,5,2,58,0
7672,177883,219_09_17,BAHAMAS,0,TOTALS,BAHAMAS,225,34,76,44.7,26,51,51.0,8,25,32.0,11,19,57.9,13,36,49,11,19,12,9,4,87,1
7673,177896,219_09_17,MEXICO,0,TOTALS,MEXICO,225,34,82,41.5,28,61,45.9,6,21,28.6,9,22,40.9,8,23,31,12,12,12,3,2,83,0
7674,177906,219_09_18,PUERTO RICO,0,TOTALS,PUERTO RICO,200,24,72,33.3,16,47,34.0,8,25,32.0,23,30,76.7,16,17,33,8,20,10,13,3,79,0
7675,177918,219_09_18,BRAZIL,0,TOTALS,BRAZIL,200,28,58,48.3,24,43,55.8,4,15,26.7,22,30,73.3,14,28,42,16,26,20,5,3,82,1
7676,177931,219_09_19,CANADA,0,TOTALS,CANADA,200,37,76,48.7,25,51,49.0,12,25,48.0,20,28,71.4,12,32,44,16,15,17,9,11,106,0
7677,177942,219_09_19,VENEZUELA,0,TOTALS,VENEZUELA,200,28,83,33.7,22,62,35.5,6,21,28.6,19,26,73.1,17,29,46,11,22,16,12,3,81,1
7678,177954,219_09_20,ARGENTINA,0,TOTALS,ARGENTINA,200,31,77,40.3,19,44,43.2,12,33,36.4,13,20,65.0,15,11,26,17,29,14,10,3,87,1
7679,177967,219_09_20,USA,0,TOTALS,USA,200,38,81,46.9,30,59,50.8,8,22,36.4,17,37,45.9,29,28,57,10,17,25,8,4,101,0
7680,178468,221_09_01,BRAZIL,0,TOTALS,BRAZIL,200,43,69,62.3,36,51,70.6,7,18,38.9,17,26,65.4,21,16,37,21,19,5,4,4,110,0
7681,178480,221_09_01,COLOMBIA,0,TOTALS,COLOMBIA,200,21,53,39.6,13,29,44.8,8,24,33.3,10,15,66.7,1,13,14,8,18,11,2,1,60,1
7682,178493,221_09_02,VENEZUELA,0,TOTALS,VENEZUELA,200,27,85,31.8,24,65,36.9,3,20,15.0,16,19,84.2,23,21,44,12,16,9,16,1,73,1
7683,178502,221_09_02,CHILE,0,TOTALS,CHILE,200,24,58,41.4,19,38,50.0,5,20,25.0,12,20,60.0,15,26,41,10,21,20,6,5,65,0
7684,178515,221_09_03,VENEZUELA,0,TOTALS,VENEZUELA,200,24,46,52.2,23,37,62.2,1,9,11.1,27,44,61.4,9,15,24,4,20,14,11,1,76,1
7685,178528,221_09_03,BOLIVIA,0,TOTALS,BOLIVIA,200,24,54,44.4,17,33,51.5,7,21,33.3,10,18,55.6,8,14,22,4,32,15,6,2,65,0
7686,178540,221_09_04,CHILE,0,TOTALS,CHILE,200,16,45,35.6,12,28,42.9,4,17,23.5,18,30,60.0,5,19,24,1,27,7,3,0,54,0
7687,178553,221_09_04,BRAZIL,0,TOTALS,BRAZIL,200,31,68,45.6,23,46,50.0,8,22,36.4,20,32,62.5,17,23,40,10,23,9,4,1,90,1
7688,178566,221_09_05,ARGENTINA,0,TOTALS,ARGENTINA,200,31,64,48.4,25,46,54.3,6,18,33.3,21,36,58.3,20,32,52,12,17,12,7,1,89,1
7689,178579,221_09_05,PARAGUAY,0,TOTALS,PARAGUAY,200,25,67,37.3,20,45,44.4,5,22,22.7,5,14,35.7,11,16,27,8,23,12,7,1,60,0
7690,178592,221_09_06,URUGUAY,0,TOTALS,URUGUAY,200,37,64,57.8,24,32,75.0,13,32,40.6,12,19,63.2,15,23,38,18,9,14,6,0,99,1
7691,178603,221_09_06,ECUADOR,0,TOTALS,ECUADOR,200,22,53,41.5,13,24,54.2,9,29,31.0,6,12,50.0,4,12,16,9,17,12,5,3,59,0
7692,178615,221_09_07,COLOMBIA,0,TOTALS,COLOMBIA,200,23,69,33.3,19,53,35.8,4,16,25.0,11,26,42.3,10,18,28,12,18,14,2,0,61,0
7693,178626,221_09_07,CHILE,0,TOTALS,CHILE,200,36,68,52.9,24,41,58.5,12,27,44.4,7,13,53.8,7,24,31,16,23,10,5,2,91,1
7694,178638,221_09_08,BRAZIL,0,TOTALS,BRAZIL,200,35,59,59.3,32,49,65.3,3,10,30.0,18,27,66.7,16,27,43,11,10,15,7,10,91,1
7695,178650,221_09_08,BOLIVIA,0,TOTALS,BOLIVIA,200,12,56,21.4,7,39,17.9,5,17,29.4,2,4,50.0,6,7,13,5,21,15,11,3,31,0
7696,178661,221_09_09,PARAGUAY,0,TOTALS,PARAGUAY,200,28,71,39.4,23,56,41.1,5,15,33.3,12,17,70.6,8,31,39,8,16,16,6,1,73,1
7697,178671,221_09_09,ECUADOR,0,TOTALS,ECUADOR,200,24,61,39.3,14,35,40.0,10,26,38.5,7,13,53.8,5,25,30,6,17,15,5,4,65,0
7698,178684,221_09_10,ARGENTINA,0,TOTALS,ARGENTINA,200,21,60,35.0,15,41,36.6,6,19,31.6,17,30,56.7,9,21,30,6,27,20,9,4,65,1
7699,178695,221_09_10,URUGUAY,0,TOTALS,URUGUAY,200,15,51,29.4,11,37,29.7,4,14,28.6,23,29,79.3,6,31,37,8,24,23,5,3,57,0
7700,178707,221_09_11,CHILE,0,TOTALS,CHILE,200,33,67,49.3,25,49,51.0,8,18,44.4,10,14,71.4,10,34,44,14,18,25,19,1,84,1
7701,178720,221_09_11,BOLIVIA,0,TOTALS,BOLIVIA,200,18,62,29.0,15,42,35.7,3,20,15.0,5,14,35.7,7,16,23,2,14,22,18,2,44,0
7702,178733,221_09_12,VENEZUELA,0,TOTALS,VENEZUELA,200,28,66,42.4,25,51,49.0,3,15,20.0,14,24,58.3,13,26,39,9,16,17,17,1,73,1
7703,178746,221_09_12,COLOMBIA,0,TOTALS,COLOMBIA,200,24,63,38.1,22,48,45.8,2,15,13.3,8,13,61.5,9,20,29,11,19,28,10,3,58,0
7704,178757,221_09_13,COLOMBIA,0,TOTALS,COLOMBIA,200,18,54,33.3,17,41,41.5,1,13,7.7,33,58,56.9,20,35,55,7,17,16,10,2,70,1
7705,178770,221_09_13,BOLIVIA,0,TOTALS,BOLIVIA,200,20,65,30.8,12,33,36.4,8,32,25.0,2,11,18.2,11,21,32,9,33,14,10,4,50,0
7706,178783,221_09_14,VENEZUELA,0,TOTALS,VENEZUELA,200,9,62,14.5,6,48,12.5,3,14,21.4,17,23,73.9,12,14,26,4,30,24,10,2,38,1
7707,178796,221_09_14,BRAZIL,0,TOTALS,BRAZIL,200,34,66,51.5,25,53,47.2,9,13,69.2,24,37,64.9,18,36,54,17,19,14,12,10,101,0
7708,178809,221_09_15,ECUADOR,0,TOTALS,ECUADOR,200,14,56,25.0,11,33,33.3,3,23,13.0,8,12,66.7,3,15,18,8,16,9,8,4,39,0
7709,178821,221_09_15,ARGENTINA,0,TOTALS,ARGENTINA,200,30,76,39.5,22,49,44.9,8,27,29.6,10,13,76.9,16,29,45,14,12,11,3,4,78,1
7710,178834,221_09_16,URUGUAY,0,TOTALS,URUGUAY,200,34,63,54.0,27,45,60.0,7,18,38.9,7,13,53.8,6,25,31,22,19,18,13,4,82,1
7711,178846,221_09_16,PARAGUAY,0,TOTALS,PARAGUAY,200,21,57,36.8,15,34,44.1,6,23,26.1,11,20,55.0,5,21,26,10,13,18,11,5,59,0
7712,178855,221_09_17,PARAGUAY,0,TOTALS,PARAGUAY,200,20,69,29.0,12,39,30.8,8,30,26.7,8,14,57.1,12,24,36,8,17,16,13,0,56,0
7713,178865,221_09_17,COLOMBIA,0,TOTALS,COLOMBIA,200,23,72,31.9,18,58,31.0,5,14,35.7,10,20,50.0,24,34,58,6,16,18,11,2,61,1
7714,178874,221_09_18,CHILE,0,TOTALS,CHILE,200,23,55,41.8,17,34,50.0,6,21,28.6,14,29,48.3,10,31,41,7,24,26,7,1,66,0
7715,178885,221_09_18,ECUADOR,0,TOTALS,ECUADOR,200,28,66,42.4,24,49,49.0,4,17,23.5,19,31,61.3,8,23,31,6,26,13,12,0,79,1
7716,178897,221_09_19,BRAZIL,0,TOTALS,BRAZIL,225,29,60,48.3,24,44,54.5,5,16,31.2,14,21,66.7,8,24,32,8,21,19,10,4,77,0
7717,178907,221_09_19,URUGUAY,0,TOTALS,URUGUAY,225,27,62,43.5,16,34,47.1,11,28,39.3,16,24,66.7,5,21,26,14,20,14,14,1,81,1
7718,178920,221_09_20,ARGENTINA,0,TOTALS,ARGENTINA,200,37,65,56.9,28,44,63.6,9,21,42.9,17,27,63.0,9,36,45,21,19,15,8,7,100,0
7719,178932,221_09_20,VENEZUELA,0,TOTALS,VENEZUELA,200,20,60,33.3,18,49,36.7,2,11,18.2,7,18,38.9,6,20,26,3,21,21,8,2,49,1
7720,178943,221_09_21,PARAGUAY,0,TOTALS,PARAGUAY,200,21,67,31.3,17,51,33.3,4,16,25.0,4,8,50.0,9,21,30,6,22,29,10,1,50,1
7721,178955,221_09_21,CHILE,0,TOTALS,CHILE,200,35,77,45.5,25,48,52.1,10,29,34.5,22,31,71.0,18,34,52,16,11,19,16,8,102,0
7722,178966,221_09_22,COLOMBIA,0,TOTALS,COLOMBIA,200,16,68,23.5,12,47,25.5,4,21,19.0,22,38,57.9,22,35,57,10,11,15,6,2,58,1
7723,178977,221_09_22,ECUADOR,0,TOTALS,ECUADOR,200,21,69,30.4,16,43,37.2,5,26,19.2,7,15,46.7,12,28,40,5,26,11,5,3,54,0
7724,178990,221_09_23,BRAZIL,0,TOTALS,BRAZIL,200,38,58,65.5,27,38,71.1,11,20,55.0,20,29,69.0,14,27,41,16,29,22,9,4,107,0
7725,179003,221_09_23,VENEZUELA,0,TOTALS,VENEZUELA,200,20,54,37.0,16,39,41.0,4,15,26.7,18,33,54.5,7,9,16,4,20,15,13,0,62,1
7726,179016,221_09_24,ARGENTINA,0,TOTALS,ARGENTINA,200,19,50,38.0,10,30,33.3,9,20,45.0,16,23,69.6,9,21,30,10,19,11,5,2,63,1
7727,179026,221_09_24,URUGUAY,0,TOTALS,URUGUAY,200,18,56,32.1,11,34,32.4,7,22,31.8,7,15,46.7,10,17,27,8,23,6,5,2,50,0
7728,179494,223_09_01,URUGUAY,0,TOTALS,URUGUAY,200,34,75,45.3,29,52,55.8,5,23,21.7,10,18,55.6,16,18,34,16,20,11,9,0,83,1
7729,179505,223_09_01,CHILE,0,TOTALS,CHILE,200,19,62,30.6,18,44,40.9,1,18,5.6,10,21,47.6,8,12,20,12,18,13,5,1,49,0
7730,179518,223_09_02,ARGENTINA,0,TOTALS,ARGENTINA,200,29,65,44.6,23,44,52.3,6,21,28.6,11,19,57.9,12,34,46,15,30,33,7,0,75,1
7731,179531,223_09_02,PARAGUAY,0,TOTALS,PARAGUAY,200,12,51,23.5,11,32,34.4,1,19,5.3,14,34,41.2,5,18,23,3,21,19,12,0,39,0
7732,179544,223_09_03,COLOMBIA,0,TOTALS,COLOMBIA,200,30,64,46.9,28,41,68.3,2,23,8.7,9,26,34.6,33,26,59,12,14,29,13,0,71,1
7733,179556,223_09_03,ECUADOR,0,TOTALS,ECUADOR,200,21,71,29.6,16,31,51.6,5,40,12.5,5,10,50.0,7,15,22,4,24,24,13,0,52,0
7734,179569,223_09_04,BRAZIL,0,TOTALS,BRAZIL,200,33,55,60.0,24,42,57.1,9,13,69.2,18,32,56.2,7,30,37,23,22,29,18,0,93,1
7735,179582,223_09_04,ECUADOR,0,TOTALS,ECUADOR,200,13,55,23.6,9,36,25.0,4,19,21.1,12,30,40.0,10,9,19,10,21,31,13,0,42,0
7736,179593,223_09_05,CHILE,0,TOTALS,CHILE,200,23,56,41.1,18,38,47.4,5,18,27.8,13,25,52.0,6,23,29,12,18,31,10,0,64,0
7737,179606,223_09_05,ARGENTINA,0,TOTALS,ARGENTINA,200,35,73,47.9,32,58,55.2,3,15,20.0,16,30,53.3,11,22,33,19,26,22,23,0,89,1
7738,179617,223_09_06,COLOMBIA,0,TOTALS,COLOMBIA,200,15,57,26.3,14,46,30.4,1,11,9.1,15,24,62.5,15,27,42,6,13,32,10,0,46,0
7739,179628,223_09_06,URUGUAY,0,TOTALS,URUGUAY,200,24,60,40.0,20,37,54.1,4,23,17.4,5,10,50.0,8,24,32,14,17,26,19,0,57,1
7740,179639,223_09_07,BRAZIL,0,TOTALS,BRAZIL,200,26,66,39.4,19,36,52.8,7,30,23.3,7,17,41.2,18,29,47,15,21,31,11,1,66,1
7741,179649,223_09_07,PARAGUAY,0,TOTALS,PARAGUAY,200,15,52,28.8,10,32,31.2,5,20,25.0,17,29,58.6,6,21,27,7,15,24,18,0,52,0
7742,179662,223_09_08,ARGENTINA,0,TOTALS,ARGENTINA,200,23,52,44.2,19,40,47.5,4,12,33.3,23,37,62.2,8,24,32,9,23,18,6,0,73,1
7743,179674,223_09_08,URUGUAY,0,TOTALS,URUGUAY,200,24,57,42.1,19,42,45.2,5,15,33.3,13,27,48.1,5,21,26,12,25,18,7,0,66,0
7744,179685,223_09_09,CHILE,0,TOTALS,CHILE,200,23,73,31.5,15,34,44.1,8,39,20.5,9,11,81.8,15,24,39,16,23,18,9,0,63,1
7745,179698,223_09_09,COLOMBIA,0,TOTALS,COLOMBIA,200,17,57,29.8,17,49,34.7,0,8,0.0,17,30,56.7,8,31,39,10,15,25,8,0,51,0
7746,179711,223_09_10,ECUADOR,0,TOTALS,ECUADOR,200,22,57,38.6,19,46,41.3,3,11,27.3,4,19,21.1,14,17,31,8,25,39,13,0,51,0
7747,179724,223_09_10,CHILE,0,TOTALS,CHILE,200,32,58,55.2,24,41,58.5,8,17,47.1,11,29,37.9,7,17,24,25,20,25,23,0,83,1
7748,179737,223_09_11,URUGUAY,0,TOTALS,URUGUAY,200,22,63,34.9,16,47,34.0,6,16,37.5,12,26,46.2,14,31,45,13,21,31,10,0,62,1
7749,179750,223_09_11,PARAGUAY,0,TOTALS,PARAGUAY,200,13,62,21.0,11,43,25.6,2,19,10.5,10,21,47.6,16,21,37,4,20,30,10,0,38,0
7750,179762,223_09_12,COLOMBIA,0,TOTALS,COLOMBIA,200,17,60,28.3,15,51,29.4,2,9,22.2,8,17,47.1,11,21,32,10,15,30,17,0,44,0
7751,179774,223_09_12,BRAZIL,0,TOTALS,BRAZIL,200,30,77,39.0,22,49,44.9,8,28,28.6,11,16,68.8,15,23,38,17,12,22,20,0,79,1
7752,179787,223_09_13,ARGENTINA,0,TOTALS,ARGENTINA,200,34,79,43.0,31,68,45.6,3,11,27.3,12,26,46.2,18,26,44,25,14,27,23,0,83,1
7753,179797,223_09_13,ECUADOR,0,TOTALS,ECUADOR,200,17,57,29.8,14,45,31.1,3,12,25.0,8,14,57.1,12,23,35,6,21,38,13,0,45,0
7754,179807,223_09_14,PARAGUAY,0,TOTALS,PARAGUAY,200,20,66,30.3,15,44,34.1,5,22,22.7,13,24,54.2,14,32,46,10,18,31,10,0,58,1
7755,179819,223_09_14,CHILE,0,TOTALS,CHILE,200,20,68,29.4,16,48,33.3,4,20,20.0,12,25,48.0,7,26,33,15,16,21,16,0,56,0
7756,179832,223_09_15,BRAZIL,0,TOTALS,BRAZIL,200,28,65,43.1,25,50,50.0,3,15,20.0,24,32,75.0,13,33,46,16,24,29,13,0,83,1
7757,179845,223_09_15,URUGUAY,0,TOTALS,URUGUAY,200,21,64,32.8,18,41,43.9,3,23,13.0,11,25,44.0,10,10,20,12,28,25,16,0,56,0
7758,179857,223_09_16,PARAGUAY,0,TOTALS,PARAGUAY,200,20,75,26.7,20,56,35.7,0,19,0.0,12,25,48.0,16,27,43,6,30,34,24,0,52,0
7759,179868,223_09_16,ECUADOR,0,TOTALS,ECUADOR,200,24,73,32.9,19,54,35.2,5,19,26.3,23,44,52.3,12,31,43,13,19,34,17,0,76,1
7760,179880,223_09_17,BRAZIL,0,TOTALS,BRAZIL,200,26,67,38.8,21,49,42.9,5,18,27.8,9,12,75.0,21,36,57,14,13,27,10,0,66,1
7761,179892,223_09_17,CHILE,0,TOTALS,CHILE,200,20,67,29.9,17,50,34.0,3,17,17.6,5,11,45.5,10,15,25,13,8,15,11,0,48,0
7762,179905,223_09_18,ARGENTINA,0,TOTALS,ARGENTINA,200,31,73,42.5,28,62,45.2,3,11,27.3,10,21,47.6,16,19,35,15,21,24,19,0,75,1
7763,179918,223_09_18,COLOMBIA,0,TOTALS,COLOMBIA,200,18,56,32.1,17,52,32.7,1,4,25.0,16,32,50.0,11,23,34,8,19,31,14,0,53,0
7764,179931,223_09_19,URUGUAY,0,TOTALS,URUGUAY,200,45,78,57.7,34,57,59.6,11,21,52.4,16,24,66.7,9,22,31,34,8,18,21,0,117,0
7765,179942,223_09_19,ECUADOR,0,TOTALS,ECUADOR,200,18,58,31.0,16,42,38.1,2,16,12.5,8,11,72.7,11,19,30,8,20,38,11,0,46,1
7766,179953,223_09_20,COLOMBIA,0,TOTALS,COLOMBIA,200,22,64,34.4,21,54,38.9,1,10,10.0,7,16,43.8,11,29,40,10,24,39,16,0,52,0
7767,179961,223_09_20,PARAGUAY,0,TOTALS,PARAGUAY,200,19,66,28.8,17,47,36.2,2,19,10.5,20,33,60.6,14,24,38,8,16,31,18,0,60,1
7768,179974,223_09_21,ARGENTINA,0,TOTALS,ARGENTINA,200,28,66,42.4,23,50,46.0,5,16,31.2,12,22,54.5,16,18,34,15,29,10,9,0,73,1
7769,179986,223_09_21,BRAZIL,0,TOTALS,BRAZIL,200,21,61,34.4,19,45,42.2,2,16,12.5,21,34,61.8,15,23,38,8,19,19,4,2,65,0
7770,179999,223_09_22,CHILE,0,TOTALS,CHILE,200,23,72,31.9,17,48,35.4,6,24,25.0,5,15,33.3,9,14,23,8,22,15,12,1,57,0
7771,180010,223_09_22,COLOMBIA,0,TOTALS,COLOMBIA,200,30,82,36.6,27,76,35.5,3,6,50.0,17,31,54.8,24,33,57,12,10,20,7,8,80,1
7772,180023,223_09_23,URUGUAY,0,TOTALS,URUGUAY,200,21,75,28.0,15,50,30.0,6,25,24.0,18,26,69.2,12,29,41,13,19,28,19,0,66,1
7773,180035,223_09_23,PARAGUAY,0,TOTALS,PARAGUAY,200,16,57,28.1,16,49,32.7,0,8,0.0,12,22,54.5,6,30,36,7,17,35,16,3,44,0
7774,180047,223_09_24,ARGENTINA,0,TOTALS,ARGENTINA,200,23,61,37.7,18,44,40.9,5,17,29.4,16,35,45.7,12,30,42,9,23,20,7,1,67,1
7775,180058,223_09_24,BRAZIL,0,TOTALS,BRAZIL,200,17,63,27.0,12,42,28.6,5,21,23.8,10,27,37.0,7,23,30,5,26,16,11,2,49,0
7776,180561,225_09_01,PUERTO RICO,0,TOTALS,PUERTO RICO,200,45,70,64.3,40,55,72.7,5,15,33.3,16,32,50.0,11,30,41,34,16,22,25,5,111,0
7777,180574,225_09_01,NICARAGUA,0,TOTALS,NICARAGUA,200,23,59,39.0,21,48,43.8,2,11,18.2,7,20,35.0,9,15,24,12,23,35,15,2,55,1
7778,180587,225_09_02,MEXICO,0,TOTALS,MEXICO,200,34,79,43.0,29,54,53.7,5,25,20.0,8,15,53.3,15,27,42,23,19,23,19,5,81,1
7779,180598,225_09_02,GUATEMALA,0,TOTALS,GUATEMALA,200,25,63,39.7,21,49,42.9,4,14,28.6,4,16,25.0,6,23,29,19,21,27,10,4,58,0
7780,180610,225_09_03,DOMINICAN REPUBLIC,0,TOTALS,DOMINICAN REPUBLIC,200,31,80,38.8,26,57,45.6,5,23,21.7,6,18,33.3,22,26,48,19,21,25,15,8,73,1
7781,180622,225_09_03,BAHAMAS,0,TOTALS,BAHAMAS,200,28,67,41.8,27,59,45.8,1,8,12.5,14,32,43.8,18,30,48,9,15,26,11,3,71,0
7782,180635,225_09_04,GUATEMALA,0,TOTALS,GUATEMALA,200,21,68,30.9,19,54,35.2,2,14,14.3,3,7,42.9,14,15,29,12,15,28,15,3,47,0
7783,180648,225_09_04,DOMINICAN REPUBLIC,0,TOTALS,DOMINICAN REPUBLIC,200,32,62,51.6,26,44,59.1,6,18,33.3,8,16,50.0,10,30,40,11,14,25,13,5,78,1
7784,180661,225_09_05,VIRGIN ISLANDS,0,TOTALS,VIRGIN ISLANDS,200,49,82,59.8,42,61,68.9,7,21,33.3,18,28,64.3,22,39,61,21,14,16,16,12,123,0
7785,180673,225_09_05,NICARAGUA,0,TOTALS,NICARAGUA,200,12,73,16.4,11,57,19.3,1,16,6.2,5,7,71.4,15,11,26,7,22,26,5,3,30,1
7786,180686,225_09_06,BAHAMAS,0,TOTALS,BAHAMAS,200,17,62,27.4,15,51,29.4,2,11,18.2,15,29,51.7,12,23,35,12,16,27,10,1,51,0
7787,180699,225_09_06,MEXICO,0,TOTALS,MEXICO,200,37,70,52.9,28,49,57.1,9,21,42.9,5,12,41.7,9,30,39,27,22,19,14,8,88,1
7788,180712,225_09_07,BAHAMAS,0,TOTALS,BAHAMAS,200,39,83,47.0,35,65,53.8,4,18,22.2,15,24,62.5,18,28,46,23,13,17,24,4,97,1
7789,180725,225_09_07,GUATEMALA,0,TOTALS,GUATEMALA,200,15,60,25.0,13,44,29.5,2,16,12.5,9,11,81.8,9,25,34,9,21,32,10,4,41,0
7790,180738,225_09_08,PUERTO RICO,0,TOTALS,PUERTO RICO,200,42,76,55.3,30,49,61.2,12,27,44.4,15,20,75.0,9,32,41,28,25,12,18,0,111,0
7791,180751,225_09_08,VIRGIN ISLANDS,0,TOTALS,VIRGIN ISLANDS,200,18,62,29.0,13,40,32.5,5,22,22.7,17,32,53.1,14,21,35,8,21,24,3,4,58,1
7792,180764,225_09_09,MEXICO,0,TOTALS,MEXICO,200,33,81,40.7,25,63,39.7,8,18,44.4,11,26,42.3,14,16,30,16,18,14,12,7,85,1
7793,180776,225_09_09,DOMINICAN REPUBLIC,0,TOTALS,DOMINICAN REPUBLIC,200,24,61,39.3,17,44,38.6,7,17,41.2,10,17,58.8,15,23,38,10,25,31,9,6,65,0
7794,180786,225_09_10,NICARAGUA,0,TOTALS,NICARAGUA,200,21,71,29.6,19,54,35.2,2,17,11.8,21,34,61.8,16,23,39,10,27,26,13,3,65,0
7795,180799,225_09_10,GUATEMALA,0,TOTALS,GUATEMALA,200,26,76,34.2,22,65,33.8,4,11,36.4,18,36,50.0,21,30,51,15,26,22,16,1,74,1
7796,180812,225_09_11,PUERTO RICO,0,TOTALS,PUERTO RICO,200,32,64,50.0,26,50,52.0,6,14,42.9,27,38,71.1,14,34,48,23,20,22,11,2,97,1
7797,180824,225_09_11,DOMINICAN REPUBLIC,0,TOTALS,DOMINICAN REPUBLIC,200,24,69,34.8,19,45,42.2,5,24,20.8,22,34,64.7,13,21,34,10,29,18,9,5,75,0
7798,180837,225_09_12,MEXICO,0,TOTALS,MEXICO,200,24,67,35.8,14,41,34.1,10,26,38.5,21,32,65.6,14,25,39,19,21,15,11,4,79,1
7799,180848,225_09_12,VIRGIN ISLANDS,0,TOTALS,VIRGIN ISLANDS,200,26,76,34.2,23,50,46.0,3,26,11.5,9,20,45.0,21,26,47,10,24,20,5,5,64,0
7800,180861,225_09_13,BAHAMAS,0,TOTALS,BAHAMAS,200,33,76,43.4,29,59,49.2,4,17,23.5,12,16,75.0,20,29,49,21,15,23,16,4,82,1
7801,180871,225_09_13,GUATEMALA,0,TOTALS,GUATEMALA,200,25,70,35.7,24,56,42.9,1,14,7.1,6,11,54.5,10,21,31,15,18,22,13,0,57,0
7802,180883,225_09_14,DOMINICAN REPUBLIC,0,TOTALS,DOMINICAN REPUBLIC,200,26,69,37.7,19,44,43.2,7,25,28.0,15,27,55.6,11,21,32,15,18,18,16,1,74,0
7803,180895,225_09_14,VIRGIN ISLANDS,0,TOTALS,VIRGIN ISLANDS,200,29,56,51.8,20,31,64.5,9,25,36.0,14,27,51.9,6,27,33,21,19,25,10,3,81,1
7804,180908,225_09_15,MEXICO,0,TOTALS,MEXICO,200,24,64,37.5,20,44,45.5,4,20,20.0,6,11,54.5,12,20,32,15,18,28,13,3,58,0
7805,180921,225_09_15,PUERTO RICO,0,TOTALS,PUERTO RICO,200,35,73,47.9,27,51,52.9,8,22,36.4,14,20,70.0,15,26,41,19,13,19,17,2,92,1
7806,181528,228_08_01,BULGARIA,0,TOTALS,BULGARIA,200,34,69,49.3,26,41,63.4,8,28,28.6,13,15,86.7,15,24,39,16,20,6,8,1,89,1
7807,181541,228_08_01,HUNGARY,0,TOTALS,HUNGARY,200,23,57,40.4,11,26,42.3,12,31,38.7,13,16,81.2,10,22,32,13,23,12,3,2,71,0
7808,181554,228_08_02,ITALY,0,TOTALS,ITALY,200,24,60,40.0,18,34,52.9,6,26,23.1,10,17,58.8,10,21,31,9,31,16,11,0,64,0
7809,181567,228_08_02,SERBIA,0,TOTALS,SERBIA,200,23,45,51.1,15,26,57.7,8,19,42.1,24,36,66.7,8,29,37,11,22,16,12,1,78,1
7810,181580,228_08_03,HUNGARY,0,TOTALS,HUNGARY,200,20,53,37.7,11,28,39.3,9,25,36.0,19,26,73.1,8,23,31,14,21,5,6,0,68,1
7811,181593,228_08_03,ITALY,0,TOTALS,ITALY,200,25,54,46.3,21,33,63.6,4,21,19.0,10,13,76.9,6,27,33,14,23,11,3,4,64,0
7812,181606,228_08_04,FINLAND,0,TOTALS,FINLAND,200,21,55,38.2,12,28,42.9,9,27,33.3,17,23,73.9,10,19,29,9,15,15,6,4,68,0
7813,181619,228_08_04,BULGARIA,0,TOTALS,BULGARIA,200,36,65,55.4,27,44,61.4,9,21,42.9,9,11,81.8,12,24,36,13,24,14,10,0,90,1
7814,181632,228_08_05,SERBIA,0,TOTALS,SERBIA,200,37,63,58.7,33,48,68.8,4,15,26.7,16,21,76.2,10,22,32,20,19,8,13,1,94,1
7815,181644,228_08_05,HUNGARY,0,TOTALS,HUNGARY,200,23,54,42.6,16,33,48.5,7,21,33.3,7,15,46.7,11,17,28,8,22,19,6,1,60,0
7816,181657,228_08_06,ITALY,0,TOTALS,ITALY,200,26,50,52.0,17,28,60.7,9,22,40.9,27,39,69.2,6,22,28,3,25,15,8,2,88,1
7817,181670,228_08_06,FINLAND,0,TOTALS,FINLAND,200,25,62,40.3,15,32,46.9,10,30,33.3,20,24,83.3,11,18,29,1,28,17,6,2,80,0
7818,181683,228_08_07,BULGARIA,0,TOTALS,BULGARIA,200,24,61,39.3,15,39,38.5,9,22,40.9,24,34,70.6,15,25,40,16,20,8,7,0,81,1
7819,181696,228_08_07,ITALY,0,TOTALS,ITALY,200,27,62,43.5,11,27,40.7,16,35,45.7,10,14,71.4,10,26,36,17,25,12,5,2,80,0
7820,181709,228_08_08,FINLAND,0,TOTALS,FINLAND,200,26,55,47.3,12,29,41.4,14,26,53.8,14,21,66.7,8,19,27,10,22,13,9,2,80,1
7821,181722,228_08_08,SERBIA,0,TOTALS,SERBIA,200,27,52,51.9,20,32,62.5,7,20,35.0,16,22,72.7,9,22,31,9,23,16,8,3,77,0
7822,181735,228_08_09,CZECH REPUBLIC,0,TOTALS,CZECH REPUBLIC,200,27,66,40.9,24,53,45.3,3,13,23.1,13,17,76.5,12,25,37,11,16,11,8,2,70,1
7823,181748,228_08_09,BOSNIA AND HERZEGOVINA,0,TOTALS,BOSNIA AND HERZEGOVINA,200,19,49,38.8,17,33,51.5,2,16,12.5,16,25,64.0,3,23,26,5,18,18,6,2,56,0
7824,181760,228_08_10,HUNGARY,0,TOTALS,HUNGARY,200,22,59,37.3,19,39,48.7,3,20,15.0,17,21,81.0,12,16,28,10,17,14,8,3,64,0
7825,181773,228_08_10,FINLAND,0,TOTALS,FINLAND,200,32,64,50.0,26,41,63.4,6,23,26.1,9,9,100.0,9,23,32,10,22,9,9,3,79,1
7826,181786,228_08_11,LATVIA,0,TOTALS,LATVIA,225,28,57,49.1,19,36,52.8,9,21,42.9,18,29,62.1,10,38,48,14,27,19,3,3,83,1
7827,181799,228_08_11,MKD,0,TOTALS,MKD,225,28,73,38.4,21,49,42.9,7,24,29.2,19,32,59.4,12,25,37,13,23,6,7,2,82,0
7828,181812,228_08_12,ISRAEL,0,TOTALS,ISRAEL,225,32,63,50.8,23,43,53.5,9,20,45.0,29,38,76.3,10,26,36,21,25,15,5,2,102,0
7829,181825,228_08_12,GREAT BRITAIN,0,TOTALS,GREAT BRITAIN,225,32,62,51.6,23,41,56.1,9,21,42.9,19,30,63.3,8,25,33,20,30,19,7,6,92,1
7830,181838,228_08_13,FRANCE,0,TOTALS,FRANCE,200,26,55,47.3,17,32,53.1,9,23,39.1,21,30,70.0,12,24,36,11,18,17,9,4,82,1
7831,181851,228_08_13,BELGIUM,0,TOTALS,BELGIUM,200,22,51,43.1,13,28,46.4,9,23,39.1,10,10,100.0,5,18,23,16,24,19,9,1,63,0
7832,181864,228_08_14,PORTUGAL,0,TOTALS,PORTUGAL,200,21,49,42.9,13,27,48.1,8,22,36.4,20,24,83.3,9,14,23,11,26,14,8,1,70,0
7833,181877,228_08_14,ESTONIA,0,TOTALS,ESTONIA,200,22,49,44.9,10,18,55.6,12,31,38.7,23,27,85.2,9,18,27,13,24,16,4,3,79,1
7834,181890,228_08_15,SERBIA,0,TOTALS,SERBIA,200,23,61,37.7,12,29,41.4,11,32,34.4,17,23,73.9,11,26,37,16,22,11,7,5,74,1
7835,181903,228_08_15,BULGARIA,0,TOTALS,BULGARIA,200,25,58,43.1,20,39,51.3,5,19,26.3,9,17,52.9,10,27,37,7,21,14,7,5,64,0
7836,181916,228_08_16,TURKEY,0,TOTALS,TURKEY,200,29,59,49.2,21,41,51.2,8,18,44.4,20,30,66.7,11,25,36,18,18,9,13,2,86,1
7837,181929,228_08_16,UKRAINE,0,TOTALS,UKRAINE,200,28,54,51.9,20,39,51.3,8,15,53.3,9,15,60.0,4,27,31,11,22,17,4,3,73,0
7838,181942,228_08_17,GREAT BRITAIN,0,TOTALS,GREAT BRITAIN,200,28,56,50.0,19,39,48.7,9,17,52.9,22,35,62.9,10,32,42,15,23,13,6,10,87,1
7839,181955,228_08_17,CZECH REPUBLIC,0,TOTALS,CZECH REPUBLIC,200,22,67,32.8,16,52,30.8,6,15,40.0,18,24,75.0,14,21,35,12,30,13,5,4,68,0
7840,181968,228_08_18,UKRAINE,0,TOTALS,UKRAINE,200,27,48,56.2,17,29,58.6,10,19,52.6,14,23,60.9,7,17,24,17,22,18,7,2,78,1
7841,181981,228_08_18,FRANCE,0,TOTALS,FRANCE,200,29,63,46.0,23,44,52.3,6,19,31.6,13,19,68.4,13,17,30,10,21,14,9,1,77,0
7842,181994,228_08_19,ESTONIA,0,TOTALS,ESTONIA,200,23,54,42.6,10,25,40.0,13,29,44.8,22,25,88.0,10,17,27,18,27,15,5,2,81,0
7843,182007,228_08_19,LATVIA,0,TOTALS,LATVIA,200,30,58,51.7,25,41,61.0,5,17,29.4,23,28,82.1,11,22,33,15,24,11,7,0,88,1
7844,182018,228_08_20,HUNGARY,0,TOTALS,HUNGARY,200,31,60,51.7,18,32,56.2,13,28,46.4,12,20,60.0,7,23,30,15,23,11,6,4,87,1
7845,182031,228_08_20,BULGARIA,0,TOTALS,BULGARIA,200,27,58,46.6,17,35,48.6,10,23,43.5,22,30,73.3,11,23,34,12,20,8,5,0,86,0
7846,182044,228_08_21,SERBIA,0,TOTALS,SERBIA,200,27,59,45.8,23,39,59.0,4,20,20.0,14,23,60.9,12,34,46,14,24,14,5,1,72,1
7847,182057,228_08_21,ITALY,0,TOTALS,ITALY,200,18,58,31.0,15,40,37.5,3,18,16.7,13,20,65.0,10,24,34,4,23,12,6,5,52,0
7848,182070,228_08_22,BOSNIA AND HERZEGOVINA,0,TOTALS,BOSNIA AND HERZEGOVINA,200,32,66,48.5,27,43,62.8,5,23,21.7,8,14,57.1,7,28,35,9,21,12,4,2,77,1
7849,182083,228_08_22,ISRAEL,0,TOTALS,ISRAEL,200,27,63,42.9,23,45,51.1,4,18,22.2,13,22,59.1,9,25,34,12,18,11,8,1,71,0
7850,182096,228_08_23,BELGIUM,0,TOTALS,BELGIUM,200,23,57,40.4,16,39,41.0,7,18,38.9,10,19,52.6,8,20,28,11,28,14,7,1,63,0
7851,182109,228_08_23,TURKEY,0,TOTALS,TURKEY,200,24,53,45.3,15,30,50.0,9,23,39.1,21,32,65.6,13,28,41,9,22,15,6,4,78,1
7852,182122,228_08_24,MKD,0,TOTALS,MKD,200,25,57,43.9,14,30,46.7,11,27,40.7,24,26,92.3,8,26,34,17,18,15,7,3,85,1
7853,182135,228_08_24,PORTUGAL,0,TOTALS,PORTUGAL,200,20,56,35.7,18,36,50.0,2,20,10.0,6,8,75.0,7,17,24,13,27,20,3,2,48,0
7854,182148,228_08_25,TURKEY,0,TOTALS,TURKEY,200,23,51,45.1,19,34,55.9,4,17,23.5,27,31,87.1,7,28,35,12,21,15,9,5,77,1
7855,182161,228_08_25,FRANCE,0,TOTALS,FRANCE,200,25,63,39.7,19,41,46.3,6,22,27.3,9,13,69.2,12,22,34,4,27,17,7,4,65,0
7856,182174,228_08_26,CZECH REPUBLIC,0,TOTALS,CZECH REPUBLIC,200,36,75,48.0,25,46,54.3,11,29,37.9,8,11,72.7,22,20,42,18,23,10,5,2,91,1
7857,182187,228_08_26,ISRAEL,0,TOTALS,ISRAEL,200,22,49,44.9,15,36,41.7,7,13,53.8,19,31,61.3,8,15,23,10,18,12,6,7,70,0
7858,182200,228_08_27,ESTONIA,0,TOTALS,ESTONIA,200,28,59,47.5,17,29,58.6,11,30,36.7,11,16,68.8,8,16,24,16,20,13,6,1,78,0
7859,182213,228_08_27,MKD,0,TOTALS,MKD,200,33,61,54.1,25,40,62.5,8,21,38.1,16,18,88.9,14,23,37,21,18,13,5,3,90,1
7860,182225,228_08_28,LATVIA,0,TOTALS,LATVIA,200,28,56,50.0,19,27,70.4,9,29,31.0,14,16,87.5,10,32,42,15,13,19,6,4,79,1
7861,182238,228_08_28,PORTUGAL,0,TOTALS,PORTUGAL,200,15,60,25.0,11,35,31.4,4,25,16.0,9,12,75.0,15,19,34,9,17,19,10,2,43,0
7862,182251,228_08_29,GREAT BRITAIN,0,TOTALS,GREAT BRITAIN,200,33,63,52.4,25,45,55.6,8,18,44.4,8,13,61.5,9,25,34,14,19,15,4,3,82,1
7863,182264,228_08_29,BOSNIA AND HERZEGOVINA,0,TOTALS,BOSNIA AND HERZEGOVINA,200,30,63,47.6,20,37,54.1,10,26,38.5,4,9,44.4,10,22,32,17,22,16,4,2,74,0
7864,182277,228_08_30,BELGIUM,0,TOTALS,BELGIUM,200,26,56,46.4,20,35,57.1,6,21,28.6,14,19,73.7,3,29,32,13,31,20,12,3,72,1
7865,182290,228_08_30,UKRAINE,0,TOTALS,UKRAINE,200,18,52,34.6,12,35,34.3,6,17,35.3,19,33,57.6,8,24,32,6,23,21,5,3,61,0
7866,182303,228_08_31,ITALY,0,TOTALS,ITALY,200,30,65,46.2,25,39,64.1,5,26,19.2,10,16,62.5,11,22,33,6,20,14,9,2,75,1
7867,182314,228_08_31,HUNGARY,0,TOTALS,HUNGARY,200,21,50,42.0,12,27,44.4,9,23,39.1,17,20,85.0,3,20,23,7,22,17,6,2,68,0
7868,182327,228_08_32,BULGARIA,0,TOTALS,BULGARIA,200,36,74,48.6,25,46,54.3,11,28,39.3,19,26,73.1,13,23,36,20,17,4,9,1,102,0
7869,182340,228_08_32,FINLAND,0,TOTALS,FINLAND,200,32,62,51.6,19,33,57.6,13,29,44.8,13,15,86.7,7,28,35,17,23,15,2,1,90,1
7870,182353,228_08_33,UKRAINE,0,TOTALS,UKRAINE,200,19,50,38.0,13,30,43.3,6,20,30.0,20,26,76.9,10,22,32,13,22,23,4,1,64,0
7871,182366,228_08_33,TURKEY,0,TOTALS,TURKEY,200,33,60,55.0,25,44,56.8,8,16,50.0,12,19,63.2,6,24,30,13,17,13,15,1,86,1
7872,182379,228_08_34,ESTONIA,0,TOTALS,ESTONIA,200,17,48,35.4,11,25,44.0,6,23,26.1,14,21,66.7,8,23,31,11,13,19,14,3,54,0
7873,182392,228_08_34,PORTUGAL,0,TOTALS,PORTUGAL,200,22,55,40.0,14,23,60.9,8,32,25.0,8,12,66.7,11,24,35,10,21,20,12,0,60,1
7874,182403,228_08_35,HUNGARY,0,TOTALS,HUNGARY,200,23,59,39.0,17,40,42.5,6,19,31.6,9,12,75.0,11,21,32,12,24,19,7,1,61,0
7875,182416,228_08_35,SERBIA,0,TOTALS,SERBIA,200,33,66,50.0,24,42,57.1,9,24,37.5,14,20,70.0,14,27,41,17,19,15,14,2,89,1
7876,182429,228_08_36,GREAT BRITAIN,0,TOTALS,GREAT BRITAIN,200,34,64,53.1,30,46,65.2,4,18,22.2,24,33,72.7,11,25,36,21,22,18,10,5,96,1
7877,182442,228_08_36,ISRAEL,0,TOTALS,ISRAEL,200,35,72,48.6,32,59,54.2,3,13,23.1,13,17,76.5,12,20,32,15,25,17,7,3,86,0
7878,182455,228_08_37,FINLAND,0,TOTALS,FINLAND,200,17,58,29.3,13,28,46.4,4,30,13.3,24,28,85.7,22,24,46,4,23,17,3,3,62,0
7879,182468,228_08_37,ITALY,0,TOTALS,ITALY,200,23,54,42.6,12,33,36.4,11,21,52.4,12,18,66.7,9,20,29,5,28,10,9,2,69,1
7880,182481,228_08_38,BELGIUM,0,TOTALS,BELGIUM,200,19,56,33.9,14,28,50.0,5,28,17.9,22,28,78.6,11,24,35,7,30,15,4,1,65,0
7881,182494,228_08_38,FRANCE,0,TOTALS,FRANCE,200,23,48,47.9,18,35,51.4,5,13,38.5,20,35,57.1,5,28,33,5,24,11,9,2,71,1
7882,182507,228_08_39,BOSNIA AND HERZEGOVINA,0,TOTALS,BOSNIA AND HERZEGOVINA,200,31,62,50.0,18,39,46.2,13,23,56.5,20,36,55.6,16,17,33,12,26,12,10,2,95,1
7883,182520,228_08_39,CZECH REPUBLIC,0,TOTALS,CZECH REPUBLIC,200,27,52,51.9,20,40,50.0,7,12,58.3,18,23,78.3,8,22,30,6,29,19,7,3,79,0
7884,182533,228_08_40,MKD,0,TOTALS,MKD,200,27,67,40.3,21,41,51.2,6,26,23.1,20,28,71.4,12,17,29,7,21,5,14,2,80,1
7885,182544,228_08_40,LATVIA,0,TOTALS,LATVIA,200,29,65,44.6,22,39,56.4,7,26,26.9,13,20,65.0,16,31,47,12,25,18,2,4,78,0
7886,182557,228_08_41,CZECH REPUBLIC,0,TOTALS,CZECH REPUBLIC,200,24,60,40.0,18,41,43.9,6,19,31.6,9,18,50.0,9,14,23,11,25,11,12,1,63,0
7887,182570,228_08_41,GREAT BRITAIN,0,TOTALS,GREAT BRITAIN,200,23,42,54.8,19,27,70.4,4,15,26.7,17,23,73.9,5,26,31,6,18,24,5,1,67,1
7888,182583,228_08_42,ISRAEL,0,TOTALS,ISRAEL,200,36,77,46.8,32,63,50.8,4,14,28.6,12,18,66.7,16,35,51,16,15,11,6,5,88,1
7889,182595,228_08_42,BOSNIA AND HERZEGOVINA,0,TOTALS,BOSNIA AND HERZEGOVINA,200,26,62,41.9,16,33,48.5,10,29,34.5,12,17,70.6,3,26,29,17,17,13,7,4,74,0
7890,182608,228_08_43,LATVIA,0,TOTALS,LATVIA,200,25,56,44.6,17,35,48.6,8,21,38.1,14,20,70.0,9,28,37,14,30,18,6,4,72,1
7891,182621,228_08_43,ESTONIA,0,TOTALS,ESTONIA,200,20,54,37.0,12,33,36.4,8,21,38.1,19,32,59.4,13,22,35,11,22,17,6,4,67,0
7892,182634,228_08_44,FRANCE,0,TOTALS,FRANCE,200,28,66,42.4,21,43,48.8,7,23,30.4,24,34,70.6,13,22,35,18,22,6,13,3,87,1
7893,182647,228_08_44,UKRAINE,0,TOTALS,UKRAINE,200,29,52,55.8,16,28,57.1,13,24,54.2,12,23,52.2,7,28,35,19,28,20,4,2,83,0
7894,182660,228_08_45,TURKEY,0,TOTALS,TURKEY,200,32,65,49.2,26,45,57.8,6,20,30.0,10,15,66.7,14,25,39,17,21,10,7,2,80,1
7895,182672,228_08_45,BELGIUM,0,TOTALS,BELGIUM,200,21,50,42.0,16,34,47.1,5,16,31.2,17,24,70.8,6,21,27,12,18,15,5,0,64,0
7896,182685,228_08_46,ITALY,0,TOTALS,ITALY,200,26,62,41.9,15,31,48.4,11,31,35.5,19,22,86.4,8,27,35,9,27,15,5,2,82,1
7897,182698,228_08_46,BULGARIA,0,TOTALS,BULGARIA,200,26,55,47.3,17,31,54.8,9,24,37.5,20,26,76.9,6,30,36,15,23,14,3,1,81,0
7898,182711,228_08_47,SERBIA,0,TOTALS,SERBIA,200,29,54,53.7,19,29,65.5,10,25,40.0,24,32,75.0,7,34,41,21,21,20,9,7,92,1
7899,182724,228_08_47,FINLAND,0,TOTALS,FINLAND,200,25,65,38.5,15,43,34.9,10,22,45.5,6,9,66.7,6,18,24,7,28,14,10,2,66,0
7900,182737,228_08_48,PORTUGAL,0,TOTALS,PORTUGAL,200,25,55,45.5,14,26,53.8,11,29,37.9,20,24,83.3,12,19,31,12,24,15,7,3,81,1
7901,182750,228_08_48,MKD,0,TOTALS,MKD,200,19,50,38.0,14,29,48.3,5,21,23.8,28,31,90.3,9,16,25,9,25,13,7,2,71,0
7902,182763,228_08_49,UKRAINE,0,TOTALS,UKRAINE,200,18,59,30.5,14,32,43.8,4,27,14.8,18,23,78.3,7,19,26,8,21,12,10,3,58,0
7903,182776,228_08_49,BELGIUM,0,TOTALS,BELGIUM,200,29,58,50.0,25,40,62.5,4,18,22.2,14,18,77.8,8,27,35,11,22,16,7,2,76,1
7904,182789,228_08_50,PORTUGAL,0,TOTALS,PORTUGAL,200,33,74,44.6,14,38,36.8,19,36,52.8,8,12,66.7,13,16,29,14,30,7,5,2,93,1
7905,182802,228_08_50,LATVIA,0,TOTALS,LATVIA,200,27,49,55.1,16,30,53.3,11,19,57.9,27,39,69.2,9,28,37,9,17,16,5,3,92,0
7906,182815,228_08_51,FINLAND,0,TOTALS,FINLAND,200,28,67,41.8,20,38,52.6,8,29,27.6,24,32,75.0,18,21,39,6,30,9,5,3,88,1
7907,182826,228_08_51,HUNGARY,0,TOTALS,HUNGARY,200,21,51,41.2,14,30,46.7,7,21,33.3,24,33,72.7,14,21,35,6,30,16,2,2,73,0
7908,182838,228_08_52,BOSNIA AND HERZEGOVINA,0,TOTALS,BOSNIA AND HERZEGOVINA,200,33,64,51.6,21,37,56.8,12,27,44.4,11,18,61.1,5,21,26,22,24,8,8,2,89,1
7909,182850,228_08_52,GREAT BRITAIN,0,TOTALS,GREAT BRITAIN,200,29,65,44.6,23,47,48.9,6,18,33.3,16,21,76.2,12,26,38,8,19,15,5,2,80,0
7910,182863,228_08_53,FRANCE,0,TOTALS,FRANCE,200,26,71,36.6,17,36,47.2,9,35,25.7,17,28,60.7,13,24,37,12,21,7,7,1,78,0
7911,182876,228_08_53,TURKEY,0,TOTALS,TURKEY,200,27,62,43.5,21,42,50.0,6,20,30.0,20,26,76.9,13,37,50,13,23,16,1,4,80,1
7912,182889,228_08_54,MKD,0,TOTALS,MKD,200,31,59,52.5,22,35,62.9,9,24,37.5,16,25,64.0,6,20,26,18,13,10,12,6,87,1
7913,182901,228_08_54,ESTONIA,0,TOTALS,ESTONIA,200,28,58,48.3,14,29,48.3,14,29,48.3,5,7,71.4,6,24,30,21,21,19,6,1,75,0
7914,182914,228_08_55,BULGARIA,0,TOTALS,BULGARIA,200,28,65,43.1,23,51,45.1,5,14,35.7,16,28,57.1,14,16,30,12,18,8,10,3,77,0
7915,182927,228_08_55,SERBIA,0,TOTALS,SERBIA,200,32,63,50.8,20,34,58.8,12,29,41.4,11,15,73.3,16,29,45,20,23,18,4,3,87,1
7916,182940,228_08_56,ISRAEL,0,TOTALS,ISRAEL,200,31,53,58.5,22,41,53.7,9,12,75.0,27,34,79.4,9,29,38,19,21,16,5,4,98,1
7917,182953,228_08_56,CZECH REPUBLIC,0,TOTALS,CZECH REPUBLIC,200,20,59,33.9,13,36,36.1,7,23,30.4,14,18,77.8,11,17,28,14,25,13,8,2,61,0
7918,182966,228_09_57,HUNGARY,0,TOTALS,HUNGARY,200,36,67,53.7,30,48,62.5,6,19,31.6,13,16,81.2,11,22,33,11,21,15,10,2,91,1
7919,182979,228_09_57,UKRAINE,0,TOTALS,UKRAINE,200,22,53,41.5,14,28,50.0,8,25,32.0,15,18,83.3,9,21,30,9,19,22,3,5,67,0
7920,182992,228_09_58,ESTONIA,0,TOTALS,ESTONIA,200,21,57,36.8,15,32,46.9,6,25,24.0,21,29,72.4,13,21,34,8,20,10,11,2,69,1
7921,183005,228_09_58,CZECH REPUBLIC,0,TOTALS,CZECH REPUBLIC,200,25,53,47.2,21,40,52.5,4,13,30.8,11,18,61.1,10,28,38,10,29,18,5,1,65,0
7922,183018,228_09_59,PORTUGAL,0,TOTALS,PORTUGAL,200,19,55,34.5,16,29,55.2,3,26,11.5,15,27,55.6,19,18,37,9,27,16,7,2,56,0
7923,183031,228_09_59,BOSNIA AND HERZEGOVINA,0,TOTALS,BOSNIA AND HERZEGOVINA,200,18,41,43.9,14,26,53.8,4,15,26.7,22,29,75.9,8,20,28,5,28,17,6,2,62,1
7924,183044,228_09_60,ITALY,0,TOTALS,ITALY,225,28,62,45.2,25,40,62.5,3,22,13.6,18,27,66.7,9,20,29,9,23,13,8,4,77,0
7925,183057,228_09_60,FRANCE,0,TOTALS,FRANCE,225,28,56,50.0,23,41,56.1,5,15,33.3,19,28,67.9,10,26,36,12,26,14,2,0,80,1
7926,183070,228_09_61,UKRAINE,0,TOTALS,UKRAINE,200,25,62,40.3,15,39,38.5,10,23,43.5,11,18,61.1,15,25,40,8,21,15,7,0,71,1
7927,183083,228_09_61,ESTONIA,0,TOTALS,ESTONIA,200,20,56,35.7,15,27,55.6,5,29,17.2,19,27,70.4,12,25,37,8,20,14,8,4,64,0
7928,183096,228_09_62,FRANCE,0,TOTALS,FRANCE,200,33,56,58.9,27,40,67.5,6,16,37.5,10,15,66.7,7,19,26,21,20,13,13,2,82,1
7929,183109,228_09_62,FINLAND,0,TOTALS,FINLAND,200,22,47,46.8,10,25,40.0,12,22,54.5,16,20,80.0,8,19,27,7,21,19,7,2,72,0
7930,183122,228_09_63,BOSNIA AND HERZEGOVINA,0,TOTALS,BOSNIA AND HERZEGOVINA,200,22,47,46.8,15,30,50.0,7,17,41.2,31,44,70.5,13,18,31,7,22,11,5,2,82,1
7931,183135,228_09_63,BELGIUM,0,TOTALS,BELGIUM,200,28,58,48.3,17,35,48.6,11,23,47.8,10,12,83.3,7,15,22,11,32,8,3,6,77,0
7932,183148,228_09_64,CZECH REPUBLIC,0,TOTALS,CZECH REPUBLIC,200,24,64,37.5,20,48,41.7,4,16,25.0,19,24,79.2,17,30,47,10,23,14,6,2,71,1
7933,183161,228_09_64,HUNGARY,0,TOTALS,HUNGARY,200,21,56,37.5,16,35,45.7,5,21,23.8,18,28,64.3,8,25,33,5,27,12,6,0,65,0
7934,183174,228_09_65,HUNGARY,0,TOTALS,HUNGARY,200,29,54,53.7,22,34,64.7,7,20,35.0,10,20,50.0,8,22,30,14,23,12,12,0,75,1
7935,183187,228_09_65,ESTONIA,0,TOTALS,ESTONIA,200,23,54,42.6,16,28,57.1,7,26,26.9,11,16,68.8,14,23,37,19,22,17,8,2,64,0
7936,183200,228_09_66,FINLAND,0,TOTALS,FINLAND,200,26,57,45.6,21,32,65.6,5,25,20.0,18,20,90.0,11,18,29,12,23,15,2,1,75,0
7937,183213,228_09_66,ITALY,0,TOTALS,ITALY,200,30,61,49.2,23,40,57.5,7,21,33.3,10,17,58.8,16,21,37,8,22,14,7,2,77,1
7938,183226,228_09_67,CZECH REPUBLIC,0,TOTALS,CZECH REPUBLIC,200,25,54,46.3,20,38,52.6,5,16,31.2,16,26,61.5,15,20,35,9,19,20,9,2,71,1
7939,183239,228_09_67,UKRAINE,0,TOTALS,UKRAINE,200,22,51,43.1,15,35,42.9,7,16,43.8,13,18,72.2,9,19,28,9,20,19,6,3,64,0
7940,183252,228_09_68,BELGIUM,0,TOTALS,BELGIUM,200,22,49,44.9,16,28,57.1,6,21,28.6,14,23,60.9,5,23,28,9,19,10,4,1,64,1
7941,183264,228_09_68,PORTUGAL,0,TOTALS,PORTUGAL,200,20,52,38.5,11,31,35.5,9,21,42.9,9,11,81.8,7,25,32,8,25,18,8,1,58,0
7942,183277,228_09_69,UKRAINE,0,TOTALS,UKRAINE,200,24,70,34.3,16,37,43.2,8,33,24.2,21,29,72.4,22,37,59,10,25,11,4,6,77,1
7943,183290,228_09_69,HUNGARY,0,TOTALS,HUNGARY,200,18,63,28.6,10,32,31.2,8,31,25.8,25,28,89.3,9,24,33,11,27,6,6,0,69,0
7944,183303,228_09_70,CZECH REPUBLIC,0,TOTALS,CZECH REPUBLIC,200,28,55,50.9,21,43,48.8,7,12,58.3,17,28,60.7,9,28,37,13,23,12,10,6,80,1
7945,183316,228_09_70,ESTONIA,0,TOTALS,ESTONIA,200,15,55,27.3,13,37,35.1,2,18,11.1,22,28,78.6,14,22,36,7,22,18,4,3,54,0
7946,183329,228_09_71,FRANCE,0,TOTALS,FRANCE,200,31,58,53.4,27,42,64.3,4,16,25.0,15,22,68.2,7,31,38,13,26,12,11,2,81,1
7947,183342,228_09_71,ITALY,0,TOTALS,ITALY,200,17,50,34.0,8,30,26.7,9,20,45.0,18,23,78.3,6,21,27,4,21,15,6,2,61,0
7948,183355,228_09_72,BOSNIA AND HERZEGOVINA,0,TOTALS,BOSNIA AND HERZEGOVINA,200,23,43,53.5,15,27,55.6,8,16,50.0,19,29,65.5,7,23,30,9,19,19,7,2,73,1
7949,183368,228_09_72,PORTUGAL,0,TOTALS,PORTUGAL,200,22,61,36.1,14,28,50.0,8,33,24.2,9,15,60.0,16,15,31,9,26,17,12,1,61,0
7950,183381,228_09_73,HUNGARY,0,TOTALS,HUNGARY,200,25,63,39.7,15,37,40.5,10,26,38.5,10,12,83.3,13,25,38,14,24,18,9,1,70,1
7951,183394,228_09_73,CZECH REPUBLIC,0,TOTALS,CZECH REPUBLIC,200,21,47,44.7,21,36,58.3,0,11,0.0,13,21,61.9,4,24,28,13,18,17,8,2,55,0
7952,183407,228_09_74,ESTONIA,0,TOTALS,ESTONIA,225,28,76,36.8,22,54,40.7,6,22,27.3,10,15,66.7,20,27,47,12,25,17,7,5,72,0
7953,183420,228_09_74,UKRAINE,0,TOTALS,UKRAINE,225,24,60,40.0,20,46,43.5,4,14,28.6,23,27,85.2,11,29,40,6,25,20,9,1,75,1
7954,183433,228_09_75,FINLAND,0,TOTALS,FINLAND,200,27,58,46.6,16,30,53.3,11,28,39.3,12,16,75.0,9,20,29,10,16,11,6,2,77,1
7955,183446,228_09_75,FRANCE,0,TOTALS,FRANCE,200,30,59,50.8,25,44,56.8,5,15,33.3,8,14,57.1,10,24,34,11,18,13,5,4,73,0
7956,183459,228_09_76,BELGIUM,0,TOTALS,BELGIUM,200,36,68,52.9,27,50,54.0,9,18,50.0,21,29,72.4,21,18,39,14,31,11,4,0,102,0
7957,183472,228_09_76,BOSNIA AND HERZEGOVINA,0,TOTALS,BOSNIA AND HERZEGOVINA,200,25,49,51.0,19,28,67.9,6,21,28.6,23,35,65.7,6,12,18,9,31,13,4,0,79,1
7958,183485,228_09_77,ESTONIA,0,TOTALS,ESTONIA,200,22,60,36.7,15,35,42.9,7,25,28.0,9,19,47.4,12,24,36,12,22,16,7,6,60,0
7959,183498,228_09_77,HUNGARY,0,TOTALS,HUNGARY,200,21,59,35.6,13,40,32.5,8,19,42.1,15,23,65.2,16,30,46,9,24,16,10,1,65,1
7960,183511,228_09_78,UKRAINE,0,TOTALS,UKRAINE,200,30,58,51.7,23,38,60.5,7,20,35.0,15,20,75.0,8,28,36,15,23,17,9,6,82,1
7961,183524,228_09_78,CZECH REPUBLIC,0,TOTALS,CZECH REPUBLIC,200,26,61,42.6,22,45,48.9,4,16,25.0,14,22,63.6,11,22,33,9,23,15,9,3,70,0
7962,183537,228_09_79,PORTUGAL,0,TOTALS,PORTUGAL,200,18,62,29.0,13,32,40.6,5,30,16.7,17,21,81.0,17,18,35,8,24,15,4,1,58,0
7963,183550,228_09_79,BELGIUM,0,TOTALS,BELGIUM,200,15,41,36.6,9,19,47.4,6,22,27.3,24,29,82.8,6,27,33,8,22,21,7,2,60,1
7964,183563,228_09_80,ITALY,0,TOTALS,ITALY,200,30,61,49.2,18,32,56.2,12,29,41.4,17,25,68.0,7,27,34,9,23,13,7,3,89,0
7965,183576,228_09_80,FINLAND,0,TOTALS,FINLAND,200,33,65,50.8,17,34,50.0,16,31,51.6,13,17,76.5,8,25,33,9,21,13,5,1,95,1
7966,183589,228_09_81,BELGIUM,0,TOTALS,BELGIUM,200,25,57,43.9,17,35,48.6,8,22,36.4,12,17,70.6,6,17,23,7,23,13,8,4,70,1
7967,183602,228_09_81,FRANCE,0,TOTALS,FRANCE,200,23,48,47.9,21,36,58.3,2,12,16.7,18,23,78.3,5,22,27,8,18,13,6,2,66,0
7968,183615,228_09_82,FRANCE,0,TOTALS,FRANCE,200,34,53,64.2,30,42,71.4,4,11,36.4,20,26,76.9,8,27,35,23,18,9,7,3,92,1
7969,183628,228_09_82,BELGIUM,0,TOTALS,BELGIUM,200,19,54,35.2,13,34,38.2,6,20,30.0,10,20,50.0,11,14,25,11,21,13,6,1,54,0
7970,183641,229_08_01,DENMARK,0,TOTALS,DENMARK,200,20,49,40.8,13,28,46.4,7,21,33.3,17,31,54.8,9,20,29,9,16,18,5,0,64,0
7971,183654,229_08_01,AUSTRIA,0,TOTALS,AUSTRIA,200,28,53,52.8,16,31,51.6,12,22,54.5,5,8,62.5,2,19,21,14,24,12,14,0,73,1
7972,183667,229_08_02,SWEDEN,0,TOTALS,SWEDEN,200,29,59,49.2,20,37,54.1,9,22,40.9,15,18,83.3,10,28,38,19,23,19,16,3,82,1
7973,183680,229_08_02,IRELAND,0,TOTALS,IRELAND,200,23,63,36.5,16,40,40.0,7,23,30.4,10,14,71.4,12,22,34,7,20,23,6,1,63,0
7974,183691,229_08_03,SWITZERLAND,0,TOTALS,SWITZERLAND,200,35,66,53.0,22,33,66.7,13,33,39.4,8,11,72.7,6,18,24,15,22,13,14,0,91,1
7975,183704,229_08_03,ALBANIA,0,TOTALS,ALBANIA,200,27,62,43.5,23,49,46.9,4,13,30.8,21,29,72.4,13,27,40,6,13,17,8,1,79,0
7976,183717,229_08_04,ROMANIA,0,TOTALS,ROMANIA,200,25,51,49.0,18,29,62.1,7,22,31.8,13,19,68.4,9,21,30,12,21,11,5,2,70,0
7977,183730,229_08_04,CYPRUS,0,TOTALS,CYPRUS,200,25,56,44.6,17,34,50.0,8,22,36.4,13,24,54.2,16,20,36,5,20,9,7,0,71,1
7978,183743,229_08_05,NETHERLANDS,0,TOTALS,NETHERLANDS,200,23,69,33.3,17,47,36.2,6,22,27.3,11,12,91.7,17,28,45,13,17,9,8,3,63,0
7979,183756,229_08_05,MONTENEGRO,0,TOTALS,MONTENEGRO,200,25,59,42.4,14,31,45.2,11,28,39.3,9,13,69.2,10,30,40,15,15,12,5,3,70,1
7980,183769,229_08_06,LUXEMBOURG,0,TOTALS,LUXEMBOURG,200,27,70,38.6,18,38,47.4,9,32,28.1,2,6,33.3,8,11,19,8,20,11,7,0,65,0
7981,183782,229_08_06,GEORGIA,0,TOTALS,GEORGIA,200,35,60,58.3,28,40,70.0,7,20,35.0,21,30,70.0,15,27,42,11,11,16,6,2,98,1
7982,183795,229_08_07,BELARUS,0,TOTALS,BELARUS,200,22,46,47.8,16,31,51.6,6,15,40.0,20,28,71.4,9,20,29,13,27,15,5,3,70,1
7983,183808,229_08_07,ROMANIA,0,TOTALS,ROMANIA,200,18,51,35.3,15,35,42.9,3,16,18.8,20,27,74.1,11,14,25,5,27,14,7,1,59,0
7984,183821,229_08_08,CYPRUS,0,TOTALS,CYPRUS,200,22,60,36.7,18,40,45.0,4,20,20.0,11,19,57.9,9,25,34,11,17,10,9,1,59,0
7985,183833,229_08_08,SWITZERLAND,0,TOTALS,SWITZERLAND,200,23,59,39.0,16,36,44.4,7,23,30.4,8,16,50.0,14,29,43,10,20,17,8,3,61,1
7986,183846,229_08_09,IRELAND,0,TOTALS,IRELAND,200,29,75,38.7,19,43,44.2,10,32,31.2,9,15,60.0,11,21,32,8,22,11,4,2,77,0
7987,183858,229_08_09,GEORGIA,0,TOTALS,GEORGIA,200,35,62,56.5,25,40,62.5,10,22,45.5,14,26,53.8,5,30,35,16,17,17,10,3,94,1
7988,183870,229_08_10,SLOVAK REPUBLIC,0,TOTALS,SLOVAK REPUBLIC,200,32,70,45.7,23,38,60.5,9,32,28.1,15,19,78.9,14,18,32,14,24,12,9,1,88,0
7989,183883,229_08_10,SWEDEN,0,TOTALS,SWEDEN,200,29,52,55.8,22,30,73.3,7,22,31.8,24,34,70.6,7,27,34,11,20,16,6,0,89,1
7990,183896,229_08_11,AUSTRIA,0,TOTALS,AUSTRIA,200,19,57,33.3,11,31,35.5,8,26,30.8,8,13,61.5,7,20,27,10,23,15,10,0,54,0
7991,183909,229_08_11,NETHERLANDS,0,TOTALS,NETHERLANDS,200,22,51,43.1,18,28,64.3,4,23,17.4,10,18,55.6,7,24,31,12,20,15,7,0,58,1
7992,183922,229_08_12,ICELAND,0,TOTALS,ICELAND,200,26,74,35.1,15,39,38.5,11,35,31.4,14,20,70.0,17,26,43,12,20,9,9,6,77,1
7993,183935,229_08_12,DENMARK,0,TOTALS,DENMARK,200,26,58,44.8,20,38,52.6,6,20,30.0,13,18,72.2,7,30,37,12,20,11,1,6,71,0
7994,183947,229_08_13,SWITZERLAND,0,TOTALS,SWITZERLAND,200,28,56,50.0,19,36,52.8,9,20,45.0,12,16,75.0,10,22,32,7,19,20,9,1,77,0
7995,183960,229_08_13,BELARUS,0,TOTALS,BELARUS,200,26,55,47.3,18,37,48.6,8,18,44.4,21,24,87.5,10,19,29,11,20,13,14,3,81,1
7996,183972,229_08_14,SLOVAK REPUBLIC,0,TOTALS,SLOVAK REPUBLIC,200,30,63,47.6,22,38,57.9,8,25,32.0,10,14,71.4,9,18,27,15,17,18,12,2,78,1
7997,183985,229_08_14,GEORGIA,0,TOTALS,GEORGIA,200,36,63,57.1,21,36,58.3,15,27,55.6,14,20,70.0,10,23,33,22,15,18,8,1,101,0
7998,183998,229_08_15,LUXEMBOURG,0,TOTALS,LUXEMBOURG,200,25,67,37.3,19,42,45.2,6,25,24.0,14,20,70.0,8,17,25,4,15,19,14,0,70,0
7999,184011,229_08_15,IRELAND,0,TOTALS,IRELAND,200,38,69,55.1,26,45,57.8,12,24,50.0,9,14,64.3,10,36,46,12,22,25,8,2,97,1
8000,184024,229_08_16,NETHERLANDS,0,TOTALS,NETHERLANDS,200,33,63,52.4,22,40,55.0,11,23,47.8,7,11,63.6,11,25,36,16,16,12,8,8,84,1
8001,184037,229_08_16,ICELAND,0,TOTALS,ICELAND,200,26,66,39.4,19,50,38.0,7,16,43.8,9,14,64.3,15,19,34,9,19,16,6,1,68,0
8002,184050,229_08_17,ALBANIA,0,TOTALS,ALBANIA,200,25,54,46.3,17,36,47.2,8,18,44.4,11,22,50.0,10,22,32,8,21,16,5,2,69,1
8003,184063,229_08_17,CYPRUS,0,TOTALS,CYPRUS,200,21,56,37.5,18,30,60.0,3,26,11.5,18,25,72.0,9,21,30,7,21,10,8,3,63,0
8004,184076,229_08_18,MONTENEGRO,0,TOTALS,MONTENEGRO,200,35,56,62.5,25,34,73.5,10,22,45.5,16,24,66.7,4,24,28,19,17,11,10,6,96,1
8005,184089,229_08_18,AUSTRIA,0,TOTALS,AUSTRIA,200,28,66,42.4,20,40,50.0,8,26,30.8,9,13,69.2,15,26,41,8,20,16,8,0,73,0
8006,184102,229_08_19,BELARUS,0,TOTALS,BELARUS,200,28,69,40.6,20,45,44.4,8,24,33.3,28,33,84.8,12,33,45,15,21,9,14,0,92,1
8007,184115,229_08_19,ALBANIA,0,TOTALS,ALBANIA,200,16,53,30.2,14,34,41.2,2,19,10.5,12,25,48.0,7,23,30,2,25,21,6,4,46,0
8008,184126,229_08_20,SLOVAK REPUBLIC,0,TOTALS,SLOVAK REPUBLIC,200,40,71,56.3,33,46,71.7,7,25,28.0,23,30,76.7,9,33,42,19,16,11,12,1,110,0
8009,184138,229_08_20,LUXEMBOURG,0,TOTALS,LUXEMBOURG,200,24,62,38.7,20,40,50.0,4,22,18.2,15,18,83.3,3,25,28,7,21,21,7,0,67,1
8010,184151,229_08_21,ROMANIA,0,TOTALS,ROMANIA,200,32,63,50.8,23,34,67.6,9,29,31.0,10,13,76.9,9,30,39,16,19,16,8,3,83,1
8011,184163,229_08_21,SWITZERLAND,0,TOTALS,SWITZERLAND,200,17,62,27.4,15,39,38.5,2,23,8.7,17,25,68.0,11,19,30,7,16,11,11,1,53,0
8012,184176,229_08_22,SWEDEN,0,TOTALS,SWEDEN,200,19,71,26.8,13,46,28.3,6,25,24.0,17,23,73.9,25,21,46,10,23,9,11,2,61,1
8013,184189,229_08_22,GEORGIA,0,TOTALS,GEORGIA,200,20,47,42.6,14,23,60.9,6,24,25.0,13,21,61.9,8,29,37,13,23,17,6,2,59,0
8014,184202,229_08_23,DENMARK,0,TOTALS,DENMARK,200,22,62,35.5,13,31,41.9,9,31,29.0,11,15,73.3,4,19,23,17,18,16,7,1,64,0
8015,184215,229_08_23,NETHERLANDS,0,TOTALS,NETHERLANDS,200,28,55,50.9,19,35,54.3,9,20,45.0,14,15,93.3,6,23,29,20,23,14,4,3,79,1
8016,184228,229_08_24,ICELAND,0,TOTALS,ICELAND,200,19,72,26.4,11,45,24.4,8,27,29.6,20,31,64.5,10,17,27,12,26,13,10,2,66,0
8017,184241,229_08_24,MONTENEGRO,0,TOTALS,MONTENEGRO,200,25,54,46.3,20,31,64.5,5,23,21.7,25,32,78.1,9,39,48,19,27,27,7,8,80,1
8018,184254,229_08_25,IRELAND,0,TOTALS,IRELAND,225,30,83,36.1,21,50,42.0,9,33,27.3,19,23,82.6,17,26,43,10,25,13,7,0,88,0
8019,184266,229_08_25,SLOVAK REPUBLIC,0,TOTALS,SLOVAK REPUBLIC,225,36,73,49.3,29,42,69.0,7,31,22.6,16,26,61.5,11,25,36,14,22,14,6,4,95,1
8020,184279,229_08_26,CYPRUS,0,TOTALS,CYPRUS,200,31,58,53.4,23,39,59.0,8,19,42.1,10,18,55.6,9,23,32,11,24,9,3,1,80,0
8021,184292,229_08_26,BELARUS,0,TOTALS,BELARUS,200,28,56,50.0,21,40,52.5,7,16,43.8,18,23,78.3,6,20,26,13,18,8,4,2,81,1
8022,184305,229_08_27,LUXEMBOURG,0,TOTALS,LUXEMBOURG,200,19,57,33.3,10,28,35.7,9,29,31.0,4,8,50.0,2,16,18,6,17,21,9,0,51,0
8023,184318,229_08_27,SWEDEN,0,TOTALS,SWEDEN,200,40,69,58.0,33,50,66.0,7,19,36.8,9,13,69.2,13,36,49,9,11,18,14,0,96,1
8024,184331,229_08_28,ALBANIA,0,TOTALS,ALBANIA,200,22,60,36.7,15,38,39.5,7,22,31.8,15,27,55.6,13,28,41,7,18,18,9,6,66,0
8025,184344,229_08_28,ROMANIA,0,TOTALS,ROMANIA,200,25,63,39.7,13,32,40.6,12,31,38.7,18,22,81.8,5,27,32,11,20,14,13,1,80,1
8026,184357,229_08_29,AUSTRIA,0,TOTALS,AUSTRIA,200,23,55,41.8,13,30,43.3,10,25,40.0,25,29,86.2,10,24,34,14,23,16,6,1,81,1
8027,184368,229_08_29,ICELAND,0,TOTALS,ICELAND,200,29,61,47.5,20,37,54.1,9,24,37.5,7,14,50.0,9,20,29,12,25,11,7,1,74,0
8028,184381,229_08_30,MONTENEGRO,0,TOTALS,MONTENEGRO,200,35,61,57.4,25,38,65.8,10,23,43.5,16,22,72.7,7,30,37,18,14,14,9,5,96,1
8029,184394,229_08_30,DENMARK,0,TOTALS,DENMARK,200,22,58,37.9,15,37,40.5,7,21,33.3,9,11,81.8,4,22,26,7,20,16,7,1,60,0
8030,184407,229_09_31,IRELAND,0,TOTALS,IRELAND,200,16,54,29.6,13,34,38.2,3,20,15.0,15,29,51.7,5,25,30,6,29,9,6,0,50,0
8031,184420,229_09_31,SWEDEN,0,TOTALS,SWEDEN,200,23,52,44.2,18,29,62.1,5,23,21.7,15,29,51.7,9,35,44,5,25,14,4,1,66,1
8032,184433,229_09_32,GEORGIA,0,TOTALS,GEORGIA,200,46,83,55.4,33,53,62.3,13,30,43.3,10,12,83.3,19,36,55,29,15,14,6,11,115,0
8033,184445,229_09_32,LUXEMBOURG,0,TOTALS,LUXEMBOURG,200,29,72,40.3,22,56,39.3,7,16,43.8,8,11,72.7,7,19,26,10,13,13,7,2,73,1
8034,184458,229_09_33,CYPRUS,0,TOTALS,CYPRUS,225,25,56,44.6,15,32,46.9,10,24,41.7,18,23,78.3,6,23,29,16,28,16,13,0,78,1
8035,184471,229_09_33,ROMANIA,0,TOTALS,ROMANIA,225,21,53,39.6,14,32,43.8,7,21,33.3,20,32,62.5,12,26,38,12,26,23,11,1,69,0
8036,184484,229_09_34,ALBANIA,0,TOTALS,ALBANIA,200,25,53,47.2,19,34,55.9,6,19,31.6,20,33,60.6,11,18,29,6,26,13,8,2,76,1
8037,184497,229_09_34,SWITZERLAND,0,TOTALS,SWITZERLAND,200,22,56,39.3,15,36,41.7,7,20,35.0,22,30,73.3,11,15,26,7,25,15,6,0,73,0
8038,184510,229_09_35,AUSTRIA,0,TOTALS,AUSTRIA,200,34,68,50.0,22,34,64.7,12,34,35.3,12,13,92.3,11,25,36,19,16,8,7,4,92,1
8039,184522,229_09_35,DENMARK,0,TOTALS,DENMARK,200,23,59,39.0,18,42,42.9,5,17,29.4,10,17,58.8,12,21,33,7,16,11,3,1,61,0
8040,184535,229_09_36,MONTENEGRO,0,TOTALS,MONTENEGRO,200,32,54,59.3,25,39,64.1,7,15,46.7,22,32,68.8,9,20,29,14,15,16,11,4,93,1
8041,184548,229_09_36,NETHERLANDS,0,TOTALS,NETHERLANDS,200,26,54,48.1,19,39,48.7,7,15,46.7,9,12,75.0,8,18,26,9,27,23,9,2,68,0
8042,184560,229_09_37,ROMANIA,0,TOTALS,ROMANIA,200,25,52,48.1,20,33,60.6,5,19,26.3,15,22,68.2,13,19,32,17,23,18,6,2,70,0
8043,184573,229_09_37,BELARUS,0,TOTALS,BELARUS,200,26,49,53.1,15,28,53.6,11,21,52.4,15,20,75.0,6,19,25,16,23,17,10,1,78,1
8044,184585,229_09_38,GEORGIA,0,TOTALS,GEORGIA,200,37,70,52.9,25,45,55.6,12,25,48.0,12,22,54.5,21,29,50,25,20,12,5,7,98,1
8045,184598,229_09_38,IRELAND,0,TOTALS,IRELAND,200,25,69,36.2,14,43,32.6,11,26,42.3,12,21,57.1,15,13,28,8,22,12,5,5,73,0
8046,184611,229_09_39,SWEDEN,0,TOTALS,SWEDEN,200,23,53,43.4,19,39,48.7,4,14,28.6,14,19,73.7,5,22,27,14,20,6,7,5,64,1
8047,184624,229_09_39,SLOVAK REPUBLIC,0,TOTALS,SLOVAK REPUBLIC,200,22,58,37.9,14,34,41.2,8,24,33.3,6,11,54.5,15,27,42,16,20,16,4,4,58,0
8048,184637,229_09_40,DENMARK,0,TOTALS,DENMARK,200,20,56,35.7,17,35,48.6,3,21,14.3,11,20,55.0,14,31,45,9,20,20,8,4,54,0
8049,184650,229_09_40,ICELAND,0,TOTALS,ICELAND,200,24,61,39.3,17,37,45.9,7,24,29.2,11,19,57.9,10,25,35,11,19,15,7,3,66,1
8050,184663,229_09_41,NETHERLANDS,0,TOTALS,NETHERLANDS,200,32,65,49.2,25,49,51.0,7,16,43.8,12,20,60.0,12,30,42,20,22,24,18,4,83,1
8051,184676,229_09_41,AUSTRIA,0,TOTALS,AUSTRIA,200,21,55,38.2,15,36,41.7,6,19,31.6,12,14,85.7,5,22,27,15,24,23,19,3,60,0
8052,184689,229_09_42,SWITZERLAND,0,TOTALS,SWITZERLAND,200,21,56,37.5,15,32,46.9,6,24,25.0,7,10,70.0,8,22,30,7,17,13,7,2,55,1
8053,184702,229_09_42,CYPRUS,0,TOTALS,CYPRUS,200,21,49,42.9,15,28,53.6,6,21,28.6,6,11,54.5,6,19,25,9,18,13,1,0,54,0
8054,184715,229_09_43,ICELAND,0,TOTALS,ICELAND,200,31,66,47.0,19,35,54.3,12,31,38.7,13,18,72.2,10,23,33,18,26,16,5,0,87,1
8055,184728,229_09_43,NETHERLANDS,0,TOTALS,NETHERLANDS,200,20,55,36.4,14,31,45.2,6,24,25.0,29,33,87.9,10,25,35,11,22,18,9,2,75,0
8056,184741,229_09_44,IRELAND,0,TOTALS,IRELAND,200,39,79,49.4,26,49,53.1,13,30,43.3,9,20,45.0,16,26,42,21,21,14,10,2,100,0
8057,184753,229_09_44,LUXEMBOURG,0,TOTALS,LUXEMBOURG,200,31,65,47.7,21,41,51.2,10,24,41.7,11,15,73.3,7,23,30,17,20,14,6,1,83,1
8058,184766,229_09_45,BELARUS,0,TOTALS,BELARUS,200,18,52,34.6,10,27,37.0,8,25,32.0,22,28,78.6,11,18,29,9,17,12,4,3,66,0
8059,184776,229_09_45,SWITZERLAND,0,TOTALS,SWITZERLAND,200,27,59,45.8,20,37,54.1,7,22,31.8,9,14,64.3,10,22,32,12,25,11,4,4,70,1
8060,184789,229_09_46,GEORGIA,0,TOTALS,GEORGIA,200,32,60,53.3,23,41,56.1,9,19,47.4,18,27,66.7,15,35,50,13,11,7,5,5,91,1
8061,184802,229_09_46,SLOVAK REPUBLIC,0,TOTALS,SLOVAK REPUBLIC,200,18,65,27.7,13,33,39.4,5,32,15.6,9,14,64.3,13,16,29,8,24,9,3,3,50,0
8062,184815,229_09_47,CYPRUS,0,TOTALS,CYPRUS,200,30,66,45.5,17,42,40.5,13,24,54.2,18,24,75.0,13,29,42,20,19,9,11,1,91,1
8063,184828,229_09_47,ALBANIA,0,TOTALS,ALBANIA,200,21,62,33.9,15,47,31.9,6,15,40.0,8,15,53.3,12,26,38,8,22,19,7,5,56,0
8064,184841,229_09_48,AUSTRIA,0,TOTALS,AUSTRIA,200,25,60,41.7,15,34,44.1,10,26,38.5,3,6,50.0,10,15,25,11,20,14,7,2,63,0
8065,184854,229_09_48,MONTENEGRO,0,TOTALS,MONTENEGRO,200,29,53,54.7,20,30,66.7,9,23,39.1,19,21,90.5,8,25,33,19,13,13,8,5,86,1
8066,184867,229_09_49,GEORGIA,0,TOTALS,GEORGIA,200,27,60,45.0,21,41,51.2,6,19,31.6,22,31,71.0,13,25,38,12,21,12,10,6,82,1
8067,184880,229_09_49,SWEDEN,0,TOTALS,SWEDEN,200,24,57,42.1,16,37,43.2,8,20,40.0,16,22,72.7,8,25,33,11,28,13,2,3,72,0
8068,184893,229_09_50,LUXEMBOURG,0,TOTALS,LUXEMBOURG,200,26,65,40.0,22,54,40.7,4,11,36.4,7,12,58.3,8,22,30,10,14,15,7,2,63,0
8069,184906,229_09_50,SLOVAK REPUBLIC,0,TOTALS,SLOVAK REPUBLIC,200,29,68,42.6,22,42,52.4,7,26,26.9,11,16,68.8,16,29,45,8,20,13,10,5,76,1
8070,184919,229_09_51,NETHERLANDS,0,TOTALS,NETHERLANDS,200,31,62,50.0,20,41,48.8,11,21,52.4,9,16,56.2,11,27,38,21,19,12,10,3,82,1
8071,184931,229_09_51,DENMARK,0,TOTALS,DENMARK,200,20,62,32.3,16,40,40.0,4,22,18.2,10,18,55.6,14,16,30,13,18,10,9,3,54,0
8072,184944,229_09_52,ALBANIA,0,TOTALS,ALBANIA,200,21,54,38.9,13,33,39.4,8,21,38.1,25,35,71.4,12,28,40,8,26,23,2,3,75,0
8073,184957,229_09_52,BELARUS,0,TOTALS,BELARUS,200,20,53,37.7,11,20,55.0,9,33,27.3,27,37,73.0,4,18,22,8,31,14,11,2,76,1
8074,184968,229_09_53,SWITZERLAND,0,TOTALS,SWITZERLAND,200,31,59,52.5,21,36,58.3,10,23,43.5,9,13,69.2,7,19,26,17,16,17,6,2,81,1
8075,184980,229_09_53,ROMANIA,0,TOTALS,ROMANIA,200,28,61,45.9,24,40,60.0,4,21,19.0,9,14,64.3,9,17,26,12,20,17,8,0,69,0
8076,184993,229_09_54,MONTENEGRO,0,TOTALS,MONTENEGRO,200,36,65,55.4,25,38,65.8,11,27,40.7,19,27,70.4,13,38,51,23,10,14,7,8,102,0
8077,185005,229_09_54,ICELAND,0,TOTALS,ICELAND,200,21,65,32.3,13,34,38.2,8,31,25.8,8,9,88.9,11,21,32,5,18,8,9,0,58,1
8078,185018,229_09_55,DENMARK,0,TOTALS,DENMARK,200,24,57,42.1,13,31,41.9,11,26,42.3,6,9,66.7,4,16,20,13,24,14,7,0,65,0
8079,185031,229_09_55,MONTENEGRO,0,TOTALS,MONTENEGRO,200,26,49,53.1,19,30,63.3,7,19,36.8,23,33,69.7,5,19,24,16,17,11,11,1,82,1
8080,185044,229_09_56,ICELAND,0,TOTALS,ICELAND,200,24,67,35.8,18,38,47.4,6,29,20.7,11,18,61.1,12,23,35,11,18,11,3,0,65,0
8081,185057,229_09_56,AUSTRIA,0,TOTALS,AUSTRIA,200,29,57,50.9,21,30,70.0,8,27,29.6,10,12,83.3,4,35,39,11,24,16,5,4,76,1
8082,185070,229_09_57,BELARUS,0,TOTALS,BELARUS,200,29,55,52.7,24,37,64.9,5,18,27.8,14,19,73.7,9,17,26,11,19,13,10,3,77,1
8083,185081,229_09_57,CYPRUS,0,TOTALS,CYPRUS,200,26,55,47.3,23,42,54.8,3,13,23.1,15,19,78.9,10,18,28,6,24,19,7,0,70,0
8084,185094,229_09_58,ROMANIA,0,TOTALS,ROMANIA,200,32,70,45.7,26,53,49.1,6,17,35.3,30,39,76.9,18,22,40,17,25,4,11,2,100,0
8085,185107,229_09_58,ALBANIA,0,TOTALS,ALBANIA,200,21,50,42.0,17,36,47.2,4,14,28.6,23,35,65.7,12,22,34,7,25,16,1,1,69,1
8086,185120,229_09_59,SLOVAK REPUBLIC,0,TOTALS,SLOVAK REPUBLIC,200,22,57,38.6,12,31,38.7,10,26,38.5,21,28,75.0,10,27,37,13,26,17,6,3,75,1
8087,185133,229_09_59,IRELAND,0,TOTALS,IRELAND,200,23,69,33.3,18,44,40.9,5,25,20.0,17,26,65.4,19,27,46,6,29,13,10,2,68,0
8088,185145,229_09_60,SWEDEN,0,TOTALS,SWEDEN,200,36,65,55.4,26,34,76.5,10,31,32.3,15,22,68.2,12,34,46,19,15,12,13,2,97,1
8089,185156,229_09_60,LUXEMBOURG,0,TOTALS,LUXEMBOURG,200,16,54,29.6,11,37,29.7,5,17,29.4,3,4,75.0,5,21,26,6,15,24,3,2,40,0
8090,185169,229_09_61,SWEDEN,0,TOTALS,SWEDEN,200,19,61,31.1,17,40,42.5,2,21,9.5,10,13,76.9,9,20,29,7,23,18,8,2,50,0
8091,185182,229_09_61,MONTENEGRO,0,TOTALS,MONTENEGRO,200,22,51,43.1,17,32,53.1,5,19,26.3,21,29,72.4,12,31,43,10,18,21,6,1,70,1
8092,185195,229_09_62,BELARUS,0,TOTALS,BELARUS,200,28,58,48.3,20,34,58.8,8,24,33.3,11,14,78.6,8,16,24,16,26,13,9,7,75,0
8093,185208,229_09_62,GEORGIA,0,TOTALS,GEORGIA,200,27,55,49.1,18,36,50.0,9,19,47.4,26,31,83.9,12,23,35,16,17,13,8,3,89,1
8094,185221,229_09_63,GEORGIA,0,TOTALS,GEORGIA,200,24,51,47.1,12,32,37.5,12,19,63.2,26,34,76.5,6,25,31,19,21,12,9,6,86,1
8095,185234,229_09_63,BELARUS,0,TOTALS,BELARUS,200,27,63,42.9,11,32,34.4,16,31,51.6,14,17,82.4,12,22,34,10,29,18,5,2,84,0
8096,185247,229_09_64,MONTENEGRO,0,TOTALS,MONTENEGRO,200,29,50,58.0,19,33,57.6,10,17,58.8,20,34,58.8,9,25,34,15,16,8,10,2,88,1
8097,185260,229_09_64,SWEDEN,0,TOTALS,SWEDEN,200,26,55,47.3,17,32,53.1,9,23,39.1,10,11,90.9,6,21,27,10,26,13,3,2,71,0
8098,185273,230_09_01,MKD,0,TOTALS,MKD,200,20,60,33.3,15,34,44.1,5,26,19.2,9,15,60.0,8,15,23,13,22,14,9,2,54,0
8099,185286,230_09_01,GREECE,0,TOTALS,GREECE,200,29,49,59.2,24,33,72.7,5,16,31.2,23,28,82.1,6,34,40,18,21,17,10,3,86,1
8100,185299,230_09_02,RUSSIA,0,TOTALS,RUSSIA,200,28,53,52.8,20,37,54.1,8,16,50.0,17,23,73.9,7,26,33,16,28,16,8,1,81,1
8101,185312,230_09_02,LATVIA,0,TOTALS,LATVIA,200,20,58,34.5,13,36,36.1,7,22,31.8,21,30,70.0,12,18,30,14,22,15,6,2,68,0
8102,185325,230_09_03,GREAT BRITAIN,0,TOTALS,GREAT BRITAIN,200,22,53,41.5,18,39,46.2,4,14,28.6,11,13,84.6,8,15,23,11,15,10,4,2,59,0
8103,185338,230_09_03,SLOVENIA,0,TOTALS,SLOVENIA,200,30,52,57.7,22,29,75.9,8,23,34.8,4,4,100.0,5,23,28,17,17,9,1,2,72,1
8104,185351,230_09_04,POLAND,0,TOTALS,POLAND,200,36,70,51.4,26,46,56.5,10,24,41.7,8,11,72.7,12,28,40,25,17,11,4,10,90,1
8105,185364,230_09_04,BULGARIA,0,TOTALS,BULGARIA,200,32,77,41.6,27,58,46.6,5,19,26.3,9,13,69.2,17,23,40,10,17,9,6,1,78,0
8106,185377,230_09_05,CROATIA,0,TOTALS,CROATIA,200,29,63,46.0,21,47,44.7,8,16,50.0,20,29,69.0,17,15,32,14,21,12,4,2,86,1
8107,185390,230_09_05,ISRAEL,0,TOTALS,ISRAEL,200,30,53,56.6,25,38,65.8,5,15,33.3,14,16,87.5,5,21,26,16,25,15,5,3,79,0
8108,185403,230_09_06,FRANCE,0,TOTALS,FRANCE,200,24,55,43.6,20,40,50.0,4,15,26.7,18,33,54.5,15,31,46,12,24,15,6,3,70,1
8109,185416,230_09_06,GERMANY,0,TOTALS,GERMANY,200,24,60,40.0,16,36,44.4,8,24,33.3,9,16,56.2,6,26,32,13,27,10,6,3,65,0
8110,185429,230_09_07,SERBIA,0,TOTALS,SERBIA,200,24,60,40.0,18,32,56.2,6,28,21.4,12,18,66.7,8,30,38,13,27,11,12,4,66,1
8111,185442,230_09_07,SPAIN,0,TOTALS,SPAIN,200,20,61,32.8,18,42,42.9,2,19,10.5,15,28,53.6,16,29,45,9,14,14,3,2,57,0
8112,185455,230_09_08,TURKEY,0,TOTALS,TURKEY,200,27,53,50.9,20,40,50.0,7,13,53.8,23,26,88.5,8,19,27,12,24,13,8,1,84,1
8113,185468,230_09_08,LITHUANIA,0,TOTALS,LITHUANIA,200,27,51,52.9,18,26,69.2,9,25,36.0,13,18,72.2,6,18,24,16,26,15,3,2,76,0
8114,185481,230_09_09,ISRAEL,0,TOTALS,ISRAEL,200,30,57,52.6,24,45,53.3,6,12,50.0,13,20,65.0,4,30,34,17,23,12,4,0,79,0
8115,185494,230_09_09,MKD,0,TOTALS,MKD,200,30,71,42.3,21,39,53.8,9,32,28.1,13,23,56.5,14,24,38,16,22,9,7,5,82,1
8116,185507,230_09_10,GERMANY,0,TOTALS,GERMANY,200,24,63,38.1,17,42,40.5,7,21,33.3,21,25,84.0,13,24,37,10,35,12,5,3,76,1
8117,185520,230_09_10,RUSSIA,0,TOTALS,RUSSIA,200,19,49,38.8,12,30,40.0,7,19,36.8,28,49,57.1,12,25,37,11,25,11,9,4,73,0
8118,185533,230_09_11,SLOVENIA,0,TOTALS,SLOVENIA,200,28,50,56.0,19,29,65.5,9,21,42.9,15,22,68.2,8,25,33,12,21,10,6,4,80,1
8119,185546,230_09_11,SERBIA,0,TOTALS,SERBIA,200,28,64,43.8,21,45,46.7,7,19,36.8,6,8,75.0,11,17,28,13,23,8,3,0,69,0
8120,185559,230_09_12,LITHUANIA,0,TOTALS,LITHUANIA,200,30,72,41.7,26,54,48.1,4,18,22.2,11,22,50.0,15,21,36,15,19,9,8,1,75,0
8121,185572,230_09_12,POLAND,0,TOTALS,POLAND,200,35,66,53.0,27,45,60.0,8,21,38.1,8,10,80.0,10,32,42,20,19,18,4,5,86,1
8122,185585,230_09_13,GREECE,0,TOTALS,GREECE,200,26,50,52.0,19,33,57.6,7,17,41.2,17,29,58.6,8,25,33,12,22,12,7,0,76,1
8123,185598,230_09_13,CROATIA,0,TOTALS,CROATIA,200,21,54,38.9,15,35,42.9,6,19,31.6,20,27,74.1,11,21,32,12,27,12,5,5,68,0
8124,185611,230_09_14,LATVIA,0,TOTALS,LATVIA,200,18,55,32.7,15,39,38.5,3,16,18.8,12,21,57.1,11,28,39,7,20,17,5,1,51,0
8125,185624,230_09_14,FRANCE,0,TOTALS,FRANCE,200,21,59,35.6,15,36,41.7,6,23,26.1,12,20,60.0,12,24,36,12,23,12,5,2,60,1
8126,185637,230_09_15,SPAIN,0,TOTALS,SPAIN,200,24,48,50.0,14,29,48.3,10,19,52.6,26,40,65.0,12,21,33,19,20,15,4,3,84,1
8127,185650,230_09_15,GREAT BRITAIN,0,TOTALS,GREAT BRITAIN,200,30,57,52.6,20,35,57.1,10,22,45.5,6,13,46.2,8,18,26,12,30,16,6,4,76,0
8128,185663,230_09_16,BULGARIA,0,TOTALS,BULGARIA,200,24,61,39.3,19,39,48.7,5,22,22.7,13,20,65.0,14,20,34,14,22,17,6,3,66,0
8129,185676,230_09_16,TURKEY,0,TOTALS,TURKEY,200,32,59,54.2,21,34,61.8,11,25,44.0,19,28,67.9,11,29,40,17,20,12,6,5,94,1
8130,185689,230_09_17,MKD,0,TOTALS,MKD,200,25,63,39.7,15,32,46.9,10,31,32.3,11,12,91.7,9,22,31,7,24,12,3,1,71,0
8131,185702,230_09_17,CROATIA,0,TOTALS,CROATIA,200,29,52,55.8,24,39,61.5,5,13,38.5,18,24,75.0,2,28,30,21,17,9,3,2,81,1
8132,185715,230_09_18,RUSSIA,0,TOTALS,RUSSIA,200,22,50,44.0,14,29,48.3,8,21,38.1,12,20,60.0,8,15,23,11,22,16,7,6,64,0
8133,185728,230_09_18,FRANCE,0,TOTALS,FRANCE,200,25,54,46.3,21,39,53.8,4,15,26.7,15,28,53.6,15,24,39,16,19,12,10,3,69,1
8134,185741,230_09_19,SPAIN,0,TOTALS,SPAIN,225,27,56,48.2,20,36,55.6,7,20,35.0,29,39,74.4,12,28,40,17,24,19,7,4,90,1
8135,185754,230_09_19,SLOVENIA,0,TOTALS,SLOVENIA,225,28,68,41.2,19,40,47.5,9,28,32.1,19,24,79.2,13,20,33,15,32,14,11,2,84,0
8136,185767,230_09_20,POLAND,0,TOTALS,POLAND,200,27,60,45.0,19,37,51.4,8,23,34.8,7,14,50.0,6,20,26,13,13,7,3,0,69,0
8137,185780,230_09_20,TURKEY,0,TOTALS,TURKEY,200,36,64,56.2,26,36,72.2,10,28,35.7,5,6,83.3,9,30,39,13,16,9,2,2,87,1
8138,185793,230_09_21,ISRAEL,0,TOTALS,ISRAEL,200,32,59,54.2,28,46,60.9,4,13,30.8,12,17,70.6,3,21,24,17,23,19,5,1,80,1
8139,185806,230_09_21,GREECE,0,TOTALS,GREECE,200,37,60,61.7,26,38,68.4,11,22,50.0,21,25,84.0,2,25,27,23,18,14,11,3,106,0
8140,185819,230_09_22,GERMANY,0,TOTALS,GERMANY,200,18,53,34.0,9,29,31.0,9,24,37.5,17,29,58.6,8,28,36,10,30,13,4,2,62,0
8141,185832,230_09_22,LATVIA,0,TOTALS,LATVIA,200,20,49,40.8,11,22,50.0,9,27,33.3,19,38,50.0,6,29,35,14,25,10,5,3,68,1
8142,185845,230_09_23,GREAT BRITAIN,0,TOTALS,GREAT BRITAIN,200,23,51,45.1,18,43,41.9,5,8,62.5,8,16,50.0,8,20,28,11,27,15,3,4,59,0
8143,185858,230_09_23,SERBIA,0,TOTALS,SERBIA,200,23,54,42.6,19,32,59.4,4,22,18.2,27,35,77.1,13,24,37,17,20,11,10,1,77,1
8144,185871,230_09_24,LITHUANIA,0,TOTALS,LITHUANIA,200,27,58,46.6,19,36,52.8,8,22,36.4,22,24,91.7,14,32,46,15,16,20,2,5,84,1
8145,185884,230_09_24,BULGARIA,0,TOTALS,BULGARIA,200,27,80,33.8,20,49,40.8,7,31,22.6,8,11,72.7,22,19,41,11,23,13,8,3,69,0
8146,185897,230_09_25,RUSSIA,0,TOTALS,RUSSIA,200,19,42,45.2,15,23,65.2,4,19,21.1,20,30,66.7,8,26,34,10,20,17,5,3,62,1
8147,185910,230_09_25,CROATIA,0,TOTALS,CROATIA,200,22,65,33.8,17,48,35.4,5,17,29.4,10,14,71.4,15,21,36,12,26,12,6,2,59,0
8148,185923,230_09_26,GERMANY,0,TOTALS,GERMANY,200,29,61,47.5,19,35,54.3,10,26,38.5,8,10,80.0,8,21,29,9,26,15,7,0,76,0
8149,185936,230_09_26,GREECE,0,TOTALS,GREECE,200,30,52,57.7,24,38,63.2,6,14,42.9,18,29,62.1,5,23,28,13,19,10,9,3,84,1
8150,185949,230_09_27,FRANCE,0,TOTALS,FRANCE,200,34,56,60.7,26,44,59.1,8,12,66.7,7,12,58.3,7,29,36,20,24,15,5,4,83,1
8151,185962,230_09_27,MKD,0,TOTALS,MKD,200,20,57,35.1,16,37,43.2,4,20,20.0,13,23,56.5,11,18,29,7,17,13,8,0,57,0
8152,185975,230_09_28,TURKEY,0,TOTALS,TURKEY,200,25,65,38.5,19,39,48.7,6,26,23.1,7,12,58.3,15,18,33,9,18,8,7,4,63,1
8153,185988,230_09_28,SPAIN,0,TOTALS,SPAIN,200,23,55,41.8,18,37,48.6,5,18,27.8,9,12,75.0,13,26,39,11,14,15,5,6,60,0
8154,186001,230_09_29,POLAND,0,TOTALS,POLAND,200,28,63,44.4,21,45,46.7,7,18,38.9,9,11,81.8,7,27,34,16,21,8,6,4,72,0
8155,186014,230_09_29,SERBIA,0,TOTALS,SERBIA,200,27,61,44.3,18,40,45.0,9,21,42.9,14,18,77.8,9,29,38,15,17,9,5,3,77,1
8156,186027,230_09_30,LITHUANIA,0,TOTALS,LITHUANIA,200,21,58,36.2,15,36,41.7,6,22,27.3,10,13,76.9,9,26,35,14,14,14,7,2,58,0
8157,186040,230_09_30,SLOVENIA,0,TOTALS,SLOVENIA,200,29,60,48.3,16,33,48.5,13,27,48.1,10,12,83.3,5,28,33,21,20,9,5,2,81,1
8158,186053,230_09_31,MKD,0,TOTALS,MKD,200,28,58,48.3,17,36,47.2,11,22,50.0,19,27,70.4,5,27,32,8,19,10,14,0,86,1
8159,186066,230_09_31,GERMANY,0,TOTALS,GERMANY,200,27,53,50.9,16,28,57.1,11,25,44.0,10,18,55.6,3,31,34,17,22,17,4,3,75,0
8160,186078,230_09_32,GREECE,0,TOTALS,GREECE,200,21,61,34.4,16,40,40.0,5,21,23.8,18,29,62.1,16,26,42,10,19,8,5,2,65,0
8161,186091,230_09_32,RUSSIA,0,TOTALS,RUSSIA,200,24,63,38.1,14,42,33.3,10,21,47.6,10,15,66.7,15,27,42,15,29,10,2,7,68,1
8162,186104,230_09_33,CROATIA,0,TOTALS,CROATIA,200,24,49,49.0,17,36,47.2,7,13,53.8,24,35,68.6,10,26,36,14,33,16,4,1,79,0
8163,186117,230_09_33,FRANCE,0,TOTALS,FRANCE,200,25,56,44.6,13,30,43.3,12,26,46.2,25,38,65.8,8,19,27,21,26,8,9,4,87,1
8164,186130,230_09_34,SPAIN,0,TOTALS,SPAIN,200,31,66,47.0,23,43,53.5,8,23,34.8,14,18,77.8,8,25,33,25,19,13,12,6,84,1
8165,186143,230_09_34,LITHUANIA,0,TOTALS,LITHUANIA,200,27,64,42.2,21,41,51.2,6,23,26.1,10,17,58.8,14,25,39,18,21,19,9,2,70,0
8166,186156,230_09_35,SLOVENIA,0,TOTALS,SLOVENIA,200,28,60,46.7,19,33,57.6,9,27,33.3,11,20,55.0,6,29,35,16,17,6,6,2,76,1
8167,186169,230_09_35,POLAND,0,TOTALS,POLAND,200,22,62,35.5,15,39,38.5,7,23,30.4,9,15,60.0,14,29,43,13,24,15,4,3,60,0
8168,186182,230_09_36,SERBIA,0,TOTALS,SERBIA,225,17,54,31.5,10,29,34.5,7,25,28.0,23,27,85.2,13,29,42,15,28,18,4,0,64,0
8169,186195,230_09_36,TURKEY,0,TOTALS,TURKEY,225,22,58,37.9,15,38,39.5,7,20,35.0,18,31,58.1,13,26,39,14,24,12,12,4,69,1
8170,186208,230_09_37,RUSSIA,0,TOTALS,RUSSIA,200,26,64,40.6,25,49,51.0,1,15,6.7,18,25,72.0,16,26,42,10,23,11,9,3,71,1
8171,186221,230_09_37,MKD,0,TOTALS,MKD,200,23,54,42.6,16,36,44.4,7,18,38.9,16,25,64.0,8,24,32,9,21,14,2,1,69,0
8172,186234,230_09_38,FRANCE,0,TOTALS,FRANCE,200,25,55,45.5,22,43,51.2,3,12,25.0,18,22,81.8,12,21,33,11,25,13,4,3,71,1
8173,186247,230_09_38,GREECE,0,TOTALS,GREECE,200,22,58,37.9,16,34,47.1,6,24,25.0,19,23,82.6,14,19,33,10,23,11,10,1,69,0
8174,186260,230_09_39,GERMANY,0,TOTALS,GERMANY,200,24,47,51.1,12,21,57.1,12,26,46.2,8,9,88.9,6,20,26,13,21,20,3,1,68,0
8175,186273,230_09_39,CROATIA,0,TOTALS,CROATIA,200,25,57,43.9,20,43,46.5,5,14,35.7,15,20,75.0,13,16,29,13,18,9,9,3,70,1
8176,186286,230_09_40,LITHUANIA,0,TOTALS,LITHUANIA,200,27,50,54.0,21,32,65.6,6,18,33.3,19,26,73.1,5,24,29,14,20,20,10,2,79,0
8177,186299,230_09_40,SERBIA,0,TOTALS,SERBIA,200,31,62,50.0,17,35,48.6,14,27,51.9,13,20,65.0,9,20,29,24,22,16,12,3,89,1
8178,186312,230_09_41,POLAND,0,TOTALS,POLAND,200,28,64,43.8,20,40,50.0,8,24,33.3,4,6,66.7,12,25,37,16,15,17,5,1,68,0
8179,186325,230_09_41,SPAIN,0,TOTALS,SPAIN,200,36,66,54.5,23,41,56.1,13,25,52.0,5,11,45.5,7,24,31,25,14,11,10,3,90,1
8180,186338,230_09_42,TURKEY,0,TOTALS,TURKEY,200,24,56,42.9,19,36,52.8,5,20,25.0,14,21,66.7,8,24,32,12,18,8,7,2,67,0
8181,186351,230_09_42,SLOVENIA,0,TOTALS,SLOVENIA,200,25,55,45.5,12,24,50.0,13,31,41.9,6,11,54.5,8,27,35,14,17,13,3,1,69,1
8182,186364,230_09_43,RUSSIA,0,TOTALS,RUSSIA,200,26,57,45.6,19,41,46.3,7,16,43.8,9,19,47.4,11,14,25,10,21,16,8,3,68,0
8183,186377,230_09_43,SERBIA,0,TOTALS,SERBIA,200,27,49,55.1,19,31,61.3,8,18,44.4,17,22,77.3,10,23,33,18,27,19,9,3,79,1
8184,186390,230_09_44,FRANCE,0,TOTALS,FRANCE,200,24,55,43.6,17,35,48.6,7,20,35.0,11,15,73.3,7,20,27,14,21,17,9,4,66,0
8185,186403,230_09_44,SPAIN,0,TOTALS,SPAIN,200,32,61,52.5,24,40,60.0,8,21,38.1,14,20,70.0,10,26,36,14,18,12,13,7,86,1
8186,186416,230_09_45,TURKEY,0,TOTALS,TURKEY,225,30,66,45.5,22,47,46.8,8,19,42.1,6,13,46.2,9,19,28,11,27,11,8,3,74,0
8187,186429,230_09_45,GREECE,0,TOTALS,GREECE,225,20,53,37.7,10,26,38.5,10,27,37.0,26,35,74.3,17,30,47,13,17,19,5,4,76,1
8188,186442,230_09_46,SLOVENIA,0,TOTALS,SLOVENIA,200,19,43,44.2,11,20,55.0,8,23,34.8,21,24,87.5,5,23,28,10,19,14,6,2,67,1
8189,186455,230_09_46,CROATIA,0,TOTALS,CROATIA,200,25,57,43.9,20,45,44.4,5,12,41.7,10,14,71.4,7,19,26,14,23,7,8,1,65,0
8190,186468,230_09_47,FRANCE,0,TOTALS,FRANCE,200,28,59,47.5,20,40,50.0,8,19,42.1,16,25,64.0,13,23,36,18,16,15,9,6,80,1
8191,186481,230_09_47,TURKEY,0,TOTALS,TURKEY,200,26,66,39.4,18,48,37.5,8,18,44.4,8,10,80.0,17,20,37,8,20,16,9,1,68,0
8192,186494,230_09_48,RUSSIA,0,TOTALS,RUSSIA,200,22,53,41.5,14,31,45.2,8,22,36.4,17,20,85.0,6,24,30,13,19,15,7,1,69,0
8193,186507,230_09_48,CROATIA,0,TOTALS,CROATIA,200,27,55,49.1,22,45,48.9,5,10,50.0,17,23,73.9,7,25,32,16,22,14,9,2,76,1
8194,186520,230_09_49,SPAIN,0,TOTALS,SPAIN,200,29,58,50.0,20,35,57.1,9,23,39.1,15,20,75.0,9,20,29,19,25,11,12,5,82,1
8195,186533,230_09_49,GREECE,0,TOTALS,GREECE,200,24,66,36.4,20,50,40.0,4,16,25.0,12,16,75.0,24,23,47,8,23,20,6,0,64,0
8196,186546,230_09_50,SERBIA,0,TOTALS,SERBIA,225,28,66,42.4,20,38,52.6,8,28,28.6,32,39,82.1,15,24,39,18,38,9,8,5,96,1
8197,186559,230_09_50,SLOVENIA,0,TOTALS,SLOVENIA,225,21,52,40.4,11,26,42.3,10,26,38.5,40,49,81.6,10,25,35,11,33,13,6,1,92,0
8198,186572,230_09_51,FRANCE,0,TOTALS,FRANCE,200,26,56,46.4,17,38,44.7,9,18,50.0,8,12,66.7,8,21,29,18,16,15,10,2,69,1
8199,186585,230_09_51,CROATIA,0,TOTALS,CROATIA,200,25,56,44.6,19,40,47.5,6,16,37.5,6,8,75.0,11,25,36,12,18,19,8,3,62,0
8200,186598,230_09_52,TURKEY,0,TOTALS,TURKEY,200,24,55,43.6,21,43,48.8,3,12,25.0,15,24,62.5,13,17,30,16,24,13,7,2,66,0
8201,186611,230_09_52,RUSSIA,0,TOTALS,RUSSIA,200,28,56,50.0,12,32,37.5,16,24,66.7,17,23,73.9,12,22,34,24,17,13,6,2,89,1
8202,186624,230_09_53,GREECE,0,TOTALS,GREECE,200,18,47,38.3,14,27,51.9,4,20,20.0,17,25,68.0,11,27,38,8,26,17,6,4,57,1
8203,186637,230_09_53,SLOVENIA,0,TOTALS,SLOVENIA,200,17,57,29.8,9,30,30.0,8,27,29.6,14,18,77.8,14,22,36,9,27,8,7,2,56,0
8204,186650,230_09_54,SPAIN,0,TOTALS,SPAIN,200,33,67,49.3,26,44,59.1,7,23,30.4,12,15,80.0,18,24,42,17,20,9,7,4,85,1
8205,186663,230_09_54,SERBIA,0,TOTALS,SERBIA,200,22,53,41.5,16,34,47.1,6,19,31.6,13,17,76.5,8,16,24,12,20,12,5,2,63,0
8206,191724,234_09_01,SPAIN,0,TOTALS,SPAIN,200,31,68,45.6,25,50,50.0,6,18,33.3,16,26,61.5,19,21,40,12,20,13,8,1,84,1
8207,191737,234_09_01,RUSSIA,0,TOTALS,RUSSIA,200,24,55,43.6,15,30,50.0,9,25,36.0,15,19,78.9,9,23,32,15,25,13,4,2,72,0
8208,191750,234_09_02,TURKEY,0,TOTALS,TURKEY,225,26,61,42.6,19,30,63.3,7,31,22.6,17,25,68.0,10,32,42,10,20,20,9,4,76,1
8209,191763,234_09_02,ISRAEL,0,TOTALS,ISRAEL,225,28,77,36.4,26,58,44.8,2,19,10.5,17,27,63.0,22,27,49,11,28,15,10,3,75,0
8210,191776,234_09_03,LATVIA,0,TOTALS,LATVIA,225,26,63,41.3,18,44,40.9,8,19,42.1,33,40,82.5,18,28,46,6,24,17,5,5,93,1
8211,191789,234_09_03,SLOVENIA,0,TOTALS,SLOVENIA,225,31,72,43.1,23,49,46.9,8,23,34.8,16,25,64.0,14,23,37,12,34,12,6,2,86,0
8212,191802,234_09_04,LITHUANIA,0,TOTALS,LITHUANIA,200,28,61,45.9,25,49,51.0,3,12,25.0,14,24,58.3,16,28,44,11,23,16,6,5,73,1
8213,191815,234_09_04,MONTENEGRO,0,TOTALS,MONTENEGRO,200,29,60,48.3,26,43,60.5,3,17,17.6,10,19,52.6,7,23,30,10,21,11,11,3,71,0
8214,191828,234_09_05,GREECE,0,TOTALS,GREECE,200,30,59,50.8,24,38,63.2,6,21,28.6,14,24,58.3,9,27,36,11,18,16,8,7,80,1
8215,191841,234_09_05,BELGIUM,0,TOTALS,BELGIUM,200,22,61,36.1,17,44,38.6,5,17,29.4,9,13,69.2,13,25,38,9,23,21,12,2,58,0
8216,191853,234_09_06,CROATIA,0,TOTALS,CROATIA,225,24,60,40.0,13,36,36.1,11,24,45.8,32,41,78.0,9,26,35,8,25,16,9,2,91,1
8217,191866,234_09_06,GERMANY,0,TOTALS,GERMANY,225,27,62,43.5,18,42,42.9,9,20,45.0,23,29,79.3,7,29,36,7,33,17,9,8,86,0
8218,191879,234_09_07,FRANCE,0,TOTALS,FRANCE,200,29,57,50.9,23,42,54.8,6,15,40.0,10,20,50.0,11,27,38,14,21,17,13,2,74,1
8219,191892,234_09_07,ITALY,0,TOTALS,ITALY,200,21,60,35.0,11,34,32.4,10,26,38.5,14,26,53.8,16,23,39,12,20,20,10,2,66,0
8220,191905,234_09_08,SERBIA,0,TOTALS,SERBIA,200,20,66,30.3,14,37,37.8,6,29,20.7,16,21,76.2,17,19,36,6,27,12,7,1,62,0
8221,191918,234_09_08,UKRAINE,0,TOTALS,UKRAINE,200,25,52,48.1,19,38,50.0,6,14,42.9,14,20,70.0,11,31,42,10,26,18,4,3,70,1
8222,191931,234_09_09,RUSSIA,0,TOTALS,RUSSIA,200,24,61,39.3,20,45,44.4,4,16,25.0,16,21,76.2,13,26,39,9,23,10,6,2,68,1
8223,191944,234_09_09,LATVIA,0,TOTALS,LATVIA,200,18,56,32.1,12,33,36.4,6,23,26.1,20,26,76.9,13,25,38,5,25,11,7,1,62,0
8224,191957,234_09_10,MONTENEGRO,0,TOTALS,MONTENEGRO,200,18,49,36.7,12,28,42.9,6,21,28.6,19,25,76.0,11,24,35,9,21,13,9,3,61,1
8225,191970,234_09_10,TURKEY,0,TOTALS,TURKEY,200,22,54,40.7,15,30,50.0,7,24,29.2,7,12,58.3,8,21,29,11,24,12,9,1,58,0
8226,191983,234_09_11,SLOVENIA,0,TOTALS,SLOVENIA,200,23,47,48.9,16,31,51.6,7,16,43.8,18,25,72.0,7,17,24,9,20,21,11,1,71,0
8227,191996,234_09_11,SPAIN,0,TOTALS,SPAIN,200,34,61,55.7,28,44,63.6,6,17,35.3,15,19,78.9,12,20,32,14,26,19,13,3,89,1
8228,192009,234_09_12,ISRAEL,0,TOTALS,ISRAEL,200,27,60,45.0,23,47,48.9,4,13,30.8,10,12,83.3,11,17,28,10,29,19,3,2,68,1
8229,192022,234_09_12,LITHUANIA,0,TOTALS,LITHUANIA,200,40,72,55.6,26,45,57.8,14,27,51.9,24,35,68.6,18,21,39,18,22,7,15,4,118,0
8230,192035,234_09_13,ITALY,0,TOTALS,ITALY,200,21,57,36.8,13,37,35.1,8,20,40.0,16,22,72.7,6,21,27,8,24,9,9,2,66,0
8231,192048,234_09_13,GREECE,0,TOTALS,GREECE,200,26,54,48.1,18,35,51.4,8,19,42.1,19,29,65.5,11,31,42,14,19,16,6,2,79,1
8232,192061,234_09_14,UKRAINE,0,TOTALS,UKRAINE,200,33,62,53.2,26,44,59.1,7,18,38.9,13,19,68.4,12,27,39,13,22,11,5,2,86,1
8233,192074,234_09_14,CROATIA,0,TOTALS,CROATIA,200,29,62,46.8,20,38,52.6,9,24,37.5,12,20,60.0,10,20,30,12,23,11,3,1,79,0
8234,192087,234_09_15,BELGIUM,0,TOTALS,BELGIUM,200,24,69,34.8,18,46,39.1,6,23,26.1,7,14,50.0,16,20,36,13,17,20,12,0,61,0
8235,192100,234_09_15,FRANCE,0,TOTALS,FRANCE,200,30,52,57.7,22,34,64.7,8,18,44.4,10,18,55.6,4,32,36,15,20,23,6,3,78,1
8236,192113,234_09_16,GERMANY,0,TOTALS,GERMANY,200,26,60,43.3,21,48,43.8,5,12,41.7,20,24,83.3,10,19,29,9,26,13,9,3,77,0
8237,192126,234_09_16,SERBIA,0,TOTALS,SERBIA,200,23,51,45.1,14,32,43.8,9,19,47.4,24,31,77.4,10,23,33,13,27,18,8,2,79,1
8238,192139,234_09_17,SPAIN,0,TOTALS,SPAIN,200,22,51,43.1,16,30,53.3,6,21,28.6,23,31,74.2,8,28,36,7,26,12,8,2,73,1
8239,192152,234_09_17,LATVIA,0,TOTALS,LATVIA,200,21,55,38.2,13,24,54.2,8,31,25.8,16,27,59.3,10,24,34,9,26,11,6,1,66,0
8240,192165,234_09_18,MONTENEGRO,0,TOTALS,MONTENEGRO,200,21,51,41.2,18,34,52.9,3,17,17.6,21,34,61.8,12,33,45,12,20,16,8,2,66,1
8241,192178,234_09_18,ISRAEL,0,TOTALS,ISRAEL,200,19,58,32.8,15,40,37.5,4,18,22.2,8,15,53.3,6,22,28,9,32,15,8,1,50,0
8242,192191,234_09_19,SLOVENIA,0,TOTALS,SLOVENIA,200,16,59,27.1,13,42,31.0,3,17,17.6,20,28,71.4,19,17,36,6,15,19,11,2,55,0
8243,192204,234_09_19,RUSSIA,0,TOTALS,RUSSIA,200,26,55,47.3,20,37,54.1,6,18,33.3,8,9,88.9,10,29,39,11,25,20,8,4,66,1
8244,192217,234_09_20,TURKEY,0,TOTALS,TURKEY,200,25,67,37.3,22,43,51.2,3,24,12.5,6,13,46.2,12,22,34,10,24,13,7,6,59,0
8245,192230,234_09_20,LITHUANIA,0,TOTALS,LITHUANIA,200,22,50,44.0,19,35,54.3,3,15,20.0,18,27,66.7,7,33,40,11,20,19,10,1,65,1
8246,192243,234_09_21,FRANCE,0,TOTALS,FRANCE,200,25,64,39.1,14,40,35.0,11,24,45.8,20,29,69.0,19,35,54,13,31,14,3,1,81,1
8247,192256,234_09_21,GREECE,0,TOTALS,GREECE,200,20,59,33.9,15,32,46.9,5,27,18.5,26,41,63.4,11,25,36,9,19,6,8,2,71,0
8248,192269,234_09_22,UKRAINE,0,TOTALS,UKRAINE,200,19,43,44.2,9,24,37.5,10,19,52.6,14,22,63.6,3,23,26,12,19,20,4,1,62,0
8249,192282,234_09_22,GERMANY,0,TOTALS,GERMANY,200,28,61,45.9,20,46,43.5,8,15,53.3,11,19,57.9,11,21,32,12,20,13,7,3,75,1
8250,192295,234_09_23,BELGIUM,0,TOTALS,BELGIUM,200,25,59,42.4,21,41,51.2,4,18,22.2,24,26,92.3,14,27,41,14,28,18,5,1,78,0
8251,192308,234_09_23,ITALY,0,TOTALS,ITALY,200,28,62,45.2,16,34,47.1,12,28,42.9,19,25,76.0,9,20,29,8,24,13,7,1,87,1
8252,192321,234_09_24,CROATIA,0,TOTALS,CROATIA,200,28,58,48.3,22,42,52.4,6,16,37.5,20,27,74.1,6,21,27,15,23,13,12,0,82,1
8253,192334,234_09_24,SERBIA,0,TOTALS,SERBIA,200,29,65,44.6,24,42,57.1,5,23,21.7,11,18,61.1,14,27,41,12,24,21,9,2,74,0
8254,192347,234_09_25,SLOVENIA,0,TOTALS,SLOVENIA,200,25,55,45.5,15,33,45.5,10,22,45.5,26,33,78.8,8,22,30,11,28,21,11,1,86,1
8255,192360,234_09_25,GERMANY,0,TOTALS,GERMANY,200,24,56,42.9,17,34,50.0,7,22,31.8,22,29,75.9,12,21,33,9,32,25,15,4,77,0
8256,192373,234_09_26,BELGIUM,0,TOTALS,BELGIUM,200,27,68,39.7,21,42,50.0,6,26,23.1,11,14,78.6,18,26,44,16,18,23,4,2,71,0
8257,192386,234_09_26,ISRAEL,0,TOTALS,ISRAEL,200,32,63,50.8,25,45,55.6,7,18,38.9,21,24,87.5,7,25,32,19,21,15,11,2,92,1
8258,192399,234_09_27,LATVIA,0,TOTALS,LATVIA,200,28,61,45.9,18,33,54.5,10,28,35.7,16,27,59.3,13,20,33,12,16,15,5,2,82,0
8259,192412,234_09_27,FRANCE,0,TOTALS,FRANCE,200,34,64,53.1,29,50,58.0,5,14,35.7,11,16,68.8,12,24,36,15,26,16,10,1,84,1
8260,192425,234_09_28,SERBIA,0,TOTALS,SERBIA,200,27,52,51.9,19,37,51.4,8,15,53.3,14,26,53.8,7,30,37,16,34,16,6,6,76,1
8261,192438,234_09_28,LITHUANIA,0,TOTALS,LITHUANIA,200,19,57,33.3,12,36,33.3,7,21,33.3,22,36,61.1,12,17,29,11,27,14,11,1,67,0
8262,192451,234_09_29,ITALY,0,TOTALS,ITALY,200,19,64,29.7,12,36,33.3,7,28,25.0,15,23,65.2,13,23,36,6,29,13,11,1,60,0
8263,192464,234_09_29,SPAIN,0,TOTALS,SPAIN,200,17,43,39.5,14,28,50.0,3,15,20.0,25,33,75.8,10,32,42,8,23,22,6,3,62,1
8264,192477,234_09_30,CROATIA,0,TOTALS,CROATIA,200,30,63,47.6,22,38,57.9,8,25,32.0,8,11,72.7,11,19,30,11,24,17,6,2,76,1
8265,192490,234_09_30,MONTENEGRO,0,TOTALS,MONTENEGRO,200,23,44,52.3,16,22,72.7,7,22,31.8,17,23,73.9,4,21,25,10,22,20,12,5,70,0
8266,192503,234_09_31,GREECE,0,TOTALS,GREECE,200,28,55,50.9,23,40,57.5,5,15,33.3,12,20,60.0,7,24,31,15,15,11,4,4,73,1
8267,192516,234_09_31,RUSSIA,0,TOTALS,RUSSIA,200,27,58,46.6,18,37,48.6,9,21,42.9,8,13,61.5,9,25,34,16,23,10,9,2,71,0
8268,192529,234_09_32,TURKEY,0,TOTALS,TURKEY,200,34,67,50.7,22,37,59.5,12,30,40.0,13,16,81.2,11,32,43,20,20,10,9,3,93,1
8269,192542,234_09_32,UKRAINE,0,TOTALS,UKRAINE,200,14,53,26.4,7,33,21.2,7,20,35.0,9,12,75.0,6,22,28,8,18,22,5,3,44,0
8270,192555,234_09_33,ITALY,0,TOTALS,ITALY,200,30,69,43.5,23,51,45.1,7,18,38.9,10,14,71.4,12,19,31,4,27,13,8,1,77,0
8271,192568,234_09_33,LATVIA,0,TOTALS,LATVIA,200,25,57,43.9,15,34,44.1,10,23,43.5,21,29,72.4,17,27,44,10,20,18,6,3,81,1
8272,192581,234_09_34,LITHUANIA,0,TOTALS,LITHUANIA,200,33,58,56.9,27,43,62.8,6,15,40.0,21,28,75.0,5,26,31,16,24,15,15,3,93,1
8273,192594,234_09_34,CROATIA,0,TOTALS,CROATIA,200,25,58,43.1,18,36,50.0,7,22,31.8,26,31,83.9,9,21,30,12,20,20,5,4,83,0
8274,192607,234_09_35,SPAIN,0,TOTALS,SPAIN,200,23,64,35.9,21,43,48.8,2,21,9.5,19,28,67.9,22,22,44,7,26,16,12,4,67,0
8275,192620,234_09_35,GREECE,0,TOTALS,GREECE,200,21,55,38.2,15,33,45.5,6,22,27.3,22,27,81.5,11,25,36,6,25,18,8,8,70,1
8276,192633,234_09_36,SERBIA,0,TOTALS,SERBIA,200,15,56,26.8,9,36,25.0,6,20,30.0,16,22,72.7,13,27,40,10,22,16,8,3,52,0
8277,192646,234_09_36,TURKEY,0,TOTALS,TURKEY,200,23,54,42.6,17,31,54.8,6,23,26.1,11,18,61.1,9,29,38,14,23,18,8,2,63,1
8278,192659,234_09_37,RUSSIA,0,TOTALS,RUSSIA,200,19,50,38.0,13,25,52.0,6,25,24.0,16,30,53.3,7,20,27,12,15,17,7,2,60,0
8279,192672,234_09_37,FRANCE,0,TOTALS,FRANCE,200,31,56,55.4,20,34,58.8,11,22,50.0,8,14,57.1,7,28,35,14,30,19,9,0,81,1
8280,192685,234_09_38,MONTENEGRO,0,TOTALS,MONTENEGRO,200,26,64,40.6,19,41,46.3,7,23,30.4,13,16,81.2,8,30,38,8,18,13,11,3,72,1
8281,192698,234_09_38,UKRAINE,0,TOTALS,UKRAINE,200,23,62,37.1,16,36,44.4,7,26,26.9,7,12,58.3,10,26,36,14,17,20,8,3,60,0
8282,192711,234_09_39,ISRAEL,0,TOTALS,ISRAEL,200,23,55,41.8,21,40,52.5,2,15,13.3,15,22,68.2,7,24,31,3,25,26,10,2,63,0
8283,192724,234_09_39,SLOVENIA,0,TOTALS,SLOVENIA,200,33,64,51.6,28,50,56.0,5,14,35.7,14,18,77.8,9,28,37,14,24,21,12,2,85,1
8284,192737,234_09_40,GERMANY,0,TOTALS,GERMANY,200,30,62,48.4,22,39,56.4,8,23,34.8,17,25,68.0,12,27,39,19,15,10,6,2,85,1
8285,192750,234_09_40,BELGIUM,0,TOTALS,BELGIUM,200,22,54,40.7,17,29,58.6,5,25,20.0,4,8,50.0,4,26,30,14,27,16,5,1,53,0
8286,192763,234_09_41,FRANCE,0,TOTALS,FRANCE,200,30,62,48.4,21,41,51.2,9,21,42.9,7,11,63.6,10,21,31,11,22,15,4,2,76,0
8287,192776,234_09_41,SPAIN,0,TOTALS,SPAIN,200,27,57,47.4,18,32,56.2,9,25,36.0,21,28,75.0,11,25,36,15,17,16,7,3,84,1
8288,192789,234_09_42,CROATIA,0,TOTALS,CROATIA,200,22,55,40.0,14,33,42.4,8,22,36.4,23,30,76.7,15,25,40,12,22,17,6,1,75,1
8289,192802,234_09_42,TURKEY,0,TOTALS,TURKEY,200,21,49,42.9,13,24,54.2,8,25,32.0,12,19,63.2,2,21,23,13,26,14,7,2,62,0
8290,192815,234_09_43,GREECE,0,TOTALS,GREECE,200,31,57,54.4,25,42,59.5,6,15,40.0,9,15,60.0,8,27,35,13,20,12,6,5,77,1
8291,192828,234_09_43,LATVIA,0,TOTALS,LATVIA,200,29,67,43.3,24,47,51.1,5,20,25.0,8,16,50.0,15,20,35,8,21,10,8,4,71,0
8292,192841,234_09_44,LITHUANIA,0,TOTALS,LITHUANIA,200,28,63,44.4,20,37,54.1,8,26,30.8,19,26,73.1,14,31,45,19,20,18,19,3,83,1
8293,192854,234_09_44,UKRAINE,0,TOTALS,UKRAINE,200,18,54,33.3,11,32,34.4,7,22,31.8,8,13,61.5,8,23,31,10,20,24,8,2,51,0
8294,192867,234_09_45,RUSSIA,0,TOTALS,RUSSIA,200,20,47,42.6,17,32,53.1,3,15,20.0,16,20,80.0,8,27,35,12,16,22,6,6,59,0
8295,192880,234_09_45,ITALY,0,TOTALS,ITALY,200,23,64,35.9,15,40,37.5,8,24,33.3,13,16,81.2,14,20,34,8,22,14,13,1,67,1
8296,192893,234_09_46,MONTENEGRO,0,TOTALS,MONTENEGRO,225,27,68,39.7,17,40,42.5,10,28,35.7,9,17,52.9,12,31,43,14,20,17,7,3,73,1
8297,192906,234_09_46,SERBIA,0,TOTALS,SERBIA,225,27,66,40.9,22,41,53.7,5,25,20.0,11,17,64.7,9,31,40,13,15,16,9,4,70,0
8298,192919,234_09_47,SPAIN,0,TOTALS,SPAIN,200,29,65,44.6,25,43,58.1,4,22,18.2,15,22,68.2,17,26,43,11,18,15,11,4,77,1
8299,192932,234_09_47,TURKEY,0,TOTALS,TURKEY,200,21,55,38.2,10,29,34.5,11,26,42.3,7,14,50.0,10,23,33,7,25,16,7,3,60,0
8300,192945,234_09_48,ISRAEL,0,TOTALS,ISRAEL,200,21,66,31.8,15,35,42.9,6,31,19.4,24,31,77.4,11,27,38,16,25,9,11,3,72,0
8301,192958,234_09_48,GERMANY,0,TOTALS,GERMANY,200,22,53,41.5,9,23,39.1,13,30,43.3,18,27,66.7,8,35,43,15,23,20,6,3,75,1
8302,192971,234_09_49,FRANCE,0,TOTALS,FRANCE,200,26,59,44.1,15,33,45.5,11,26,42.3,5,7,71.4,12,25,37,15,14,16,8,2,68,1
8303,192984,234_09_49,MONTENEGRO,0,TOTALS,MONTENEGRO,200,18,51,35.3,14,20,70.0,4,31,12.9,7,10,70.0,7,21,28,9,13,18,5,1,47,0
8304,192997,234_09_50,CROATIA,0,TOTALS,CROATIA,200,22,63,34.9,16,38,42.1,6,25,24.0,18,24,75.0,12,23,35,10,28,12,6,4,68,0
8305,193010,234_09_50,GREECE,0,TOTALS,GREECE,200,26,59,44.1,22,49,44.9,4,10,40.0,21,28,75.0,12,26,38,10,20,15,9,8,77,1
8306,193023,234_09_51,LATVIA,0,TOTALS,LATVIA,200,28,70,40.0,15,38,39.5,13,32,40.6,5,11,45.5,16,22,38,12,22,11,9,1,74,1
8307,193036,234_09_51,SERBIA,0,TOTALS,SERBIA,200,22,50,44.0,19,39,48.7,3,11,27.3,20,27,74.1,8,27,35,8,14,16,5,7,67,0
8308,193049,234_09_52,LITHUANIA,0,TOTALS,LITHUANIA,200,21,55,38.2,13,37,35.1,8,18,44.4,18,25,72.0,12,24,36,7,19,21,14,6,68,0
8309,193062,234_09_52,ITALY,0,TOTALS,ITALY,200,29,59,49.2,25,41,61.0,4,18,22.2,7,11,63.6,5,24,29,8,25,20,9,4,69,1
8310,193075,234_09_53,UKRAINE,0,TOTALS,UKRAINE,200,22,68,32.4,15,34,44.1,7,34,20.6,3,5,60.0,11,21,32,9,13,11,5,0,54,0
8311,193088,234_09_53,RUSSIA,0,TOTALS,RUSSIA,200,24,53,45.3,20,33,60.6,4,20,20.0,13,17,76.5,7,34,41,18,10,14,6,3,65,1
8312,193101,234_09_54,TURKEY,0,TOTALS,TURKEY,200,33,69,47.8,28,48,58.3,5,21,23.8,7,14,50.0,12,26,38,14,13,14,12,2,78,1
8313,193114,234_09_54,CROATIA,0,TOTALS,CROATIA,200,26,61,42.6,15,28,53.6,11,33,33.3,6,6,100.0,6,25,31,13,21,19,4,0,69,0
8314,193127,234_09_55,LITHUANIA,0,TOTALS,LITHUANIA,200,32,66,48.5,26,49,53.1,6,17,35.3,10,11,90.9,13,27,40,19,16,13,7,2,80,1
8315,193140,234_09_55,MONTENEGRO,0,TOTALS,MONTENEGRO,200,28,54,51.9,20,34,58.8,8,20,40.0,8,14,57.1,3,20,23,16,15,14,8,5,72,0
8316,193153,234_09_56,SPAIN,0,TOTALS,SPAIN,200,29,66,43.9,18,34,52.9,11,32,34.4,7,13,53.8,12,14,26,12,24,14,9,5,76,0
8317,193166,234_09_56,GREECE,0,TOTALS,GREECE,200,26,57,45.6,18,35,51.4,8,22,36.4,27,32,84.4,16,27,43,12,23,17,9,2,87,1
8318,193179,234_09_57,ITALY,0,TOTALS,ITALY,200,22,63,34.9,13,33,39.4,9,30,30.0,15,23,65.2,14,18,32,7,22,12,5,1,68,0
8319,193192,234_09_57,FRANCE,0,TOTALS,FRANCE,200,34,65,52.3,26,43,60.5,8,22,36.4,18,25,72.0,18,31,49,19,21,11,8,4,94,1
8320,193205,234_09_58,SERBIA,0,TOTALS,SERBIA,200,29,63,46.0,20,37,54.1,9,26,34.6,16,21,76.2,18,25,43,15,12,14,8,2,83,1
8321,193218,234_09_58,UKRAINE,0,TOTALS,UKRAINE,200,21,55,38.2,14,29,48.3,7,26,26.9,7,12,58.3,11,20,31,11,16,18,5,4,56,0
8322,193231,234_09_59,CROATIA,0,TOTALS,CROATIA,200,31,60,51.7,26,42,61.9,5,18,27.8,9,11,81.8,6,29,35,21,17,18,5,1,76,0
8323,193244,234_09_59,MONTENEGRO,0,TOTALS,MONTENEGRO,200,29,69,42.0,23,43,53.5,6,26,23.1,13,19,68.4,12,23,35,15,14,11,11,2,77,1
8324,193257,234_09_60,LATVIA,0,TOTALS,LATVIA,200,24,66,36.4,12,34,35.3,12,32,37.5,6,13,46.2,12,17,29,12,15,10,4,0,66,0
8325,193270,234_09_60,RUSSIA,0,TOTALS,RUSSIA,200,36,71,50.7,32,55,58.2,4,16,25.0,13,23,56.5,21,28,49,22,13,11,3,2,89,1
8326,193283,234_09_61,TURKEY,0,TOTALS,TURKEY,200,24,55,43.6,17,32,53.1,7,23,30.4,17,20,85.0,6,19,25,13,24,24,15,0,72,0
8327,193296,234_09_61,LITHUANIA,0,TOTALS,LITHUANIA,200,27,54,50.0,23,34,67.6,4,20,20.0,19,25,76.0,9,26,35,8,18,27,13,0,77,1
8328,193309,234_09_62,SPAIN,0,TOTALS,SPAIN,200,20,57,35.1,15,35,42.9,5,22,22.7,30,39,76.9,15,24,39,6,17,10,9,4,75,1
8329,193322,234_09_62,ITALY,0,TOTALS,ITALY,200,26,63,41.3,15,34,44.1,11,29,37.9,9,14,64.3,14,22,36,10,29,15,1,3,72,0
8330,193335,234_09_63,GREECE,0,TOTALS,GREECE,200,32,64,50.0,18,32,56.2,14,32,43.8,12,15,80.0,7,24,31,23,17,8,5,8,90,1
8331,193348,234_09_63,FRANCE,0,TOTALS,FRANCE,200,31,65,47.7,20,39,51.3,11,26,42.3,12,15,80.0,11,25,36,10,18,13,5,2,85,0
8332,193361,235_09_01,PORTUGAL,0,TOTALS,PORTUGAL,200,28,66,42.4,20,39,51.3,8,27,29.6,14,23,60.9,9,19,28,14,22,9,4,2,78,1
8333,193374,235_09_01,GEORGIA,0,TOTALS,GEORGIA,200,29,59,49.2,24,44,54.5,5,15,33.3,12,29,41.4,10,27,37,18,19,15,4,1,75,0
8334,193387,235_09_02,CZECH REPUBLIC,0,TOTALS,CZECH REPUBLIC,200,33,71,46.5,31,51,60.8,2,20,10.0,11,19,57.9,15,10,25,10,21,7,9,4,79,1
8335,193400,235_09_02,ROMANIA,0,TOTALS,ROMANIA,200,24,50,48.0,17,31,54.8,7,19,36.8,19,27,70.4,9,17,26,8,20,16,4,0,74,0
8336,193413,235_09_03,SWEDEN,0,TOTALS,SWEDEN,200,36,60,60.0,25,35,71.4,11,25,44.0,8,18,44.4,7,37,44,22,19,17,6,4,91,1
8337,193426,235_09_03,LUXEMBOURG,0,TOTALS,LUXEMBOURG,200,21,82,25.6,18,51,35.3,3,31,9.7,14,22,63.6,19,17,36,10,19,11,9,0,59,0
8338,193439,235_09_04,NETHERLANDS,0,TOTALS,NETHERLANDS,200,33,78,42.3,23,50,46.0,10,28,35.7,15,25,60.0,21,20,41,10,16,11,11,5,91,1
8339,193452,235_09_04,SWITZERLAND,0,TOTALS,SWITZERLAND,200,24,62,38.7,20,43,46.5,4,19,21.1,4,12,33.3,5,19,24,9,21,17,6,1,56,0
8340,193465,235_09_05,FINLAND,0,TOTALS,FINLAND,200,22,58,37.9,11,31,35.5,11,27,40.7,10,17,58.8,9,12,21,16,24,19,7,1,65,0
8341,193478,235_09_05,POLAND,0,TOTALS,POLAND,200,24,49,49.0,21,37,56.8,3,12,25.0,16,21,76.2,9,20,29,16,22,23,8,2,67,1
8342,193491,235_09_06,HUNGARY,0,TOTALS,HUNGARY,200,29,58,50.0,26,44,59.1,3,14,21.4,20,28,71.4,8,23,31,9,18,11,2,3,81,1
8343,193504,235_09_06,BULGARIA,0,TOTALS,BULGARIA,200,27,74,36.5,21,50,42.0,6,24,25.0,15,22,68.2,17,13,30,12,22,5,3,3,75,0
8344,193516,235_09_07,NORWAY,0,TOTALS,NORWAY,200,27,57,47.4,20,36,55.6,7,21,33.3,10,19,52.6,13,22,35,11,15,17,7,1,71,1
8345,193529,235_09_07,GREAT BRITAIN,0,TOTALS,GREAT BRITAIN,200,22,61,36.1,15,37,40.5,7,24,29.2,8,12,66.7,12,15,27,9,23,20,11,4,59,0
8346,193542,235_09_08,AUSTRIA,0,TOTALS,AUSTRIA,200,29,68,42.6,27,50,54.0,2,18,11.1,10,15,66.7,12,24,36,5,26,14,6,3,70,0
8347,193555,235_09_08,MKD,0,TOTALS,MKD,200,23,54,42.6,10,23,43.5,13,31,41.9,19,32,59.4,4,20,24,9,21,10,10,1,78,1
8348,193568,235_09_09,SLOVAK REPUBLIC,0,TOTALS,SLOVAK REPUBLIC,200,27,67,40.3,20,40,50.0,7,27,25.9,13,19,68.4,12,20,32,7,24,13,5,3,74,0
8349,193581,235_09_09,SWEDEN,0,TOTALS,SWEDEN,200,29,59,49.2,23,41,56.1,6,18,33.3,16,31,51.6,8,26,34,11,19,10,6,2,80,1
8350,193594,235_09_10,LUXEMBOURG,0,TOTALS,LUXEMBOURG,200,31,64,48.4,20,39,51.3,11,25,44.0,13,23,56.5,13,18,31,18,29,19,13,1,86,1
8351,193607,235_09_10,PORTUGAL,0,TOTALS,PORTUGAL,200,20,51,39.2,17,38,44.7,3,13,23.1,24,41,58.5,12,12,24,6,22,20,9,2,67,0
8352,193620,235_09_11,POLAND,0,TOTALS,POLAND,200,32,63,50.8,25,44,56.8,7,19,36.8,10,18,55.6,9,30,39,16,19,14,5,6,81,1
8353,193632,235_09_11,NORWAY,0,TOTALS,NORWAY,200,19,57,33.3,15,42,35.7,4,15,26.7,10,22,45.5,4,19,23,10,19,8,3,0,52,0
8354,193645,235_09_12,BULGARIA,0,TOTALS,BULGARIA,200,22,59,37.3,20,36,55.6,2,23,8.7,7,11,63.6,7,25,32,9,17,18,8,4,53,0
8355,193658,235_09_12,AUSTRIA,0,TOTALS,AUSTRIA,200,19,69,27.5,14,48,29.2,5,21,23.8,12,19,63.2,11,23,34,7,14,15,10,1,55,1
8356,193671,235_09_13,GREAT BRITAIN,0,TOTALS,GREAT BRITAIN,200,28,66,42.4,22,49,44.9,6,17,35.3,12,19,63.2,13,16,29,16,20,12,7,4,74,0
8357,193684,235_09_13,FINLAND,0,TOTALS,FINLAND,200,30,56,53.6,21,34,61.8,9,22,40.9,13,18,72.2,5,24,29,18,18,13,4,0,82,1
8358,193697,235_09_14,SWITZERLAND,0,TOTALS,SWITZERLAND,200,17,56,30.4,16,40,40.0,1,16,6.2,7,17,41.2,7,12,19,4,18,19,8,4,42,0
8359,193710,235_09_14,CZECH REPUBLIC,0,TOTALS,CZECH REPUBLIC,200,34,70,48.6,24,47,51.1,10,23,43.5,14,20,70.0,11,19,30,12,19,14,9,4,92,1
8360,193723,235_09_15,GEORGIA,0,TOTALS,GEORGIA,200,35,72,48.6,31,52,59.6,4,20,20.0,14,25,56.0,25,29,54,15,9,18,6,6,88,1
8361,193736,235_09_15,LUXEMBOURG,0,TOTALS,LUXEMBOURG,200,19,63,30.2,11,44,25.0,8,19,42.1,7,11,63.6,3,10,13,8,17,12,8,2,53,0
8362,193749,235_09_16,ROMANIA,0,TOTALS,ROMANIA,200,15,49,30.6,10,31,32.3,5,18,27.8,10,25,40.0,5,20,25,4,16,21,1,4,45,0
8363,193762,235_09_16,NETHERLANDS,0,TOTALS,NETHERLANDS,200,27,62,43.5,21,46,45.7,6,16,37.5,11,21,52.4,6,21,27,12,23,13,9,5,71,1
8364,193775,235_09_17,PORTUGAL,0,TOTALS,PORTUGAL,200,28,58,48.3,22,37,59.5,6,21,28.6,30,43,69.8,11,23,34,8,21,12,7,3,92,1
8365,193788,235_09_17,SLOVAK REPUBLIC,0,TOTALS,SLOVAK REPUBLIC,200,21,70,30.0,12,38,31.6,9,32,28.1,13,18,72.2,18,19,37,13,33,17,5,3,64,0
8366,193801,235_09_18,MKD,0,TOTALS,MKD,200,21,63,33.3,12,33,36.4,9,30,30.0,17,24,70.8,13,26,39,11,21,9,9,2,68,1
8367,193814,235_09_18,HUNGARY,0,TOTALS,HUNGARY,200,25,52,48.1,19,39,48.7,6,13,46.2,10,22,45.5,2,23,25,9,22,11,5,4,66,0
8368,193827,235_09_19,SWEDEN,0,TOTALS,SWEDEN,200,22,54,40.7,15,30,50.0,7,24,29.2,12,20,60.0,10,13,23,10,30,20,10,1,63,1
8369,193840,235_09_19,PORTUGAL,0,TOTALS,PORTUGAL,200,17,44,38.6,11,28,39.3,6,16,37.5,20,39,51.3,8,11,19,5,22,19,9,2,60,0
8370,193853,235_09_20,SLOVAK REPUBLIC,0,TOTALS,SLOVAK REPUBLIC,200,22,71,31.0,18,46,39.1,4,25,16.0,19,24,79.2,12,20,32,10,29,12,5,5,67,0
8371,193866,235_09_20,GEORGIA,0,TOTALS,GEORGIA,200,30,67,44.8,22,40,55.0,8,27,29.6,17,36,47.2,16,25,41,21,19,15,3,6,85,1
8372,193879,235_09_21,FINLAND,0,TOTALS,FINLAND,200,33,68,48.5,23,44,52.3,10,24,41.7,11,13,84.6,11,12,23,14,22,9,7,1,87,1
8373,193890,235_09_21,NORWAY,0,TOTALS,NORWAY,200,26,46,56.5,17,26,65.4,9,20,45.0,20,28,71.4,8,12,20,7,17,19,6,1,81,0
8374,193903,235_09_22,CZECH REPUBLIC,0,TOTALS,CZECH REPUBLIC,200,24,61,39.3,19,40,47.5,5,21,23.8,19,22,86.4,8,21,29,13,19,15,4,4,72,0
8375,193916,235_09_22,NETHERLANDS,0,TOTALS,NETHERLANDS,200,30,72,41.7,20,43,46.5,10,29,34.5,10,17,58.8,12,20,32,10,22,12,10,2,80,1
8376,193929,235_09_23,GEORGIA,0,TOTALS,GEORGIA,200,20,64,31.2,12,35,34.3,8,29,27.6,14,29,48.3,15,21,36,9,20,11,7,3,62,1
8377,193942,235_09_23,SWEDEN,0,TOTALS,SWEDEN,200,18,62,29.0,11,29,37.9,7,33,21.2,10,15,66.7,6,17,23,7,22,12,4,2,53,0
8378,193955,235_09_24,HUNGARY,0,TOTALS,HUNGARY,200,13,57,22.8,9,38,23.7,4,19,21.1,18,33,54.5,10,14,24,5,21,14,10,6,48,0
8379,193968,235_09_24,AUSTRIA,0,TOTALS,AUSTRIA,200,24,58,41.4,11,32,34.4,13,26,50.0,13,20,65.0,7,29,36,13,25,28,8,6,74,1
8380,193981,235_09_25,GREAT BRITAIN,0,TOTALS,GREAT BRITAIN,200,25,73,34.2,20,54,37.0,5,19,26.3,12,16,75.0,10,11,21,11,26,6,6,1,67,0
8381,193994,235_09_25,POLAND,0,TOTALS,POLAND,200,29,57,50.9,23,38,60.5,6,19,31.6,20,33,60.6,11,23,34,12,14,14,0,2,84,1
8382,194007,235_09_26,SWITZERLAND,0,TOTALS,SWITZERLAND,200,34,66,51.5,26,47,55.3,8,19,42.1,8,17,47.1,10,21,31,12,19,18,11,8,84,1
8383,194020,235_09_26,ROMANIA,0,TOTALS,ROMANIA,200,24,78,30.8,15,50,30.0,9,28,32.1,14,21,66.7,23,16,39,10,21,20,7,4,71,0
8384,194033,235_09_27,LUXEMBOURG,0,TOTALS,LUXEMBOURG,200,26,70,37.1,18,43,41.9,8,27,29.6,6,13,46.2,10,8,18,9,22,6,12,2,66,0
8385,194046,235_09_27,SLOVAK REPUBLIC,0,TOTALS,SLOVAK REPUBLIC,200,37,66,56.1,28,47,59.6,9,19,47.4,13,19,68.4,18,24,42,12,20,18,2,6,96,1
8386,194059,235_09_28,MKD,0,TOTALS,MKD,200,22,59,37.3,16,39,41.0,6,20,30.0,12,15,80.0,10,20,30,12,9,25,8,2,62,0
8387,194072,235_09_28,BULGARIA,0,TOTALS,BULGARIA,200,39,73,53.4,30,47,63.8,9,26,34.6,5,9,55.6,7,21,28,14,14,12,20,8,92,1
8388,194084,235_09_29,NORWAY,0,TOTALS,NORWAY,200,31,66,47.0,21,44,47.7,10,22,45.5,6,12,50.0,8,14,22,15,13,8,10,1,78,1
8389,194097,235_09_29,SWITZERLAND,0,TOTALS,SWITZERLAND,200,29,61,47.5,24,42,57.1,5,19,26.3,11,16,68.8,11,22,33,6,17,20,7,4,74,0
8390,194110,235_09_30,PORTUGAL,0,TOTALS,PORTUGAL,200,19,56,33.9,16,33,48.5,3,23,13.0,15,23,65.2,10,22,32,7,19,17,8,3,56,0
8391,194123,235_09_30,GREAT BRITAIN,0,TOTALS,GREAT BRITAIN,200,26,66,39.4,22,57,38.6,4,9,44.4,6,17,35.3,13,24,37,14,23,16,11,2,62,1
8392,194136,235_09_31,HUNGARY,0,TOTALS,HUNGARY,200,25,63,39.7,23,51,45.1,2,12,16.7,28,41,68.3,15,22,37,6,20,21,5,9,80,0
8393,194149,235_09_31,SLOVAK REPUBLIC,0,TOTALS,SLOVAK REPUBLIC,200,37,90,41.1,27,61,44.3,10,29,34.5,10,19,52.6,19,20,39,15,28,13,10,5,94,1
8394,194162,235_09_32,GEORGIA,0,TOTALS,GEORGIA,200,21,57,36.8,15,35,42.9,6,22,27.3,11,18,61.1,9,19,28,8,21,12,10,3,59,0
8395,194175,235_09_32,FINLAND,0,TOTALS,FINLAND,200,21,59,35.6,9,21,42.9,12,38,31.6,14,18,77.8,11,24,35,13,22,13,8,3,68,1
8396,194188,235_09_33,SLOVAK REPUBLIC,0,TOTALS,SLOVAK REPUBLIC,200,34,79,43.0,27,57,47.4,7,22,31.8,8,15,53.3,18,26,44,17,25,21,9,3,83,1
8397,194201,235_09_33,ROMANIA,0,TOTALS,ROMANIA,200,22,69,31.9,17,46,37.0,5,23,21.7,18,36,50.0,20,14,34,11,17,19,15,2,67,0
8398,194214,235_09_34,SWEDEN,0,TOTALS,SWEDEN,200,25,58,43.1,19,43,44.2,6,15,40.0,7,13,53.8,7,18,25,14,11,18,3,5,63,0
8399,194227,235_09_34,POLAND,0,TOTALS,POLAND,200,29,56,51.8,19,39,48.7,10,17,58.8,5,8,62.5,7,22,29,12,12,12,8,4,73,1
8400,194240,235_09_35,SWITZERLAND,0,TOTALS,SWITZERLAND,200,30,66,45.5,20,42,47.6,10,24,41.7,6,16,37.5,9,27,36,16,19,16,12,7,76,1
8401,194253,235_09_35,LUXEMBOURG,0,TOTALS,LUXEMBOURG,200,24,71,33.8,17,41,41.5,7,30,23.3,11,19,57.9,13,26,39,12,20,16,10,1,66,0
8402,194266,235_09_36,CZECH REPUBLIC,0,TOTALS,CZECH REPUBLIC,200,33,72,45.8,26,48,54.2,7,24,29.2,18,25,72.0,14,24,38,15,16,10,9,7,91,1
8403,194279,235_09_36,MKD,0,TOTALS,MKD,200,27,63,42.9,16,36,44.4,11,27,40.7,4,10,40.0,7,22,29,15,19,14,4,3,69,0
8404,194292,235_09_37,GREAT BRITAIN,0,TOTALS,GREAT BRITAIN,200,28,75,37.3,23,56,41.1,5,19,26.3,8,15,53.3,16,12,28,13,18,21,16,1,69,0
8405,194305,235_09_37,BULGARIA,0,TOTALS,BULGARIA,200,33,59,55.9,27,38,71.1,6,21,28.6,13,20,65.0,11,27,38,16,15,26,13,6,85,1
8406,194318,235_09_38,NETHERLANDS,0,TOTALS,NETHERLANDS,200,25,73,34.2,16,41,39.0,9,32,28.1,8,12,66.7,13,20,33,17,23,11,7,1,67,1
8407,194331,235_09_38,AUSTRIA,0,TOTALS,AUSTRIA,200,21,58,36.2,17,37,45.9,4,21,19.0,16,27,59.3,17,23,40,13,17,18,8,3,62,0
8408,194344,235_09_39,FINLAND,0,TOTALS,FINLAND,200,18,54,33.3,12,34,35.3,6,20,30.0,5,6,83.3,10,21,31,11,8,18,2,2,47,0
8409,194357,235_09_39,SWEDEN,0,TOTALS,SWEDEN,200,30,73,41.1,24,48,50.0,6,25,24.0,4,7,57.1,14,21,35,12,12,9,8,2,70,1
8410,194370,235_09_40,AUSTRIA,0,TOTALS,AUSTRIA,200,23,56,41.1,14,25,56.0,9,31,29.0,16,23,69.6,13,16,29,17,28,13,7,0,71,0
8411,194383,235_09_40,CZECH REPUBLIC,0,TOTALS,CZECH REPUBLIC,200,23,45,51.1,12,23,52.2,11,22,50.0,26,34,76.5,8,18,26,16,22,15,4,2,83,1
8412,194396,235_09_41,BULGARIA,0,TOTALS,BULGARIA,200,35,69,50.7,30,49,61.2,5,20,25.0,14,19,73.7,10,29,39,22,27,8,7,3,89,1
8413,194409,235_09_41,PORTUGAL,0,TOTALS,PORTUGAL,200,21,64,32.8,14,40,35.0,7,24,29.2,15,27,55.6,8,21,29,11,16,13,2,0,64,0
8414,194422,235_09_42,POLAND,0,TOTALS,POLAND,200,27,69,39.1,21,41,51.2,6,28,21.4,11,15,73.3,11,26,37,13,26,16,6,3,71,1
8415,194435,235_09_42,GEORGIA,0,TOTALS,GEORGIA,200,24,61,39.3,24,46,52.2,0,15,0.0,14,27,51.9,10,22,32,15,19,14,6,2,62,0
8416,194448,235_09_43,ROMANIA,0,TOTALS,ROMANIA,200,17,92,18.5,10,50,20.0,7,42,16.7,7,17,41.2,16,18,34,8,15,15,11,2,48,0
8417,194461,235_09_43,HUNGARY,0,TOTALS,HUNGARY,200,39,73,53.4,34,57,59.6,5,16,31.2,12,15,80.0,9,45,54,24,21,24,8,16,95,1
8418,194474,235_09_44,MKD,0,TOTALS,MKD,200,28,61,45.9,21,31,67.7,7,30,23.3,4,5,80.0,4,12,16,20,11,11,4,6,67,0
8419,194487,235_09_44,NETHERLANDS,0,TOTALS,NETHERLANDS,200,39,67,58.2,27,45,60.0,12,22,54.5,1,4,25.0,13,29,42,22,12,13,7,2,91,1
8420,194500,235_09_45,LUXEMBOURG,0,TOTALS,LUXEMBOURG,200,24,61,39.3,20,49,40.8,4,12,33.3,2,15,13.3,12,20,32,11,16,17,8,2,54,0
8421,194512,235_09_45,NORWAY,0,TOTALS,NORWAY,200,31,72,43.1,25,51,49.0,6,21,28.6,10,18,55.6,17,28,45,12,15,15,10,3,78,1
8422,194525,235_09_46,SWITZERLAND,0,TOTALS,SWITZERLAND,200,27,65,41.5,18,40,45.0,9,25,36.0,16,21,76.2,8,20,28,13,21,20,10,5,79,1
8423,194538,235_09_46,GREAT BRITAIN,0,TOTALS,GREAT BRITAIN,200,27,65,41.5,25,53,47.2,2,12,16.7,16,27,59.3,13,25,38,13,19,22,11,0,72,0
8424,194550,235_09_47,NORWAY,0,TOTALS,NORWAY,225,32,77,41.6,24,45,53.3,8,32,25.0,8,13,61.5,7,19,26,12,19,14,12,3,80,0
8425,194563,235_09_47,BULGARIA,0,TOTALS,BULGARIA,225,32,65,49.2,24,45,53.3,8,20,40.0,12,16,75.0,11,29,40,20,15,22,8,6,84,1
8426,194576,235_09_48,LUXEMBOURG,0,TOTALS,LUXEMBOURG,200,25,60,41.7,18,31,58.1,7,29,24.1,9,12,75.0,6,21,27,15,25,8,4,1,66,0
8427,194589,235_09_48,PORTUGAL,0,TOTALS,PORTUGAL,200,21,58,36.2,17,38,44.7,4,20,20.0,30,37,81.1,9,24,33,12,17,10,6,1,76,1
8428,194602,235_09_49,GEORGIA,0,TOTALS,GEORGIA,200,28,64,43.8,17,36,47.2,11,28,39.3,13,18,72.2,13,22,35,15,19,21,8,4,80,0
8429,194615,235_09_49,AUSTRIA,0,TOTALS,AUSTRIA,200,36,71,50.7,30,47,63.8,6,24,25.0,10,19,52.6,14,26,40,14,19,16,13,2,88,1
8430,194628,235_09_50,PORTUGAL,0,TOTALS,PORTUGAL,200,38,68,55.9,30,52,57.7,8,16,50.0,12,17,70.6,9,21,30,13,19,15,15,0,96,1
8431,194641,235_09_50,ROMANIA,0,TOTALS,ROMANIA,200,24,56,42.9,17,34,50.0,7,22,31.8,8,18,44.4,12,19,31,12,18,26,5,2,63,0
8432,194654,235_09_51,MKD,0,TOTALS,MKD,200,28,57,49.1,17,34,50.0,11,23,47.8,10,15,66.7,4,22,26,22,17,9,9,4,77,1
8433,194667,235_09_51,FINLAND,0,TOTALS,FINLAND,200,18,58,31.0,5,27,18.5,13,31,41.9,6,9,66.7,10,20,30,14,17,16,3,2,55,0
8434,194680,235_09_52,GREAT BRITAIN,0,TOTALS,GREAT BRITAIN,200,31,74,41.9,29,54,53.7,2,20,10.0,16,22,72.7,16,21,37,17,17,14,11,3,80,1
8435,194693,235_09_52,HUNGARY,0,TOTALS,HUNGARY,200,22,56,39.3,14,38,36.8,8,18,44.4,13,20,65.0,9,24,33,12,21,23,7,5,65,0
8436,194706,235_09_53,POLAND,0,TOTALS,POLAND,200,26,58,44.8,21,36,58.3,5,22,22.7,9,12,75.0,5,22,27,12,21,15,3,4,66,0
8437,194719,235_09_53,CZECH REPUBLIC,0,TOTALS,CZECH REPUBLIC,200,28,56,50.0,20,44,45.5,8,12,66.7,15,19,78.9,6,19,25,13,15,11,8,5,79,1
8438,194732,235_09_54,BULGARIA,0,TOTALS,BULGARIA,200,32,61,52.5,27,41,65.9,5,20,25.0,23,30,76.7,8,12,20,17,25,15,12,5,92,1
8439,194745,235_09_54,SLOVAK REPUBLIC,0,TOTALS,SLOVAK REPUBLIC,200,31,66,47.0,23,42,54.8,8,24,33.3,19,25,76.0,15,20,35,10,26,25,8,2,89,0
8440,194758,235_09_55,NETHERLANDS,0,TOTALS,NETHERLANDS,200,25,54,46.3,19,35,54.3,6,19,31.6,15,23,65.2,11,22,33,16,23,17,7,1,71,1
8441,194771,235_09_55,SWEDEN,0,TOTALS,SWEDEN,200,24,54,44.4,17,29,58.6,7,25,28.0,14,25,56.0,8,20,28,8,23,12,12,0,69,0
8442,194784,235_09_56,ROMANIA,0,TOTALS,ROMANIA,200,27,77,35.1,16,47,34.0,11,30,36.7,14,20,70.0,19,30,49,12,8,18,4,2,79,0
8443,194797,235_09_56,LUXEMBOURG,0,TOTALS,LUXEMBOURG,200,36,77,46.8,24,47,51.1,12,30,40.0,8,13,61.5,7,28,35,18,19,9,13,2,92,1
8444,194810,235_09_57,GEORGIA,0,TOTALS,GEORGIA,200,25,56,44.6,20,37,54.1,5,19,26.3,20,29,69.0,12,21,33,17,20,15,7,2,75,0
8445,194823,235_09_57,FINLAND,0,TOTALS,FINLAND,200,32,67,47.8,15,29,51.7,17,38,44.7,16,22,72.7,7,15,22,20,23,11,5,1,97,1
8446,194836,235_09_58,HUNGARY,0,TOTALS,HUNGARY,200,30,73,41.1,28,57,49.1,2,16,12.5,23,34,67.6,19,24,43,17,26,14,7,6,85,0
8447,194849,235_09_58,SWITZERLAND,0,TOTALS,SWITZERLAND,200,28,65,43.1,19,43,44.2,9,22,40.9,23,32,71.9,6,21,27,15,25,13,8,8,88,1
8448,194862,235_09_59,AUSTRIA,0,TOTALS,AUSTRIA,200,30,59,50.8,23,44,52.3,7,15,46.7,20,29,69.0,9,26,35,15,13,11,5,1,87,1
8449,194875,235_09_59,MKD,0,TOTALS,MKD,200,24,63,38.1,11,25,44.0,13,38,34.2,6,8,75.0,8,18,26,17,24,12,7,6,67,0
8450,194888,235_09_60,SLOVAK REPUBLIC,0,TOTALS,SLOVAK REPUBLIC,200,28,60,46.7,24,43,55.8,4,17,23.5,20,37,54.1,14,32,46,15,23,23,6,4,80,1
8451,194900,235_09_60,NORWAY,0,TOTALS,NORWAY,200,25,71,35.2,20,48,41.7,5,23,21.7,14,28,50.0,13,16,29,11,30,16,7,1,69,0
8452,194913,235_09_61,POLAND,0,TOTALS,POLAND,200,37,67,55.2,28,48,58.3,9,19,47.4,13,21,61.9,11,22,33,16,14,10,5,4,96,1
8453,194926,235_09_61,SWEDEN,0,TOTALS,SWEDEN,200,25,63,39.7,16,41,39.0,9,22,40.9,7,11,63.6,10,11,21,14,16,10,4,4,66,0
8454,194939,235_09_62,CZECH REPUBLIC,0,TOTALS,CZECH REPUBLIC,225,27,64,42.2,16,34,47.1,11,30,36.7,12,17,70.6,13,13,26,13,21,18,9,3,77,0
8455,194952,235_09_62,NETHERLANDS,0,TOTALS,NETHERLANDS,225,33,69,47.8,27,51,52.9,6,18,33.3,16,24,66.7,18,21,39,20,17,19,12,1,88,1
8456,197643,238_09_01,CZECH REPUBLIC,0,TOTALS,CZECH REPUBLIC,200,29,70,41.4,21,45,46.7,8,25,32.0,5,6,83.3,16,17,33,11,15,11,12,4,71,0
8457,197656,238_09_01,SLOVENIA,0,TOTALS,SLOVENIA,200,29,57,50.9,21,35,60.0,8,22,36.4,8,11,72.7,10,25,35,18,12,18,5,0,74,1
8458,197669,238_09_02,LATVIA,0,TOTALS,LATVIA,200,26,73,35.6,18,49,36.7,8,24,33.3,3,7,42.9,24,33,57,12,19,15,2,6,63,1
8459,197682,238_09_02,BULGARIA,0,TOTALS,BULGARIA,200,15,52,28.8,12,33,36.4,3,19,15.8,14,26,53.8,10,25,35,7,18,14,8,4,47,0
8460,197695,238_09_03,UKRAINE,0,TOTALS,UKRAINE,200,27,69,39.1,13,36,36.1,14,33,42.4,9,11,81.8,10,23,33,10,21,14,7,4,77,1
8461,197708,238_09_03,GERMANY,0,TOTALS,GERMANY,200,34,64,53.1,19,37,51.4,15,27,55.6,17,24,70.8,12,31,43,18,15,12,8,6,100,0
8462,197721,238_09_04,ISRAEL,0,TOTALS,ISRAEL,200,24,63,38.1,19,42,45.2,5,21,23.8,10,20,50.0,15,22,37,8,22,14,11,0,63,1
8463,197734,238_09_04,RUSSIA,0,TOTALS,RUSSIA,200,24,55,43.6,21,38,55.3,3,17,17.6,11,23,47.8,14,26,40,10,20,20,2,0,62,0
8464,197747,238_09_05,CROATIA,0,TOTALS,CROATIA,200,30,59,50.8,24,37,64.9,6,22,27.3,16,28,57.1,1,28,29,12,19,15,14,2,82,1
8465,197760,238_09_05,SPAIN,0,TOTALS,SPAIN,200,32,67,47.8,25,42,59.5,7,25,28.0,7,14,50.0,9,32,41,19,18,19,8,1,78,0
8466,197773,238_09_06,GREECE,0,TOTALS,GREECE,200,27,57,47.4,23,39,59.0,4,18,22.2,16,34,47.1,13,20,33,15,25,16,10,2,74,0
8467,197786,238_09_06,TURKEY,0,TOTALS,TURKEY,200,29,67,43.3,23,42,54.8,6,25,24.0,14,29,48.3,24,22,46,13,27,18,7,1,78,1
8468,197799,238_09_07,FRANCE,0,TOTALS,FRANCE,200,27,61,44.3,22,43,51.2,5,18,27.8,9,14,64.3,6,23,29,13,21,20,14,0,68,1
8469,197812,238_09_07,SERBIA,0,TOTALS,SERBIA,200,23,49,46.9,16,28,57.1,7,21,33.3,10,20,50.0,9,31,40,14,23,24,5,6,63,0
8470,197825,238_09_08,ITALY,0,TOTALS,ITALY,200,29,66,43.9,18,43,41.9,11,23,47.8,16,28,57.1,12,21,33,15,30,15,12,6,85,0
8471,197838,238_09_08,LITHUANIA,0,TOTALS,LITHUANIA,200,31,63,49.2,26,44,59.1,5,19,26.3,19,32,59.4,18,30,48,16,29,24,6,3,86,1
8472,197851,238_09_09,GERMANY,0,TOTALS,GERMANY,200,16,49,32.7,13,32,40.6,3,17,17.6,16,19,84.2,5,32,37,6,14,17,2,11,51,0
8473,197864,238_09_09,CROATIA,0,TOTALS,CROATIA,200,27,70,38.6,16,36,44.4,11,34,32.4,8,12,66.7,11,28,39,19,16,8,10,4,73,1
8474,197877,238_09_10,BULGARIA,0,TOTALS,BULGARIA,200,19,53,35.8,9,21,42.9,10,32,31.2,17,29,58.6,11,36,47,14,18,25,8,0,65,1
8475,197890,238_09_10,GREECE,0,TOTALS,GREECE,200,20,66,30.3,13,29,44.8,7,37,18.9,8,21,38.1,15,25,40,13,25,19,12,5,55,0
8476,197903,238_09_11,SPAIN,0,TOTALS,SPAIN,200,38,73,52.1,31,47,66.0,7,26,26.9,14,17,82.4,17,30,47,15,20,16,10,6,97,1
8477,197916,238_09_11,UKRAINE,0,TOTALS,UKRAINE,200,25,67,37.3,20,40,50.0,5,27,18.5,19,26,73.1,12,18,30,8,19,15,7,4,74,0
8478,197929,238_09_12,RUSSIA,0,TOTALS,RUSSIA,200,15,49,30.6,12,32,37.5,3,17,17.6,22,35,62.9,17,31,48,9,19,21,5,5,55,1
8479,197942,238_09_12,ITALY,0,TOTALS,ITALY,200,19,60,31.7,14,41,34.1,5,19,26.3,11,18,61.1,13,24,37,10,28,18,15,4,54,0
8480,197955,238_09_13,SERBIA,0,TOTALS,SERBIA,200,26,59,44.1,21,38,55.3,5,21,23.8,18,26,69.2,12,26,38,14,17,13,9,8,75,1
8481,197968,238_09_13,CZECH REPUBLIC,0,TOTALS,CZECH REPUBLIC,200,23,69,33.3,17,46,37.0,6,23,26.1,4,8,50.0,19,22,41,10,23,17,6,2,56,0
8482,197981,238_09_14,LITHUANIA,0,TOTALS,LITHUANIA,200,34,60,56.7,26,39,66.7,8,21,38.1,16,21,76.2,11,36,47,17,21,22,14,5,92,1
8483,197994,238_09_14,ISRAEL,0,TOTALS,ISRAEL,200,18,54,33.3,11,32,34.4,7,22,31.8,10,19,52.6,4,17,21,9,19,19,13,1,53,0
8484,198007,238_09_15,SLOVENIA,0,TOTALS,SLOVENIA,200,29,54,53.7,22,35,62.9,7,19,36.8,18,21,85.7,11,25,36,13,17,20,7,5,83,1
8485,198020,238_09_15,FRANCE,0,TOTALS,FRANCE,200,29,69,42.0,22,51,43.1,7,18,38.9,16,19,84.2,15,14,29,11,18,11,11,0,81,0
8486,198033,238_09_16,TURKEY,0,TOTALS,TURKEY,200,34,64,53.1,24,40,60.0,10,24,41.7,7,14,50.0,7,33,40,15,21,13,9,4,85,1
8487,198046,238_09_16,LATVIA,0,TOTALS,LATVIA,200,15,60,25.0,11,41,26.8,4,19,21.1,16,22,72.7,15,24,39,7,19,14,5,1,50,0
8488,198059,238_09_17,SPAIN,0,TOTALS,SPAIN,200,33,75,44.0,21,48,43.8,12,27,44.4,5,10,50.0,19,33,52,21,19,14,9,5,83,1
8489,198072,238_09_17,GERMANY,0,TOTALS,GERMANY,200,18,63,28.6,8,43,18.6,10,20,50.0,10,18,55.6,15,25,40,12,12,18,7,4,56,0
8490,198085,238_09_18,ISRAEL,0,TOTALS,ISRAEL,200,16,60,26.7,12,42,28.6,4,18,22.2,21,30,70.0,11,24,35,4,25,16,13,1,57,0
8491,198098,238_09_18,ITALY,0,TOTALS,ITALY,200,18,59,30.5,11,33,33.3,7,26,26.9,23,27,85.2,19,34,53,7,22,24,4,3,66,1
8492,198111,238_09_19,SERBIA,0,TOTALS,SERBIA,200,28,62,45.2,24,48,50.0,4,14,28.6,9,15,60.0,11,35,46,12,17,22,14,9,69,1
8493,198124,238_09_19,SLOVENIA,0,TOTALS,SLOVENIA,200,18,61,29.5,15,43,34.9,3,18,16.7,11,17,64.7,10,26,36,7,20,18,13,2,50,0
8494,198137,238_09_20,TURKEY,0,TOTALS,TURKEY,200,32,68,47.1,25,46,54.3,7,22,31.8,3,6,50.0,18,23,41,17,20,17,11,4,74,1
8495,198150,238_09_20,BULGARIA,0,TOTALS,BULGARIA,200,22,54,40.7,14,27,51.9,8,27,29.6,6,9,66.7,10,18,28,13,10,18,10,1,58,0
8496,198163,238_09_21,UKRAINE,0,TOTALS,UKRAINE,200,21,59,35.6,15,42,35.7,6,17,35.3,21,31,67.7,12,23,35,6,16,10,8,3,69,0
8497,198176,238_09_21,CROATIA,0,TOTALS,CROATIA,200,31,64,48.4,24,40,60.0,7,24,29.2,4,11,36.4,12,32,44,15,25,14,7,4,73,1
8498,198189,238_09_22,LITHUANIA,0,TOTALS,LITHUANIA,200,23,59,39.0,16,39,41.0,7,20,35.0,23,30,76.7,16,32,48,13,23,18,5,8,76,1
8499,198202,238_09_22,RUSSIA,0,TOTALS,RUSSIA,200,25,68,36.8,19,49,38.8,6,19,31.6,13,18,72.2,11,18,29,10,23,9,8,3,69,0
8500,198215,238_09_23,CZECH REPUBLIC,0,TOTALS,CZECH REPUBLIC,200,26,60,43.3,22,40,55.0,4,20,20.0,11,23,47.8,7,28,35,15,18,17,12,0,67,0
8501,198228,238_09_23,FRANCE,0,TOTALS,FRANCE,200,30,60,50.0,21,38,55.3,9,22,40.9,9,18,50.0,5,33,38,22,22,19,14,1,78,1
8502,198241,238_09_24,LATVIA,0,TOTALS,LATVIA,200,27,62,43.5,22,42,52.4,5,20,25.0,9,17,52.9,16,20,36,17,23,19,8,3,68,0
8503,198254,238_09_24,GREECE,0,TOTALS,GREECE,200,26,60,43.3,17,33,51.5,9,27,33.3,10,16,62.5,13,21,34,13,21,15,11,3,71,1
8504,198267,238_09_25,CZECH REPUBLIC,0,TOTALS,CZECH REPUBLIC,200,23,54,42.6,19,38,50.0,4,16,25.0,10,19,52.6,11,25,36,8,20,29,8,3,60,0
8505,198280,238_09_25,ISRAEL,0,TOTALS,ISRAEL,200,28,72,38.9,22,51,43.1,6,21,28.6,16,18,88.9,18,24,42,12,20,18,20,3,78,1
8506,198293,238_09_26,UKRAINE,0,TOTALS,UKRAINE,200,17,58,29.3,11,33,33.3,6,25,24.0,5,12,41.7,14,22,36,11,15,23,6,0,45,0
8507,198306,238_09_26,GREECE,0,TOTALS,GREECE,200,29,65,44.6,23,44,52.3,6,21,28.6,9,17,52.9,16,32,48,11,15,16,17,1,73,1
8508,198319,238_09_27,GERMANY,0,TOTALS,GERMANY,200,24,65,36.9,18,47,38.3,6,18,33.3,14,20,70.0,4,19,23,10,17,13,13,1,68,0
8509,198332,238_09_27,SERBIA,0,TOTALS,SERBIA,200,34,59,57.6,21,36,58.3,13,23,56.5,8,15,53.3,11,37,48,22,22,27,9,6,89,1
8510,198345,238_09_28,RUSSIA,0,TOTALS,RUSSIA,225,28,64,43.8,22,43,51.2,6,21,28.6,8,18,44.4,9,30,39,10,22,16,11,1,70,0
8511,198358,238_09_28,TURKEY,0,TOTALS,TURKEY,225,25,69,36.2,19,46,41.3,6,23,26.1,16,25,64.0,19,31,50,10,22,18,3,2,72,1
8512,198371,238_09_29,SLOVENIA,0,TOTALS,SLOVENIA,200,29,73,39.7,14,40,35.0,15,33,45.5,11,15,73.3,15,18,33,16,26,14,6,0,84,0
8513,198384,238_09_29,CROATIA,0,TOTALS,CROATIA,200,33,53,62.3,29,44,65.9,4,9,44.4,20,27,74.1,4,29,33,14,19,18,7,5,90,1
8514,198397,238_09_30,BULGARIA,0,TOTALS,BULGARIA,200,14,61,23.0,11,39,28.2,3,22,13.6,9,16,56.2,15,21,36,4,19,10,3,0,40,0
8515,198410,238_09_30,LITHUANIA,0,TOTALS,LITHUANIA,200,36,70,51.4,26,47,55.3,10,23,43.5,9,18,50.0,13,34,47,16,23,8,4,9,91,1
8516,198423,238_09_31,SPAIN,0,TOTALS,SPAIN,200,33,61,54.1,29,48,60.4,4,13,30.8,5,10,50.0,9,28,37,21,16,13,9,2,75,1
8517,198436,238_09_31,FRANCE,0,TOTALS,FRANCE,200,26,70,37.1,21,48,43.8,5,22,22.7,12,17,70.6,18,22,40,10,15,14,9,2,69,0
8518,198449,238_09_32,ITALY,0,TOTALS,ITALY,200,26,65,40.0,24,46,52.2,2,19,10.5,12,22,54.5,17,20,37,9,24,20,16,2,66,1
8519,198462,238_09_32,LATVIA,0,TOTALS,LATVIA,200,19,49,38.8,14,29,48.3,5,20,25.0,15,24,62.5,13,25,38,7,25,27,9,3,58,0
8520,198475,238_09_33,GERMANY,0,TOTALS,GERMANY,200,24,58,41.4,20,37,54.1,4,21,19.0,24,36,66.7,13,28,41,7,15,16,7,2,76,1
8521,198488,238_09_33,SLOVENIA,0,TOTALS,SLOVENIA,200,27,69,39.1,17,41,41.5,10,28,35.7,7,12,58.3,16,27,43,10,29,18,5,1,71,0
8522,198501,238_09_34,RUSSIA,0,TOTALS,RUSSIA,200,35,68,51.5,25,42,59.5,10,26,38.5,15,18,83.3,18,17,35,12,12,8,13,2,95,1
8523,198514,238_09_34,BULGARIA,0,TOTALS,BULGARIA,200,21,45,46.7,14,27,51.9,7,18,38.9,8,11,72.7,3,18,21,14,21,21,7,1,57,0
8524,198527,238_09_35,SERBIA,0,TOTALS,SERBIA,200,21,56,37.5,16,33,48.5,5,23,21.7,13,20,65.0,7,33,40,10,30,17,5,3,60,0
8525,198540,238_09_35,SPAIN,0,TOTALS,SPAIN,200,21,67,31.3,17,45,37.8,4,22,18.2,19,36,52.8,20,30,50,12,20,12,8,2,65,1
8526,198553,238_09_36,TURKEY,0,TOTALS,TURKEY,200,23,55,41.8,20,37,54.1,3,18,16.7,12,20,60.0,13,30,43,12,21,24,6,2,61,0
8527,198566,238_09_36,ITALY,0,TOTALS,ITALY,200,24,65,36.9,15,47,31.9,9,18,50.0,13,17,76.5,12,20,32,9,19,12,10,3,70,1
8528,198579,238_09_37,FRANCE,0,TOTALS,FRANCE,200,24,62,38.7,17,43,39.5,7,19,36.8,12,18,66.7,15,22,37,10,9,13,7,2,67,1
8529,198592,238_09_37,CROATIA,0,TOTALS,CROATIA,200,24,55,43.6,16,33,48.5,8,22,36.4,5,10,50.0,9,25,34,15,20,17,7,1,61,0
8530,198605,238_09_38,LATVIA,0,TOTALS,LATVIA,200,20,59,33.9,18,38,47.4,2,21,9.5,18,28,64.3,10,21,31,8,27,19,12,7,60,0
8531,198618,238_09_38,LITHUANIA,0,TOTALS,LITHUANIA,200,33,77,42.9,29,59,49.2,4,18,22.2,19,34,55.9,24,33,57,18,25,16,15,1,89,1
8532,198631,238_09_39,GREECE,0,TOTALS,GREECE,200,27,66,40.9,20,43,46.5,7,23,30.4,4,11,36.4,16,33,49,10,19,14,7,4,65,1
8533,198644,238_09_39,CZECH REPUBLIC,0,TOTALS,CZECH REPUBLIC,200,19,58,32.8,13,39,33.3,6,19,31.6,12,22,54.5,12,26,38,8,15,18,7,2,56,0
8534,198657,238_09_40,ISRAEL,0,TOTALS,ISRAEL,200,22,64,34.4,14,43,32.6,8,21,38.1,17,25,68.0,14,15,29,11,21,11,11,2,69,0
8535,198670,238_09_40,UKRAINE,0,TOTALS,UKRAINE,200,25,59,42.4,17,35,48.6,8,24,33.3,16,19,84.2,18,32,50,15,23,21,6,6,74,1
8536,198683,238_09_41,SPAIN,0,TOTALS,SPAIN,200,29,61,47.5,25,48,52.1,4,13,30.8,12,26,46.2,12,33,45,18,14,18,11,6,74,1
8537,198696,238_09_41,SLOVENIA,0,TOTALS,SLOVENIA,200,27,69,39.1,21,50,42.0,6,19,31.6,7,13,53.8,10,25,35,15,25,17,5,2,67,0
8538,198709,238_09_42,ITALY,0,TOTALS,ITALY,200,26,58,44.8,17,34,50.0,9,24,37.5,15,19,78.9,6,27,33,12,23,14,10,7,76,1
8539,198722,238_09_42,BULGARIA,0,TOTALS,BULGARIA,200,16,50,32.0,9,26,34.6,7,24,29.2,17,20,85.0,6,26,32,12,21,20,7,0,56,0
8540,198735,238_09_43,CROATIA,0,TOTALS,CROATIA,225,25,73,34.2,17,43,39.5,8,30,26.7,12,22,54.5,16,29,45,12,28,13,8,1,70,0
8541,198748,238_09_43,SERBIA,0,TOTALS,SERBIA,225,29,71,40.8,24,50,48.0,5,21,23.8,14,28,50.0,18,36,54,10,21,13,8,7,77,1
8542,198761,238_09_44,LITHUANIA,0,TOTALS,LITHUANIA,200,31,60,51.7,22,40,55.0,9,20,45.0,19,21,90.5,6,27,33,18,25,10,4,6,90,1
8543,198774,238_09_44,TURKEY,0,TOTALS,TURKEY,200,29,65,44.6,22,42,52.4,7,23,30.4,16,21,76.2,11,23,34,8,20,12,3,4,81,0
8544,198787,238_09_45,FRANCE,0,TOTALS,FRANCE,200,28,66,42.4,23,48,47.9,5,18,27.8,10,16,62.5,16,31,47,10,13,10,5,2,71,1
8545,198800,238_09_45,GERMANY,0,TOTALS,GERMANY,200,20,62,32.3,14,35,40.0,6,27,22.2,13,18,72.2,12,22,34,9,16,10,5,4,59,0
8546,198813,238_09_46,LATVIA,0,TOTALS,LATVIA,200,22,60,36.7,15,37,40.5,7,23,30.4,7,16,43.8,17,27,44,17,24,16,5,5,58,0
8547,198826,238_09_46,RUSSIA,0,TOTALS,RUSSIA,200,24,61,39.3,17,41,41.5,7,20,35.0,17,28,60.7,14,25,39,9,18,7,9,4,72,1
8548,198839,238_09_47,SPAIN,0,TOTALS,SPAIN,200,23,70,32.9,14,42,33.3,9,28,32.1,7,9,77.8,17,26,43,10,22,15,12,5,62,0
8549,198852,238_09_47,TURKEY,0,TOTALS,TURKEY,200,26,66,39.4,18,42,42.9,8,24,33.3,16,23,69.6,16,29,45,14,17,14,7,6,76,1
8550,198865,238_09_48,GERMANY,0,TOTALS,GERMANY,200,17,53,32.1,12,31,38.7,5,22,22.7,8,23,34.8,14,33,47,8,20,22,8,3,47,0
8551,198878,238_09_48,BULGARIA,0,TOTALS,BULGARIA,200,19,58,32.8,13,26,50.0,6,32,18.8,11,22,50.0,12,28,40,10,19,13,14,2,55,1
8552,198891,238_09_49,ITALY,0,TOTALS,ITALY,200,28,77,36.4,18,48,37.5,10,29,34.5,8,17,47.1,19,16,35,8,30,12,11,4,74,0
8553,198904,238_09_49,SERBIA,0,TOTALS,SERBIA,200,25,47,53.2,18,29,62.1,7,18,38.9,25,32,78.1,8,31,39,12,20,19,8,3,82,1
8554,198917,238_09_50,LATVIA,0,TOTALS,LATVIA,200,32,58,55.2,27,44,61.4,5,14,35.7,24,35,68.6,8,30,38,19,21,17,11,6,93,1
8555,198930,238_09_50,SLOVENIA,0,TOTALS,SLOVENIA,200,25,66,37.9,13,32,40.6,12,34,35.3,9,19,47.4,14,20,34,13,29,17,7,4,71,0
8556,198943,238_09_51,GREECE,0,TOTALS,GREECE,200,31,68,45.6,22,44,50.0,9,24,37.5,9,24,37.5,15,46,61,18,28,22,7,11,80,1
8557,198956,238_09_51,ISRAEL,0,TOTALS,ISRAEL,200,15,73,20.5,11,52,21.2,4,21,19.0,20,38,52.6,19,26,45,3,22,9,14,3,54,0
8558,198969,238_09_52,LITHUANIA,0,TOTALS,LITHUANIA,200,28,85,32.9,23,72,31.9,5,13,38.5,13,19,68.4,26,36,62,12,17,8,6,4,74,1
8559,198982,238_09_52,CROATIA,0,TOTALS,CROATIA,200,22,64,34.4,21,47,44.7,1,17,5.9,10,13,76.9,8,32,40,8,18,12,3,6,55,0
8560,198995,238_09_53,FRANCE,0,TOTALS,FRANCE,200,27,64,42.2,21,43,48.8,6,21,28.6,14,27,51.9,12,24,36,15,17,12,10,3,74,1
8561,199008,238_09_53,RUSSIA,0,TOTALS,RUSSIA,200,21,54,38.9,12,31,38.7,9,23,39.1,10,14,71.4,8,27,35,11,24,21,7,6,61,0
8562,199021,238_09_54,CZECH REPUBLIC,0,TOTALS,CZECH REPUBLIC,200,27,75,36.0,22,51,43.1,5,24,20.8,11,16,68.8,14,30,44,8,23,14,8,1,70,0
8563,199034,238_09_54,UKRAINE,0,TOTALS,UKRAINE,200,31,73,42.5,26,55,47.3,5,18,27.8,12,21,57.1,15,34,49,13,16,16,9,5,79,1
8564,199047,238_09_55,GERMANY,0,TOTALS,GERMANY,200,33,66,50.0,27,50,54.0,6,16,37.5,25,30,83.3,15,31,46,16,12,20,8,5,97,1
8565,199060,238_09_55,SLOVENIA,0,TOTALS,SLOVENIA,200,26,72,36.1,15,42,35.7,11,30,36.7,12,16,75.0,16,20,36,10,25,18,6,4,75,0
8566,199073,238_09_56,SPAIN,0,TOTALS,SPAIN,200,30,56,53.6,20,39,51.3,10,17,58.8,14,18,77.8,5,33,38,24,18,20,6,2,84,1
8567,199086,238_09_56,ITALY,0,TOTALS,ITALY,200,26,70,37.1,19,43,44.2,7,27,25.9,13,18,72.2,10,24,34,8,16,14,13,2,72,0
8568,199099,238_09_57,BULGARIA,0,TOTALS,BULGARIA,200,19,63,30.2,13,35,37.1,6,28,21.4,11,22,50.0,9,23,32,15,14,16,16,1,55,0
8569,199112,238_09_57,LATVIA,0,TOTALS,LATVIA,200,22,53,41.5,14,30,46.7,8,23,34.8,13,16,81.2,11,39,50,18,20,30,9,4,65,1
8570,199125,238_09_58,CROATIA,0,TOTALS,CROATIA,200,24,59,40.7,12,28,42.9,12,31,38.7,14,19,73.7,15,27,42,14,20,26,12,1,74,0
8571,199138,238_09_58,RUSSIA,0,TOTALS,RUSSIA,200,27,64,42.2,20,39,51.3,7,25,28.0,15,19,78.9,12,20,32,10,23,19,13,2,76,1
8572,199151,238_09_59,TURKEY,0,TOTALS,TURKEY,200,25,69,36.2,20,49,40.8,5,20,25.0,6,8,75.0,15,28,43,9,17,9,2,2,61,0
8573,199164,238_09_59,SERBIA,0,TOTALS,SERBIA,200,23,56,41.1,19,41,46.3,4,15,26.7,16,20,80.0,7,30,37,9,14,9,4,8,66,1
8574,199177,238_09_60,LITHUANIA,0,TOTALS,LITHUANIA,200,21,60,35.0,19,40,47.5,2,20,10.0,19,28,67.9,17,33,50,10,13,19,5,6,63,0
8575,199190,238_09_60,FRANCE,0,TOTALS,FRANCE,200,29,70,41.4,26,51,51.0,3,19,15.8,7,9,77.8,8,25,33,19,23,9,10,1,68,1
8576,199203,238_09_61,ITALY,0,TOTALS,ITALY,200,39,71,54.9,30,50,60.0,9,21,42.9,12,18,66.7,13,21,34,14,16,7,5,3,99,1
8577,199216,238_09_61,CROATIA,0,TOTALS,CROATIA,200,35,66,53.0,28,52,53.8,7,14,50.0,11,15,73.3,12,20,32,20,21,10,3,1,88,0
8578,199229,238_09_62,SPAIN,0,TOTALS,SPAIN,200,32,67,47.8,24,42,57.1,8,25,32.0,20,30,66.7,12,28,40,22,26,15,10,1,92,1
8579,199242,238_09_62,RUSSIA,0,TOTALS,RUSSIA,200,27,65,41.5,23,45,51.1,4,20,20.0,25,35,71.4,16,27,43,12,25,20,7,4,83,0
8580,199255,238_09_63,TURKEY,0,TOTALS,TURKEY,200,41,67,61.2,32,51,62.7,9,16,56.2,4,11,36.4,12,27,39,18,18,14,10,7,95,1
8581,199268,238_09_63,LITHUANIA,0,TOTALS,LITHUANIA,200,27,63,42.9,22,45,48.9,5,18,27.8,15,25,60.0,12,18,30,12,14,14,10,5,74,0
8582,199281,238_09_64,SERBIA,0,TOTALS,SERBIA,200,23,52,44.2,15,27,55.6,8,25,32.0,24,31,77.4,14,27,41,14,20,23,11,4,78,1
8583,199294,238_09_64,FRANCE,0,TOTALS,FRANCE,200,26,69,37.7,23,55,41.8,3,14,21.4,17,20,85.0,15,18,33,9,25,13,17,1,72,0
8584,199307,239_09_01,HUNGARY,0,TOTALS,HUNGARY,225,34,72,47.2,27,56,48.2,7,16,43.8,16,24,66.7,10,22,32,6,28,25,9,3,91,1
8585,199320,239_09_01,DENMARK,0,TOTALS,DENMARK,225,30,70,42.9,27,53,50.9,3,17,17.6,19,35,54.3,18,27,45,4,20,19,13,0,82,0
8586,199333,239_09_02,ENGLAND,0,TOTALS,ENGLAND,200,25,52,48.1,18,31,58.1,7,21,33.3,10,17,58.8,5,22,27,7,16,14,4,0,67,1
8587,199346,239_09_02,BELGIUM,0,TOTALS,BELGIUM,200,23,56,41.1,16,31,51.6,7,25,28.0,5,8,62.5,6,22,28,6,17,12,4,0,58,0
8588,199359,239_09_03,MONTENEGRO,0,TOTALS,MONTENEGRO,200,36,72,50.0,31,54,57.4,5,18,27.8,13,21,61.9,15,24,39,6,16,17,10,5,90,1
8589,199372,239_09_03,NETHERLANDS,0,TOTALS,NETHERLANDS,200,30,66,45.5,24,49,49.0,6,17,35.3,7,14,50.0,12,21,33,4,19,18,7,1,73,0
8590,199385,239_09_04,NORWAY,0,TOTALS,NORWAY,200,29,61,47.5,24,46,52.2,5,15,33.3,12,21,57.1,13,25,38,10,24,19,3,2,75,1
8591,199398,239_09_04,BELARUS,0,TOTALS,BELARUS,200,27,71,38.0,23,48,47.9,4,23,17.4,10,23,43.5,18,18,36,6,23,8,10,4,68,0
8592,199411,239_09_05,ESTONIA,0,TOTALS,ESTONIA,200,28,67,41.8,18,42,42.9,10,25,40.0,8,12,66.7,10,16,26,2,22,19,10,1,74,0
8593,199424,239_09_05,BOSNIA AND HERZEGOVINA,0,TOTALS,BOSNIA AND HERZEGOVINA,200,33,58,56.9,30,49,61.2,3,9,33.3,13,23,56.5,8,26,34,4,22,19,13,2,82,1
8594,199436,239_09_06,SCOTLAND,0,TOTALS,SCOTLAND,200,26,53,49.1,25,41,61.0,1,12,8.3,18,25,72.0,7,30,37,9,22,18,2,6,71,1
8595,199449,239_09_06,GEORGIA,0,TOTALS,GEORGIA,200,21,66,31.8,17,36,47.2,4,30,13.3,15,25,60.0,10,21,31,11,24,15,8,1,61,0
8596,199462,239_09_07,SWEDEN,0,TOTALS,SWEDEN,200,28,61,45.9,23,43,53.5,5,18,27.8,11,23,47.8,12,25,37,8,21,13,12,1,72,1
8597,199475,239_09_07,FINLAND,0,TOTALS,FINLAND,200,23,60,38.3,18,44,40.9,5,16,31.2,5,13,38.5,13,22,35,4,23,19,4,0,56,0
8598,199488,239_09_08,SWITZERLAND,0,TOTALS,SWITZERLAND,200,32,62,51.6,21,37,56.8,11,25,44.0,11,21,52.4,13,24,37,9,20,12,7,2,86,1
8599,199501,239_09_08,PORTUGAL,0,TOTALS,PORTUGAL,200,24,58,41.4,17,39,43.6,7,19,36.8,13,19,68.4,11,16,27,9,23,9,4,2,68,0
8600,199514,239_09_09,ICELAND,0,TOTALS,ICELAND,200,25,75,33.3,17,42,40.5,8,33,24.2,7,10,70.0,7,24,31,6,23,16,13,2,65,0
8601,199527,239_09_09,POLAND,0,TOTALS,POLAND,200,23,54,42.6,14,31,45.2,9,23,39.1,12,22,54.5,11,37,48,8,15,27,7,2,67,1
8602,199540,239_09_10,SLOVAK REPUBLIC,0,TOTALS,SLOVAK REPUBLIC,200,33,83,39.8,29,64,45.3,4,19,21.1,3,9,33.3,18,32,50,9,23,13,7,2,73,0
8603,199553,239_09_10,SWEDEN,0,TOTALS,SWEDEN,200,34,80,42.5,30,63,47.6,4,17,23.5,12,22,54.5,20,34,54,5,15,10,5,4,84,1
8604,199566,239_09_11,ROMANIA,0,TOTALS,ROMANIA,200,20,50,40.0,14,35,40.0,6,15,40.0,7,14,50.0,5,14,19,11,21,20,4,0,53,0
8605,199579,239_09_11,MONTENEGRO,0,TOTALS,MONTENEGRO,200,38,66,57.6,31,49,63.3,7,17,41.2,5,12,41.7,12,26,38,16,19,15,11,3,88,1
8606,199592,239_09_12,BELGIUM,0,TOTALS,BELGIUM,200,29,61,47.5,23,42,54.8,6,19,31.6,6,8,75.0,9,30,39,4,17,16,9,7,70,1
8607,199605,239_09_12,SWITZERLAND,0,TOTALS,SWITZERLAND,200,16,67,23.9,14,48,29.2,2,19,10.5,13,20,65.0,16,25,41,0,15,20,11,3,47,0
8608,199618,239_09_13,BOSNIA AND HERZEGOVINA,0,TOTALS,BOSNIA AND HERZEGOVINA,200,26,54,48.1,23,39,59.0,3,15,20.0,23,35,65.7,12,29,41,10,28,15,8,2,78,1
8609,199631,239_09_13,NORWAY,0,TOTALS,NORWAY,200,21,62,33.9,13,30,43.3,8,32,25.0,20,32,62.5,11,14,25,5,28,14,5,1,70,0
8610,199644,239_09_14,FINLAND,0,TOTALS,FINLAND,200,24,57,42.1,16,32,50.0,8,25,32.0,11,22,50.0,8,30,38,3,14,12,6,1,67,1
8611,199657,239_09_14,ICELAND,0,TOTALS,ICELAND,200,21,61,34.4,17,38,44.7,4,23,17.4,9,17,52.9,7,25,32,1,18,12,4,2,55,0
8612,199670,239_09_15,BELARUS,0,TOTALS,BELARUS,200,21,69,30.4,20,54,37.0,1,15,6.7,5,12,41.7,20,29,49,6,22,23,4,2,48,0
8613,199683,239_09_15,HUNGARY,0,TOTALS,HUNGARY,200,26,71,36.6,24,58,41.4,2,13,15.4,12,24,50.0,15,26,41,9,11,9,9,2,66,1
8614,199696,239_09_16,NETHERLANDS,0,TOTALS,NETHERLANDS,200,38,80,47.5,26,48,54.2,12,32,37.5,10,13,76.9,13,31,44,8,16,16,12,4,98,1
8615,199708,239_09_16,SCOTLAND,0,TOTALS,SCOTLAND,200,23,66,34.8,20,49,40.8,3,17,17.6,10,18,55.6,10,25,35,2,14,27,9,3,59,0
8616,199721,239_09_17,DENMARK,0,TOTALS,DENMARK,200,22,58,37.9,18,43,41.9,4,15,26.7,22,33,66.7,12,18,30,5,18,11,5,3,70,0
8617,199734,239_09_17,ESTONIA,0,TOTALS,ESTONIA,200,29,63,46.0,21,38,55.3,8,25,32.0,9,15,60.0,12,19,31,11,27,10,9,5,75,1
8618,199747,239_09_18,AUSTRIA,0,TOTALS,AUSTRIA,200,27,72,37.5,21,49,42.9,6,23,26.1,16,23,69.6,13,14,27,1,26,17,15,1,76,0
8619,199760,239_09_18,ENGLAND,0,TOTALS,ENGLAND,200,33,57,57.9,26,41,63.4,7,16,43.8,17,24,70.8,11,27,38,8,21,31,10,6,90,1
8620,199773,239_09_19,PORTUGAL,0,TOTALS,PORTUGAL,200,19,58,32.8,11,34,32.4,8,24,33.3,13,19,68.4,11,19,30,6,24,15,8,1,59,0
8621,199786,239_09_19,BELGIUM,0,TOTALS,BELGIUM,200,29,58,50.0,22,35,62.9,7,23,30.4,19,30,63.3,13,27,40,12,20,15,8,4,84,1
8622,199799,239_09_20,POLAND,0,TOTALS,POLAND,200,24,56,42.9,16,37,43.2,8,19,42.1,24,31,77.4,7,33,40,15,22,17,10,3,80,1
8623,199812,239_09_20,FINLAND,0,TOTALS,FINLAND,200,18,63,28.6,12,33,36.4,6,30,20.0,25,33,75.8,8,22,30,4,24,12,10,2,67,0
8624,199825,239_09_21,GEORGIA,0,TOTALS,GEORGIA,200,25,58,43.1,22,43,51.2,3,15,20.0,12,20,60.0,8,25,33,6,23,17,4,2,65,0
8625,199838,239_09_21,NETHERLANDS,0,TOTALS,NETHERLANDS,200,32,78,41.0,26,53,49.1,6,25,24.0,14,21,66.7,19,26,45,6,19,14,8,1,84,1
8626,199851,239_09_22,SWITZERLAND,0,TOTALS,SWITZERLAND,200,26,65,40.0,18,37,48.6,8,28,28.6,20,28,71.4,11,23,34,14,21,14,9,1,80,1
8627,199864,239_09_22,AUSTRIA,0,TOTALS,AUSTRIA,200,22,71,31.0,18,48,37.5,4,23,17.4,16,24,66.7,18,29,47,6,26,19,7,3,64,0
8628,199877,239_09_23,BOSNIA AND HERZEGOVINA,0,TOTALS,BOSNIA AND HERZEGOVINA,200,25,68,36.8,24,62,38.7,1,6,16.7,17,25,68.0,18,24,42,11,22,12,8,0,68,1
8629,199890,239_09_23,BELARUS,0,TOTALS,BELARUS,200,23,62,37.1,18,46,39.1,5,16,31.2,12,23,52.2,18,26,44,4,23,18,8,11,63,0
8630,199903,239_09_24,ICELAND,0,TOTALS,ICELAND,200,30,69,43.5,17,33,51.5,13,36,36.1,7,14,50.0,14,27,41,16,23,13,8,3,80,1
8631,199916,239_09_24,SLOVAK REPUBLIC,0,TOTALS,SLOVAK REPUBLIC,200,19,59,32.2,14,38,36.8,5,21,23.8,14,27,51.9,15,21,36,7,14,14,6,2,57,0
8632,199929,239_09_25,NORWAY,0,TOTALS,NORWAY,200,26,70,37.1,17,46,37.0,9,24,37.5,8,9,88.9,16,17,33,8,13,11,5,1,69,0
8633,199942,239_09_25,DENMARK,0,TOTALS,DENMARK,200,38,72,52.8,29,56,51.8,9,16,56.2,5,7,71.4,16,27,43,7,13,11,4,2,90,1
8634,199955,239_09_26,ESTONIA,0,TOTALS,ESTONIA,200,28,66,42.4,21,41,51.2,7,25,28.0,17,20,85.0,13,19,32,10,26,11,12,4,80,1
8635,199968,239_09_26,HUNGARY,0,TOTALS,HUNGARY,200,26,65,40.0,21,49,42.9,5,16,31.2,14,23,60.9,17,22,39,6,19,17,4,3,71,0
8636,199980,239_09_27,SCOTLAND,0,TOTALS,SCOTLAND,200,32,63,50.8,25,43,58.1,7,20,35.0,17,27,63.0,7,27,34,6,16,10,4,8,88,1
8637,199993,239_09_27,ROMANIA,0,TOTALS,ROMANIA,200,26,68,38.2,18,49,36.7,8,19,42.1,17,23,73.9,13,24,37,2,21,12,4,1,77,0
8638,200006,239_09_28,ENGLAND,0,TOTALS,ENGLAND,200,26,66,39.4,22,50,44.0,4,16,25.0,21,33,63.6,16,32,48,7,9,12,6,4,77,1
8639,200019,239_09_28,SWITZERLAND,0,TOTALS,SWITZERLAND,200,25,69,36.2,18,45,40.0,7,24,29.2,5,6,83.3,10,27,37,8,21,15,4,4,62,0
8640,200032,239_09_29,SWEDEN,0,TOTALS,SWEDEN,200,27,67,40.3,25,53,47.2,2,14,14.3,20,23,87.0,14,34,48,13,13,20,12,2,76,1
8641,200045,239_09_29,ICELAND,0,TOTALS,ICELAND,200,26,66,39.4,19,42,45.2,7,24,29.2,3,5,60.0,6,21,27,9,20,19,10,0,62,0
8642,200058,239_09_30,HUNGARY,0,TOTALS,HUNGARY,200,35,74,47.3,26,50,52.0,9,24,37.5,14,23,60.9,15,31,46,13,11,19,15,5,93,1
8643,200071,239_09_30,NORWAY,0,TOTALS,NORWAY,200,22,66,33.3,18,44,40.9,4,22,18.2,3,8,37.5,15,24,39,6,19,29,12,2,51,0
8644,200084,239_09_31,MONTENEGRO,0,TOTALS,MONTENEGRO,200,34,63,54.0,25,39,64.1,9,24,37.5,23,32,71.9,12,27,39,19,21,17,15,4,100,0
8645,200096,239_09_31,SCOTLAND,0,TOTALS,SCOTLAND,200,18,55,32.7,17,42,40.5,1,13,7.7,7,15,46.7,4,20,24,7,25,22,7,1,44,1
8646,200109,239_09_32,BELARUS,0,TOTALS,BELARUS,200,27,61,44.3,21,46,45.7,6,15,40.0,14,19,73.7,15,26,41,7,19,22,7,2,74,0
8647,200122,239_09_32,ESTONIA,0,TOTALS,ESTONIA,200,27,56,48.2,24,44,54.5,3,12,25.0,18,28,64.3,4,16,20,11,19,14,12,4,75,1
8648,200135,239_09_33,AUSTRIA,0,TOTALS,AUSTRIA,200,33,68,48.5,19,41,46.3,14,27,51.9,9,11,81.8,12,28,40,14,13,7,6,0,89,1
8649,200148,239_09_33,PORTUGAL,0,TOTALS,PORTUGAL,200,25,67,37.3,18,45,40.0,7,22,31.8,9,13,69.2,13,22,35,10,16,10,2,4,66,0
8650,200161,239_09_34,ROMANIA,0,TOTALS,ROMANIA,200,21,54,38.9,20,43,46.5,1,11,9.1,15,25,60.0,6,17,23,4,13,14,11,1,58,0
8651,200174,239_09_34,GEORGIA,0,TOTALS,GEORGIA,200,31,65,47.7,25,46,54.3,6,19,31.6,11,15,73.3,13,29,42,12,23,20,9,6,79,1
8652,200187,239_09_35,DENMARK,0,TOTALS,DENMARK,200,32,68,47.1,29,53,54.7,3,15,20.0,7,17,41.2,14,18,32,10,18,13,1,5,74,0
8653,200200,239_09_35,BOSNIA AND HERZEGOVINA,0,TOTALS,BOSNIA AND HERZEGOVINA,200,30,66,45.5,24,45,53.3,6,21,28.6,14,20,70.0,14,20,34,12,24,11,9,4,80,1
8654,200213,239_09_36,SLOVAK REPUBLIC,0,TOTALS,SLOVAK REPUBLIC,200,24,69,34.8,18,44,40.9,6,25,24.0,14,22,63.6,12,18,30,0,29,16,10,1,68,0
8655,200226,239_09_36,POLAND,0,TOTALS,POLAND,200,28,53,52.8,20,34,58.8,8,19,42.1,21,30,70.0,10,34,44,3,24,26,9,3,85,1
8656,200239,239_09_37,BELGIUM,0,TOTALS,BELGIUM,200,24,63,38.1,19,44,43.2,5,19,26.3,17,23,73.9,15,28,43,14,14,13,3,1,70,1
8657,200252,239_09_37,AUSTRIA,0,TOTALS,AUSTRIA,200,24,59,40.7,20,37,54.1,4,22,18.2,9,9,100.0,7,25,32,6,23,16,5,1,61,0
8658,200265,239_09_38,PORTUGAL,0,TOTALS,PORTUGAL,200,31,75,41.3,27,57,47.4,4,18,22.2,13,22,59.1,17,23,40,18,23,12,8,1,79,0
8659,200278,239_09_38,ENGLAND,0,TOTALS,ENGLAND,200,27,55,49.1,18,37,48.6,9,18,50.0,25,32,78.1,11,31,42,20,21,14,3,3,88,1
8660,200291,239_09_39,POLAND,0,TOTALS,POLAND,200,24,62,38.7,15,35,42.9,9,27,33.3,12,19,63.2,7,16,23,8,16,17,9,5,69,0
8661,200304,239_09_39,SWEDEN,0,TOTALS,SWEDEN,200,29,67,43.3,23,47,48.9,6,20,30.0,17,21,81.0,16,29,45,13,18,21,10,5,81,1
8662,200317,239_09_40,DENMARK,0,TOTALS,DENMARK,200,31,69,44.9,27,60,45.0,4,9,44.4,15,24,62.5,13,29,42,15,16,15,13,7,81,1
8663,200330,239_09_40,BELARUS,0,TOTALS,BELARUS,200,29,83,34.9,23,67,34.3,6,16,37.5,7,11,63.6,28,28,56,8,23,21,8,5,71,0
8664,200343,239_09_41,NETHERLANDS,0,TOTALS,NETHERLANDS,200,33,72,45.8,25,48,52.1,8,24,33.3,9,11,81.8,11,32,43,21,22,20,11,2,83,1
8665,200356,239_09_41,ROMANIA,0,TOTALS,ROMANIA,200,24,66,36.4,16,41,39.0,8,25,32.0,16,26,61.5,12,24,36,14,13,20,11,3,72,0
8666,200369,239_09_42,BOSNIA AND HERZEGOVINA,0,TOTALS,BOSNIA AND HERZEGOVINA,200,29,71,40.8,24,45,53.3,5,26,19.2,12,22,54.5,15,28,43,12,19,16,10,3,75,1
8667,200382,239_09_42,HUNGARY,0,TOTALS,HUNGARY,200,24,61,39.3,15,32,46.9,9,29,31.0,15,23,65.2,10,32,42,14,23,19,8,1,72,0
8668,200395,239_09_43,FINLAND,0,TOTALS,FINLAND,200,30,58,51.7,21,37,56.8,9,21,42.9,14,23,60.9,7,22,29,16,21,15,11,1,83,1
8669,200408,239_09_43,SLOVAK REPUBLIC,0,TOTALS,SLOVAK REPUBLIC,200,21,62,33.9,18,46,39.1,3,16,18.8,12,17,70.6,16,18,34,7,26,22,8,1,57,0
8670,200421,239_09_44,GEORGIA,0,TOTALS,GEORGIA,200,23,57,40.4,19,36,52.8,4,21,19.0,24,34,70.6,13,22,35,9,20,20,8,5,74,0
8671,200434,239_09_44,MONTENEGRO,0,TOTALS,MONTENEGRO,200,37,75,49.3,33,61,54.1,4,14,28.6,7,13,53.8,17,23,40,18,25,17,11,3,85,1
8672,200447,239_09_45,BELARUS,0,TOTALS,BELARUS,200,23,64,35.9,22,55,40.0,1,9,11.1,19,39,48.7,18,36,54,5,21,18,15,5,66,1
8673,200460,239_09_45,SLOVAK REPUBLIC,0,TOTALS,SLOVAK REPUBLIC,200,18,69,26.1,14,47,29.8,4,22,18.2,14,20,70.0,18,32,50,10,27,20,9,8,54,0
8674,200473,239_09_46,HUNGARY,0,TOTALS,HUNGARY,200,27,58,46.6,23,42,54.8,4,16,25.0,19,27,70.4,15,26,41,16,13,22,7,7,77,0
8675,200486,239_09_46,ICELAND,0,TOTALS,ICELAND,200,34,80,42.5,20,44,45.5,14,36,38.9,2,3,66.7,14,21,35,24,19,16,14,0,84,1
8676,200498,239_09_47,SCOTLAND,0,TOTALS,SCOTLAND,200,23,55,41.8,20,45,44.4,3,10,30.0,16,27,59.3,14,30,44,10,11,15,6,5,65,0
8677,200511,239_09_47,AUSTRIA,0,TOTALS,AUSTRIA,200,33,81,40.7,22,48,45.8,11,33,33.3,3,9,33.3,20,23,43,16,18,6,11,1,80,1
8678,200524,239_09_48,DENMARK,0,TOTALS,DENMARK,200,22,57,38.6,19,41,46.3,3,16,18.8,11,18,61.1,6,28,34,14,14,15,10,1,58,0
8679,200537,239_09_48,FINLAND,0,TOTALS,FINLAND,200,22,65,33.8,12,33,36.4,10,32,31.2,10,12,83.3,12,24,36,14,18,14,7,3,64,1
8680,200550,239_09_49,GEORGIA,0,TOTALS,GEORGIA,200,30,79,38.0,21,53,39.6,9,26,34.6,18,26,69.2,20,29,49,14,26,10,6,1,87,0
8681,200563,239_09_49,SWITZERLAND,0,TOTALS,SWITZERLAND,200,31,60,51.7,20,35,57.1,11,25,44.0,18,26,69.2,4,30,34,18,24,9,5,3,91,1
8682,200576,239_09_50,MONTENEGRO,0,TOTALS,MONTENEGRO,200,27,55,49.1,21,38,55.3,6,17,35.3,17,30,56.7,9,29,38,14,19,13,6,2,77,1
8683,200589,239_09_50,BELGIUM,0,TOTALS,BELGIUM,200,21,61,34.4,18,34,52.9,3,27,11.1,18,21,85.7,8,20,28,5,21,13,4,1,63,0
8684,200602,239_09_51,BOSNIA AND HERZEGOVINA,0,TOTALS,BOSNIA AND HERZEGOVINA,200,19,60,31.7,16,42,38.1,3,18,16.7,18,28,64.3,14,30,44,5,22,17,4,5,59,0
8685,200615,239_09_51,POLAND,0,TOTALS,POLAND,200,24,59,40.7,20,36,55.6,4,23,17.4,10,20,50.0,7,32,39,5,26,15,6,5,62,1
8686,200628,239_09_52,NETHERLANDS,0,TOTALS,NETHERLANDS,200,27,76,35.5,22,53,41.5,5,23,21.7,6,14,42.9,13,28,41,11,19,15,11,4,65,0
8687,200641,239_09_52,ENGLAND,0,TOTALS,ENGLAND,200,28,70,40.0,17,44,38.6,11,26,42.3,10,16,62.5,11,29,40,12,17,16,6,5,77,1
8688,200654,239_09_53,ESTONIA,0,TOTALS,ESTONIA,200,23,56,41.1,18,35,51.4,5,21,23.8,4,8,50.0,12,23,35,9,17,14,8,4,55,0
8689,200667,239_09_53,SWEDEN,0,TOTALS,SWEDEN,200,24,69,34.8,15,44,34.1,9,25,36.0,9,11,81.8,23,23,46,13,11,12,7,1,66,1
8690,200680,239_09_54,ROMANIA,0,TOTALS,ROMANIA,200,23,62,37.1,23,49,46.9,0,13,0.0,20,27,74.1,15,29,44,12,17,19,6,3,66,0
8691,200693,239_09_54,PORTUGAL,0,TOTALS,PORTUGAL,200,27,71,38.0,25,50,50.0,2,21,9.5,11,18,61.1,16,26,42,18,20,12,13,5,67,1
8692,200706,239_09_55,SWITZERLAND,0,TOTALS,SWITZERLAND,200,30,64,46.9,15,36,41.7,15,28,53.6,9,17,52.9,6,24,30,20,18,14,10,3,84,1
8693,200718,239_09_55,SCOTLAND,0,TOTALS,SCOTLAND,200,28,63,44.4,23,49,46.9,5,14,35.7,14,19,73.7,8,29,37,8,20,17,5,3,75,0
8694,200731,239_09_56,FINLAND,0,TOTALS,FINLAND,200,27,63,42.9,15,32,46.9,12,31,38.7,13,16,81.2,8,27,35,14,22,17,8,4,79,0
8695,200744,239_09_56,HUNGARY,0,TOTALS,HUNGARY,200,31,76,40.8,24,55,43.6,7,21,33.3,14,22,63.6,21,29,50,12,19,13,10,3,83,1
8696,200757,239_09_57,AUSTRIA,0,TOTALS,AUSTRIA,200,27,55,49.1,23,39,59.0,4,16,25.0,11,16,68.8,9,20,29,13,25,13,6,1,69,0
8697,200770,239_09_57,GEORGIA,0,TOTALS,GEORGIA,200,26,53,49.1,22,33,66.7,4,20,20.0,15,30,50.0,7,15,22,16,18,10,7,4,71,1
8698,200783,239_09_58,ICELAND,0,TOTALS,ICELAND,200,39,91,42.9,23,48,47.9,16,43,37.2,5,9,55.6,17,23,40,15,26,12,15,3,99,1
8699,200796,239_09_58,DENMARK,0,TOTALS,DENMARK,200,27,53,50.9,24,43,55.8,3,10,30.0,23,37,62.2,8,37,45,10,10,23,6,4,80,0
8700,200809,239_09_59,SWEDEN,0,TOTALS,SWEDEN,200,29,70,41.4,24,50,48.0,5,20,25.0,10,17,58.8,20,23,43,12,18,13,8,3,73,1
8701,200822,239_09_59,BOSNIA AND HERZEGOVINA,0,TOTALS,BOSNIA AND HERZEGOVINA,200,25,57,43.9,16,42,38.1,9,15,60.0,12,17,70.6,9,19,28,12,19,17,4,1,71,0
8702,200835,239_09_60,ENGLAND,0,TOTALS,ENGLAND,200,21,64,32.8,18,43,41.9,3,21,14.3,23,26,88.5,11,22,33,7,15,10,11,3,68,0
8703,200848,239_09_60,MONTENEGRO,0,TOTALS,MONTENEGRO,200,31,73,42.5,25,50,50.0,6,23,26.1,9,10,90.0,19,35,54,13,21,18,4,7,77,1
8704,200861,239_09_61,POLAND,0,TOTALS,POLAND,200,25,57,43.9,17,36,47.2,8,21,38.1,18,28,64.3,7,33,40,13,18,15,2,1,76,1
8705,200874,239_09_61,ESTONIA,0,TOTALS,ESTONIA,200,25,69,36.2,13,37,35.1,12,32,37.5,10,17,58.8,11,19,30,13,28,6,6,2,72,0
8706,200887,239_09_62,BELGIUM,0,TOTALS,BELGIUM,200,42,72,58.3,30,49,61.2,12,23,52.2,10,13,76.9,11,33,44,22,11,18,8,7,106,0
8707,200900,239_09_62,NETHERLANDS,0,TOTALS,NETHERLANDS,200,28,67,41.8,21,47,44.7,7,20,35.0,8,14,57.1,8,20,28,12,16,19,7,2,71,1
8708,200913,239_09_63,SLOVAK REPUBLIC,0,TOTALS,SLOVAK REPUBLIC,200,27,71,38.0,24,52,46.2,3,19,15.8,13,20,65.0,13,35,48,6,20,13,9,4,70,0
8709,200926,239_09_63,NORWAY,0,TOTALS,NORWAY,200,26,71,36.6,15,42,35.7,11,29,37.9,13,17,76.5,12,34,46,14,16,15,7,1,76,1
8710,200939,239_09_64,ICELAND,0,TOTALS,ICELAND,200,37,80,46.2,30,53,56.6,7,27,25.9,13,16,81.2,10,26,36,23,22,8,12,3,94,1
8711,200952,239_09_64,GEORGIA,0,TOTALS,GEORGIA,200,20,54,37.0,16,37,43.2,4,17,23.5,21,32,65.6,7,25,32,6,18,21,7,2,65,0
8712,200965,239_09_65,FINLAND,0,TOTALS,FINLAND,200,26,60,43.3,16,36,44.4,10,24,41.7,10,17,58.8,11,35,46,16,17,23,9,2,72,1
8713,200978,239_09_65,AUSTRIA,0,TOTALS,AUSTRIA,200,23,68,33.8,18,42,42.9,5,26,19.2,9,10,90.0,10,24,34,11,20,15,9,2,60,0
8714,200990,239_09_66,SCOTLAND,0,TOTALS,SCOTLAND,200,31,65,47.7,30,53,56.6,1,12,8.3,5,10,50.0,11,31,42,13,20,25,10,2,68,0
8715,201003,239_09_66,DENMARK,0,TOTALS,DENMARK,200,26,64,40.6,19,45,42.2,7,19,36.8,13,24,54.2,10,21,31,17,12,18,14,2,72,1
8716,201016,239_09_67,SWITZERLAND,0,TOTALS,SWITZERLAND,200,24,70,34.3,15,39,38.5,9,31,29.0,12,24,50.0,13,17,30,11,21,15,9,3,69,0
8717,201029,239_09_67,HUNGARY,0,TOTALS,HUNGARY,200,35,69,50.7,27,51,52.9,8,18,44.4,10,16,62.5,19,31,50,13,23,15,4,1,88,1
8718,201042,239_09_68,BOSNIA AND HERZEGOVINA,0,TOTALS,BOSNIA AND HERZEGOVINA,200,32,68,47.1,25,46,54.3,7,22,31.8,14,23,60.9,8,18,26,13,15,17,5,2,85,1
8719,201055,239_09_68,NETHERLANDS,0,TOTALS,NETHERLANDS,200,46,77,59.7,29,42,69.0,17,35,48.6,7,11,63.6,14,27,41,23,21,16,8,0,116,0
8720,201068,239_09_69,SWEDEN,0,TOTALS,SWEDEN,200,34,71,47.9,29,54,53.7,5,17,29.4,8,14,57.1,15,29,44,13,22,10,5,3,81,1
8721,201081,239_09_69,ENGLAND,0,TOTALS,ENGLAND,200,22,57,38.6,18,41,43.9,4,16,25.0,18,26,69.2,10,23,33,8,16,12,3,3,66,0
8722,201094,239_09_70,BELGIUM,0,TOTALS,BELGIUM,200,24,56,42.9,18,40,45.0,6,16,37.5,18,23,78.3,5,21,26,7,13,8,3,2,72,1
8723,201107,239_09_70,ESTONIA,0,TOTALS,ESTONIA,200,21,51,41.2,17,30,56.7,4,21,19.0,5,8,62.5,3,23,26,5,17,17,1,1,51,0
8724,201120,239_09_71,MONTENEGRO,0,TOTALS,MONTENEGRO,200,23,70,32.9,20,53,37.7,3,17,17.6,14,22,63.6,19,35,54,13,19,18,14,8,63,0
8725,201133,239_09_71,POLAND,0,TOTALS,POLAND,200,24,69,34.8,16,43,37.2,8,26,30.8,9,14,64.3,12,31,43,11,21,18,6,6,65,1
8726,201146,239_09_72,BELARUS,0,TOTALS,BELARUS,200,31,66,47.0,25,52,48.1,6,14,42.9,14,24,58.3,15,25,40,14,17,9,12,1,82,1
8727,201159,239_09_72,ROMANIA,0,TOTALS,ROMANIA,200,24,50,48.0,21,40,52.5,3,10,30.0,11,18,61.1,5,22,27,8,17,18,6,1,62,0
8728,201172,239_09_73,ICELAND,0,TOTALS,ICELAND,200,34,78,43.6,22,43,51.2,12,35,34.3,9,15,60.0,23,33,56,19,20,18,10,4,89,1
8729,201185,239_09_73,DENMARK,0,TOTALS,DENMARK,200,24,58,41.4,19,44,43.2,5,14,35.7,16,29,55.2,8,21,29,9,14,17,13,2,69,0
8730,201198,239_09_74,NORWAY,0,TOTALS,NORWAY,200,27,58,46.6,22,38,57.9,5,20,25.0,9,19,47.4,12,26,38,15,20,13,6,1,68,1
8731,201211,239_09_74,PORTUGAL,0,TOTALS,PORTUGAL,200,23,69,33.3,16,42,38.1,7,27,25.9,10,13,76.9,15,20,35,7,18,11,6,1,63,0
8732,201224,239_09_75,AUSTRIA,0,TOTALS,AUSTRIA,200,29,58,50.0,20,32,62.5,9,26,34.6,8,11,72.7,8,26,34,15,17,18,5,2,75,1
8733,201237,239_09_75,SWITZERLAND,0,TOTALS,SWITZERLAND,200,25,58,43.1,20,38,52.6,5,20,25.0,9,18,50.0,13,22,35,8,16,17,7,0,64,0
8734,201250,239_09_76,GEORGIA,0,TOTALS,GEORGIA,200,27,66,40.9,19,44,43.2,8,22,36.4,7,14,50.0,12,29,41,12,21,9,8,6,69,1
8735,201262,239_09_76,SCOTLAND,0,TOTALS,SCOTLAND,200,19,58,32.8,16,49,32.7,3,9,33.3,18,24,75.0,7,28,35,7,13,12,4,1,59,0
8736,201275,239_09_77,NETHERLANDS,0,TOTALS,NETHERLANDS,200,26,60,43.3,21,38,55.3,5,22,22.7,12,16,75.0,8,30,38,14,10,17,4,3,69,0
8737,201288,239_09_77,BELGIUM,0,TOTALS,BELGIUM,200,32,71,45.1,23,46,50.0,9,25,36.0,9,11,81.8,10,27,37,12,13,13,10,5,82,1
8738,201301,239_09_78,FINLAND,0,TOTALS,FINLAND,200,27,61,44.3,16,32,50.0,11,29,37.9,9,11,81.8,11,20,31,16,24,15,7,1,74,0
8739,201314,239_09_78,HUNGARY,0,TOTALS,HUNGARY,200,28,54,51.9,23,43,53.5,5,11,45.5,18,24,75.0,5,22,27,12,17,16,6,0,79,1
8740,201327,239_09_79,ENGLAND,0,TOTALS,ENGLAND,200,24,65,36.9,17,48,35.4,7,17,41.2,16,21,76.2,15,23,38,8,14,13,7,2,71,0
8741,201340,239_09_79,MONTENEGRO,0,TOTALS,MONTENEGRO,200,25,64,39.1,15,38,39.5,10,26,38.5,13,18,72.2,17,29,46,10,20,16,7,1,73,1
8742,201353,239_09_80,BOSNIA AND HERZEGOVINA,0,TOTALS,BOSNIA AND HERZEGOVINA,200,17,50,34.0,10,30,33.3,7,20,35.0,22,27,81.5,6,17,23,9,16,21,9,1,63,0
8743,201366,239_09_80,ESTONIA,0,TOTALS,ESTONIA,200,31,64,48.4,25,36,69.4,6,28,21.4,13,17,76.5,15,24,39,11,24,15,16,0,81,1
8744,201379,239_09_81,SWEDEN,0,TOTALS,SWEDEN,200,36,75,48.0,29,55,52.7,7,20,35.0,8,17,47.1,11,30,41,16,15,11,12,5,87,1
8745,201392,239_09_81,POLAND,0,TOTALS,POLAND,200,28,65,43.1,21,39,53.8,7,26,26.9,8,16,50.0,9,34,43,12,19,19,8,4,71,0
8746,201405,240_09_01,MOLDOVA,0,TOTALS,MOLDOVA,200,31,84,36.9,29,62,46.8,2,22,9.1,3,10,30.0,23,29,52,12,18,26,14,3,67,1
8747,201415,240_09_01,PRINCIPALITY OF MONACO,0,TOTALS,PRINCIPALITY OF MONACO,200,25,56,44.6,22,43,51.2,3,13,23.1,11,17,64.7,8,32,40,12,17,33,12,7,64,0
8748,201428,240_09_02,ANDORRA,0,TOTALS,ANDORRA,200,25,86,29.1,23,58,39.7,2,28,7.1,12,23,52.2,24,20,44,9,25,18,20,1,64,0
8749,201441,240_09_02,GIBRALTAR,0,TOTALS,GIBRALTAR,200,30,61,49.2,28,51,54.9,2,10,20.0,17,23,73.9,14,42,56,10,24,34,6,2,79,1
8750,201454,240_09_03,MALTA,0,TOTALS,MALTA,200,29,59,49.2,27,48,56.2,2,11,18.2,16,35,45.7,14,46,60,12,15,33,10,7,76,1
8751,201467,240_09_03,SAN MARINO,0,TOTALS,SAN MARINO,200,27,89,30.3,20,63,31.7,7,26,26.9,5,11,45.5,17,24,41,10,29,17,19,1,66,0
8752,201480,240_09_04,GIBRALTAR,0,TOTALS,GIBRALTAR,200,25,62,40.3,23,45,51.1,2,17,11.8,11,29,37.9,19,44,63,11,20,31,4,12,63,1
8753,201493,240_09_04,WALES,0,TOTALS,WALES,200,22,90,24.4,16,56,28.6,6,34,17.6,5,12,41.7,23,28,51,12,29,16,15,0,55,0
8754,201506,240_09_05,SAN MARINO,0,TOTALS,SAN MARINO,200,21,71,29.6,16,47,34.0,5,24,20.8,9,14,64.3,12,24,36,8,26,18,12,1,56,0
8755,201519,240_09_05,MOLDOVA,0,TOTALS,MOLDOVA,200,28,67,41.8,24,56,42.9,4,11,36.4,17,33,51.5,23,41,64,10,16,27,11,6,77,1
8756,201529,240_09_06,PRINCIPALITY OF MONACO,0,TOTALS,PRINCIPALITY OF MONACO,200,16,61,26.2,13,47,27.7,3,14,21.4,14,27,51.9,10,24,34,7,22,18,15,7,49,0
8757,201542,240_09_06,MALTA,0,TOTALS,MALTA,200,34,82,41.5,32,65,49.2,2,17,11.8,10,29,34.5,32,40,72,13,19,20,10,4,80,1
8758,201555,240_09_07,WALES,0,TOTALS,WALES,200,22,74,29.7,17,58,29.3,5,16,31.2,16,35,45.7,26,32,58,14,33,24,12,1,65,0
8759,201568,240_09_07,ANDORRA,0,TOTALS,ANDORRA,200,24,65,36.9,21,53,39.6,3,12,25.0,26,45,57.8,14,36,50,11,25,18,7,6,77,1
8760,201578,240_09_08,PRINCIPALITY OF MONACO,0,TOTALS,PRINCIPALITY OF MONACO,200,26,59,44.1,24,51,47.1,2,8,25.0,25,48,52.1,17,38,55,10,29,31,15,9,79,1
8761,201591,240_09_08,SAN MARINO,0,TOTALS,SAN MARINO,200,23,79,29.1,18,49,36.7,5,30,16.7,21,30,70.0,21,26,47,8,32,24,15,3,72,0
8762,201604,240_09_09,MALTA,0,TOTALS,MALTA,200,24,66,36.4,22,52,42.3,2,14,14.3,11,27,40.7,27,43,70,7,8,19,6,5,61,1
8763,201617,240_09_09,MOLDOVA,0,TOTALS,MOLDOVA,200,16,78,20.5,11,54,20.4,5,24,20.8,2,9,22.2,23,23,46,7,25,9,8,7,39,0
8764,201627,240_09_10,PRINCIPALITY OF MONACO,0,TOTALS,PRINCIPALITY OF MONACO,200,18,64,28.1,17,56,30.4,1,8,12.5,20,34,58.8,11,22,33,9,17,29,21,3,57,0
8765,201640,240_09_10,WALES,0,TOTALS,WALES,200,37,82,45.1,28,57,49.1,9,25,36.0,10,16,62.5,25,45,70,25,29,35,18,4,93,1
8766,201653,240_09_11,MALTA,0,TOTALS,MALTA,200,39,77,50.6,38,66,57.6,1,11,9.1,23,41,56.1,20,43,63,12,17,23,6,9,102,0
8767,201666,240_09_11,ANDORRA,0,TOTALS,ANDORRA,200,31,91,34.1,18,55,32.7,13,36,36.1,9,16,56.2,18,25,43,21,27,11,9,4,84,1
8768,201679,240_09_12,GIBRALTAR,0,TOTALS,GIBRALTAR,200,22,67,32.8,17,49,34.7,5,18,27.8,10,21,47.6,15,41,56,5,19,24,8,7,59,1
8769,201692,240_09_12,MOLDOVA,0,TOTALS,MOLDOVA,200,16,71,22.5,10,48,20.8,6,23,26.1,19,26,73.1,15,34,49,10,20,15,9,5,57,0
8770,201705,240_09_13,WALES,0,TOTALS,WALES,200,42,78,53.8,38,70,54.3,4,8,50.0,17,30,56.7,19,32,51,23,28,30,18,2,105,0
8771,201718,240_09_13,SAN MARINO,0,TOTALS,SAN MARINO,200,28,70,40.0,24,52,46.2,4,18,22.2,21,35,60.0,17,21,38,13,24,31,15,8,81,1
8772,201731,240_09_14,ANDORRA,0,TOTALS,ANDORRA,200,28,80,35.0,22,53,41.5,6,27,22.2,14,32,43.8,19,35,54,15,26,21,10,2,76,1
8773,201744,240_09_14,MOLDOVA,0,TOTALS,MOLDOVA,200,24,65,36.9,20,50,40.0,4,15,26.7,19,40,47.5,19,40,59,7,25,31,16,3,71,0
8774,201757,240_09_15,MALTA,0,TOTALS,MALTA,200,27,73,37.0,21,45,46.7,6,28,21.4,15,23,65.2,30,39,69,7,15,22,10,5,75,1
8775,201770,240_09_15,GIBRALTAR,0,TOTALS,GIBRALTAR,200,15,62,24.2,14,37,37.8,1,25,4.0,7,10,70.0,7,20,27,8,18,16,10,4,38,0
8776,205204,244_09_01,CZECH REPUBLIC,0,TOTALS,CZECH REPUBLIC,200,26,66,39.4,18,47,38.3,8,19,42.1,4,10,40.0,14,23,37,13,19,19,10,2,64,0
8777,205217,244_09_01,GERMANY,0,TOTALS,GERMANY,200,28,61,45.9,20,41,48.8,8,20,40.0,11,17,64.7,11,27,38,12,16,20,14,2,75,1
8778,205230,244_09_02,ISRAEL,0,TOTALS,ISRAEL,200,29,65,44.6,24,48,50.0,5,17,29.4,18,27,66.7,14,33,47,13,21,17,13,5,81,1
8779,205243,244_09_02,MONTENEGRO,0,TOTALS,MONTENEGRO,200,26,75,34.7,21,54,38.9,5,21,23.8,9,13,69.2,18,23,41,9,27,19,9,3,66,0
8780,205256,244_09_03,SPAIN,0,TOTALS,SPAIN,225,22,63,34.9,14,32,43.8,8,31,25.8,14,20,70.0,13,27,40,12,31,17,11,3,66,1
8781,205269,244_09_03,CROATIA,0,TOTALS,CROATIA,225,17,48,35.4,10,26,38.5,7,22,31.8,23,38,60.5,9,29,38,9,25,21,8,3,64,0
8782,205282,244_09_04,TURKEY,0,TOTALS,TURKEY,200,26,68,38.2,24,53,45.3,2,15,13.3,15,23,65.2,23,28,51,15,18,14,11,2,69,1
8783,205295,244_09_04,ITALY,0,TOTALS,ITALY,200,23,59,39.0,17,37,45.9,6,22,27.3,7,13,53.8,10,23,33,8,20,15,6,1,59,0
8784,205308,244_09_05,LATVIA,0,TOTALS,LATVIA,200,31,70,44.3,23,42,54.8,8,28,28.6,10,20,50.0,16,40,56,17,17,15,7,5,80,1
8785,205321,244_09_05,UKRAINE,0,TOTALS,UKRAINE,200,20,70,28.6,14,50,28.0,6,20,30.0,14,18,77.8,12,28,40,12,24,11,6,3,60,0
8786,205334,244_09_06,LITHUANIA,0,TOTALS,LITHUANIA,200,22,69,31.9,13,32,40.6,9,37,24.3,17,25,68.0,14,34,48,14,19,16,8,6,70,0
8787,205347,244_09_06,RUSSIA,0,TOTALS,RUSSIA,200,33,84,39.3,29,65,44.6,4,19,21.1,10,17,58.8,21,36,57,12,21,14,8,8,80,1
8788,205360,244_09_07,GREECE,0,TOTALS,GREECE,200,23,64,35.9,16,37,43.2,7,27,25.9,16,25,64.0,10,23,33,14,21,13,11,4,69,0
8789,205373,244_09_07,POLAND,0,TOTALS,POLAND,200,28,69,40.6,23,42,54.8,5,27,18.5,15,23,65.2,21,35,56,11,21,22,9,4,76,1
8790,205386,244_09_08,SERBIA,0,TOTALS,SERBIA,200,30,71,42.3,23,44,52.3,7,27,25.9,7,10,70.0,14,25,39,14,16,15,9,1,74,0
8791,205399,244_09_08,FRANCE,0,TOTALS,FRANCE,200,32,68,47.1,20,42,47.6,12,26,46.2,11,11,100.0,8,27,35,19,13,11,9,0,87,1
8792,205412,244_09_09,MONTENEGRO,0,TOTALS,MONTENEGRO,200,21,71,29.6,12,34,35.3,9,37,24.3,13,26,50.0,23,25,48,10,20,19,9,7,64,0
8793,205425,244_09_09,TURKEY,0,TOTALS,TURKEY,200,30,69,43.5,28,50,56.0,2,19,10.5,12,18,66.7,14,33,47,17,20,19,10,7,74,1
8794,205438,244_09_10,GERMANY,0,TOTALS,GERMANY,200,12,47,25.5,8,30,26.7,4,17,23.5,12,17,70.6,9,25,34,5,16,21,7,3,40,0
8795,205451,244_09_10,SPAIN,0,TOTALS,SPAIN,200,32,66,48.5,26,49,53.1,6,17,35.3,9,11,81.8,10,27,37,14,16,12,10,1,79,1
8796,205464,244_09_11,RUSSIA,0,TOTALS,RUSSIA,200,29,68,42.6,25,47,53.2,4,21,19.0,14,21,66.7,19,24,43,16,19,17,12,8,76,1
8797,205477,244_09_11,GREECE,0,TOTALS,GREECE,200,20,61,32.8,19,43,44.2,1,18,5.6,11,18,61.1,17,24,41,7,20,23,8,2,52,0
8798,205490,244_09_12,FRANCE,0,TOTALS,FRANCE,200,32,64,50.0,25,44,56.8,7,20,35.0,19,26,73.1,12,27,39,12,16,13,11,2,90,1
8799,205503,244_09_12,LATVIA,0,TOTALS,LATVIA,200,25,58,43.1,10,33,30.3,15,25,60.0,11,15,73.3,5,22,27,17,17,15,7,1,76,0
8800,205516,244_09_13,POLAND,0,TOTALS,POLAND,200,28,77,36.4,22,53,41.5,6,24,25.0,5,16,31.2,27,31,58,17,18,22,12,5,67,1
8801,205529,244_09_13,LITHUANIA,0,TOTALS,LITHUANIA,200,25,65,38.5,18,40,45.0,7,25,28.0,7,14,50.0,11,27,38,12,21,18,14,4,64,0
8802,205542,244_09_14,UKRAINE,0,TOTALS,UKRAINE,200,21,60,35.0,12,38,31.6,9,22,40.9,10,15,66.7,11,28,39,13,27,23,8,6,61,0
8803,205555,244_09_14,SERBIA,0,TOTALS,SERBIA,200,31,79,39.2,27,57,47.4,4,22,18.2,16,29,55.2,28,26,54,14,20,16,12,1,82,1
8804,205568,244_09_15,ITALY,0,TOTALS,ITALY,200,35,73,47.9,26,56,46.4,9,17,52.9,11,22,50.0,13,32,45,10,16,13,12,5,90,1
8805,205581,244_09_15,ISRAEL,0,TOTALS,ISRAEL,200,23,75,30.7,14,47,29.8,9,28,32.1,9,16,56.2,19,27,46,13,20,22,9,4,64,0
8806,205594,244_09_16,CROATIA,0,TOTALS,CROATIA,200,23,62,37.1,12,23,52.2,11,39,28.2,13,18,72.2,13,25,38,19,25,22,11,3,70,1
8807,205607,244_09_16,CZECH REPUBLIC,0,TOTALS,CZECH REPUBLIC,200,24,56,42.9,15,31,48.4,9,25,36.0,11,16,68.8,10,27,37,11,21,20,7,1,68,0
8808,205620,244_09_17,RUSSIA,0,TOTALS,RUSSIA,200,34,77,44.2,25,54,46.3,9,23,39.1,16,20,80.0,17,26,43,16,17,10,16,2,93,1
8809,205633,244_09_17,POLAND,0,TOTALS,POLAND,200,24,60,40.0,16,35,45.7,8,25,32.0,15,19,78.9,12,27,39,14,22,24,5,3,71,0
8810,205646,244_09_18,FRANCE,0,TOTALS,FRANCE,200,33,75,44.0,26,50,52.0,7,25,28.0,8,12,66.7,21,43,64,21,8,19,11,5,81,1
8811,205659,244_09_18,UKRAINE,0,TOTALS,UKRAINE,200,15,71,21.1,12,43,27.9,3,28,10.7,7,9,77.8,10,23,33,7,14,16,8,5,40,0
8812,205672,244_09_19,ITALY,0,TOTALS,ITALY,200,32,71,45.1,26,50,52.0,6,21,28.6,4,8,50.0,17,20,37,20,21,22,15,3,74,0
8813,205685,244_09_19,MONTENEGRO,0,TOTALS,MONTENEGRO,200,26,61,42.6,17,39,43.6,9,22,40.9,19,25,76.0,16,20,36,13,16,20,15,3,80,1
8814,205698,244_09_20,LATVIA,0,TOTALS,LATVIA,200,25,63,39.7,15,44,34.1,10,19,52.6,25,37,67.6,15,30,45,13,23,24,10,8,85,1
8815,205711,244_09_20,SERBIA,0,TOTALS,SERBIA,200,26,72,36.1,21,47,44.7,5,25,20.0,18,25,72.0,17,26,43,15,30,24,18,8,75,0
8816,205724,244_09_21,GREECE,0,TOTALS,GREECE,200,27,63,42.9,19,42,45.2,8,21,38.1,9,17,52.9,9,23,32,13,26,13,9,1,71,0
8817,205736,244_09_21,LITHUANIA,0,TOTALS,LITHUANIA,200,24,65,36.9,17,37,45.9,7,28,25.0,23,31,74.2,20,30,50,12,20,15,4,3,78,1
8818,205749,244_09_22,CZECH REPUBLIC,0,TOTALS,CZECH REPUBLIC,200,21,52,40.4,12,31,38.7,9,21,42.9,9,14,64.3,7,25,32,13,19,32,10,7,60,0
8819,205762,244_09_22,SPAIN,0,TOTALS,SPAIN,200,33,80,41.2,24,48,50.0,9,32,28.1,13,20,65.0,23,24,47,22,18,21,20,3,88,1
8820,205775,244_09_23,ISRAEL,0,TOTALS,ISRAEL,200,23,61,37.7,17,43,39.5,6,18,33.3,19,23,82.6,8,18,26,10,21,18,10,1,71,0
8821,205788,244_09_23,TURKEY,0,TOTALS,TURKEY,200,34,63,54.0,28,45,62.2,6,18,33.3,19,25,76.0,14,30,44,22,23,24,10,3,93,1
8822,205801,244_09_24,CROATIA,0,TOTALS,CROATIA,200,27,66,40.9,15,40,37.5,12,26,46.2,11,17,64.7,17,26,43,15,16,10,12,0,77,1
8823,205814,244_09_24,GERMANY,0,TOTALS,GERMANY,200,14,52,26.9,11,33,33.3,3,19,15.8,9,15,60.0,15,23,38,5,19,23,3,5,40,0
8824,205827,244_09_25,ISRAEL,0,TOTALS,ISRAEL,200,33,79,41.8,28,58,48.3,5,21,23.8,11,18,61.1,21,33,54,16,28,22,15,2,82,1
8825,205840,244_09_25,UKRAINE,0,TOTALS,UKRAINE,200,25,73,34.2,21,56,37.5,4,17,23.5,20,35,57.1,22,27,49,10,21,22,12,3,74,0
8826,205853,244_09_26,GREECE,0,TOTALS,GREECE,200,30,63,47.6,20,36,55.6,10,27,37.0,12,19,63.2,12,28,40,19,17,19,18,5,82,1
8827,205866,244_09_26,CZECH REPUBLIC,0,TOTALS,CZECH REPUBLIC,200,16,52,30.8,11,31,35.5,5,21,23.8,9,17,52.9,11,25,36,8,22,30,6,1,46,0
8828,205879,244_09_27,POLAND,0,TOTALS,POLAND,200,25,58,43.1,21,39,53.8,4,19,21.1,5,10,50.0,15,35,50,16,8,21,3,3,59,1
8829,205892,244_09_27,ITALY,0,TOTALS,ITALY,200,20,68,29.4,12,42,28.6,8,26,30.8,5,6,83.3,10,18,28,8,14,7,11,1,53,0
8830,205905,244_09_28,LATVIA,0,TOTALS,LATVIA,200,21,66,31.8,20,52,38.5,1,14,7.1,13,18,72.2,8,32,40,6,21,12,7,2,56,0
8831,205918,244_09_28,CROATIA,0,TOTALS,CROATIA,200,31,70,44.3,24,50,48.0,7,20,35.0,15,23,65.2,12,39,51,20,22,11,10,5,84,1
8832,205931,244_09_29,LITHUANIA,0,TOTALS,LITHUANIA,200,20,46,43.5,14,27,51.9,6,19,31.6,20,34,58.8,11,35,46,9,23,22,6,7,66,1
8833,205944,244_09_29,TURKEY,0,TOTALS,TURKEY,200,15,63,23.8,8,41,19.5,7,22,31.8,10,18,55.6,16,22,38,9,27,17,14,3,47,0
8834,205957,244_09_30,SERBIA,0,TOTALS,SERBIA,200,32,65,49.2,29,52,55.8,3,13,23.1,23,32,71.9,13,22,35,11,27,14,9,5,90,0
8835,205970,244_09_30,SPAIN,0,TOTALS,SPAIN,200,31,57,54.4,19,36,52.8,12,21,57.1,18,29,62.1,9,18,27,18,26,16,8,2,92,1
8836,205983,244_09_31,MONTENEGRO,0,TOTALS,MONTENEGRO,200,19,68,27.9,13,40,32.5,6,28,21.4,12,25,48.0,21,19,40,9,17,24,12,2,56,0
8837,205996,244_09_31,RUSSIA,0,TOTALS,RUSSIA,200,38,77,49.4,30,55,54.5,8,22,36.4,8,14,57.1,25,32,57,17,23,19,15,4,92,1
8838,206009,244_09_32,GERMANY,0,TOTALS,GERMANY,200,14,50,28.0,10,32,31.2,4,18,22.2,10,18,55.6,12,31,43,7,19,31,12,2,42,0
8839,206022,244_09_32,FRANCE,0,TOTALS,FRANCE,200,20,60,33.3,18,46,39.1,2,14,14.3,14,18,77.8,11,26,37,4,17,16,19,3,56,1
8840,206035,244_09_33,TURKEY,0,TOTALS,TURKEY,200,25,71,35.2,21,53,39.6,4,18,22.2,7,16,43.8,15,27,42,11,21,11,11,2,61,0
8841,206048,244_09_33,POLAND,0,TOTALS,POLAND,200,26,60,43.3,18,39,46.2,8,21,38.1,10,20,50.0,12,34,46,12,16,16,5,6,70,1
8842,206061,244_09_34,SERBIA,0,TOTALS,SERBIA,200,36,68,52.9,34,59,57.6,2,9,22.2,20,25,80.0,12,28,40,11,25,18,17,6,94,1
8843,206074,244_09_34,GERMANY,0,TOTALS,GERMANY,200,24,65,36.9,22,45,48.9,2,20,10.0,15,23,65.2,15,22,37,10,22,26,9,0,65,0
8844,206087,244_09_35,LITHUANIA,0,TOTALS,LITHUANIA,200,31,55,56.4,22,38,57.9,9,17,52.9,4,5,80.0,6,33,39,21,9,32,11,7,75,1
8845,206100,244_09_35,MONTENEGRO,0,TOTALS,MONTENEGRO,200,29,81,35.8,25,57,43.9,4,24,16.7,3,7,42.9,20,18,38,7,13,19,18,3,65,0
8846,206113,244_09_36,SPAIN,0,TOTALS,SPAIN,200,18,69,26.1,12,39,30.8,6,30,20.0,16,19,84.2,19,20,39,9,22,19,8,2,58,0
8847,206126,244_09_36,LATVIA,0,TOTALS,LATVIA,200,31,67,46.3,23,42,54.8,8,25,32.0,15,20,75.0,17,33,50,14,22,19,12,8,85,1
8848,206139,244_09_37,ITALY,0,TOTALS,ITALY,200,22,66,33.3,14,46,30.4,8,20,40.0,12,17,70.6,15,16,31,8,13,22,15,2,64,0
8849,206152,244_09_37,RUSSIA,0,TOTALS,RUSSIA,200,38,66,57.6,33,49,67.3,5,17,29.4,10,13,76.9,11,31,42,24,16,21,15,4,91,1
8850,206165,244_09_38,CROATIA,0,TOTALS,CROATIA,200,23,56,41.1,18,30,60.0,5,26,19.2,8,11,72.7,15,24,39,9,22,20,3,2,59,0
8851,206178,244_09_38,FRANCE,0,TOTALS,FRANCE,200,25,58,43.1,15,36,41.7,10,22,45.5,10,16,62.5,11,18,29,14,17,12,12,4,70,1
8852,206191,244_09_39,CZECH REPUBLIC,0,TOTALS,CZECH REPUBLIC,200,20,69,29.0,15,48,31.2,5,21,23.8,12,14,85.7,12,32,44,7,12,21,9,2,57,0
8853,206204,244_09_39,ISRAEL,0,TOTALS,ISRAEL,200,33,78,42.3,22,44,50.0,11,34,32.4,5,10,50.0,14,37,51,20,16,17,16,14,82,1
8854,206217,244_09_40,UKRAINE,0,TOTALS,UKRAINE,200,25,70,35.7,14,40,35.0,11,30,36.7,6,10,60.0,13,21,34,13,17,14,9,6,67,0
8855,206230,244_09_40,GREECE,0,TOTALS,GREECE,200,31,55,56.4,24,39,61.5,7,16,43.8,13,18,72.2,6,34,40,20,15,17,8,3,82,1
8856,206243,244_09_41,POLAND,0,TOTALS,POLAND,200,31,75,41.3,24,49,49.0,7,26,26.9,3,5,60.0,19,26,45,10,12,21,8,1,72,0
8857,206256,244_09_41,MONTENEGRO,0,TOTALS,MONTENEGRO,200,30,72,41.7,24,45,53.3,6,27,22.2,9,12,75.0,17,24,41,12,12,17,12,5,75,1
8858,206269,244_09_42,LATVIA,0,TOTALS,LATVIA,200,24,66,36.4,19,46,41.3,5,20,25.0,10,18,55.6,9,30,39,6,17,16,10,7,63,0
8859,206282,244_09_42,GERMANY,0,TOTALS,GERMANY,200,22,65,33.8,15,40,37.5,7,25,28.0,18,22,81.8,13,35,48,10,23,17,10,2,69,1
8860,206295,244_09_43,ITALY,0,TOTALS,ITALY,200,30,64,46.9,24,45,53.3,6,19,31.6,5,8,62.5,9,19,28,12,19,17,14,4,71,1
8861,206308,244_09_43,LITHUANIA,0,TOTALS,LITHUANIA,200,26,59,44.1,22,35,62.9,4,24,16.7,13,22,59.1,17,28,45,15,10,24,13,2,69,0
8862,206321,244_09_44,CROATIA,0,TOTALS,CROATIA,200,24,62,38.7,19,42,45.2,5,20,25.0,13,20,65.0,9,26,35,13,24,13,5,2,66,0
8863,206334,244_09_44,SERBIA,0,TOTALS,SERBIA,200,28,66,42.4,24,53,45.3,4,13,30.8,15,25,60.0,15,31,46,8,22,11,8,3,75,1
8864,206347,244_09_45,RUSSIA,0,TOTALS,RUSSIA,200,25,54,46.3,16,32,50.0,9,22,40.9,8,10,80.0,8,22,30,16,14,24,8,5,67,0
8865,206360,244_09_45,TURKEY,0,TOTALS,TURKEY,200,30,69,43.5,20,47,42.6,10,22,45.5,8,12,66.7,17,24,41,15,14,18,17,3,78,1
8866,206373,244_09_46,FRANCE,0,TOTALS,FRANCE,200,27,62,43.5,25,50,50.0,2,12,16.7,12,23,52.2,11,31,42,12,17,16,2,2,68,1
8867,206386,244_09_46,SPAIN,0,TOTALS,SPAIN,200,26,64,40.6,24,44,54.5,2,20,10.0,10,21,47.6,11,25,36,10,27,12,5,3,64,0
8868,206399,244_09_47,ISRAEL,0,TOTALS,ISRAEL,200,29,58,50.0,23,39,59.0,6,19,31.6,21,27,77.8,10,32,42,13,19,25,12,0,85,1
8869,206412,244_09_47,GREECE,0,TOTALS,GREECE,200,30,72,41.7,23,52,44.2,7,20,35.0,9,14,64.3,12,20,32,14,22,20,12,0,76,0
8870,206425,244_09_48,RUSSIA,0,TOTALS,RUSSIA,225,28,83,33.7,22,56,39.3,6,27,22.2,28,38,73.7,16,34,50,14,25,12,7,11,90,0
8871,206438,244_09_48,SERBIA,0,TOTALS,SERBIA,225,34,79,43.0,26,52,50.0,8,27,29.6,19,30,63.3,16,42,58,19,34,21,6,9,95,1
8872,206451,244_09_49,CZECH REPUBLIC,0,TOTALS,CZECH REPUBLIC,200,19,56,33.9,15,36,41.7,4,20,20.0,12,17,70.6,10,29,39,8,16,23,2,3,54,0
8873,206464,244_09_49,UKRAINE,0,TOTALS,UKRAINE,200,32,70,45.7,27,50,54.0,5,20,25.0,5,8,62.5,11,29,40,14,15,13,12,3,74,1
8874,206477,244_09_50,POLAND,0,TOTALS,POLAND,200,18,54,33.3,15,33,45.5,3,21,14.3,12,15,80.0,6,41,47,3,19,19,7,4,51,1
8875,206490,244_09_50,CROATIA,0,TOTALS,CROATIA,200,15,72,20.8,9,36,25.0,6,36,16.7,10,16,62.5,18,30,48,5,15,13,12,1,46,0
8876,206503,244_09_51,MONTENEGRO,0,TOTALS,MONTENEGRO,200,23,57,40.4,19,34,55.9,4,23,17.4,4,6,66.7,11,21,32,14,16,23,17,5,54,1
8877,206516,244_09_51,GERMANY,0,TOTALS,GERMANY,200,19,53,35.8,15,38,39.5,4,15,26.7,6,13,46.2,15,24,39,5,12,27,8,1,48,0
8878,206529,244_09_52,FRANCE,0,TOTALS,FRANCE,200,18,70,25.7,11,44,25.0,7,26,26.9,17,18,94.4,19,27,46,8,21,17,12,2,60,0
8879,206542,244_09_52,LITHUANIA,0,TOTALS,LITHUANIA,200,25,61,41.0,20,39,51.3,5,22,22.7,13,22,59.1,12,33,45,9,17,17,11,9,68,1
8880,206555,244_09_53,LATVIA,0,TOTALS,LATVIA,200,29,62,46.8,23,46,50.0,6,16,37.5,9,13,69.2,15,36,51,18,14,26,5,3,73,1
8881,206568,244_09_53,ITALY,0,TOTALS,ITALY,200,31,76,40.8,26,53,49.1,5,23,21.7,5,9,55.6,9,21,30,14,18,9,16,3,72,0
8882,206581,244_09_54,SPAIN,0,TOTALS,SPAIN,200,20,52,38.5,14,30,46.7,6,22,27.3,11,19,57.9,14,26,40,13,10,25,11,2,57,1
8883,206594,244_09_54,TURKEY,0,TOTALS,TURKEY,200,17,55,30.9,14,39,35.9,3,16,18.8,4,8,50.0,13,21,34,6,19,24,15,0,41,0
8884,206607,244_09_55,FRANCE,0,TOTALS,FRANCE,200,18,56,32.1,15,33,45.5,3,23,13.0,10,15,66.7,16,20,36,7,15,26,6,0,49,0
8885,206620,244_09_55,CROATIA,0,TOTALS,CROATIA,200,31,60,51.7,20,38,52.6,11,22,50.0,6,8,75.0,10,23,33,22,15,18,13,3,79,1
8886,206633,244_09_56,RUSSIA,0,TOTALS,RUSSIA,200,26,53,49.1,18,30,60.0,8,23,34.8,17,24,70.8,14,23,37,15,14,27,12,6,77,1
8887,206645,244_09_56,TURKEY,0,TOTALS,TURKEY,200,24,66,36.4,19,50,38.0,5,16,31.2,8,12,66.7,18,13,31,11,24,22,17,0,61,0
8888,206658,244_09_57,LITHUANIA,0,TOTALS,LITHUANIA,200,27,72,37.5,18,48,37.5,9,24,37.5,7,13,53.8,14,25,39,11,20,7,9,6,70,1
8889,206671,244_09_57,POLAND,0,TOTALS,POLAND,200,23,61,37.7,15,37,40.5,8,24,33.3,9,16,56.2,17,32,49,11,15,20,2,6,63,0
8890,206684,244_09_58,SERBIA,0,TOTALS,SERBIA,200,27,58,46.6,19,41,46.3,8,17,47.1,13,22,59.1,12,23,35,7,25,21,9,3,75,0
8891,206697,244_09_58,SPAIN,0,TOTALS,SPAIN,200,31,62,50.0,24,44,54.5,7,18,38.9,19,25,76.0,9,21,30,18,22,15,11,1,88,1
8892,206710,244_09_59,GERMANY,0,TOTALS,GERMANY,200,20,54,37.0,16,36,44.4,4,18,22.2,11,14,78.6,12,33,45,12,12,24,8,2,55,1
8893,206723,244_09_59,ITALY,0,TOTALS,ITALY,200,22,65,33.8,17,45,37.8,5,20,25.0,4,9,44.4,11,23,34,7,12,14,14,3,53,0
8894,206736,244_09_60,TURKEY,0,TOTALS,TURKEY,200,27,59,45.8,19,38,50.0,8,21,38.1,4,7,57.1,6,17,23,11,9,15,8,1,66,0
8895,206749,244_09_60,FRANCE,0,TOTALS,FRANCE,200,33,65,50.8,26,44,59.1,7,21,33.3,6,8,75.0,15,28,43,17,9,17,10,2,79,1
8896,206762,244_09_61,MONTENEGRO,0,TOTALS,MONTENEGRO,200,27,72,37.5,20,45,44.4,7,27,25.9,8,15,53.3,15,19,34,8,20,15,12,1,69,0
8897,206775,244_09_61,LATVIA,0,TOTALS,LATVIA,200,31,63,49.2,29,47,61.7,2,16,12.5,12,18,66.7,14,33,47,16,11,20,9,2,76,1
8898,206788,244_09_62,RUSSIA,0,TOTALS,RUSSIA,200,31,70,44.3,24,48,50.0,7,22,31.8,14,21,66.7,11,21,32,15,24,10,10,6,83,1
8899,206801,244_09_62,CROATIA,0,TOTALS,CROATIA,200,25,62,40.3,16,35,45.7,9,27,33.3,20,27,74.1,21,31,52,10,25,19,6,1,79,0
8900,206814,244_09_63,SERBIA,0,TOTALS,SERBIA,200,29,69,42.0,23,48,47.9,6,21,28.6,11,18,61.1,13,31,44,13,21,14,9,4,75,1
8901,206827,244_09_63,POLAND,0,TOTALS,POLAND,200,27,69,39.1,23,51,45.1,4,18,22.2,11,20,55.0,14,31,45,18,18,16,9,5,69,0
8902,206840,244_09_64,SPAIN,0,TOTALS,SPAIN,200,25,62,40.3,18,43,41.9,7,19,36.8,13,19,68.4,14,29,43,9,24,14,10,1,70,1
8903,206853,244_09_64,LITHUANIA,0,TOTALS,LITHUANIA,200,24,64,37.5,20,49,40.8,4,15,26.7,12,20,60.0,13,25,38,6,21,16,7,3,64,0
8904,206866,245_09_01,IRELAND,0,TOTALS,IRELAND,200,30,77,39.0,21,46,45.7,9,31,29.0,9,17,52.9,13,27,40,12,23,20,9,1,78,0
8905,206879,245_09_01,GEORGIA,0,TOTALS,GEORGIA,200,34,70,48.6,28,50,56.0,6,20,30.0,12,29,41.4,10,28,38,14,19,17,12,7,86,1
8906,206892,245_09_02,BULGARIA,0,TOTALS,BULGARIA,200,37,77,48.1,30,45,66.7,7,32,21.9,6,19,31.6,12,24,36,18,11,8,11,3,87,1
8907,206905,245_09_02,ROMANIA,0,TOTALS,ROMANIA,200,28,65,43.1,25,48,52.1,3,17,17.6,5,7,71.4,10,27,37,7,17,20,5,2,64,0
8908,206918,245_09_03,SWEDEN,0,TOTALS,SWEDEN,200,43,72,59.7,34,50,68.0,9,22,40.9,13,18,72.2,12,36,48,12,15,7,9,0,108,0
8909,206931,245_09_03,LUXEMBOURG,0,TOTALS,LUXEMBOURG,200,19,54,35.2,11,29,37.9,8,25,32.0,8,12,66.7,3,20,23,12,17,7,3,0,54,1
8910,206944,245_09_04,NETHERLANDS,0,TOTALS,NETHERLANDS,200,27,67,40.3,21,42,50.0,6,25,24.0,10,16,62.5,11,19,30,16,24,28,17,4,70,0
8911,206957,245_09_04,SLOVAK REPUBLIC,0,TOTALS,SLOVAK REPUBLIC,200,31,59,52.5,29,47,61.7,2,12,16.7,16,34,47.1,12,20,32,14,18,22,16,3,80,1
8912,206970,245_09_05,SWITZERLAND,0,TOTALS,SWITZERLAND,200,24,58,41.4,17,39,43.6,7,19,36.8,14,22,63.6,8,19,27,6,25,22,7,2,69,0
8913,206983,245_09_05,PORTUGAL,0,TOTALS,PORTUGAL,200,34,67,50.7,29,46,63.0,5,21,23.8,17,26,65.4,9,21,30,17,22,12,15,3,90,1
8914,206996,245_09_06,BELARUS,0,TOTALS,BELARUS,200,22,41,53.7,19,29,65.5,3,12,25.0,16,30,53.3,10,29,39,19,23,11,7,0,63,1
8915,207009,245_09_06,SLOVENIA,0,TOTALS,SLOVENIA,200,35,59,59.3,28,44,63.6,7,15,46.7,23,32,71.9,16,27,43,19,29,12,11,0,100,0
8916,207022,245_09_07,ENGLAND,0,TOTALS,ENGLAND,200,30,70,42.9,22,42,52.4,8,28,28.6,12,13,92.3,10,23,33,16,17,13,11,2,80,1
8917,207035,245_09_07,HUNGARY,0,TOTALS,HUNGARY,200,26,71,36.6,23,63,36.5,3,8,37.5,17,21,81.0,16,27,43,12,14,17,7,5,72,0
8918,207048,245_09_08,FINLAND,0,TOTALS,FINLAND,200,31,68,45.6,24,42,57.1,7,26,26.9,8,12,66.7,9,21,30,11,20,23,12,3,77,0
8919,207061,245_09_08,DENMARK,0,TOTALS,DENMARK,200,34,74,45.9,27,58,46.6,7,16,43.8,9,19,47.4,19,28,47,17,15,26,15,2,84,1
8920,207074,245_09_09,BELGIUM,0,TOTALS,BELGIUM,200,29,56,51.8,21,37,56.8,8,19,42.1,16,28,57.1,12,22,34,13,25,13,4,0,82,1
8921,207087,245_09_09,SWITZERLAND,0,TOTALS,SWITZERLAND,200,25,53,47.2,16,35,45.7,9,18,50.0,15,28,53.6,14,18,32,15,26,13,8,0,74,0
8922,207100,245_09_10,AUSTRIA,0,TOTALS,AUSTRIA,200,22,71,31.0,16,49,32.7,6,22,27.3,2,7,28.6,10,23,33,13,18,21,19,1,52,0
8923,207113,245_09_10,BELARUS,0,TOTALS,BELARUS,200,23,57,40.4,18,38,47.4,5,19,26.3,10,18,55.6,7,26,33,14,12,22,11,5,61,1
8924,207126,245_09_11,PORTUGAL,0,TOTALS,PORTUGAL,200,28,60,46.7,19,35,54.3,9,25,36.0,7,14,50.0,8,36,44,18,23,16,2,0,72,0
8925,207139,245_09_11,BULGARIA,0,TOTALS,BULGARIA,200,33,72,45.8,27,50,54.0,6,22,27.3,19,27,70.4,7,26,33,10,18,4,8,0,91,1
8926,207152,245_09_12,SLOVENIA,0,TOTALS,SLOVENIA,200,27,60,45.0,17,35,48.6,10,25,40.0,8,11,72.7,4,20,24,12,20,17,12,2,72,1
8927,207165,245_09_12,SWEDEN,0,TOTALS,SWEDEN,200,27,65,41.5,20,47,42.6,7,18,38.9,9,16,56.2,13,21,34,9,11,20,14,4,70,0
8928,207178,245_09_13,HUNGARY,0,TOTALS,HUNGARY,200,29,68,42.6,23,49,46.9,6,19,31.6,23,30,76.7,12,20,32,17,19,19,16,1,87,1
8929,207191,245_09_13,NETHERLANDS,0,TOTALS,NETHERLANDS,200,29,56,51.8,19,33,57.6,10,23,43.5,9,15,60.0,4,18,22,15,26,26,11,2,77,0
8930,207204,245_09_14,SWEDEN,0,TOTALS,SWEDEN,200,31,61,50.8,21,38,55.3,10,23,43.5,8,18,44.4,13,20,33,21,12,19,16,4,80,1
8931,207217,245_09_14,AUSTRIA,0,TOTALS,AUSTRIA,200,18,53,34.0,17,40,42.5,1,13,7.7,4,6,66.7,7,13,20,6,17,27,10,3,41,0
8932,207230,245_09_15,DENMARK,0,TOTALS,DENMARK,200,33,67,49.3,27,53,50.9,6,14,42.9,4,8,50.0,16,33,49,12,19,19,3,0,76,1
8933,207243,245_09_15,GEORGIA,0,TOTALS,GEORGIA,200,20,57,35.1,11,28,39.3,9,29,31.0,12,21,57.1,9,19,28,7,16,20,7,1,61,0
8934,207256,245_09_16,ROMANIA,0,TOTALS,ROMANIA,200,27,72,37.5,25,59,42.4,2,13,15.4,11,19,57.9,14,23,37,4,17,13,14,6,67,1
8935,207269,245_09_16,PORTUGAL,0,TOTALS,PORTUGAL,200,23,65,35.4,18,41,43.9,5,24,20.8,7,13,53.8,18,29,47,12,18,25,4,6,58,0
8936,207282,245_09_17,LUXEMBOURG,0,TOTALS,LUXEMBOURG,200,20,57,35.1,15,32,46.9,5,25,20.0,6,11,54.5,7,16,23,6,22,30,13,3,51,0
8937,207295,245_09_17,SLOVENIA,0,TOTALS,SLOVENIA,200,35,64,54.7,26,46,56.5,9,18,50.0,12,18,66.7,10,26,36,22,14,22,19,1,91,1
8938,207308,245_09_18,BULGARIA,0,TOTALS,BULGARIA,200,26,56,46.4,20,33,60.6,6,23,26.1,10,15,66.7,9,26,35,10,14,18,9,2,68,1
8939,207321,245_09_18,BELGIUM,0,TOTALS,BELGIUM,200,23,66,34.8,19,46,41.3,4,20,20.0,4,6,66.7,13,22,35,10,17,15,8,0,54,0
8940,207334,245_09_19,SLOVAK REPUBLIC,0,TOTALS,SLOVAK REPUBLIC,200,22,63,34.9,15,42,35.7,7,21,33.3,11,15,73.3,11,24,35,9,30,37,11,2,62,0
8941,207347,245_09_19,ENGLAND,0,TOTALS,ENGLAND,200,30,64,46.9,22,43,51.2,8,21,38.1,28,42,66.7,8,22,30,13,19,21,26,3,96,1
8942,207360,245_09_20,FINLAND,0,TOTALS,FINLAND,200,34,70,48.6,22,46,47.8,12,24,50.0,6,10,60.0,7,35,42,13,20,23,2,3,86,1
8943,207373,245_09_20,IRELAND,0,TOTALS,IRELAND,200,24,75,32.0,19,50,38.0,5,25,20.0,16,22,72.7,15,25,40,8,19,23,4,0,69,0
8944,207386,245_09_21,SWITZERLAND,0,TOTALS,SWITZERLAND,200,27,68,39.7,24,56,42.9,3,12,25.0,11,18,61.1,13,29,42,11,19,16,5,3,68,0
8945,207399,245_09_21,BULGARIA,0,TOTALS,BULGARIA,200,34,83,41.0,28,53,52.8,6,30,20.0,13,16,81.2,15,25,40,14,15,7,7,3,87,1
8946,207412,245_09_22,BELARUS,0,TOTALS,BELARUS,200,26,70,37.1,13,42,31.0,13,28,46.4,4,7,57.1,14,22,36,12,20,24,8,0,69,0
8947,207425,245_09_22,SWEDEN,0,TOTALS,SWEDEN,200,31,66,47.0,26,53,49.1,5,13,38.5,13,22,59.1,15,26,41,11,14,19,13,3,80,1
8948,207438,245_09_23,BELGIUM,0,TOTALS,BELGIUM,200,21,67,31.3,17,47,36.2,4,20,20.0,11,15,73.3,13,19,32,12,24,16,10,0,57,0
8949,207451,245_09_23,ROMANIA,0,TOTALS,ROMANIA,200,22,58,37.9,20,44,45.5,2,14,14.3,15,26,57.7,16,21,37,7,18,16,8,4,61,1
8950,207464,245_09_24,AUSTRIA,0,TOTALS,AUSTRIA,250,31,87,35.6,20,54,37.0,11,33,33.3,10,27,37.0,25,39,64,15,23,26,9,2,83,1
8951,207477,245_09_24,LUXEMBOURG,0,TOTALS,LUXEMBOURG,250,27,72,37.5,16,43,37.2,11,29,37.9,13,22,59.1,6,33,39,9,23,23,10,1,78,0
8952,207490,245_09_25,DENMARK,0,TOTALS,DENMARK,200,30,82,36.6,23,58,39.7,7,24,29.2,4,5,80.0,16,26,42,18,18,23,17,6,71,1
8953,207503,245_09_25,IRELAND,0,TOTALS,IRELAND,200,20,60,33.3,17,37,45.9,3,23,13.0,16,18,88.9,4,31,35,4,14,27,14,0,59,0
8954,207516,245_09_26,GEORGIA,0,TOTALS,GEORGIA,200,12,60,20.0,5,32,15.6,7,28,25.0,1,10,10.0,8,22,30,8,23,21,14,7,32,0
8955,207529,245_09_26,FINLAND,0,TOTALS,FINLAND,200,22,66,33.3,15,48,31.2,7,18,38.9,15,23,65.2,14,38,52,12,14,21,12,2,66,1
8956,207542,245_09_27,ROMANIA,0,TOTALS,ROMANIA,200,29,70,41.4,22,49,44.9,7,21,33.3,6,11,54.5,13,28,41,16,21,23,12,2,71,0
8957,207555,245_09_27,SWITZERLAND,0,TOTALS,SWITZERLAND,200,28,73,38.4,22,53,41.5,6,20,30.0,16,23,69.6,12,19,31,13,12,13,12,5,78,1
8958,207568,245_09_28,LUXEMBOURG,0,TOTALS,LUXEMBOURG,200,25,57,43.9,19,38,50.0,6,19,31.6,20,31,64.5,5,33,38,8,14,21,6,3,76,1
8959,207581,245_09_28,BELARUS,0,TOTALS,BELARUS,200,29,82,35.4,23,54,42.6,6,28,21.4,11,14,78.6,16,30,46,11,26,15,13,4,75,0
8960,207594,245_09_29,NETHERLANDS,0,TOTALS,NETHERLANDS,200,27,59,45.8,17,36,47.2,10,23,43.5,5,8,62.5,6,20,26,9,8,28,3,2,69,0
8961,207607,245_09_29,ENGLAND,0,TOTALS,ENGLAND,200,36,66,54.5,27,45,60.0,9,21,42.9,7,8,87.5,11,24,35,14,10,17,12,2,88,1
8962,207620,245_09_30,PORTUGAL,0,TOTALS,PORTUGAL,200,22,56,39.3,17,33,51.5,5,23,21.7,7,19,36.8,12,22,34,12,15,22,12,2,56,1
8963,207633,245_09_30,BELGIUM,0,TOTALS,BELGIUM,200,20,64,31.2,14,34,41.2,6,30,20.0,5,8,62.5,12,21,33,7,22,18,15,0,51,0
8964,207646,245_09_31,SLOVENIA,0,TOTALS,SLOVENIA,200,35,64,54.7,31,49,63.3,4,15,26.7,6,10,60.0,12,29,41,14,24,20,9,3,80,1
8965,207659,245_09_31,AUSTRIA,0,TOTALS,AUSTRIA,200,20,59,33.9,17,41,41.5,3,18,16.7,12,24,50.0,9,16,25,9,17,16,8,2,55,0
8966,207672,245_09_32,HUNGARY,0,TOTALS,HUNGARY,200,34,80,42.5,31,52,59.6,3,28,10.7,16,22,72.7,18,24,42,14,19,13,2,3,87,1
8967,207685,245_09_32,SLOVAK REPUBLIC,0,TOTALS,SLOVAK REPUBLIC,200,29,59,49.2,18,33,54.5,11,26,42.3,7,15,46.7,6,27,33,13,27,23,2,3,76,0
8968,207698,245_09_33,DENMARK,0,TOTALS,DENMARK,200,24,68,35.3,20,53,37.7,4,15,26.7,11,19,57.9,13,24,37,10,8,17,12,1,63,1
8969,207711,245_09_33,ROMANIA,0,TOTALS,ROMANIA,200,27,64,42.2,23,39,59.0,4,25,16.0,2,5,40.0,8,22,30,10,20,20,15,8,60,0
8970,207724,245_09_34,GEORGIA,0,TOTALS,GEORGIA,225,21,49,42.9,15,23,65.2,6,26,23.1,18,31,58.1,4,25,29,10,20,32,13,3,66,0
8971,207737,245_09_34,BELGIUM,0,TOTALS,BELGIUM,225,24,76,31.6,15,45,33.3,9,31,29.0,13,13,100.0,19,25,44,9,27,29,14,0,70,1
8972,207750,245_09_35,FINLAND,0,TOTALS,FINLAND,200,21,70,30.0,12,31,38.7,9,39,23.1,4,12,33.3,10,27,37,11,11,13,7,0,55,0
8973,207763,245_09_35,BULGARIA,0,TOTALS,BULGARIA,200,31,70,44.3,22,43,51.2,9,27,33.3,2,3,66.7,9,34,43,11,15,16,10,3,73,1
8974,207776,245_09_36,IRELAND,0,TOTALS,IRELAND,200,26,69,37.7,18,39,46.2,8,30,26.7,9,19,47.4,7,32,39,12,39,26,6,1,69,0
8975,207789,245_09_36,PORTUGAL,0,TOTALS,PORTUGAL,200,25,61,41.0,22,43,51.2,3,18,16.7,28,50,56.0,5,37,42,12,19,20,13,2,81,1
8976,207802,245_09_37,SLOVENIA,0,TOTALS,SLOVENIA,200,32,56,57.1,29,40,72.5,3,16,18.8,24,35,68.6,9,26,35,20,22,19,9,1,91,1
8977,207815,245_09_37,HUNGARY,0,TOTALS,HUNGARY,200,24,61,39.3,22,42,52.4,2,19,10.5,19,30,63.3,10,15,25,12,30,17,6,0,69,0
8978,207828,245_09_38,BELARUS,0,TOTALS,BELARUS,200,27,64,42.2,23,43,53.5,4,21,19.0,14,24,58.3,12,27,39,8,22,28,11,6,72,1
8979,207841,245_09_38,NETHERLANDS,0,TOTALS,NETHERLANDS,200,27,71,38.0,26,50,52.0,1,21,4.8,14,25,56.0,11,28,39,10,20,21,11,5,69,0
8980,207854,245_09_39,SWEDEN,0,TOTALS,SWEDEN,200,31,70,44.3,23,51,45.1,8,19,42.1,10,17,58.8,8,19,27,11,15,9,9,1,80,0
8981,207867,245_09_39,ENGLAND,0,TOTALS,ENGLAND,200,33,66,50.0,24,44,54.5,9,22,40.9,6,15,40.0,15,27,42,13,15,17,7,6,81,1
8982,207880,245_09_40,LUXEMBOURG,0,TOTALS,LUXEMBOURG,200,23,60,38.3,15,36,41.7,8,24,33.3,12,19,63.2,13,17,30,8,17,27,12,1,66,0
8983,207893,245_09_40,SLOVAK REPUBLIC,0,TOTALS,SLOVAK REPUBLIC,200,36,70,51.4,34,59,57.6,2,11,18.2,10,17,58.8,14,25,39,13,20,21,15,1,84,1
8984,207906,245_09_41,BULGARIA,0,TOTALS,BULGARIA,200,24,68,35.3,14,32,43.8,10,36,27.8,6,11,54.5,9,20,29,9,12,13,13,5,64,0
8985,207919,245_09_41,DENMARK,0,TOTALS,DENMARK,200,30,65,46.2,21,41,51.2,9,24,37.5,6,10,60.0,9,29,38,15,14,19,9,0,75,1
8986,207932,245_09_42,PORTUGAL,0,TOTALS,PORTUGAL,200,21,67,31.3,13,44,29.5,8,23,34.8,14,18,77.8,13,22,35,10,27,15,10,0,64,0
8987,207945,245_09_42,GEORGIA,0,TOTALS,GEORGIA,200,27,57,47.4,20,36,55.6,7,21,33.3,24,35,68.6,9,28,37,12,17,15,9,8,85,1
8988,207958,245_09_43,ROMANIA,0,TOTALS,ROMANIA,200,30,62,48.4,22,41,53.7,8,21,38.1,8,12,66.7,8,18,26,14,18,17,13,4,76,0
8989,207971,245_09_43,FINLAND,0,TOTALS,FINLAND,200,30,59,50.8,19,34,55.9,11,25,44.0,7,11,63.6,3,18,21,15,19,20,9,3,78,1
8990,207984,245_09_44,BELGIUM,0,TOTALS,BELGIUM,200,30,80,37.5,22,49,44.9,8,31,25.8,9,17,52.9,22,21,43,16,19,17,14,3,77,1
8991,207997,245_09_44,IRELAND,0,TOTALS,IRELAND,200,18,46,39.1,14,30,46.7,4,16,25.0,8,21,38.1,7,22,29,7,18,30,12,2,48,0
8992,208010,245_09_45,ENGLAND,0,TOTALS,ENGLAND,200,22,61,36.1,18,44,40.9,4,17,23.5,8,16,50.0,10,22,32,8,11,22,8,1,56,0
8993,208023,245_09_45,SLOVENIA,0,TOTALS,SLOVENIA,200,32,66,48.5,27,48,56.2,5,18,27.8,3,7,42.9,6,19,25,18,14,15,16,4,72,1
8994,208036,245_09_46,SLOVAK REPUBLIC,0,TOTALS,SLOVAK REPUBLIC,200,24,73,32.9,18,47,38.3,6,26,23.1,10,14,71.4,18,30,48,12,13,22,8,4,64,0
8995,208049,245_09_46,BELARUS,0,TOTALS,BELARUS,200,29,70,41.4,19,44,43.2,10,26,38.5,7,10,70.0,9,26,35,16,15,14,12,10,75,1
8996,208062,245_09_47,SWITZERLAND,0,TOTALS,SWITZERLAND,200,25,58,43.1,19,41,46.3,6,17,35.3,12,23,52.2,12,25,37,10,21,17,5,5,68,1
8997,208075,245_09_47,AUSTRIA,0,TOTALS,AUSTRIA,200,25,62,40.3,21,50,42.0,4,12,33.3,10,21,47.6,11,20,31,8,21,15,10,4,64,0
8998,208088,245_09_48,HUNGARY,0,TOTALS,HUNGARY,200,35,70,50.0,30,48,62.5,5,22,22.7,5,10,50.0,8,19,27,12,18,27,17,3,80,0
8999,208101,245_09_48,SWEDEN,0,TOTALS,SWEDEN,200,32,63,50.8,17,40,42.5,15,23,65.2,7,11,63.6,7,25,32,21,11,23,11,3,86,1
9000,208114,245_09_49,NETHERLANDS,0,TOTALS,NETHERLANDS,200,24,67,35.8,14,37,37.8,10,30,33.3,14,18,77.8,14,23,37,15,12,13,5,3,72,0
9001,208127,245_09_49,LUXEMBOURG,0,TOTALS,LUXEMBOURG,200,30,64,46.9,19,37,51.4,11,27,40.7,4,10,40.0,9,27,36,13,18,13,4,4,75,1
9002,208140,245_09_50,FINLAND,0,TOTALS,FINLAND,200,24,65,36.9,17,39,43.6,7,26,26.9,10,12,83.3,6,30,36,7,15,17,10,2,65,1
9003,208153,245_09_50,HUNGARY,0,TOTALS,HUNGARY,200,25,70,35.7,20,50,40.0,5,20,25.0,9,12,75.0,10,34,44,10,19,16,8,7,64,0
9004,208166,245_09_51,GEORGIA,0,TOTALS,GEORGIA,200,26,56,46.4,21,43,48.8,5,13,38.5,7,12,58.3,11,24,35,15,18,19,12,1,64,1
9005,208179,245_09_51,SLOVAK REPUBLIC,0,TOTALS,SLOVAK REPUBLIC,200,19,56,33.9,15,37,40.5,4,19,21.1,13,16,81.2,10,13,23,12,19,16,6,3,55,0
9006,208192,245_09_52,PORTUGAL,0,TOTALS,PORTUGAL,200,28,74,37.8,21,51,41.2,7,23,30.4,13,18,72.2,13,19,32,13,26,14,13,1,76,1
9007,208205,245_09_52,NETHERLANDS,0,TOTALS,NETHERLANDS,200,24,49,49.0,19,32,59.4,5,17,29.4,18,29,62.1,5,24,29,11,19,22,9,4,71,0
9008,208218,245_09_53,SWEDEN,0,TOTALS,SWEDEN,200,35,69,50.7,27,47,57.4,8,22,36.4,7,14,50.0,15,21,36,17,10,18,9,5,85,1
9009,208231,245_09_53,ROMANIA,0,TOTALS,ROMANIA,200,29,64,45.3,23,47,48.9,6,17,35.3,6,9,66.7,12,20,32,12,16,23,11,4,70,0
9010,208244,245_09_54,LUXEMBOURG,0,TOTALS,LUXEMBOURG,200,20,67,29.9,16,47,34.0,4,20,20.0,15,31,48.4,14,28,42,5,19,27,10,4,59,0
9011,208257,245_09_54,IRELAND,0,TOTALS,IRELAND,200,35,79,44.3,29,59,49.2,6,20,30.0,11,17,64.7,16,34,50,13,29,18,14,2,87,1
9012,208270,245_09_55,BELARUS,0,TOTALS,BELARUS,200,21,52,40.4,14,35,40.0,7,17,41.2,7,10,70.0,2,29,31,5,30,29,3,1,56,0
9013,208283,245_09_55,BELGIUM,0,TOTALS,BELGIUM,200,24,68,35.3,20,42,47.6,4,26,15.4,21,31,67.7,15,27,42,12,16,15,15,0,73,1
9014,208296,245_09_56,DENMARK,0,TOTALS,DENMARK,200,37,68,54.4,32,51,62.7,5,17,29.4,3,5,60.0,4,42,46,12,15,23,4,6,82,1
9015,208309,245_09_56,ENGLAND,0,TOTALS,ENGLAND,200,22,75,29.3,16,51,31.4,6,24,25.0,6,14,42.9,8,17,25,5,11,12,13,6,56,0
9016,208322,245_09_57,SLOVENIA,0,TOTALS,SLOVENIA,200,25,76,32.9,17,45,37.8,8,31,25.8,5,10,50.0,16,20,36,12,15,19,12,3,63,0
9017,208335,245_09_57,BULGARIA,0,TOTALS,BULGARIA,200,36,69,52.2,30,42,71.4,6,27,22.2,9,11,81.8,9,33,42,16,12,18,11,11,87,1
9018,208348,245_09_58,AUSTRIA,0,TOTALS,AUSTRIA,200,25,47,53.2,21,37,56.8,4,10,40.0,8,21,38.1,10,21,31,7,17,22,10,1,62,1
9019,208361,245_09_58,SWITZERLAND,0,TOTALS,SWITZERLAND,200,24,61,39.3,18,41,43.9,6,20,30.0,5,10,50.0,12,16,28,7,19,15,13,1,59,0
9020,208374,245_09_59,PORTUGAL,0,TOTALS,PORTUGAL,200,39,77,50.6,30,50,60.0,9,27,33.3,8,13,61.5,17,27,44,12,21,21,14,1,95,1
9021,208387,245_09_59,IRELAND,0,TOTALS,IRELAND,200,24,56,42.9,19,38,50.0,5,18,27.8,13,23,56.5,5,20,25,14,18,25,10,1,66,0
9022,208400,245_09_60,HUNGARY,0,TOTALS,HUNGARY,200,21,59,35.6,18,45,40.0,3,14,21.4,10,15,66.7,16,28,44,13,15,22,11,1,55,1
9023,208413,245_09_60,ROMANIA,0,TOTALS,ROMANIA,200,22,65,33.8,20,42,47.6,2,23,8.7,4,8,50.0,11,17,28,13,17,15,14,7,50,0
9024,208426,245_09_61,NETHERLANDS,0,TOTALS,NETHERLANDS,200,36,73,49.3,32,55,58.2,4,18,22.2,27,46,58.7,26,29,55,15,15,18,15,5,103,0
9025,208439,245_09_61,LUXEMBOURG,0,TOTALS,LUXEMBOURG,200,22,61,36.1,18,45,40.0,4,16,25.0,7,16,43.8,16,20,36,8,34,30,5,6,55,1
9026,208452,245_09_62,SLOVAK REPUBLIC,0,TOTALS,SLOVAK REPUBLIC,200,26,62,41.9,22,43,51.2,4,19,21.1,9,18,50.0,14,28,42,14,18,20,7,7,65,0
9027,208465,245_09_62,BELARUS,0,TOTALS,BELARUS,200,24,69,34.8,19,53,35.8,5,16,31.2,17,24,70.8,11,19,30,10,18,10,11,3,70,1
9028,208478,245_09_63,FINLAND,0,TOTALS,FINLAND,200,22,59,37.3,16,41,39.0,6,18,33.3,9,11,81.8,5,24,29,11,20,18,11,0,59,0
9029,208491,245_09_63,SWEDEN,0,TOTALS,SWEDEN,200,32,72,44.4,25,51,49.0,7,21,33.3,10,18,55.6,16,22,38,18,9,17,15,4,81,1
9030,208504,245_09_64,GEORGIA,0,TOTALS,GEORGIA,200,17,54,31.5,14,34,41.2,3,20,15.0,15,28,53.6,7,22,29,6,17,28,8,4,52,0
9031,208517,245_09_64,BELGIUM,0,TOTALS,BELGIUM,200,27,64,42.2,25,50,50.0,2,14,14.3,9,20,45.0,14,29,43,13,25,25,15,3,65,1
9032,208530,245_09_65,ENGLAND,0,TOTALS,ENGLAND,200,23,57,40.4,16,40,40.0,7,17,41.2,25,34,73.5,13,22,35,14,16,18,11,3,78,1
9033,208543,245_09_65,SLOVENIA,0,TOTALS,SLOVENIA,200,25,69,36.2,20,47,42.6,5,22,22.7,8,11,72.7,11,24,35,13,30,21,13,2,63,0
9034,208556,245_09_66,DENMARK,0,TOTALS,DENMARK,200,26,61,42.6,19,45,42.2,7,16,43.8,4,16,25.0,8,23,31,18,10,21,8,3,63,0
9035,208569,245_09_66,BULGARIA,0,TOTALS,BULGARIA,200,31,69,44.9,21,38,55.3,10,31,32.3,9,12,75.0,9,26,35,18,16,18,15,3,81,1
9036,212090,248_09_01,AUSTRALIA,0,TOTALS,AUSTRALIA,200,31,66,47.0,22,48,45.8,9,18,50.0,13,23,56.5,6,25,31,14,20,10,4,6,84,1
9037,212103,248_09_01,NEW ZEALAND,0,TOTALS,NEW ZEALAND,200,28,72,38.9,21,56,37.5,7,16,43.8,14,24,58.3,15,30,45,13,16,16,2,0,77,0
9038,212114,248_09_02,NEW ZEALAND,0,TOTALS,NEW ZEALAND,200,36,60,60.0,29,49,59.2,7,11,63.6,21,32,65.6,9,32,41,21,21,17,4,3,100,0
9039,212126,248_09_02,AUSTRALIA,0,TOTALS,AUSTRALIA,200,29,70,41.4,26,47,55.3,3,23,13.0,17,26,65.4,12,18,30,13,25,11,8,4,78,1
9040,212189,250_09_01,AUSTRALIA,0,TOTALS,AUSTRALIA,200,31,71,43.7,26,44,59.1,5,27,18.5,7,13,53.8,21,31,52,9,20,15,8,1,74,1
9041,212202,250_09_01,NEW ZEALAND,0,TOTALS,NEW ZEALAND,200,15,48,31.2,9,25,36.0,6,23,26.1,9,25,36.0,8,18,26,4,17,19,4,4,45,0
9042,212214,250_09_02,NEW ZEALAND,0,TOTALS,NEW ZEALAND,200,23,46,50.0,12,26,46.2,11,20,55.0,12,24,50.0,3,26,29,11,25,22,1,1,69,1
9043,212227,250_09_02,AUSTRALIA,0,TOTALS,AUSTRALIA,200,22,72,30.6,15,42,35.7,7,30,23.3,16,28,57.1,27,22,49,10,22,15,8,1,67,0
9044,212240,250_09_03,AUSTRALIA,0,TOTALS,AUSTRALIA,200,24,59,40.7,22,42,52.4,2,17,11.8,15,26,57.7,12,28,40,10,25,24,13,2,65,1
9045,212252,250_09_03,NEW ZEALAND,0,TOTALS,NEW ZEALAND,200,14,46,30.4,7,23,30.4,7,23,30.4,20,28,71.4,5,24,29,4,17,23,7,4,55,0
9046,212335,252_10_01,GREECE,0,TOTALS,GREECE,200,29,68,42.6,16,29,55.2,13,39,33.3,18,22,81.8,14,28,42,13,23,11,2,3,89,1
9047,212348,252_10_01,CHINA,0,TOTALS,CHINA,200,25,60,41.7,18,43,41.9,7,17,41.2,24,35,68.6,9,28,37,10,20,10,6,2,81,0
9048,212361,252_10_02,NEW ZEALAND,0,TOTALS,NEW ZEALAND,200,26,65,40.0,22,40,55.0,4,25,16.0,23,32,71.9,14,24,38,13,28,11,9,2,79,0
9049,212374,252_10_02,LITHUANIA,0,TOTALS,LITHUANIA,200,32,58,55.2,28,42,66.7,4,16,25.0,24,38,63.2,11,24,35,18,23,13,4,3,92,1
9050,212387,252_10_03,AUSTRALIA,0,TOTALS,AUSTRALIA,200,30,58,51.7,26,39,66.7,4,19,21.1,12,16,75.0,9,26,35,11,14,13,3,3,76,1
9051,212400,252_10_03,JORDAN,0,TOTALS,JORDAN,200,29,70,41.4,20,45,44.4,9,25,36.0,8,12,66.7,16,21,37,16,20,9,5,1,75,0
9052,212413,252_10_04,TUNISIA,0,TOTALS,TUNISIA,200,21,62,33.9,16,42,38.1,5,20,25.0,9,15,60.0,16,19,35,5,15,12,3,3,56,0
9053,212426,252_10_04,SLOVENIA,0,TOTALS,SLOVENIA,200,31,57,54.4,22,32,68.8,9,25,36.0,9,12,75.0,9,27,36,17,20,12,6,2,80,1
9054,212439,252_10_05,RUSSIA,0,TOTALS,RUSSIA,200,22,57,38.6,16,35,45.7,6,22,27.3,25,32,78.1,9,29,38,21,19,9,2,3,75,1
9055,212452,252_10_05,PUERTO RICO,0,TOTALS,PUERTO RICO,200,24,62,38.7,20,41,48.8,4,21,19.0,14,19,73.7,8,29,37,10,26,11,4,3,66,0
9056,212465,252_10_06,CANADA,0,TOTALS,CANADA,200,27,63,42.9,17,33,51.5,10,30,33.3,7,11,63.6,11,26,37,17,26,14,3,4,71,0
9057,212478,252_10_06,LEBANON,0,TOTALS,LEBANON,200,25,60,41.7,16,39,41.0,9,21,42.9,22,32,68.8,12,25,37,10,11,10,8,2,81,1
9058,212491,252_10_07,ANGOLA,0,TOTALS,ANGOLA,200,18,55,32.7,16,44,36.4,2,11,18.2,6,11,54.5,7,18,25,5,18,17,5,3,44,0
9059,212502,252_10_07,SERBIA,0,TOTALS,SERBIA,200,34,71,47.9,23,41,56.1,11,30,36.7,15,22,68.2,19,30,49,26,13,8,5,5,94,1
9060,212515,252_10_08,USA,0,TOTALS,USA,200,41,74,55.4,29,44,65.9,12,30,40.0,12,22,54.5,14,25,39,22,21,7,8,3,106,0
9061,212528,252_10_08,CROATIA,0,TOTALS,CROATIA,200,31,71,43.7,23,47,48.9,8,24,33.3,8,19,42.1,16,25,41,9,25,12,4,2,78,1
9062,212541,252_10_09,COTE D'IVOIRE,0,TOTALS,COTE D'IVOIRE,200,17,61,27.9,12,41,29.3,5,20,25.0,8,12,66.7,11,27,38,7,20,21,5,7,47,0
9063,212554,252_10_09,TURKEY,0,TOTALS,TURKEY,200,29,67,43.3,17,44,38.6,12,23,52.2,16,26,61.5,14,33,47,21,13,13,15,4,86,1
9064,212567,252_10_10,FRANCE,0,TOTALS,FRANCE,200,23,49,46.9,17,31,54.8,6,18,33.3,20,27,74.1,4,30,34,15,28,20,8,5,72,1
9065,212580,252_10_10,SPAIN,0,TOTALS,SPAIN,200,20,55,36.4,11,31,35.5,9,24,37.5,17,32,53.1,9,23,32,9,23,13,9,0,66,0
9066,212593,252_10_11,GERMANY,0,TOTALS,GERMANY,200,26,56,46.4,16,35,45.7,10,21,47.6,12,15,80.0,7,29,36,17,27,18,6,3,74,0
9067,212606,252_10_11,ARGENTINA,0,TOTALS,ARGENTINA,200,23,52,44.2,16,34,47.1,7,18,38.9,25,34,73.5,5,24,29,11,18,11,8,2,78,1
9068,212619,252_10_12,IRAN,0,TOTALS,IRAN,200,26,62,41.9,21,47,44.7,5,15,33.3,8,13,61.5,12,22,34,7,19,17,6,7,65,0
9069,212632,252_10_12,BRAZIL,0,TOTALS,BRAZIL,200,30,64,46.9,24,43,55.8,6,21,28.6,15,18,83.3,14,27,41,16,20,14,7,2,81,1
9070,212645,252_10_13,CHINA,0,TOTALS,CHINA,200,27,62,43.5,20,43,46.5,7,19,36.8,22,30,73.3,12,32,44,14,14,10,8,2,83,1
9071,212658,252_10_13,COTE D'IVOIRE,0,TOTALS,COTE D'IVOIRE,200,27,74,36.5,17,40,42.5,10,34,29.4,9,14,64.3,18,25,43,14,24,13,8,3,73,0
9072,212671,252_10_14,LITHUANIA,0,TOTALS,LITHUANIA,200,22,61,36.1,13,31,41.9,9,30,30.0,17,26,65.4,13,27,40,14,17,13,4,2,70,1
9073,212684,252_10_14,CANADA,0,TOTALS,CANADA,200,23,62,37.1,15,36,41.7,8,26,30.8,14,20,70.0,12,26,38,10,22,11,9,5,68,0
9074,212697,252_10_15,JORDAN,0,TOTALS,JORDAN,200,22,57,38.6,12,29,41.4,10,28,35.7,11,17,64.7,17,32,49,11,23,25,4,0,65,0
9075,212710,252_10_15,ANGOLA,0,TOTALS,ANGOLA,200,27,69,39.1,17,37,45.9,10,32,31.2,15,27,55.6,15,19,34,15,21,8,11,2,79,1
9076,212723,252_10_16,SLOVENIA,0,TOTALS,SLOVENIA,200,24,64,37.5,19,40,47.5,5,24,20.8,24,33,72.7,8,25,33,12,22,12,6,2,77,0
9077,212736,252_10_16,USA,0,TOTALS,USA,200,37,71,52.1,27,44,61.4,10,27,37.0,15,22,68.2,14,36,50,22,28,17,10,5,99,1
9078,212749,252_10_17,PUERTO RICO,0,TOTALS,PUERTO RICO,200,30,61,49.2,19,39,48.7,11,22,50.0,9,18,50.0,9,29,38,12,28,12,3,5,80,0
9079,212760,252_10_17,GREECE,0,TOTALS,GREECE,200,26,59,44.1,15,29,51.7,11,30,36.7,20,33,60.6,10,26,36,14,20,7,8,5,83,1
9080,212773,252_10_18,LEBANON,0,TOTALS,LEBANON,200,21,55,38.2,16,37,43.2,5,18,27.8,12,20,60.0,9,17,26,11,12,17,7,0,59,0
9081,212786,252_10_18,FRANCE,0,TOTALS,FRANCE,200,33,59,55.9,25,38,65.8,8,21,38.1,12,13,92.3,10,28,38,24,19,14,8,4,86,1
9082,212797,252_10_19,SERBIA,0,TOTALS,SERBIA,250,27,65,41.5,20,41,48.8,7,24,29.2,20,25,80.0,14,29,43,16,18,15,5,3,81,0
9083,212810,252_10_19,GERMANY,0,TOTALS,GERMANY,250,32,65,49.2,24,44,54.5,8,21,38.1,10,12,83.3,4,23,27,13,23,13,10,3,82,1
9084,212823,252_10_20,CROATIA,0,TOTALS,CROATIA,200,30,66,45.5,19,40,47.5,11,26,42.3,4,4,100.0,17,25,42,10,20,13,7,0,75,1
9085,212836,252_10_20,IRAN,0,TOTALS,IRAN,200,24,64,37.5,22,50,44.0,2,14,14.3,4,8,50.0,18,17,35,7,12,13,6,3,54,0
9086,212849,252_10_21,TURKEY,0,TOTALS,TURKEY,200,25,56,44.6,16,31,51.6,9,25,36.0,6,11,54.5,8,30,38,11,22,12,5,4,65,1
9087,212862,252_10_21,RUSSIA,0,TOTALS,RUSSIA,200,17,53,32.1,8,28,28.6,9,25,36.0,13,17,76.5,8,24,32,12,20,12,7,3,56,0
9088,212875,252_10_22,SPAIN,0,TOTALS,SPAIN,200,35,54,64.8,25,34,73.5,10,20,50.0,21,25,84.0,3,28,31,24,17,14,10,5,101,0
9089,212888,252_10_22,NEW ZEALAND,0,TOTALS,NEW ZEALAND,200,31,78,39.7,19,45,42.2,12,33,36.4,10,15,66.7,20,19,39,19,25,15,9,0,84,1
9090,212901,252_10_23,ARGENTINA,0,TOTALS,ARGENTINA,200,26,57,45.6,17,31,54.8,9,26,34.6,13,21,61.9,13,30,43,16,22,15,2,1,74,1
9091,212914,252_10_23,AUSTRALIA,0,TOTALS,AUSTRALIA,200,26,67,38.8,17,35,48.6,9,32,28.1,11,18,61.1,12,24,36,12,21,6,6,0,72,0
9092,212927,252_10_24,BRAZIL,0,TOTALS,BRAZIL,200,28,61,45.9,21,41,51.2,7,20,35.0,17,24,70.8,12,23,35,12,19,11,9,0,80,1
9093,212940,252_10_24,TUNISIA,0,TOTALS,TUNISIA,200,20,54,37.0,12,33,36.4,8,21,38.1,17,21,81.0,9,23,32,10,21,17,5,6,65,0
9094,212953,252_10_25,JORDAN,0,TOTALS,JORDAN,200,24,62,38.7,19,33,57.6,5,29,17.2,16,25,64.0,15,16,31,11,18,17,4,1,69,1
9095,212965,252_10_25,SERBIA,0,TOTALS,SERBIA,200,43,65,66.2,33,46,71.7,10,19,52.6,16,19,84.2,6,26,32,28,19,9,9,4,112,0
9096,212978,252_10_26,SLOVENIA,0,TOTALS,SLOVENIA,200,31,56,55.4,20,34,58.8,11,22,50.0,18,28,64.3,13,22,35,13,25,14,4,0,91,1
9097,212991,252_10_26,CROATIA,0,TOTALS,CROATIA,200,29,56,51.8,18,36,50.0,11,20,55.0,15,26,57.7,12,17,29,12,29,15,7,2,84,0
9098,213004,252_10_27,AUSTRALIA,0,TOTALS,AUSTRALIA,200,30,58,51.7,18,32,56.2,12,26,46.2,6,9,66.7,6,34,40,17,20,13,8,3,78,1
9099,213017,252_10_27,GERMANY,0,TOTALS,GERMANY,200,15,58,25.9,7,32,21.9,8,26,30.8,5,11,45.5,11,19,30,6,17,17,4,2,43,0
9100,213030,252_10_28,TUNISIA,0,TOTALS,TUNISIA,200,22,62,35.5,16,41,39.0,6,21,28.6,8,13,61.5,12,22,34,9,24,17,11,2,58,0
9101,213043,252_10_28,IRAN,0,TOTALS,IRAN,200,23,53,43.4,16,29,55.2,7,24,29.2,18,23,78.3,9,28,37,8,20,19,8,4,71,1
9102,213056,252_10_29,ANGOLA,0,TOTALS,ANGOLA,200,27,66,40.9,17,40,42.5,10,26,38.5,6,8,75.0,11,23,34,13,18,11,3,2,70,0
9103,213069,252_10_29,ARGENTINA,0,TOTALS,ARGENTINA,200,35,67,52.2,30,44,68.2,5,23,21.7,16,17,94.1,9,26,35,17,14,5,9,1,91,1
9104,213082,252_10_30,USA,0,TOTALS,USA,200,23,55,41.8,17,38,44.7,6,17,35.3,18,23,78.3,8,28,36,8,14,22,15,3,70,1
9105,213095,252_10_30,BRAZIL,0,TOTALS,BRAZIL,200,27,64,42.2,17,36,47.2,10,28,35.7,4,8,50.0,8,24,32,15,19,20,11,2,68,0
9106,213108,252_10_31,RUSSIA,0,TOTALS,RUSSIA,200,25,53,47.2,18,33,54.5,7,20,35.0,15,20,75.0,11,30,41,16,20,22,1,2,72,1
9107,213121,252_10_31,COTE D'IVOIRE,0,TOTALS,COTE D'IVOIRE,200,24,61,39.3,22,47,46.8,2,14,14.3,16,21,76.2,10,19,29,8,18,12,14,2,66,0
9108,213134,252_10_32,NEW ZEALAND,0,TOTALS,NEW ZEALAND,200,40,70,57.1,29,46,63.0,11,24,45.8,17,24,70.8,15,14,29,24,26,8,11,1,108,0
9109,213147,252_10_32,LEBANON,0,TOTALS,LEBANON,200,24,49,49.0,18,34,52.9,6,15,40.0,22,30,73.3,10,14,24,10,20,21,6,2,76,1
9110,213160,252_10_33,PUERTO RICO,0,TOTALS,PUERTO RICO,200,33,69,47.8,28,48,58.3,5,21,23.8,13,19,68.4,16,28,44,19,20,13,5,2,84,1
9111,213173,252_10_33,CHINA,0,TOTALS,CHINA,200,27,60,45.0,18,34,52.9,9,26,34.6,13,18,72.2,6,20,26,13,20,10,6,4,76,0
9112,213186,252_10_34,FRANCE,0,TOTALS,FRANCE,200,24,53,45.3,18,34,52.9,6,19,31.6,14,23,60.9,12,17,29,13,16,14,10,2,68,1
9113,213199,252_10_34,CANADA,0,TOTALS,CANADA,200,24,54,44.4,18,34,52.9,6,20,30.0,9,14,64.3,13,16,29,9,20,16,9,2,63,0
9114,213212,252_10_35,GREECE,0,TOTALS,GREECE,200,22,55,40.0,12,22,54.5,10,33,30.3,11,17,64.7,7,24,31,16,21,10,8,1,65,0
9115,213225,252_10_35,TURKEY,0,TOTALS,TURKEY,200,26,56,46.4,14,31,45.2,12,25,48.0,12,19,63.2,10,27,37,17,17,11,5,4,76,1
9116,213238,252_10_36,SPAIN,0,TOTALS,SPAIN,200,25,57,43.9,17,35,48.6,8,22,36.4,15,23,65.2,8,23,31,13,22,13,7,5,73,0
9117,213251,252_10_36,LITHUANIA,0,TOTALS,LITHUANIA,200,27,64,42.2,20,42,47.6,7,22,31.8,15,22,68.2,14,26,40,10,25,11,8,0,76,1
9118,213264,252_10_37,CHINA,0,TOTALS,CHINA,200,26,53,49.1,18,38,47.4,8,15,53.3,20,27,74.1,8,25,33,6,20,19,5,1,80,0
9119,213277,252_10_37,RUSSIA,0,TOTALS,RUSSIA,200,31,66,47.0,23,48,47.9,8,18,44.4,19,23,82.6,12,21,33,17,24,13,9,4,89,1
9120,213290,252_10_38,CANADA,0,TOTALS,CANADA,200,22,60,36.7,20,48,41.7,2,12,16.7,15,25,60.0,11,21,32,10,20,11,8,3,61,0
9121,213303,252_10_38,NEW ZEALAND,0,TOTALS,NEW ZEALAND,200,22,54,40.7,13,26,50.0,9,28,32.1,18,22,81.8,9,32,41,13,22,18,5,1,71,1
9122,213316,252_10_39,SERBIA,0,TOTALS,SERBIA,200,30,66,45.5,16,31,51.6,14,35,40.0,20,23,87.0,14,29,43,11,21,16,8,1,94,1
9123,213329,252_10_39,AUSTRALIA,0,TOTALS,AUSTRALIA,200,28,60,46.7,20,38,52.6,8,22,36.4,15,24,62.5,7,22,29,16,20,15,9,2,79,0
9124,213342,252_10_40,CROATIA,0,TOTALS,CROATIA,200,36,64,56.2,27,40,67.5,9,24,37.5,3,3,100.0,6,24,30,23,23,12,5,2,84,1
9125,213355,252_10_40,TUNISIA,0,TOTALS,TUNISIA,200,20,54,37.0,16,35,45.7,4,19,21.1,20,29,69.0,12,21,33,11,9,14,7,3,64,0
9126,213368,252_10_41,COTE D'IVOIRE,0,TOTALS,COTE D'IVOIRE,200,20,60,33.3,15,42,35.7,5,18,27.8,15,27,55.6,13,21,34,10,19,17,6,7,60,0
9127,213381,252_10_41,GREECE,0,TOTALS,GREECE,200,35,69,50.7,25,44,56.8,10,25,40.0,17,21,81.0,14,31,45,26,22,11,12,2,97,1
9128,213394,252_10_42,LEBANON,0,TOTALS,LEBANON,200,22,61,36.1,16,39,41.0,6,22,27.3,7,16,43.8,10,22,32,5,22,20,9,1,57,0
9129,213407,252_10_42,SPAIN,0,TOTALS,SPAIN,200,33,66,50.0,27,40,67.5,6,26,23.1,19,27,70.4,12,34,46,29,19,15,12,2,91,1
9130,213420,252_10_43,GERMANY,0,TOTALS,GERMANY,225,30,66,45.5,12,26,46.2,18,40,45.0,10,15,66.7,9,28,37,17,23,21,5,3,88,0
9131,213433,252_10_43,ANGOLA,0,TOTALS,ANGOLA,225,33,73,45.2,23,43,53.5,10,30,33.3,16,26,61.5,17,27,44,10,18,15,11,1,92,1
9132,213446,252_10_44,IRAN,0,TOTALS,IRAN,200,15,52,28.8,12,31,38.7,3,21,14.3,18,26,69.2,12,19,31,5,16,25,10,0,51,0
9133,213459,252_10_44,USA,0,TOTALS,USA,200,37,64,57.8,30,47,63.8,7,17,41.2,7,11,63.6,10,29,39,19,19,17,13,2,88,1
9134,213472,252_10_45,TURKEY,0,TOTALS,TURKEY,200,26,63,41.3,15,32,46.9,11,31,35.5,16,28,57.1,10,27,37,19,15,7,4,2,79,1
9135,213485,252_10_45,PUERTO RICO,0,TOTALS,PUERTO RICO,200,28,62,45.2,16,33,48.5,12,29,41.4,9,11,81.8,7,33,40,22,21,13,3,5,77,0
9136,213498,252_10_46,LITHUANIA,0,TOTALS,LITHUANIA,200,23,49,46.9,16,30,53.3,7,19,36.8,16,19,84.2,8,24,32,13,19,19,8,5,69,1
9137,213511,252_10_46,FRANCE,0,TOTALS,FRANCE,200,18,52,34.6,11,32,34.4,7,20,35.0,12,19,63.2,10,19,29,11,20,18,10,2,55,0
9138,213524,252_10_47,ARGENTINA,0,TOTALS,ARGENTINA,200,33,67,49.3,23,38,60.5,10,29,34.5,12,15,80.0,10,25,35,22,18,10,8,2,88,1
9139,213537,252_10_47,JORDAN,0,TOTALS,JORDAN,200,29,57,50.9,20,34,58.8,9,23,39.1,12,16,75.0,6,25,31,9,16,13,7,1,79,0
9140,213550,252_10_48,BRAZIL,0,TOTALS,BRAZIL,200,28,61,45.9,22,44,50.0,6,17,35.3,15,23,65.2,7,16,23,17,22,7,11,0,77,0
9141,213563,252_10_48,SLOVENIA,0,TOTALS,SLOVENIA,200,29,51,56.9,21,29,72.4,8,22,36.4,14,18,77.8,7,28,35,11,24,16,3,0,80,1
9142,213576,252_10_49,PUERTO RICO,0,TOTALS,PUERTO RICO,200,27,65,41.5,21,40,52.5,6,25,24.0,19,25,76.0,12,31,43,16,15,15,5,2,79,0
9143,213589,252_10_49,COTE D'IVOIRE,0,TOTALS,COTE D'IVOIRE,200,30,67,44.8,17,37,45.9,13,30,43.3,15,20,75.0,7,28,35,14,22,10,9,5,88,1
9144,213602,252_10_50,SPAIN,0,TOTALS,SPAIN,200,33,63,52.4,25,39,64.1,8,24,33.3,15,19,78.9,11,38,49,22,21,17,3,9,89,1
9145,213615,252_10_50,CANADA,0,TOTALS,CANADA,200,20,65,30.8,12,45,26.7,8,20,40.0,19,25,76.0,8,20,28,7,15,9,9,1,67,0
9146,213628,252_10_51,ANGOLA,0,TOTALS,ANGOLA,200,19,51,37.3,14,29,48.3,5,22,22.7,12,18,66.7,7,22,29,8,22,20,10,1,55,0
9147,213641,252_10_51,AUSTRALIA,0,TOTALS,AUSTRALIA,200,25,59,42.4,16,30,53.3,9,29,31.0,17,20,85.0,12,28,40,17,17,18,10,2,76,1
9148,213654,252_10_52,USA,0,TOTALS,USA,200,36,69,52.2,26,43,60.5,10,26,38.5,10,10,100.0,11,28,39,15,11,10,9,6,92,1
9149,213667,252_10_52,TUNISIA,0,TOTALS,TUNISIA,200,20,72,27.8,12,44,27.3,8,28,28.6,9,14,64.3,25,21,46,7,11,16,8,2,57,0
9150,213680,252_10_53,GREECE,0,TOTALS,GREECE,200,27,65,41.5,21,43,48.8,6,22,27.3,9,16,56.2,15,22,37,9,17,13,10,2,69,0
9151,213693,252_10_53,RUSSIA,0,TOTALS,RUSSIA,200,30,57,52.6,26,38,68.4,4,19,21.1,9,11,81.8,6,25,31,20,17,14,9,8,73,1
9152,213706,252_10_54,LEBANON,0,TOTALS,LEBANON,200,23,59,39.0,16,36,44.4,7,23,30.4,13,21,61.9,13,18,31,17,16,16,9,1,66,0
9153,213719,252_10_54,LITHUANIA,0,TOTALS,LITHUANIA,200,32,62,51.6,22,37,59.5,10,25,40.0,10,14,71.4,11,27,38,18,19,16,6,5,84,1
9154,213732,252_10_55,ARGENTINA,0,TOTALS,ARGENTINA,200,29,63,46.0,20,44,45.5,9,19,47.4,15,23,65.2,6,26,32,14,20,12,13,3,82,0
9155,213745,252_10_55,SERBIA,0,TOTALS,SERBIA,200,31,67,46.3,22,41,53.7,9,26,34.6,13,18,72.2,11,32,43,14,24,15,6,2,84,1
9156,213758,252_10_56,SLOVENIA,0,TOTALS,SLOVENIA,200,26,60,43.3,21,38,55.3,5,22,22.7,8,13,61.5,10,23,33,11,15,12,13,3,65,1
9157,213771,252_10_56,IRAN,0,TOTALS,IRAN,200,23,55,41.8,18,38,47.4,5,17,29.4,9,11,81.8,10,26,36,12,16,18,8,2,60,0
9158,213784,252_10_57,TURKEY,0,TOTALS,TURKEY,200,36,62,58.1,28,40,70.0,8,22,36.4,7,17,41.2,12,32,44,22,11,17,13,8,87,1
9159,213797,252_10_57,CHINA,0,TOTALS,CHINA,200,17,63,27.0,11,37,29.7,6,26,23.1,0,1,0.0,15,18,33,9,16,24,6,4,40,0
9160,213810,252_10_58,NEW ZEALAND,0,TOTALS,NEW ZEALAND,200,27,60,45.0,13,28,46.4,14,32,43.8,14,20,70.0,9,22,31,17,25,12,5,1,82,1
9161,213823,252_10_58,FRANCE,0,TOTALS,FRANCE,200,21,53,39.6,15,36,41.7,6,17,35.3,22,29,75.9,9,24,33,11,20,14,2,4,70,0
9162,213836,252_10_59,JORDAN,0,TOTALS,JORDAN,200,24,59,40.7,10,24,41.7,14,35,40.0,11,15,73.3,9,19,28,14,21,13,4,2,73,0
9163,213849,252_10_59,GERMANY,0,TOTALS,GERMANY,200,31,57,54.4,24,39,61.5,7,18,38.9,22,24,91.7,6,30,36,15,19,10,3,3,91,1
9164,213862,252_10_60,BRAZIL,0,TOTALS,BRAZIL,200,29,53,54.7,19,34,55.9,10,19,52.6,24,29,82.8,7,32,39,16,21,12,3,5,92,1
9165,213875,252_10_60,CROATIA,0,TOTALS,CROATIA,200,25,67,37.3,18,44,40.9,7,23,30.4,17,23,73.9,12,16,28,9,24,7,7,1,74,0
9166,213888,252_10_61,SERBIA,0,TOTALS,SERBIA,200,25,53,47.2,20,38,52.6,5,15,33.3,18,25,72.0,7,22,29,14,19,12,9,0,73,1
9167,213901,252_10_61,CROATIA,0,TOTALS,CROATIA,200,26,62,41.9,21,38,55.3,5,24,20.8,15,17,88.2,13,23,36,12,22,13,7,3,72,0
9168,213914,252_10_62,SPAIN,0,TOTALS,SPAIN,200,30,55,54.5,22,37,59.5,8,18,44.4,12,19,63.2,10,19,29,14,20,10,7,3,80,1
9169,213927,252_10_62,GREECE,0,TOTALS,GREECE,200,29,57,50.9,22,34,64.7,7,23,30.4,7,16,43.8,13,18,31,10,23,13,6,3,72,0
9170,213940,252_10_63,SLOVENIA,0,TOTALS,SLOVENIA,200,30,60,50.0,14,27,51.9,16,33,48.5,11,15,73.3,10,29,39,18,24,14,8,4,87,1
9171,213953,252_10_63,AUSTRALIA,0,TOTALS,AUSTRALIA,200,18,58,31.0,16,39,41.0,2,19,10.5,20,25,80.0,12,20,32,5,21,13,6,4,58,0
9172,213966,252_10_64,TURKEY,0,TOTALS,TURKEY,200,35,55,63.6,26,36,72.2,9,19,47.4,16,25,64.0,8,17,25,16,19,12,9,1,95,1
9173,213979,252_10_64,FRANCE,0,TOTALS,FRANCE,200,25,50,50.0,13,26,50.0,12,24,50.0,15,18,83.3,9,18,27,20,22,17,4,1,77,0
9174,213992,252_10_65,USA,0,TOTALS,USA,200,41,78,52.6,23,40,57.5,18,38,47.4,21,26,80.8,21,27,48,30,16,5,10,4,121,0
9175,214005,252_10_65,ANGOLA,0,TOTALS,ANGOLA,200,24,57,42.1,17,30,56.7,7,27,25.9,11,15,73.3,8,15,23,12,20,15,0,2,66,1
9176,214018,252_10_66,RUSSIA,0,TOTALS,RUSSIA,200,29,59,49.2,21,35,60.0,8,24,33.3,12,17,70.6,13,28,41,13,26,14,7,5,78,1
9177,214031,252_10_66,NEW ZEALAND,0,TOTALS,NEW ZEALAND,200,15,48,31.2,10,24,41.7,5,24,20.8,21,27,77.8,8,17,25,10,22,15,5,1,56,0
9178,214044,252_10_67,LITHUANIA,0,TOTALS,LITHUANIA,200,31,73,42.5,24,52,46.2,7,21,33.3,9,12,75.0,17,33,50,11,20,10,3,2,78,1
9179,214057,252_10_67,CHINA,0,TOTALS,CHINA,200,23,62,37.1,16,42,38.1,7,20,35.0,14,17,82.4,5,25,30,12,16,8,4,3,67,0
9180,214070,252_10_68,ARGENTINA,0,TOTALS,ARGENTINA,200,33,57,57.9,22,39,56.4,11,18,61.1,16,20,80.0,11,18,29,17,24,11,4,0,93,1
9181,214083,252_10_68,BRAZIL,0,TOTALS,BRAZIL,200,29,54,53.7,17,30,56.7,12,24,50.0,19,25,76.0,7,15,22,10,21,8,8,1,89,0
9182,214096,252_10_69,SERBIA,0,TOTALS,SERBIA,200,34,65,52.3,19,35,54.3,15,30,50.0,9,17,52.9,10,22,32,17,23,14,9,3,92,1
9183,214109,252_10_69,SPAIN,0,TOTALS,SPAIN,200,30,62,48.4,20,36,55.6,10,26,38.5,19,22,86.4,11,23,34,17,21,16,8,6,89,0
9184,214122,252_10_70,TURKEY,0,TOTALS,TURKEY,200,32,48,66.7,22,31,71.0,10,17,58.8,21,32,65.6,4,27,31,24,22,9,8,2,95,1
9185,214135,252_10_70,SLOVENIA,0,TOTALS,SLOVENIA,200,20,56,35.7,12,33,36.4,8,23,34.8,20,25,80.0,11,18,29,11,23,11,6,1,68,0
9186,214148,252_10_71,USA,0,TOTALS,USA,200,29,68,42.6,19,42,45.2,10,26,38.5,21,28,75.0,12,25,37,17,24,8,14,3,89,1
9187,214161,252_10_71,RUSSIA,0,TOTALS,RUSSIA,200,29,64,45.3,22,43,51.2,7,21,33.3,14,20,70.0,14,31,45,19,25,18,2,4,79,0
9188,214174,252_10_72,LITHUANIA,0,TOTALS,LITHUANIA,200,37,69,53.6,25,45,55.6,12,24,50.0,18,23,78.3,8,28,36,14,24,10,4,4,104,0
9189,214187,252_10_72,ARGENTINA,0,TOTALS,ARGENTINA,200,29,66,43.9,25,45,55.6,4,21,19.0,23,27,85.2,9,24,33,10,23,12,7,2,85,1
9190,214200,252_10_73,SPAIN,0,TOTALS,SPAIN,200,33,67,49.3,23,48,47.9,10,19,52.6,21,25,84.0,13,27,40,19,27,11,4,8,97,1
9191,214213,252_10_73,SLOVENIA,0,TOTALS,SLOVENIA,200,25,63,39.7,18,42,42.9,7,21,33.3,23,28,82.1,11,22,33,12,28,12,9,0,80,0
9192,214226,252_10_74,RUSSIA,0,TOTALS,RUSSIA,200,24,52,46.2,15,28,53.6,9,24,37.5,4,4,100.0,5,23,28,10,19,16,4,2,61,0
9193,214239,252_10_74,ARGENTINA,0,TOTALS,ARGENTINA,200,28,53,52.8,21,38,55.3,7,15,46.7,10,20,50.0,6,22,28,14,13,6,7,1,73,1
9194,214252,252_10_75,SLOVENIA,0,TOTALS,SLOVENIA,200,27,57,47.4,19,33,57.6,8,24,33.3,16,19,84.2,10,23,33,14,29,17,7,0,78,0
9195,214265,252_10_75,RUSSIA,0,TOTALS,RUSSIA,200,23,52,44.2,16,37,43.2,7,15,46.7,30,32,93.8,7,22,29,16,23,15,11,3,83,1
9196,214278,252_10_76,USA,0,TOTALS,USA,200,33,71,46.5,25,46,54.3,8,25,32.0,15,20,75.0,11,34,45,15,16,11,10,7,89,1
9197,214291,252_10_76,LITHUANIA,0,TOTALS,LITHUANIA,200,27,70,38.6,16,42,38.1,11,28,39.3,9,11,81.8,9,30,39,13,16,14,8,2,74,0
9198,214304,252_10_77,SERBIA,0,TOTALS,SERBIA,200,26,57,45.6,14,28,50.0,12,29,41.4,18,24,75.0,8,28,36,17,28,14,5,0,82,0
9199,214317,252_10_77,TURKEY,0,TOTALS,TURKEY,200,27,57,47.4,18,34,52.9,9,23,39.1,20,33,60.6,8,25,33,10,24,10,10,4,83,1
9200,214330,252_10_78,SPAIN,0,TOTALS,SPAIN,200,29,69,42.0,22,41,53.7,7,28,25.0,16,24,66.7,14,29,43,17,23,13,7,6,81,0
9201,214343,252_10_78,ARGENTINA,0,TOTALS,ARGENTINA,200,26,62,41.9,14,40,35.0,12,22,54.5,22,30,73.3,12,29,41,18,20,12,8,0,86,1
9202,214356,252_10_79,SERBIA,0,TOTALS,SERBIA,200,32,60,53.3,26,43,60.5,6,17,35.3,18,24,75.0,7,17,24,20,18,11,6,1,88,0
9203,214369,252_10_79,LITHUANIA,0,TOTALS,LITHUANIA,200,36,61,59.0,24,38,63.2,12,23,52.2,15,16,93.8,6,24,30,19,23,12,6,2,99,1
9204,214382,252_10_80,TURKEY,0,TOTALS,TURKEY,200,20,55,36.4,13,37,35.1,7,18,38.9,17,27,63.0,11,23,34,9,18,14,4,2,64,0
9205,214395,252_10_80,USA,0,TOTALS,USA,200,30,68,44.1,19,35,54.3,11,33,33.3,10,14,71.4,16,26,42,16,22,11,5,3,81,1
9206,216012,254_10_01,LITHUANIA,0,TOTALS,LITHUANIA,200,32,72,44.4,25,44,56.8,7,28,25.0,14,23,60.9,21,21,42,18,26,19,12,2,85,1
9207,216025,254_10_01,CHINA,0,TOTALS,CHINA,200,23,56,41.1,17,32,53.1,6,24,25.0,20,27,74.1,14,21,35,9,22,24,9,3,72,0
9208,216038,254_10_02,SERBIA,0,TOTALS,SERBIA,200,40,80,50.0,32,58,55.2,8,22,36.4,11,22,50.0,22,35,57,23,26,23,6,10,99,1
9209,216051,254_10_02,EGYPT,0,TOTALS,EGYPT,200,27,66,40.9,23,55,41.8,4,11,36.4,9,31,29.0,13,23,36,6,25,22,5,5,67,0
9210,216064,254_10_03,ARGENTINA,0,TOTALS,ARGENTINA,200,24,64,37.5,15,31,48.4,9,33,27.3,13,21,61.9,8,27,35,14,25,25,17,7,70,0
9211,216077,254_10_03,USA,0,TOTALS,USA,200,28,73,38.4,24,60,40.0,4,13,30.8,22,31,71.0,23,34,57,14,19,26,11,8,82,1
9212,216090,254_10_04,AUSTRALIA,0,TOTALS,AUSTRALIA,200,20,66,30.3,16,44,36.4,4,22,18.2,10,14,71.4,12,21,33,13,21,15,9,1,54,0
9213,216103,254_10_04,POLAND,0,TOTALS,POLAND,200,24,57,42.1,16,34,47.1,8,23,34.8,15,20,75.0,13,36,49,16,13,21,5,5,71,1
9214,216116,254_10_05,GERMANY,0,TOTALS,GERMANY,200,22,54,40.7,16,35,45.7,6,19,31.6,19,25,76.0,9,30,39,9,23,24,11,3,69,1
9215,216129,254_10_05,CANADA,0,TOTALS,CANADA,200,22,60,36.7,15,42,35.7,7,18,38.9,17,24,70.8,11,25,36,8,23,17,10,5,68,0
9216,216142,254_10_06,KOREA,0,TOTALS,KOREA,200,24,71,33.8,22,48,45.8,2,23,8.7,21,34,61.8,15,26,41,13,23,17,16,12,71,0
9217,216155,254_10_06,SPAIN,0,TOTALS,SPAIN,200,31,84,36.9,25,59,42.4,6,25,24.0,18,27,66.7,29,35,64,19,27,21,7,6,86,1
9218,216168,254_10_07,EGYPT,0,TOTALS,EGYPT,200,22,52,42.3,17,35,48.6,5,17,29.4,20,37,54.1,10,24,34,11,25,23,1,5,69,0
9219,216181,254_10_07,ARGENTINA,0,TOTALS,ARGENTINA,200,35,69,50.7,24,45,53.3,11,24,45.8,17,32,53.1,14,28,42,21,30,14,10,3,98,1
9220,216194,254_10_08,USA,0,TOTALS,USA,200,41,73,56.2,32,51,62.7,9,22,40.9,11,18,61.1,12,34,46,27,26,25,17,5,102,0
9221,216207,254_10_08,LITHUANIA,0,TOTALS,LITHUANIA,200,20,62,32.3,12,34,35.3,8,28,28.6,18,29,62.1,13,23,36,12,16,30,14,3,66,1
9222,216220,254_10_09,CANADA,0,TOTALS,CANADA,200,26,61,42.6,21,40,52.5,5,21,23.8,19,25,76.0,14,34,48,13,14,20,4,4,76,1
9223,216233,254_10_09,AUSTRALIA,0,TOTALS,AUSTRALIA,200,25,67,37.3,16,44,36.4,9,23,39.1,9,14,64.3,11,22,33,14,26,15,10,2,68,0
9224,216246,254_10_10,POLAND,0,TOTALS,POLAND,200,39,77,50.6,30,55,54.5,9,22,40.9,14,22,63.6,19,40,59,27,17,20,8,5,101,0
9225,216259,254_10_10,KOREA,0,TOTALS,KOREA,200,29,78,37.2,20,43,46.5,9,35,25.7,16,22,72.7,13,21,34,16,18,14,14,3,83,1
9226,216272,254_10_11,SPAIN,0,TOTALS,SPAIN,200,22,54,40.7,15,31,48.4,7,23,30.4,13,22,59.1,7,21,28,11,22,16,9,4,64,0
9227,216285,254_10_11,GERMANY,0,TOTALS,GERMANY,200,29,71,40.8,24,53,45.3,5,18,27.8,11,23,47.8,22,28,50,13,23,18,7,5,74,1
9228,216298,254_10_12,CHINA,0,TOTALS,CHINA,200,27,60,45.0,20,44,45.5,7,16,43.8,13,23,56.5,9,29,38,11,18,16,7,5,74,1
9229,216311,254_10_12,SERBIA,0,TOTALS,SERBIA,200,27,64,42.2,19,37,51.4,8,27,29.6,9,15,60.0,9,27,36,16,27,14,8,4,71,0
9230,216324,254_10_13,SPAIN,0,TOTALS,SPAIN,200,25,69,36.2,17,40,42.5,8,29,27.6,14,23,60.9,13,30,43,17,25,17,12,0,72,0
9231,216337,254_10_13,CANADA,0,TOTALS,CANADA,200,29,65,44.6,26,55,47.3,3,10,30.0,18,31,58.1,12,32,44,16,20,16,9,6,79,1
9232,216350,254_10_14,KOREA,0,TOTALS,KOREA,200,20,55,36.4,14,26,53.8,6,29,20.7,24,31,77.4,9,22,31,13,22,14,6,4,70,0
9233,216363,254_10_14,AUSTRALIA,0,TOTALS,AUSTRALIA,200,31,73,42.5,22,49,44.9,9,24,37.5,13,19,68.4,23,28,51,14,26,19,6,0,84,1
9234,216376,254_10_15,ARGENTINA,0,TOTALS,ARGENTINA,200,22,59,37.3,21,45,46.7,1,14,7.1,11,27,40.7,12,22,34,14,28,13,12,2,56,0
9235,216389,254_10_15,SERBIA,0,TOTALS,SERBIA,200,20,49,40.8,20,44,45.5,0,5,0.0,22,30,73.3,11,30,41,6,25,23,3,2,62,1
9236,216402,254_10_16,USA,0,TOTALS,USA,200,44,87,50.6,37,62,59.7,7,25,28.0,18,27,66.7,19,22,41,32,16,16,27,4,113,0
9237,216415,254_10_16,CHINA,0,TOTALS,CHINA,200,26,60,43.3,20,37,54.1,6,23,26.1,15,23,65.2,15,28,43,11,22,36,5,3,73,1
9238,216428,254_10_17,GERMANY,0,TOTALS,GERMANY,200,14,60,23.3,10,31,32.3,4,29,13.8,1,2,50.0,11,31,42,6,15,24,3,4,33,0
9239,216441,254_10_17,POLAND,0,TOTALS,POLAND,200,36,75,48.0,34,58,58.6,2,17,11.8,5,8,62.5,11,34,45,15,11,7,17,5,79,1
9240,216454,254_10_18,LITHUANIA,0,TOTALS,LITHUANIA,200,29,64,45.3,22,39,56.4,7,25,28.0,32,44,72.7,18,32,50,21,25,26,7,6,97,1
9241,216467,254_10_18,EGYPT,0,TOTALS,EGYPT,200,25,69,36.2,17,45,37.8,8,24,33.3,19,38,50.0,17,18,35,13,34,21,12,4,77,0
9242,216480,254_10_19,CANADA,0,TOTALS,CANADA,200,37,71,52.1,32,56,57.1,5,15,33.3,16,24,66.7,21,36,57,22,22,22,12,6,95,1
9243,216493,254_10_19,KOREA,0,TOTALS,KOREA,200,21,68,30.9,12,37,32.4,9,31,29.0,23,26,88.5,12,14,26,10,20,16,9,3,74,0
9244,216506,254_10_20,CHINA,0,TOTALS,CHINA,200,24,62,38.7,14,36,38.9,10,26,38.5,18,25,72.0,21,30,51,11,12,12,3,0,76,1
9245,216519,254_10_20,ARGENTINA,0,TOTALS,ARGENTINA,200,22,56,39.3,11,27,40.7,11,29,37.9,9,12,75.0,7,19,26,17,22,11,3,4,64,0
9246,216532,254_10_21,POLAND,0,TOTALS,POLAND,225,31,51,60.8,29,39,74.4,2,12,16.7,24,31,77.4,5,34,39,14,19,26,14,4,88,1
9247,216545,254_10_21,SPAIN,0,TOTALS,SPAIN,225,29,75,38.7,16,40,40.0,13,35,37.1,11,19,57.9,16,14,30,17,26,18,12,1,82,0
9248,216558,254_10_22,EGYPT,0,TOTALS,EGYPT,200,26,81,32.1,22,62,35.5,4,19,21.1,8,22,36.4,20,27,47,10,19,26,5,4,64,1
9249,216571,254_10_22,USA,0,TOTALS,USA,200,53,92,57.6,43,64,67.2,10,28,35.7,16,23,69.6,15,42,57,36,20,12,17,13,132,0
9250,216584,254_10_23,AUSTRALIA,0,TOTALS,AUSTRALIA,200,22,55,40.0,20,42,47.6,2,13,15.4,16,20,80.0,11,25,36,10,27,22,14,4,62,1
9251,216597,254_10_23,GERMANY,0,TOTALS,GERMANY,200,16,51,31.4,9,29,31.0,7,22,31.8,19,22,86.4,9,22,31,13,22,23,10,3,58,0
9252,216610,254_10_24,SERBIA,0,TOTALS,SERBIA,200,28,66,42.4,25,46,54.3,3,20,15.0,12,19,63.2,15,19,34,10,23,16,9,3,71,0
9253,216623,254_10_24,LITHUANIA,0,TOTALS,LITHUANIA,200,27,59,45.8,23,45,51.1,4,14,28.6,16,20,80.0,13,24,37,12,22,20,9,1,74,1
9254,216636,254_10_25,POLAND,0,TOTALS,POLAND,200,23,59,39.0,13,32,40.6,10,27,37.0,19,27,70.4,5,34,39,19,16,16,12,6,75,1
9255,216649,254_10_25,CANADA,0,TOTALS,CANADA,200,27,72,37.5,23,54,42.6,4,18,22.2,12,20,60.0,15,36,51,12,19,19,4,4,70,0
9256,216662,254_10_26,EGYPT,0,TOTALS,EGYPT,200,24,72,33.3,18,47,38.3,6,25,24.0,18,24,75.0,18,21,39,8,19,10,5,3,72,1
9257,216675,254_10_26,CHINA,0,TOTALS,CHINA,200,36,70,51.4,22,42,52.4,14,28,50.0,17,22,77.3,14,34,48,19,22,11,6,3,103,0
9258,216688,254_10_27,USA,0,TOTALS,USA,200,42,77,54.5,35,51,68.6,7,26,26.9,21,34,61.8,19,26,45,19,18,12,16,5,112,0
9259,216701,254_10_27,SERBIA,0,TOTALS,SERBIA,200,31,66,47.0,25,47,53.2,6,19,31.6,7,16,43.8,15,20,35,13,29,23,2,1,75,1
9260,216714,254_10_28,LITHUANIA,0,TOTALS,LITHUANIA,200,26,52,50.0,20,30,66.7,6,22,27.3,16,29,55.2,8,35,43,18,26,23,9,4,74,1
9261,216727,254_10_28,ARGENTINA,0,TOTALS,ARGENTINA,200,24,64,37.5,19,46,41.3,5,18,27.8,18,32,56.2,9,25,34,13,25,11,12,2,71,0
9262,216740,254_10_29,GERMANY,0,TOTALS,GERMANY,200,27,57,47.4,22,41,53.7,5,16,31.2,19,30,63.3,16,34,50,19,16,20,8,4,78,1
9263,216753,254_10_29,KOREA,0,TOTALS,KOREA,200,25,67,37.3,16,41,39.0,9,26,34.6,9,14,64.3,10,18,28,12,18,12,7,4,68,0
9264,216766,254_10_30,SPAIN,0,TOTALS,SPAIN,200,27,65,41.5,22,45,48.9,5,20,25.0,7,12,58.3,10,24,34,14,23,5,4,3,66,0
9265,216779,254_10_30,AUSTRALIA,0,TOTALS,AUSTRALIA,200,23,52,44.2,16,34,47.1,7,18,38.9,15,29,51.7,9,30,39,16,18,12,3,3,68,1
9266,216792,254_10_31,ARGENTINA,0,TOTALS,ARGENTINA,200,36,64,56.2,27,43,62.8,9,21,42.9,9,23,39.1,12,21,33,22,24,17,14,5,90,1
9267,216805,254_10_31,KOREA,0,TOTALS,KOREA,200,26,52,50.0,18,35,51.4,8,17,47.1,17,28,60.7,8,20,28,12,19,23,9,1,77,0
9268,216818,254_10_32,SPAIN,0,TOTALS,SPAIN,200,32,72,44.4,25,50,50.0,7,22,31.8,16,26,61.5,17,27,44,18,24,19,15,4,87,1
9269,216831,254_10_32,EGYPT,0,TOTALS,EGYPT,200,22,60,36.7,21,48,43.8,1,12,8.3,17,29,58.6,16,26,42,6,23,26,12,2,62,0
9270,216844,254_10_33,CANADA,0,TOTALS,CANADA,200,36,78,46.2,22,49,44.9,14,29,48.3,16,28,57.1,20,31,51,22,23,18,10,5,102,0
9271,216857,254_10_33,CHINA,0,TOTALS,CHINA,200,34,74,45.9,24,44,54.5,10,30,33.3,18,29,62.1,13,26,39,14,23,15,9,3,96,1
9272,216870,254_10_34,USA,0,TOTALS,USA,200,41,80,51.2,30,56,53.6,11,24,45.8,12,19,63.2,16,38,54,24,21,19,14,7,105,0
9273,216883,254_10_34,AUSTRALIA,0,TOTALS,AUSTRALIA,200,24,62,38.7,18,39,46.2,6,23,26.1,16,32,50.0,9,24,33,16,19,23,10,0,70,1
9274,216896,254_10_35,LITHUANIA,0,TOTALS,LITHUANIA,200,25,53,47.2,15,33,45.5,10,20,50.0,13,25,52.0,7,30,37,13,22,18,13,5,73,1
9275,216909,254_10_35,GERMANY,0,TOTALS,GERMANY,200,22,63,34.9,15,39,38.5,7,24,29.2,10,19,52.6,14,28,42,8,21,20,6,4,61,0
9276,216922,254_10_36,POLAND,0,TOTALS,POLAND,200,33,63,52.4,29,47,61.7,4,16,25.0,30,36,83.3,7,32,39,20,17,12,11,4,100,0
9277,216935,254_10_36,SERBIA,0,TOTALS,SERBIA,200,28,67,41.8,23,50,46.0,5,17,29.4,9,18,50.0,11,25,36,13,30,20,8,2,70,1
9278,216948,254_10_37,KOREA,0,TOTALS,KOREA,200,31,72,43.1,16,32,50.0,15,40,37.5,10,18,55.6,13,21,34,19,22,14,13,6,87,0
9279,216961,254_10_37,EGYPT,0,TOTALS,EGYPT,200,37,66,56.1,36,59,61.0,1,7,14.3,13,29,44.8,13,32,45,8,19,18,7,2,88,1
9280,216974,254_10_38,ARGENTINA,0,TOTALS,ARGENTINA,200,24,55,43.6,21,46,45.7,3,9,33.3,15,30,50.0,10,26,36,9,19,13,14,5,66,1
9281,216987,254_10_38,SPAIN,0,TOTALS,SPAIN,200,20,58,34.5,16,43,37.2,4,15,26.7,12,15,80.0,12,28,40,14,21,18,3,0,56,0
9282,217000,254_10_39,CHINA,0,TOTALS,CHINA,200,22,60,36.7,14,31,45.2,8,29,27.6,14,20,70.0,10,28,38,14,22,18,7,5,66,0
9283,217013,254_10_39,AUSTRALIA,0,TOTALS,AUSTRALIA,200,24,60,40.0,19,44,43.2,5,16,31.2,15,28,53.6,14,29,43,10,23,15,10,4,68,1
9284,217026,254_10_40,GERMANY,0,TOTALS,GERMANY,200,18,50,36.0,12,33,36.4,6,17,35.3,9,15,60.0,12,26,38,12,23,25,9,1,51,0
9285,217039,254_10_40,SERBIA,0,TOTALS,SERBIA,200,23,59,39.0,15,38,39.5,8,21,38.1,13,22,59.1,14,22,36,10,18,16,11,3,67,1
9286,217052,254_10_41,CANADA,0,TOTALS,CANADA,200,30,80,37.5,24,57,42.1,6,23,26.1,17,28,60.7,23,22,45,14,17,21,6,2,83,1
9287,217065,254_10_41,USA,0,TOTALS,USA,200,40,87,46.0,33,61,54.1,7,26,26.9,16,24,66.7,28,32,60,20,21,21,14,9,103,0
9288,217078,254_10_42,LITHUANIA,0,TOTALS,LITHUANIA,200,27,66,40.9,18,35,51.4,9,31,29.0,2,4,50.0,10,24,34,13,22,17,12,3,65,0
9289,217091,254_10_42,POLAND,0,TOTALS,POLAND,200,27,63,42.9,20,45,44.4,7,18,38.9,14,20,70.0,13,28,41,12,17,18,8,4,75,1
9290,217104,254_10_43,CHINA,0,TOTALS,CHINA,200,24,58,41.4,18,41,43.9,6,17,35.3,11,17,64.7,14,22,36,9,13,20,9,3,65,1
9291,217117,254_10_43,GERMANY,0,TOTALS,GERMANY,200,26,61,42.6,18,36,50.0,8,25,32.0,4,7,57.1,14,20,34,18,16,17,8,2,64,0
9292,217130,254_10_44,AUSTRALIA,0,TOTALS,AUSTRALIA,200,23,63,36.5,21,43,48.8,2,20,10.0,16,25,64.0,11,18,29,17,24,11,9,2,64,0
9293,217143,254_10_44,SERBIA,0,TOTALS,SERBIA,200,23,55,41.8,15,34,44.1,8,21,38.1,20,25,80.0,15,34,49,17,25,21,7,1,74,1
9294,217156,254_10_45,CANADA,0,TOTALS,CANADA,200,30,72,41.7,23,53,43.4,7,19,36.8,16,26,61.5,18,23,41,14,18,11,10,1,83,1
9295,217169,254_10_45,LITHUANIA,0,TOTALS,LITHUANIA,200,31,65,47.7,23,41,56.1,8,24,33.3,11,16,68.8,13,28,41,15,24,18,6,4,81,0
9296,217182,254_10_46,USA,0,TOTALS,USA,200,47,87,54.0,38,68,55.9,9,19,47.4,8,11,72.7,22,24,46,26,17,16,15,7,111,0
9297,217195,254_10_46,POLAND,0,TOTALS,POLAND,200,30,64,46.9,23,39,59.0,7,25,28.0,13,14,92.9,10,18,28,15,10,27,8,6,80,1
9298,218400,258_10_01,URUGUAY,0,TOTALS,URUGUAY,200,23,62,37.1,17,41,41.5,6,21,28.6,14,26,53.8,15,31,46,14,19,21,8,10,66,1
9299,218412,258_10_01,PARAGUAY,0,TOTALS,PARAGUAY,200,22,66,33.3,20,48,41.7,2,18,11.1,15,23,65.2,14,24,38,11,22,14,15,4,61,0
9300,218425,258_10_02,BRAZIL,0,TOTALS,BRAZIL,200,25,64,39.1,20,42,47.6,5,22,22.7,14,16,87.5,15,27,42,15,21,12,10,4,69,1
9301,218437,258_10_02,CHILE,0,TOTALS,CHILE,200,15,50,30.0,6,29,20.7,9,21,42.9,15,23,65.2,9,22,31,10,19,17,6,3,54,0
9302,218449,258_10_03,VENEZUELA,0,TOTALS,VENEZUELA,200,23,63,36.5,19,45,42.2,4,18,22.2,25,34,73.5,13,28,41,12,20,10,7,1,75,1
9303,218459,258_10_03,ARGENTINA,0,TOTALS,ARGENTINA,200,26,65,40.0,22,46,47.8,4,19,21.1,16,23,69.6,15,28,43,14,24,12,8,4,72,0
9304,218472,258_10_04,COLOMBIA,0,TOTALS,COLOMBIA,200,40,88,45.5,34,65,52.3,6,23,26.1,8,17,47.1,18,38,56,25,3,7,16,4,94,1
9305,218485,258_10_04,ECUADOR,0,TOTALS,ECUADOR,200,22,74,29.7,20,55,36.4,2,19,10.5,0,4,0.0,10,32,42,8,11,19,3,6,46,0
9306,218497,258_10_05,CHILE,0,TOTALS,CHILE,200,23,55,41.8,16,36,44.4,7,19,36.8,19,24,79.2,6,21,27,14,21,10,7,7,72,0
9307,218508,258_10_05,PARAGUAY,0,TOTALS,PARAGUAY,200,27,62,43.5,19,42,45.2,8,20,40.0,14,17,82.4,10,29,39,18,21,14,5,5,76,1
9308,218519,258_10_06,ARGENTINA,0,TOTALS,ARGENTINA,200,43,78,55.1,32,53,60.4,11,25,44.0,10,12,83.3,15,46,61,35,10,9,10,7,107,0
9309,218532,258_10_06,ECUADOR,0,TOTALS,ECUADOR,200,14,67,20.9,7,37,18.9,7,30,23.3,8,11,72.7,4,19,23,5,8,12,4,2,43,1
9310,218545,258_10_07,BRAZIL,0,TOTALS,BRAZIL,200,32,56,57.1,23,39,59.0,9,17,52.9,16,20,80.0,8,23,31,23,23,13,12,3,89,1
9311,218557,258_10_07,URUGUAY,0,TOTALS,URUGUAY,200,21,59,35.6,15,39,38.5,6,20,30.0,15,27,55.6,14,17,31,11,17,15,10,2,63,0
9312,218570,258_10_08,VENEZUELA,0,TOTALS,VENEZUELA,200,36,66,54.5,22,36,61.1,14,30,46.7,18,28,64.3,12,36,48,22,8,9,10,5,104,0
9313,218582,258_10_08,ECUADOR,0,TOTALS,ECUADOR,200,16,62,25.8,11,36,30.6,5,26,19.2,6,9,66.7,6,19,25,8,16,17,4,0,43,1
9314,218594,258_10_09,BRAZIL,0,TOTALS,BRAZIL,200,29,65,44.6,15,33,45.5,14,32,43.8,21,25,84.0,13,20,33,23,23,16,11,0,93,1
9315,218606,258_10_09,PARAGUAY,0,TOTALS,PARAGUAY,200,27,60,45.0,22,43,51.2,5,17,29.4,22,29,75.9,12,21,33,13,18,19,10,3,81,0
9316,218619,258_10_10,CHILE,0,TOTALS,CHILE,200,23,48,47.9,14,23,60.9,9,25,36.0,9,11,81.8,4,16,20,16,26,13,4,6,64,0
9317,218629,258_10_10,URUGUAY,0,TOTALS,URUGUAY,200,24,52,46.2,14,32,43.8,10,20,50.0,17,20,85.0,13,15,28,11,19,11,5,5,75,1
9318,218640,258_10_11,COLOMBIA,0,TOTALS,COLOMBIA,200,21,56,37.5,16,42,38.1,5,14,35.7,16,24,66.7,6,19,25,8,14,4,6,3,63,0
9319,218650,258_10_11,ARGENTINA,0,TOTALS,ARGENTINA,200,26,61,42.6,15,28,53.6,11,33,33.3,7,12,58.3,16,28,44,19,22,13,1,3,70,1
9320,218663,258_10_12,ECUADOR,0,TOTALS,ECUADOR,200,19,68,27.9,15,50,30.0,4,18,22.2,3,10,30.0,17,30,47,11,15,26,7,1,45,0
9321,218675,258_10_12,PARAGUAY,0,TOTALS,PARAGUAY,200,32,74,43.2,22,47,46.8,10,27,37.0,15,26,57.7,14,32,46,23,13,12,14,3,89,1
9322,218686,258_10_13,COLOMBIA,0,TOTALS,COLOMBIA,200,25,57,43.9,21,45,46.7,4,12,33.3,24,35,68.6,10,27,37,13,21,13,10,8,78,1
9323,218696,258_10_13,CHILE,0,TOTALS,CHILE,200,26,63,41.3,22,45,48.9,4,18,22.2,15,24,62.5,10,24,34,14,24,15,4,6,71,0
9324,218708,258_10_14,URUGUAY,0,TOTALS,URUGUAY,200,24,59,40.7,18,36,50.0,6,23,26.1,19,24,79.2,9,20,29,7,19,6,2,3,73,0
9325,218717,258_10_14,ARGENTINA,0,TOTALS,ARGENTINA,200,28,62,45.2,21,41,51.2,7,21,33.3,16,21,76.2,10,25,35,16,20,6,4,3,79,1
9326,218729,258_10_15,BRAZIL,0,TOTALS,BRAZIL,200,31,65,47.7,23,41,56.1,8,24,33.3,9,15,60.0,7,24,31,22,23,11,7,2,79,1
9327,218742,258_10_15,VENEZUELA,0,TOTALS,VENEZUELA,200,20,51,39.2,12,31,38.7,8,20,40.0,19,29,65.5,7,25,32,14,15,17,6,3,67,0
9328,218754,258_10_16,ECUADOR,0,TOTALS,ECUADOR,200,27,70,38.6,19,45,42.2,8,25,32.0,8,14,57.1,11,24,35,10,16,14,7,2,70,0
9329,218764,258_10_16,CHILE,0,TOTALS,CHILE,200,35,70,50.0,25,45,55.6,10,25,40.0,8,11,72.7,9,31,40,23,13,13,8,2,88,1
9330,218774,258_10_17,PARAGUAY,0,TOTALS,PARAGUAY,200,32,65,49.2,19,35,54.3,13,30,43.3,9,12,75.0,11,29,40,20,12,12,7,3,86,1
9331,218786,258_10_17,COLOMBIA,0,TOTALS,COLOMBIA,200,28,64,43.8,24,50,48.0,4,14,28.6,6,11,54.5,7,22,29,11,13,11,8,3,66,0
9332,218797,258_10_18,VENEZUELA,0,TOTALS,VENEZUELA,200,22,63,34.9,16,39,41.0,6,24,25.0,20,28,71.4,14,17,31,11,14,8,12,5,70,0
9333,218808,258_10_18,URUGUAY,0,TOTALS,URUGUAY,200,28,59,47.5,19,32,59.4,9,27,33.3,11,11,100.0,6,26,32,18,19,16,4,3,76,1
9334,218819,258_10_19,BRAZIL,0,TOTALS,BRAZIL,200,30,61,49.2,17,31,54.8,13,30,43.3,14,14,100.0,10,25,35,23,16,12,6,2,87,1
9335,218829,258_10_19,ARGENTINA,0,TOTALS,ARGENTINA,200,28,62,45.2,15,36,41.7,13,26,50.0,8,14,57.1,8,18,26,17,15,9,9,2,77,0
9336,219197,260_10_01,TRINIDAD AND TOBAGO,0,TOTALS,TRINIDAD AND TOBAGO,200,31,82,37.8,27,63,42.9,4,19,21.1,5,14,35.7,19,24,43,14,16,15,11,3,71,0
9337,219209,260_10_01,BELIZE,0,TOTALS,BELIZE,200,31,73,42.5,26,56,46.4,5,17,29.4,13,17,76.5,12,33,45,14,9,16,9,2,80,1
9338,219221,260_10_02,BRITISH VIRGIN ISLANDS,0,TOTALS,BRITISH VIRGIN ISLANDS,200,22,69,31.9,16,41,39.0,6,28,21.4,9,19,47.4,11,33,44,11,20,18,15,9,59,1
9339,219231,260_10_02,VIRGIN ISLANDS,0,TOTALS,VIRGIN ISLANDS,200,17,64,26.6,14,42,33.3,3,22,13.6,13,30,43.3,15,35,50,8,19,23,8,4,50,0
9340,219244,260_10_03,MEXICO,0,TOTALS,MEXICO,200,22,72,30.6,18,45,40.0,4,27,14.8,14,24,58.3,15,21,36,8,24,18,7,4,62,0
9341,219255,260_10_03,CUBA,0,TOTALS,CUBA,200,29,60,48.3,21,41,51.2,8,19,42.1,16,24,66.7,10,30,40,17,27,23,8,6,82,1
9342,219267,260_10_04,DOMINICAN REPUBLIC,0,TOTALS,DOMINICAN REPUBLIC,200,24,79,30.4,17,51,33.3,7,28,25.0,8,12,66.7,19,28,47,13,13,9,10,4,63,1
9343,219278,260_10_04,PANAMA,0,TOTALS,PANAMA,200,19,64,29.7,9,35,25.7,10,29,34.5,8,14,57.1,11,33,44,10,15,16,8,2,56,0
9344,219291,260_10_05,BELIZE,0,TOTALS,BELIZE,200,21,60,35.0,13,36,36.1,8,24,33.3,13,25,52.0,9,26,35,11,19,18,6,2,63,0
9345,219302,260_10_05,MEXICO,0,TOTALS,MEXICO,200,33,73,45.2,24,46,52.2,9,27,33.3,10,16,62.5,9,27,36,24,22,10,11,3,85,1
9346,219314,260_10_06,PANAMA,0,TOTALS,PANAMA,200,27,62,43.5,23,45,51.1,4,17,23.5,17,32,53.1,16,23,39,13,14,12,6,7,75,1
9347,219327,260_10_06,BRITISH VIRGIN ISLANDS,0,TOTALS,BRITISH VIRGIN ISLANDS,200,24,67,35.8,20,45,44.4,4,22,18.2,9,11,81.8,13,21,34,9,24,14,6,4,61,0
9348,219340,260_10_07,PUERTO RICO,0,TOTALS,PUERTO RICO,225,31,77,40.3,18,41,43.9,13,36,36.1,16,29,55.2,13,19,32,21,27,18,13,8,91,0
9349,219352,260_10_07,TRINIDAD AND TOBAGO,0,TOTALS,TRINIDAD AND TOBAGO,225,37,81,45.7,31,61,50.8,6,20,30.0,17,32,53.1,18,28,46,11,25,19,8,6,97,1
9350,219365,260_10_08,JAMAICA,0,TOTALS,JAMAICA,200,22,66,33.3,16,48,33.3,6,18,33.3,12,18,66.7,18,21,39,12,20,17,6,2,62,0
9351,219377,260_10_08,DOMINICAN REPUBLIC,0,TOTALS,DOMINICAN REPUBLIC,200,27,74,36.5,24,54,44.4,3,20,15.0,11,22,50.0,17,25,42,14,15,9,9,5,68,1
9352,219387,260_10_09,VIRGIN ISLANDS,0,TOTALS,VIRGIN ISLANDS,200,29,65,44.6,22,50,44.0,7,15,46.7,17,30,56.7,13,34,47,17,20,16,8,6,82,1
9353,219399,260_10_09,PANAMA,0,TOTALS,PANAMA,200,27,72,37.5,18,46,39.1,9,26,34.6,11,25,44.0,16,23,39,9,23,16,10,4,74,0
9354,219411,260_10_10,BRITISH VIRGIN ISLANDS,0,TOTALS,BRITISH VIRGIN ISLANDS,200,22,68,32.4,16,47,34.0,6,21,28.6,6,7,85.7,11,29,40,12,23,21,10,5,56,0
9355,219423,260_10_10,JAMAICA,0,TOTALS,JAMAICA,200,24,67,35.8,19,45,42.2,5,22,22.7,18,27,66.7,15,30,45,14,16,17,12,2,71,1
9356,219435,260_10_11,CUBA,0,TOTALS,CUBA,200,32,79,40.5,26,58,44.8,6,21,28.6,8,9,88.9,16,18,34,16,20,13,14,2,78,0
9357,219448,260_10_11,BELIZE,0,TOTALS,BELIZE,200,35,66,53.0,24,42,57.1,11,24,45.8,13,17,76.5,11,30,41,23,16,20,5,2,94,1
9358,219460,260_10_12,MEXICO,0,TOTALS,MEXICO,200,30,76,39.5,21,52,40.4,9,24,37.5,13,19,68.4,15,21,36,11,15,13,10,1,82,0
9359,219473,260_10_12,PUERTO RICO,0,TOTALS,PUERTO RICO,200,37,63,58.7,26,40,65.0,11,23,47.8,10,16,62.5,7,29,36,26,20,18,4,11,95,1
9360,219485,260_10_13,JAMAICA,0,TOTALS,JAMAICA,200,21,61,34.4,16,45,35.6,5,16,31.2,24,33,72.7,8,24,32,10,20,14,15,2,71,1
9361,219495,260_10_13,VIRGIN ISLANDS,0,TOTALS,VIRGIN ISLANDS,200,25,68,36.8,20,47,42.6,5,21,23.8,10,19,52.6,16,31,47,8,24,18,7,4,65,0
9362,219507,260_10_14,TRINIDAD AND TOBAGO,0,TOTALS,TRINIDAD AND TOBAGO,200,19,60,31.7,18,49,36.7,1,11,9.1,13,23,56.5,13,27,40,9,14,14,4,4,52,0
9363,219520,260_10_14,MEXICO,0,TOTALS,MEXICO,200,26,70,37.1,17,42,40.5,9,28,32.1,14,19,73.7,14,29,43,18,22,9,10,6,75,1
9364,219533,260_10_15,PUERTO RICO,0,TOTALS,PUERTO RICO,200,28,70,40.0,19,37,51.4,9,33,27.3,8,11,72.7,14,35,49,19,14,19,5,3,73,1
9365,219545,260_10_15,CUBA,0,TOTALS,CUBA,200,19,63,30.2,19,47,40.4,0,16,0.0,13,20,65.0,9,26,35,10,13,14,13,0,51,0
9366,219558,260_10_16,DOMINICAN REPUBLIC,0,TOTALS,DOMINICAN REPUBLIC,200,32,68,47.1,22,46,47.8,10,22,45.5,11,20,55.0,15,31,46,19,7,16,13,0,85,1
9367,219571,260_10_16,BRITISH VIRGIN ISLANDS,0,TOTALS,BRITISH VIRGIN ISLANDS,200,18,66,27.3,13,39,33.3,5,27,18.5,6,11,54.5,12,22,34,8,16,24,9,1,47,0
9368,219581,260_10_17,PANAMA,0,TOTALS,PANAMA,200,21,56,37.5,17,39,43.6,4,17,23.5,9,17,52.9,15,24,39,12,16,21,3,2,55,1
9369,219592,260_10_17,JAMAICA,0,TOTALS,JAMAICA,200,21,60,35.0,21,49,42.9,0,11,0.0,9,15,60.0,9,17,26,4,17,11,12,2,51,0
9370,219605,260_10_18,CUBA,0,TOTALS,CUBA,200,38,71,53.5,30,48,62.5,8,23,34.8,6,12,50.0,6,30,36,22,19,14,12,4,90,1
9371,219617,260_10_18,TRINIDAD AND TOBAGO,0,TOTALS,TRINIDAD AND TOBAGO,200,20,60,33.3,16,46,34.8,4,14,28.6,16,23,69.6,10,27,37,8,9,24,7,3,60,0
9372,219628,260_10_19,BELIZE,0,TOTALS,BELIZE,200,34,86,39.5,24,52,46.2,10,34,29.4,10,14,71.4,17,21,38,15,17,5,2,0,88,0
9373,219638,260_10_19,PUERTO RICO,0,TOTALS,PUERTO RICO,200,40,67,59.7,34,50,68.0,6,17,35.3,10,15,66.7,5,32,37,22,16,10,4,2,96,1
9374,219648,260_10_20,VIRGIN ISLANDS,0,TOTALS,VIRGIN ISLANDS,200,28,64,43.8,18,39,46.2,10,25,40.0,22,31,71.0,9,27,36,10,22,16,5,4,88,0
9375,219660,260_10_20,DOMINICAN REPUBLIC,0,TOTALS,DOMINICAN REPUBLIC,200,35,75,46.7,26,53,49.1,9,22,40.9,19,28,67.9,12,24,36,22,23,9,7,2,98,1
9376,219671,260_10_21,PUERTO RICO,0,TOTALS,PUERTO RICO,200,31,65,47.7,21,42,50.0,10,23,43.5,5,9,55.6,7,26,33,12,16,8,4,2,77,1
9377,219682,260_10_21,PANAMA,0,TOTALS,PANAMA,200,26,61,42.6,21,47,44.7,5,14,35.7,13,22,59.1,9,26,35,13,10,8,4,1,70,0
9378,219694,260_10_22,DOMINICAN REPUBLIC,0,TOTALS,DOMINICAN REPUBLIC,200,35,73,47.9,32,57,56.1,3,16,18.8,12,16,75.0,15,24,39,24,7,13,16,5,85,1
9379,219707,260_10_22,CUBA,0,TOTALS,CUBA,200,29,72,40.3,23,50,46.0,6,22,27.3,7,11,63.6,13,19,32,15,12,18,9,5,71,0
9380,219719,260_10_23,CUBA,0,TOTALS,CUBA,200,32,64,50.0,28,47,59.6,4,17,23.5,6,9,66.7,4,21,25,20,21,8,12,3,74,0
9381,219730,260_10_23,PANAMA,0,TOTALS,PANAMA,200,31,68,45.6,27,57,47.4,4,11,36.4,9,17,52.9,17,27,44,14,14,17,3,4,75,1
9382,219740,260_10_24,DOMINICAN REPUBLIC,0,TOTALS,DOMINICAN REPUBLIC,200,30,65,46.2,17,38,44.7,13,27,48.1,7,14,50.0,12,23,35,18,19,11,3,2,80,0
9383,219750,260_10_24,PUERTO RICO,0,TOTALS,PUERTO RICO,200,32,63,50.8,17,32,53.1,15,31,48.4,10,16,62.5,7,21,28,20,15,7,4,2,89,1
9384,220204,262_10_01,CANADA,0,TOTALS,CANADA,200,25,60,41.7,17,40,42.5,8,20,40.0,18,25,72.0,13,29,42,13,13,16,7,8,76,1
9385,220217,262_10_01,URUGUAY,0,TOTALS,URUGUAY,200,21,70,30.0,16,44,36.4,5,26,19.2,5,11,45.5,15,25,40,13,21,16,10,1,52,0
9386,220230,262_10_02,BRAZIL,0,TOTALS,BRAZIL,200,27,61,44.3,22,42,52.4,5,19,26.3,19,26,73.1,15,31,46,16,21,20,7,11,78,1
9387,220243,262_10_02,PUERTO RICO,0,TOTALS,PUERTO RICO,200,22,62,35.5,19,46,41.3,3,16,18.8,6,14,42.9,8,19,27,7,25,17,11,3,53,0
9388,220255,262_10_03,ARGENTINA,0,TOTALS,ARGENTINA,200,28,55,50.9,26,42,61.9,2,13,15.4,20,31,64.5,11,32,43,12,19,14,9,5,78,1
9389,220267,262_10_03,MEXICO,0,TOTALS,MEXICO,200,20,64,31.2,18,41,43.9,2,23,8.7,11,18,61.1,9,18,27,8,21,16,9,4,53,0
9390,220280,262_10_04,USA,0,TOTALS,USA,200,46,85,54.1,35,60,58.3,11,25,44.0,28,38,73.7,24,41,65,20,21,14,14,8,131,0
9391,220293,262_10_04,VIRGIN ISLANDS,0,TOTALS,VIRGIN ISLANDS,200,20,68,29.4,12,43,27.9,8,25,32.0,15,28,53.6,7,19,26,10,26,19,8,2,63,1
9392,220304,262_10_05,PUERTO RICO,0,TOTALS,PUERTO RICO,200,33,88,37.5,28,70,40.0,5,18,27.8,12,19,63.2,17,17,34,15,25,20,14,6,83,1
9393,220315,262_10_05,CANADA,0,TOTALS,CANADA,200,33,67,49.3,25,50,50.0,8,17,47.1,26,33,78.8,13,33,46,17,17,26,12,10,100,0
9394,220326,262_10_06,URUGUAY,0,TOTALS,URUGUAY,200,22,57,38.6,16,35,45.7,6,22,27.3,14,19,73.7,12,25,37,5,29,20,12,5,64,0
9395,220339,262_10_06,BRAZIL,0,TOTALS,BRAZIL,200,23,59,39.0,16,43,37.2,7,16,43.8,18,33,54.5,15,19,34,12,20,16,12,3,71,1
9396,220352,262_10_07,VIRGIN ISLANDS,0,TOTALS,VIRGIN ISLANDS,200,19,62,30.6,17,45,37.8,2,17,11.8,10,17,58.8,13,22,35,6,23,23,7,4,50,0
9397,220364,262_10_07,ARGENTINA,0,TOTALS,ARGENTINA,200,28,60,46.7,21,44,47.7,7,16,43.8,19,32,59.4,12,28,40,17,20,21,10,3,82,1
9398,220377,262_10_08,USA,0,TOTALS,USA,200,47,76,61.8,37,52,71.2,10,24,41.7,10,12,83.3,16,42,58,22,11,15,9,8,114,0
9399,220390,262_10_08,MEXICO,0,TOTALS,MEXICO,200,14,66,21.2,7,35,20.0,7,31,22.6,3,6,50.0,8,11,19,11,9,16,7,0,38,1
9400,220400,262_10_09,CANADA,0,TOTALS,CANADA,200,29,86,33.7,19,59,32.2,10,27,37.0,10,14,71.4,27,21,48,11,21,11,6,3,78,0
9401,220412,262_10_09,BRAZIL,0,TOTALS,BRAZIL,200,29,62,46.8,21,45,46.7,8,17,47.1,17,23,73.9,10,27,37,16,20,13,6,10,83,1
9402,220424,262_10_10,PUERTO RICO,0,TOTALS,PUERTO RICO,200,21,63,33.3,17,46,37.0,4,17,23.5,8,12,66.7,16,28,44,12,11,18,2,1,54,0
9403,220434,262_10_10,URUGUAY,0,TOTALS,URUGUAY,200,25,57,43.9,17,36,47.2,8,21,38.1,9,17,52.9,4,25,29,14,13,11,11,4,67,1
9404,220445,262_10_11,MEXICO,0,TOTALS,MEXICO,200,29,71,40.8,21,50,42.0,8,21,38.1,12,16,75.0,9,20,29,10,14,15,6,2,78,0
9405,220455,262_10_11,VIRGIN ISLANDS,0,TOTALS,VIRGIN ISLANDS,200,35,75,46.7,30,52,57.7,5,23,21.7,13,14,92.9,16,27,43,14,17,17,10,5,88,1
9406,220467,262_10_12,ARGENTINA,0,TOTALS,ARGENTINA,200,26,60,43.3,22,41,53.7,4,19,21.1,11,15,73.3,8,20,28,17,18,27,4,1,67,0
9407,220480,262_10_12,USA,0,TOTALS,USA,200,33,64,51.6,24,39,61.5,9,25,36.0,13,22,59.1,13,18,31,13,22,18,15,4,88,1
9408,220490,262_10_13,VIRGIN ISLANDS,0,TOTALS,VIRGIN ISLANDS,200,26,70,37.1,20,54,37.0,6,16,37.5,21,35,60.0,18,21,39,9,25,18,16,2,79,0
9409,220503,262_10_13,PUERTO RICO,0,TOTALS,PUERTO RICO,200,32,78,41.0,28,66,42.4,4,12,33.3,19,31,61.3,25,28,53,12,23,22,8,5,87,1
9410,220516,262_10_14,URUGUAY,0,TOTALS,URUGUAY,200,39,62,62.9,28,40,70.0,11,22,50.0,17,22,77.3,4,34,38,23,20,23,17,4,106,0
9411,220529,262_10_14,MEXICO,0,TOTALS,MEXICO,200,21,57,36.8,14,35,40.0,7,22,31.8,14,19,73.7,2,16,18,12,20,23,9,1,63,1
9412,220542,262_10_15,BRAZIL,0,TOTALS,BRAZIL,200,24,55,43.6,21,43,48.8,3,12,25.0,19,29,65.5,11,35,46,11,26,15,3,8,70,1
9413,220554,262_10_15,ARGENTINA,0,TOTALS,ARGENTINA,200,18,56,32.1,13,43,30.2,5,13,38.5,15,20,75.0,6,21,27,11,26,11,6,4,56,0
9414,220567,262_10_16,USA,0,TOTALS,USA,200,44,82,53.7,30,58,51.7,14,24,58.3,20,24,83.3,13,27,40,22,19,9,12,4,122,0
9415,220579,262_10_16,CANADA,0,TOTALS,CANADA,200,33,78,42.3,28,58,48.3,5,20,25.0,18,25,72.0,19,22,41,14,20,20,4,5,89,1
9416,220590,262_10_17,URUGUAY,0,TOTALS,URUGUAY,200,29,58,50.0,19,38,50.0,10,20,50.0,10,13,76.9,12,22,34,16,15,21,5,4,78,1
9417,220599,262_10_17,PUERTO RICO,0,TOTALS,PUERTO RICO,200,26,69,37.7,22,53,41.5,4,16,25.0,8,14,57.1,16,16,32,6,16,15,14,3,64,0
9418,220610,262_10_18,USA,0,TOTALS,USA,200,30,67,44.8,25,49,51.0,5,18,27.8,16,20,80.0,13,24,37,13,16,14,5,5,81,1
9419,220622,262_10_18,BRAZIL,0,TOTALS,BRAZIL,200,31,73,42.5,23,52,44.2,8,21,38.1,8,13,61.5,13,20,33,14,23,13,5,3,78,0
9420,221127,264_10_01,CHILE,0,TOTALS,CHILE,200,29,62,46.8,24,44,54.5,5,18,27.8,18,36,50.0,5,34,39,13,18,16,13,0,81,1
9421,221140,264_10_01,ECUADOR,0,TOTALS,ECUADOR,200,22,64,34.4,20,43,46.5,2,21,9.5,6,12,50.0,6,27,33,4,27,26,12,0,52,0
9422,221153,264_10_02,VENEZUELA,0,TOTALS,VENEZUELA,200,15,44,34.1,12,37,32.4,3,7,42.9,21,44,47.7,7,20,27,3,11,24,12,3,54,0
9423,221166,264_10_02,ARGENTINA,0,TOTALS,ARGENTINA,200,36,69,52.2,27,47,57.4,9,22,40.9,8,11,72.7,9,29,38,15,29,19,14,5,89,1
9424,221179,264_10_03,URUGUAY,0,TOTALS,URUGUAY,200,14,50,28.0,11,37,29.7,3,13,23.1,22,42,52.4,6,18,24,2,21,11,5,1,53,0
9425,221192,264_10_03,BRAZIL,0,TOTALS,BRAZIL,200,26,61,42.6,22,38,57.9,4,23,17.4,16,21,76.2,12,25,37,4,27,16,5,2,72,1
9426,221205,264_10_04,COLOMBIA,0,TOTALS,COLOMBIA,200,38,90,42.2,36,66,54.5,2,24,8.3,7,18,38.9,22,39,61,6,11,12,24,4,85,1
9427,221218,264_10_04,PERU,0,TOTALS,PERU,200,18,63,28.6,17,52,32.7,1,11,9.1,6,16,37.5,8,32,40,4,13,27,4,0,43,0
9428,221230,264_10_05,URUGUAY,0,TOTALS,URUGUAY,200,24,55,43.6,20,44,45.5,4,11,36.4,17,29,58.6,8,20,28,2,14,26,11,2,69,1
9429,221242,264_10_05,VENEZUELA,0,TOTALS,VENEZUELA,200,25,66,37.9,19,44,43.2,6,22,27.3,11,15,73.3,8,21,29,5,22,17,19,1,67,0
9430,221253,264_10_06,ARGENTINA,0,TOTALS,ARGENTINA,200,62,110,56.4,54,88,61.4,8,22,36.4,10,25,40.0,28,28,56,25,10,12,35,7,142,0
9431,221266,264_10_06,PERU,0,TOTALS,PERU,200,9,42,21.4,7,34,20.6,2,8,25.0,4,6,66.7,1,18,19,2,17,51,5,0,24,1
9432,221274,264_10_07,CHILE,0,TOTALS,CHILE,200,25,53,47.2,19,37,51.4,6,16,37.5,20,30,66.7,1,17,18,13,14,14,7,1,76,0
9433,221286,264_10_07,BRAZIL,0,TOTALS,BRAZIL,200,29,64,45.3,20,46,43.5,9,18,50.0,11,16,68.8,13,27,40,14,26,23,8,2,78,1
9434,221298,264_10_08,COLOMBIA,0,TOTALS,COLOMBIA,200,31,67,46.3,31,58,53.4,0,9,0.0,6,14,42.9,14,37,51,8,17,20,13,4,68,1
9435,221309,264_10_08,ECUADOR,0,TOTALS,ECUADOR,200,18,71,25.4,13,38,34.2,5,33,15.2,14,23,60.9,12,22,34,4,14,17,8,1,55,0
9436,221321,264_10_09,BRAZIL,0,TOTALS,BRAZIL,200,35,70,50.0,25,42,59.5,10,28,35.7,10,20,50.0,14,33,47,18,7,11,1,3,90,1
9437,221332,264_10_09,PERU,0,TOTALS,PERU,200,14,60,23.3,9,31,29.0,5,29,17.2,2,10,20.0,2,22,24,2,10,10,0,0,35,0
9438,221344,264_10_10,ECUADOR,0,TOTALS,ECUADOR,200,19,63,30.2,15,44,34.1,4,19,21.1,2,9,22.2,11,27,38,0,12,26,1,2,44,0
9439,221357,264_10_10,VENEZUELA,0,TOTALS,VENEZUELA,200,30,81,37.0,28,65,43.1,2,16,12.5,8,9,88.9,13,33,46,7,11,24,2,1,70,1
9440,221369,264_10_11,ARGENTINA,0,TOTALS,ARGENTINA,200,33,70,47.1,26,54,48.1,7,16,43.8,13,21,61.9,17,24,41,11,16,19,8,6,86,1
9441,221381,264_10_11,URUGUAY,0,TOTALS,URUGUAY,200,17,56,30.4,14,35,40.0,3,21,14.3,6,12,50.0,8,15,23,2,15,29,6,4,43,0
9442,221393,264_10_12,COLOMBIA,0,TOTALS,COLOMBIA,200,19,60,31.7,14,45,31.1,5,15,33.3,10,19,52.6,20,23,43,6,24,20,13,1,53,0
9443,221404,264_10_12,CHILE,0,TOTALS,CHILE,200,21,60,35.0,15,39,38.5,6,21,28.6,12,30,40.0,20,19,39,7,19,22,12,3,60,1
9444,221417,264_10_13,ECUADOR,0,TOTALS,ECUADOR,200,28,79,35.4,18,43,41.9,10,36,27.8,9,20,45.0,20,30,50,9,15,21,16,3,75,1
9445,221427,264_10_13,PERU,0,TOTALS,PERU,200,25,72,34.7,24,60,40.0,1,12,8.3,10,23,43.5,11,33,44,6,15,24,11,0,61,0
9446,221440,264_10_14,URUGUAY,0,TOTALS,URUGUAY,200,25,62,40.3,22,46,47.8,3,16,18.8,14,26,53.8,12,26,38,5,32,19,7,2,67,0
9447,221451,264_10_14,CHILE,0,TOTALS,CHILE,200,21,57,36.8,13,37,35.1,8,20,40.0,19,34,55.9,5,20,25,9,23,12,5,1,69,1
9448,221463,264_10_15,ARGENTINA,0,TOTALS,ARGENTINA,200,27,70,38.6,23,47,48.9,4,23,17.4,19,31,61.3,19,25,44,5,26,16,17,2,77,1
9449,221475,264_10_15,BRAZIL,0,TOTALS,BRAZIL,200,21,59,35.6,21,50,42.0,0,9,0.0,13,27,48.1,9,20,29,6,27,22,10,5,55,0
9450,221488,264_10_16,COLOMBIA,0,TOTALS,COLOMBIA,200,23,73,31.5,22,57,38.6,1,16,6.2,6,15,40.0,10,34,44,4,19,21,10,8,53,0
9451,221501,264_10_16,VENEZUELA,0,TOTALS,VENEZUELA,200,23,81,28.4,19,64,29.7,4,17,23.5,16,23,69.6,16,30,46,4,15,17,10,1,66,1
9452,221514,264_10_17,ECUADOR,0,TOTALS,ECUADOR,200,12,58,20.7,9,43,20.9,3,15,20.0,15,26,57.7,9,22,31,1,14,22,10,1,42,0
9453,221525,264_10_17,ARGENTINA,0,TOTALS,ARGENTINA,200,36,72,50.0,31,56,55.4,5,16,31.2,12,17,70.6,9,39,48,8,21,21,17,0,89,1
9454,221538,264_10_18,CHILE,0,TOTALS,CHILE,200,36,70,51.4,29,43,67.4,7,27,25.9,11,17,64.7,10,16,26,12,16,18,16,2,90,1
9455,221548,264_10_18,PERU,0,TOTALS,PERU,200,14,39,35.9,12,33,36.4,2,6,33.3,10,16,62.5,1,18,19,3,16,31,6,1,40,0
9456,221559,264_10_19,BRAZIL,0,TOTALS,BRAZIL,200,22,70,31.4,17,51,33.3,5,19,26.3,13,23,56.5,13,18,31,12,19,12,12,3,62,1
9457,221570,264_10_19,VENEZUELA,0,TOTALS,VENEZUELA,200,21,54,38.9,16,40,40.0,5,14,35.7,9,23,39.1,5,27,32,7,21,21,7,5,56,0
9458,221582,264_10_20,COLOMBIA,0,TOTALS,COLOMBIA,200,27,66,40.9,21,43,48.8,6,23,26.1,14,27,51.9,9,12,21,7,23,15,18,1,74,1
9459,221592,264_10_20,URUGUAY,0,TOTALS,URUGUAY,200,20,52,38.5,14,37,37.8,6,15,40.0,26,38,68.4,13,27,40,1,20,24,8,2,72,0
9460,221602,264_10_21,CHILE,0,TOTALS,CHILE,200,20,49,40.8,13,27,48.1,7,22,31.8,13,27,48.1,9,19,28,10,17,22,9,2,60,0
9461,221613,264_10_21,VENEZUELA,0,TOTALS,VENEZUELA,200,25,61,41.0,22,50,44.0,3,11,27.3,11,21,52.4,14,23,37,1,22,18,12,0,64,1
9462,221626,264_10_22,ECUADOR,0,TOTALS,ECUADOR,200,15,52,28.8,7,24,29.2,8,28,28.6,11,19,57.9,3,17,20,6,13,23,10,1,49,0
9463,221638,264_10_22,BRAZIL,0,TOTALS,BRAZIL,200,36,78,46.2,28,53,52.8,8,25,32.0,10,16,62.5,19,33,52,12,13,15,15,0,90,1
9464,221650,264_10_23,URUGUAY,0,TOTALS,URUGUAY,200,30,59,50.8,24,49,49.0,6,10,60.0,24,34,70.6,13,35,48,12,16,24,11,0,90,1
9465,221660,264_10_23,PERU,0,TOTALS,PERU,200,22,67,32.8,19,50,38.0,3,17,17.6,10,20,50.0,9,18,27,6,23,18,12,0,57,0
9466,221673,264_10_24,URUGUAY,0,TOTALS,URUGUAY,200,28,63,44.4,21,46,45.7,7,17,41.2,3,7,42.9,11,29,40,8,8,18,6,1,66,1
9467,221682,264_10_24,ECUADOR,0,TOTALS,ECUADOR,200,27,75,36.0,20,35,57.1,7,40,17.5,3,7,42.9,13,24,37,7,10,11,11,3,64,0
9468,221695,264_10_25,VENEZUELA,0,TOTALS,VENEZUELA,200,32,63,50.8,28,49,57.1,4,14,28.6,10,15,66.7,13,31,44,10,3,16,11,1,78,1
9469,221708,264_10_25,PERU,0,TOTALS,PERU,200,13,66,19.7,12,53,22.6,1,13,7.7,0,2,0.0,15,20,35,4,10,19,8,0,27,0
9470,221719,264_10_26,ARGENTINA,0,TOTALS,ARGENTINA,200,39,75,52.0,29,51,56.9,10,24,41.7,11,15,73.3,21,29,50,10,30,11,5,3,99,1
9471,221730,264_10_26,CHILE,0,TOTALS,CHILE,200,16,46,34.8,15,34,44.1,1,12,8.3,26,45,57.8,2,13,15,3,17,14,8,1,59,0
9472,221743,264_10_27,COLOMBIA,0,TOTALS,COLOMBIA,200,15,61,24.6,12,41,29.3,3,20,15.0,19,28,67.9,9,20,29,5,25,23,9,4,52,0
9473,221756,264_10_27,BRAZIL,0,TOTALS,BRAZIL,200,30,69,43.5,25,54,46.3,5,15,33.3,22,28,78.6,17,29,46,13,25,20,15,3,87,1
9474,221769,264_10_28,ECUADOR,0,TOTALS,ECUADOR,200,30,68,44.1,26,49,53.1,4,19,21.1,23,42,54.8,14,34,48,8,22,19,17,3,87,1
9475,221781,264_10_28,PERU,0,TOTALS,PERU,200,23,64,35.9,21,51,41.2,2,13,15.4,17,32,53.1,8,25,33,6,30,23,9,1,65,0
9476,221793,264_10_29,COLOMBIA,0,TOTALS,COLOMBIA,200,16,57,28.1,14,33,42.4,2,24,8.3,10,16,62.5,12,25,37,1,24,13,9,4,44,0
9477,221803,264_10_29,URUGUAY,0,TOTALS,URUGUAY,200,20,53,37.7,12,30,40.0,8,23,34.8,13,27,48.1,8,23,31,10,13,13,6,1,61,1
9478,221814,264_10_30,VENEZUELA,0,TOTALS,VENEZUELA,225,22,78,28.2,20,63,31.7,2,15,13.3,11,15,73.3,19,34,53,4,18,16,6,0,57,0
9479,221823,264_10_30,CHILE,0,TOTALS,CHILE,225,27,63,42.9,23,45,51.1,4,18,22.2,8,20,40.0,5,27,32,12,12,13,8,3,66,1
9480,221832,264_10_31,ARGENTINA,0,TOTALS,ARGENTINA,200,23,64,35.9,19,42,45.2,4,22,18.2,21,36,58.3,16,25,41,8,18,15,15,0,71,1
9481,221845,264_10_31,BRAZIL,0,TOTALS,BRAZIL,200,24,56,42.9,19,37,51.4,5,19,26.3,12,19,63.2,9,23,32,11,29,20,5,2,65,0
9482,222212,268_10_01,ANDORRA,0,TOTALS,ANDORRA,200,27,60,45.0,20,42,47.6,7,18,38.9,12,21,57.1,13,25,38,9,19,12,7,0,73,1
9483,222225,268_10_01,MOLDOVA,0,TOTALS,MOLDOVA,200,26,61,42.6,19,44,43.2,7,17,41.2,11,19,57.9,9,24,33,10,24,13,9,1,70,0
9484,222238,268_10_02,SCOTLAND,0,TOTALS,SCOTLAND,200,26,55,47.3,18,37,48.6,8,18,44.4,8,14,57.1,8,21,29,17,24,21,10,0,68,0
9485,222251,268_10_02,DENMARK,0,TOTALS,DENMARK,200,29,64,45.3,19,39,48.7,10,25,40.0,20,25,80.0,11,24,35,19,15,15,16,1,88,1
9486,222264,268_10_03,WALES,0,TOTALS,WALES,200,25,63,39.7,21,46,45.7,4,17,23.5,4,13,30.8,14,22,36,14,23,23,19,2,58,0
9487,222277,268_10_03,GIBRALTAR,0,TOTALS,GIBRALTAR,200,24,57,42.1,18,39,46.2,6,18,33.3,14,23,60.9,13,27,40,16,12,22,17,4,68,1
9488,222290,268_10_04,MALTA,0,TOTALS,MALTA,200,26,59,44.1,15,35,42.9,11,24,45.8,20,31,64.5,15,32,47,18,21,14,12,2,83,1
9489,222303,268_10_04,SAN MARINO,0,TOTALS,SAN MARINO,200,18,56,32.1,14,39,35.9,4,17,23.5,11,20,55.0,10,23,33,13,23,14,9,1,51,0
9490,222316,268_10_05,MOLDOVA,0,TOTALS,MOLDOVA,200,19,47,40.4,18,37,48.6,1,10,10.0,16,25,64.0,6,19,25,11,21,21,15,2,55,0
9491,222329,268_10_05,WALES,0,TOTALS,WALES,200,25,62,40.3,19,44,43.2,6,18,33.3,8,12,66.7,16,20,36,16,25,19,7,4,64,1
9492,222342,268_10_06,GIBRALTAR,0,TOTALS,GIBRALTAR,200,19,53,35.8,16,38,42.1,3,15,20.0,10,18,55.6,7,15,22,12,18,21,14,2,51,0
9493,222355,268_10_06,ANDORRA,0,TOTALS,ANDORRA,200,37,81,45.7,30,62,48.4,7,19,36.8,12,22,54.5,24,24,48,22,15,14,18,4,93,1
9494,222368,268_10_07,DENMARK,0,TOTALS,DENMARK,200,31,59,52.5,22,38,57.9,9,21,42.9,15,22,68.2,7,29,36,17,16,9,7,2,86,1
9495,222381,268_10_07,MALTA,0,TOTALS,MALTA,200,26,65,40.0,18,46,39.1,8,19,42.1,13,16,81.2,7,23,30,13,18,9,8,0,73,0
9496,222394,268_10_08,SAN MARINO,0,TOTALS,SAN MARINO,200,24,64,37.5,17,34,50.0,7,30,23.3,14,21,66.7,5,24,29,14,25,16,11,0,69,0
9497,222407,268_10_08,SCOTLAND,0,TOTALS,SCOTLAND,200,29,66,43.9,24,48,50.0,5,18,27.8,20,32,62.5,16,36,52,11,22,21,12,1,83,1
9498,222420,268_10_09,MOLDOVA,0,TOTALS,MOLDOVA,200,29,77,37.7,21,42,50.0,8,35,22.9,14,19,73.7,16,32,48,12,16,13,19,4,80,1
9499,222433,268_10_09,GIBRALTAR,0,TOTALS,GIBRALTAR,200,12,54,22.2,9,41,22.0,3,13,23.1,10,15,66.7,5,31,36,6,16,28,6,1,37,0
9500,222446,268_10_10,DENMARK,0,TOTALS,DENMARK,200,32,66,48.5,25,49,51.0,7,17,41.2,24,40,60.0,15,32,47,18,14,18,16,3,95,1
9501,222459,268_10_10,SAN MARINO,0,TOTALS,SAN MARINO,200,14,53,26.4,12,38,31.6,2,15,13.3,7,8,87.5,5,20,25,9,28,22,11,1,37,0
9502,222472,268_10_11,MALTA,0,TOTALS,MALTA,200,31,64,48.4,25,45,55.6,6,19,31.6,21,29,72.4,9,32,41,13,21,20,9,3,89,1
9503,222485,268_10_11,SCOTLAND,0,TOTALS,SCOTLAND,200,27,64,42.2,20,42,47.6,7,22,31.8,15,26,57.7,6,22,28,18,28,13,13,1,76,0
9504,222498,268_10_12,WALES,0,TOTALS,WALES,200,24,60,40.0,19,45,42.2,5,15,33.3,4,5,80.0,2,27,29,15,27,26,11,3,57,0
9505,222511,268_10_12,ANDORRA,0,TOTALS,ANDORRA,200,28,62,45.2,20,43,46.5,8,19,42.1,23,35,65.7,7,33,40,14,19,22,19,3,87,1
9506,222524,268_10_13,WALES,0,TOTALS,WALES,200,30,64,46.9,27,50,54.0,3,14,21.4,16,28,57.1,21,29,50,17,17,16,10,2,79,1
9507,222537,268_10_13,SAN MARINO,0,TOTALS,SAN MARINO,200,19,62,30.6,14,34,41.2,5,28,17.9,4,8,50.0,11,14,25,11,27,20,13,0,47,0
9508,222550,268_10_14,SCOTLAND,0,TOTALS,SCOTLAND,200,28,76,36.8,23,53,43.4,5,23,21.7,17,22,77.3,24,34,58,15,18,23,18,4,78,1
9509,222563,268_10_14,GIBRALTAR,0,TOTALS,GIBRALTAR,200,16,59,27.1,12,39,30.8,4,20,20.0,6,14,42.9,7,24,31,10,16,29,19,5,42,0
9510,222576,268_10_15,DENMARK,0,TOTALS,DENMARK,200,33,71,46.5,22,43,51.2,11,28,39.3,11,18,61.1,9,25,34,16,14,16,15,1,88,1
9511,222589,268_10_15,MOLDOVA,0,TOTALS,MOLDOVA,200,30,72,41.7,23,47,48.9,7,25,28.0,2,8,25.0,16,26,42,10,20,23,6,2,69,0
9512,222602,268_10_16,ANDORRA,0,TOTALS,ANDORRA,200,30,74,40.5,20,43,46.5,10,31,32.3,12,22,54.5,17,30,47,17,13,15,13,2,82,1
9513,222615,268_10_16,MALTA,0,TOTALS,MALTA,200,23,67,34.3,20,50,40.0,3,17,17.6,11,17,64.7,10,28,38,6,19,20,9,4,60,0
9514,222628,268_10_17,SAN MARINO,0,TOTALS,SAN MARINO,200,32,81,39.5,20,48,41.7,12,33,36.4,5,10,50.0,8,12,20,21,22,8,11,1,81,0
9515,222641,268_10_17,GIBRALTAR,0,TOTALS,GIBRALTAR,200,31,55,56.4,24,41,58.5,7,14,50.0,20,26,76.9,11,40,51,18,13,24,4,3,89,1
9516,222654,268_10_18,WALES,0,TOTALS,WALES,200,27,68,39.7,23,54,42.6,4,14,28.6,17,26,65.4,14,23,37,14,17,20,14,1,75,1
9517,222667,268_10_18,SCOTLAND,0,TOTALS,SCOTLAND,200,19,56,33.9,18,45,40.0,1,11,9.1,10,15,66.7,9,22,31,7,23,26,8,2,49,0
9518,222680,268_10_19,MALTA,0,TOTALS,MALTA,200,29,63,46.0,22,46,47.8,7,17,41.2,20,33,60.6,11,25,36,7,6,12,3,1,85,1
9519,222693,268_10_19,MOLDOVA,0,TOTALS,MOLDOVA,200,33,67,49.3,25,40,62.5,8,27,29.6,3,5,60.0,7,21,28,13,25,10,4,2,77,0
9520,222706,268_10_20,ANDORRA,0,TOTALS,ANDORRA,200,25,55,45.5,17,36,47.2,8,19,42.1,11,18,61.1,13,20,33,13,13,21,9,0,69,0
9521,222719,268_10_20,DENMARK,0,TOTALS,DENMARK,200,31,63,49.2,14,35,40.0,17,28,60.7,8,12,66.7,13,19,32,17,21,15,14,1,87,1
9522,223090,270_10_01,UKRAINE,0,TOTALS,UKRAINE,200,30,59,50.8,17,35,48.6,13,24,54.2,18,28,64.3,11,26,37,16,21,7,9,6,91,1
9523,223103,270_10_01,LATVIA,0,TOTALS,LATVIA,200,22,65,33.8,15,40,37.5,7,25,28.0,19,29,65.5,20,16,36,10,24,11,2,1,70,0
9524,223116,270_10_02,GERMANY,0,TOTALS,GERMANY,200,24,59,40.7,18,38,47.4,6,21,28.6,9,15,60.0,11,30,41,10,21,17,6,0,63,1
9525,223129,270_10_02,SPAIN,0,TOTALS,SPAIN,200,21,61,34.4,14,34,41.2,7,27,25.9,12,18,66.7,15,23,38,8,17,19,5,3,61,0
9526,223142,270_10_03,MONTENEGRO,0,TOTALS,MONTENEGRO,225,25,64,39.1,22,39,56.4,3,25,12.0,10,12,83.3,11,22,33,8,21,22,8,3,63,0
9527,223155,270_10_03,LITHUANIA,0,TOTALS,LITHUANIA,225,29,59,49.2,24,43,55.8,5,16,31.2,9,19,47.4,13,25,38,15,19,18,14,5,72,1
9528,223168,270_10_04,ITALY,0,TOTALS,ITALY,200,24,71,33.8,19,44,43.2,5,27,18.5,15,20,75.0,11,23,34,5,25,10,14,0,68,0
9529,223181,270_10_04,RUSSIA,0,TOTALS,RUSSIA,200,24,53,45.3,17,32,53.1,7,21,33.3,18,30,60.0,12,37,49,11,23,23,2,1,73,1
9530,223192,270_10_05,CZECH REPUBLIC,0,TOTALS,CZECH REPUBLIC,200,23,58,39.7,14,32,43.8,9,26,34.6,12,21,57.1,10,18,28,9,16,10,7,0,67,0
9531,223205,270_10_05,GREECE,0,TOTALS,GREECE,200,34,60,56.7,24,41,58.5,10,19,52.6,14,18,77.8,7,30,37,18,19,12,6,2,92,1
9532,223218,270_10_06,NETHERLANDS,0,TOTALS,NETHERLANDS,200,21,52,40.4,14,33,42.4,7,19,36.8,5,14,35.7,8,15,23,7,18,13,4,2,54,0
9533,223231,270_10_06,FRANCE,0,TOTALS,FRANCE,200,23,47,48.9,16,30,53.3,7,17,41.2,13,19,68.4,12,28,40,8,19,18,9,0,66,1
9534,223244,270_10_07,TURKEY,0,TOTALS,TURKEY,200,25,62,40.3,14,34,41.2,11,28,39.3,6,13,46.2,12,16,28,6,18,12,10,5,67,0
9535,223257,270_10_07,SERBIA,0,TOTALS,SERBIA,200,31,61,50.8,18,33,54.5,13,28,46.4,7,10,70.0,11,22,33,14,17,14,7,9,82,1
9536,223270,270_10_08,SLOVENIA,0,TOTALS,SLOVENIA,200,24,71,33.8,14,41,34.1,10,30,33.3,7,14,50.0,14,26,40,12,24,11,4,2,65,0
9537,223283,270_10_08,CROATIA,0,TOTALS,CROATIA,200,27,54,50.0,20,35,57.1,7,19,36.8,11,26,42.3,6,36,42,13,20,15,5,7,72,1
9538,223296,270_10_09,LATVIA,0,TOTALS,LATVIA,200,34,69,49.3,28,49,57.1,6,20,30.0,10,17,58.8,19,29,48,19,21,21,8,5,84,1
9539,223308,270_10_09,CZECH REPUBLIC,0,TOTALS,CZECH REPUBLIC,200,18,60,30.0,13,40,32.5,5,20,25.0,12,16,75.0,7,14,21,9,23,19,9,0,53,0
9540,223321,270_10_10,RUSSIA,0,TOTALS,RUSSIA,200,25,61,41.0,18,32,56.2,7,29,24.1,22,35,62.9,14,23,37,13,22,11,7,1,79,1
9541,223334,270_10_10,NETHERLANDS,0,TOTALS,NETHERLANDS,200,22,55,40.0,14,40,35.0,8,15,53.3,19,24,79.2,11,30,41,12,34,14,7,1,71,0
9542,223347,270_10_11,GREECE,0,TOTALS,GREECE,200,27,61,44.3,14,29,48.3,13,32,40.6,21,23,91.3,13,19,32,17,22,15,12,1,88,1
9543,223360,270_10_11,UKRAINE,0,TOTALS,UKRAINE,200,24,60,40.0,17,37,45.9,7,23,30.4,21,24,87.5,13,23,36,5,24,20,8,5,76,0
9544,223373,270_10_12,FRANCE,0,TOTALS,FRANCE,200,20,52,38.5,14,33,42.4,6,19,31.6,15,24,62.5,15,24,39,9,26,16,10,0,61,1
9545,223386,270_10_12,ITALY,0,TOTALS,ITALY,200,16,48,33.3,8,23,34.8,8,25,32.0,18,27,66.7,10,22,32,4,24,13,5,4,58,0
9546,223399,270_10_13,SERBIA,0,TOTALS,SERBIA,200,19,57,33.3,12,26,46.2,7,31,22.6,14,22,63.6,11,21,32,14,25,14,7,5,59,0
9547,223412,270_10_13,MONTENEGRO,0,TOTALS,MONTENEGRO,200,21,61,34.4,13,33,39.4,8,28,28.6,18,26,69.2,17,28,45,10,25,16,10,1,68,1
9548,223425,270_10_14,SPAIN,0,TOTALS,SPAIN,200,24,56,42.9,20,42,47.6,4,14,28.6,14,19,73.7,15,19,34,9,24,17,8,2,66,1
9549,223438,270_10_14,SLOVENIA,0,TOTALS,SLOVENIA,200,19,57,33.3,13,32,40.6,6,25,24.0,17,26,65.4,19,19,38,7,21,19,9,2,61,0
9550,223451,270_10_15,LITHUANIA,0,TOTALS,LITHUANIA,200,28,60,46.7,17,36,47.2,11,24,45.8,18,22,81.8,13,27,40,14,22,11,2,0,85,1
9551,223464,270_10_15,TURKEY,0,TOTALS,TURKEY,200,25,66,37.9,18,41,43.9,7,25,28.0,12,19,63.2,16,21,37,15,24,8,5,5,69,0
9552,223476,270_10_16,CROATIA,0,TOTALS,CROATIA,200,24,55,43.6,16,29,55.2,8,26,30.8,10,18,55.6,10,30,40,9,23,16,6,3,66,1
9553,223489,270_10_16,GERMANY,0,TOTALS,GERMANY,200,20,61,32.8,17,39,43.6,3,22,13.6,11,12,91.7,10,23,33,9,19,12,4,0,54,0
9554,223502,270_10_17,UKRAINE,0,TOTALS,UKRAINE,200,28,68,41.2,18,47,38.3,10,21,47.6,19,25,76.0,14,23,37,11,19,10,7,5,85,1
9555,223513,270_10_17,CZECH REPUBLIC,0,TOTALS,CZECH REPUBLIC,200,26,69,37.7,17,39,43.6,9,30,30.0,14,16,87.5,14,25,39,14,24,14,5,3,75,0
9556,223526,270_10_18,ITALY,0,TOTALS,ITALY,200,24,67,35.8,15,35,42.9,9,32,28.1,20,25,80.0,14,22,36,5,20,10,6,1,77,1
9557,223539,270_10_18,NETHERLANDS,0,TOTALS,NETHERLANDS,200,25,57,43.9,21,35,60.0,4,22,18.2,11,21,52.4,15,29,44,8,26,19,6,4,65,0
9558,223552,270_10_19,GREECE,0,TOTALS,GREECE,200,30,63,47.6,26,49,53.1,4,14,28.6,18,22,81.8,15,24,39,9,21,12,14,4,82,1
9559,223565,270_10_19,LATVIA,0,TOTALS,LATVIA,200,18,56,32.1,13,37,35.1,5,19,26.3,12,16,75.0,11,14,25,8,21,21,6,4,53,0
9560,223578,270_10_20,FRANCE,0,TOTALS,FRANCE,200,26,56,46.4,24,37,64.9,2,19,10.5,6,11,54.5,17,22,39,8,25,17,7,0,60,1
9561,223591,270_10_20,RUSSIA,0,TOTALS,RUSSIA,200,16,47,34.0,10,25,40.0,6,22,27.3,21,27,77.8,13,17,30,9,16,15,7,2,59,0
9562,223604,270_10_21,TURKEY,0,TOTALS,TURKEY,200,22,52,42.3,18,36,50.0,4,16,25.0,13,20,65.0,13,26,39,8,22,19,5,2,61,0
9563,223617,270_10_21,MONTENEGRO,0,TOTALS,MONTENEGRO,200,23,58,39.7,17,36,47.2,6,22,27.3,11,18,61.1,8,16,24,5,24,14,7,0,63,1
9564,223630,270_10_22,GERMANY,0,TOTALS,GERMANY,200,16,52,30.8,12,35,34.3,4,17,23.5,18,26,69.2,12,20,32,7,27,19,7,2,54,0
9565,223643,270_10_22,SLOVENIA,0,TOTALS,SLOVENIA,200,25,55,45.5,18,27,66.7,7,28,25.0,18,26,69.2,12,25,37,9,24,17,10,1,75,1
9566,223656,270_10_23,LITHUANIA,0,TOTALS,LITHUANIA,200,25,63,39.7,21,43,48.8,4,20,20.0,15,23,65.2,14,21,35,13,25,18,10,1,69,0
9567,223669,270_10_23,SERBIA,0,TOTALS,SERBIA,200,31,53,58.5,21,34,61.8,10,19,52.6,8,23,34.8,2,26,28,17,26,17,9,4,80,1
9568,223681,270_10_24,CROATIA,0,TOTALS,CROATIA,200,18,62,29.0,10,31,32.3,8,31,25.8,15,23,65.2,21,27,48,9,23,21,8,1,59,0
9569,223694,270_10_24,SPAIN,0,TOTALS,SPAIN,200,23,59,39.0,18,36,50.0,5,23,21.7,13,22,59.1,11,23,34,11,21,18,13,4,64,1
9570,223707,270_10_25,LITHUANIA,0,TOTALS,LITHUANIA,200,27,56,48.2,21,33,63.6,6,23,26.1,10,16,62.5,8,18,26,8,22,16,9,1,70,0
9571,223720,270_10_25,GREECE,0,TOTALS,GREECE,200,26,58,44.8,20,40,50.0,6,18,33.3,17,19,89.5,12,22,34,12,22,14,10,3,75,1
9572,223733,270_10_26,ITALY,0,TOTALS,ITALY,200,23,64,35.9,16,35,45.7,7,29,24.1,3,4,75.0,10,20,30,8,25,16,5,1,56,0
9573,223746,270_10_26,SPAIN,0,TOTALS,SPAIN,200,28,58,48.3,24,44,54.5,4,14,28.6,18,26,69.2,13,31,44,11,13,13,9,0,78,1
9574,223759,270_10_27,MONTENEGRO,0,TOTALS,MONTENEGRO,200,24,57,42.1,15,28,53.6,9,29,31.0,18,21,85.7,9,16,25,7,20,15,9,0,75,0
9575,223772,270_10_27,UKRAINE,0,TOTALS,UKRAINE,200,31,54,57.4,21,29,72.4,10,25,40.0,16,23,69.6,11,20,31,12,19,13,9,1,88,1
9576,223785,270_10_28,SLOVENIA,0,TOTALS,SLOVENIA,200,15,46,32.6,11,26,42.3,4,20,20.0,9,14,64.3,8,28,36,6,19,17,2,5,43,0
9577,223798,270_10_28,FRANCE,0,TOTALS,FRANCE,200,18,60,30.0,14,41,34.1,4,19,21.1,10,12,83.3,12,23,35,8,18,9,13,2,50,1
9578,223809,270_10_29,CZECH REPUBLIC,0,TOTALS,CZECH REPUBLIC,225,21,63,33.3,13,29,44.8,8,34,23.5,18,33,54.5,17,25,42,8,23,18,10,0,68,0
9579,223822,270_10_29,GERMANY,0,TOTALS,GERMANY,225,24,56,42.9,18,38,47.4,6,18,33.3,19,27,70.4,6,25,31,8,23,26,11,1,73,1
9580,223835,270_10_30,LATVIA,0,TOTALS,LATVIA,200,23,66,34.8,22,46,47.8,1,20,5.0,10,15,66.7,15,24,39,5,22,11,3,1,57,0
9581,223848,270_10_30,SERBIA,0,TOTALS,SERBIA,200,21,54,38.9,14,35,40.0,7,19,36.8,21,26,80.8,8,25,33,11,22,13,3,2,70,1
9582,223860,270_10_31,CROATIA,0,TOTALS,CROATIA,200,31,63,49.2,28,45,62.2,3,18,16.7,10,13,76.9,13,23,36,9,19,18,8,2,75,1
9583,223873,270_10_31,RUSSIA,0,TOTALS,RUSSIA,200,22,58,37.9,14,31,45.2,8,27,29.6,9,10,90.0,13,18,31,7,16,23,12,1,61,0
9584,223886,270_10_32,TURKEY,0,TOTALS,TURKEY,200,23,48,47.9,19,31,61.3,4,17,23.5,13,23,56.5,11,26,37,11,22,20,9,2,63,0
9585,223899,270_10_32,NETHERLANDS,0,TOTALS,NETHERLANDS,200,24,61,39.3,16,34,47.1,8,27,29.6,12,20,60.0,10,15,25,12,24,14,10,0,68,1
9586,223912,270_10_33,GREECE,0,TOTALS,GREECE,225,25,53,47.2,19,38,50.0,6,15,40.0,27,34,79.4,9,21,30,12,23,12,7,5,83,1
9587,223925,270_10_33,MONTENEGRO,0,TOTALS,MONTENEGRO,225,25,59,42.4,16,34,47.1,9,25,36.0,20,23,87.0,11,20,31,7,30,12,4,3,79,0
9588,223938,270_10_34,SLOVENIA,0,TOTALS,SLOVENIA,200,23,60,38.3,17,43,39.5,6,17,35.3,13,16,81.2,16,21,37,6,19,15,5,1,65,0
9589,223951,270_10_34,ITALY,0,TOTALS,ITALY,200,30,62,48.4,19,33,57.6,11,29,37.9,9,10,90.0,12,21,33,10,18,13,8,1,80,1
9590,223964,270_10_35,RUSSIA,0,TOTALS,RUSSIA,200,25,66,37.9,20,38,52.6,5,28,17.9,15,19,78.9,20,27,47,11,15,12,5,2,70,1
9591,223977,270_10_35,SPAIN,0,TOTALS,SPAIN,200,28,66,42.4,23,48,47.9,5,18,27.8,7,13,53.8,13,23,36,17,19,10,6,3,68,0
9592,223990,270_10_36,LITHUANIA,0,TOTALS,LITHUANIA,200,26,61,42.6,21,40,52.5,5,21,23.8,15,31,48.4,15,18,33,12,22,10,5,4,72,0
9593,224003,270_10_36,LATVIA,0,TOTALS,LATVIA,200,28,61,45.9,24,40,60.0,4,21,19.0,15,21,71.4,12,26,38,9,28,12,4,2,75,1
9594,224016,270_10_37,NETHERLANDS,0,TOTALS,NETHERLANDS,200,27,53,50.9,20,38,52.6,7,15,46.7,6,11,54.5,3,21,24,13,22,18,9,0,67,0
9595,224027,270_10_37,CZECH REPUBLIC,0,TOTALS,CZECH REPUBLIC,200,26,55,47.3,20,37,54.1,6,18,33.3,17,26,65.4,5,22,27,9,13,19,9,0,75,1
9596,224040,270_10_38,UKRAINE,0,TOTALS,UKRAINE,200,25,66,37.9,17,43,39.5,8,23,34.8,8,13,61.5,11,25,36,8,20,14,9,5,66,1
9597,224053,270_10_38,SERBIA,0,TOTALS,SERBIA,200,22,65,33.8,15,40,37.5,7,25,28.0,13,18,72.2,18,33,51,12,22,17,7,1,64,0
9598,224066,270_10_39,FRANCE,0,TOTALS,FRANCE,200,15,53,28.3,10,34,29.4,5,19,26.3,5,8,62.5,9,18,27,9,14,14,7,3,40,0
9599,224078,270_10_39,CROATIA,0,TOTALS,CROATIA,200,24,52,46.2,15,30,50.0,9,22,40.9,8,9,88.9,11,29,40,12,15,13,5,2,65,1
9600,224091,270_10_40,GERMANY,0,TOTALS,GERMANY,200,19,42,45.2,11,21,52.4,8,21,38.1,19,25,76.0,7,18,25,3,22,18,5,0,65,0
9601,224104,270_10_40,TURKEY,0,TOTALS,TURKEY,200,28,61,45.9,23,36,63.9,5,25,20.0,14,20,70.0,15,17,32,15,22,11,8,1,75,1
9602,224117,270_10_41,MONTENEGRO,0,TOTALS,MONTENEGRO,200,24,63,38.1,16,42,38.1,8,21,38.1,14,18,77.8,15,19,34,11,18,14,13,3,70,1
9603,224130,270_10_41,LATVIA,0,TOTALS,LATVIA,200,19,41,46.3,15,30,50.0,4,11,36.4,15,18,83.3,3,24,27,11,16,23,8,8,57,0
9604,224143,270_10_42,RUSSIA,0,TOTALS,RUSSIA,200,20,65,30.8,14,36,38.9,6,29,20.7,22,29,75.9,23,24,47,7,16,15,7,0,68,0
9605,224156,270_10_42,SLOVENIA,0,TOTALS,SLOVENIA,200,30,59,50.8,19,36,52.8,11,23,47.8,11,19,57.9,9,23,32,14,29,12,9,2,82,1
9606,224169,270_10_43,SERBIA,0,TOTALS,SERBIA,200,23,60,38.3,19,42,45.2,4,18,22.2,12,15,80.0,9,31,40,11,21,11,3,0,62,0
9607,224182,270_10_43,GREECE,0,TOTALS,GREECE,200,24,61,39.3,22,48,45.8,2,13,15.4,13,22,59.1,9,28,37,7,18,7,7,3,63,1
9608,224195,270_10_44,SPAIN,0,TOTALS,SPAIN,200,21,46,45.7,17,27,63.0,4,19,21.1,23,29,79.3,9,33,42,11,18,17,5,3,69,1
9609,224208,270_10_44,FRANCE,0,TOTALS,FRANCE,200,28,71,39.4,22,45,48.9,6,26,23.1,4,12,33.3,13,18,31,9,26,8,10,2,66,0
9610,224219,270_10_45,CZECH REPUBLIC,0,TOTALS,CZECH REPUBLIC,225,24,59,40.7,18,34,52.9,6,25,24.0,7,13,53.8,6,19,25,8,21,18,5,0,61,0
9611,224232,270_10_45,TURKEY,0,TOTALS,TURKEY,225,24,58,41.4,16,33,48.5,8,25,32.0,14,19,73.7,8,21,29,14,22,21,12,1,70,1
9612,224245,270_10_46,UKRAINE,0,TOTALS,UKRAINE,200,25,61,41.0,16,40,40.0,9,21,42.9,6,10,60.0,11,21,32,11,22,21,7,3,65,1
9613,224258,270_10_46,LITHUANIA,0,TOTALS,LITHUANIA,200,34,66,51.5,20,37,54.1,14,29,48.3,18,26,69.2,14,20,34,21,13,11,7,4,100,0
9614,224270,270_10_47,CROATIA,0,TOTALS,CROATIA,200,27,59,45.8,21,42,50.0,6,17,35.3,17,22,77.3,11,32,43,16,16,20,11,2,77,1
9615,224283,270_10_47,ITALY,0,TOTALS,ITALY,200,21,61,34.4,11,31,35.5,10,30,33.3,11,13,84.6,8,23,31,12,18,20,11,4,63,0
9616,224296,270_10_48,NETHERLANDS,0,TOTALS,NETHERLANDS,200,19,67,28.4,12,31,38.7,7,36,19.4,12,16,75.0,13,22,35,6,19,12,5,0,57,0
9617,224309,270_10_48,GERMANY,0,TOTALS,GERMANY,200,26,57,45.6,21,43,48.8,5,14,35.7,10,18,55.6,13,28,41,8,17,17,5,1,67,1
9618,224322,270_10_49,GERMANY,0,TOTALS,GERMANY,200,26,62,41.9,19,42,45.2,7,20,35.0,16,20,80.0,9,23,32,16,21,15,12,2,75,1
9619,224333,270_10_49,CZECH REPUBLIC,0,TOTALS,CZECH REPUBLIC,200,22,56,39.3,14,36,38.9,8,20,40.0,7,13,53.8,8,20,28,7,23,20,6,3,59,0
9620,224346,270_10_50,GREECE,0,TOTALS,GREECE,200,31,63,49.2,28,50,56.0,3,13,23.1,9,16,56.2,8,31,39,7,17,15,8,1,74,1
9621,224359,270_10_50,RUSSIA,0,TOTALS,RUSSIA,200,22,65,33.8,17,42,40.5,5,23,21.7,6,8,75.0,11,20,31,7,17,13,6,1,55,0
9622,224372,270_10_51,NETHERLANDS,0,TOTALS,NETHERLANDS,200,27,63,42.9,21,41,51.2,6,22,27.3,10,15,66.7,10,16,26,12,19,16,19,4,70,1
9623,224385,270_10_51,TURKEY,0,TOTALS,TURKEY,200,25,53,47.2,19,32,59.4,6,21,28.6,10,14,71.4,11,24,35,9,18,25,13,3,66,0
9624,224398,270_10_52,UKRAINE,0,TOTALS,UKRAINE,200,19,41,46.3,10,24,41.7,9,17,52.9,10,16,62.5,6,18,24,10,19,19,5,0,57,0
9625,224411,270_10_52,FRANCE,0,TOTALS,FRANCE,200,26,54,48.1,10,22,45.5,16,32,50.0,12,20,60.0,13,15,28,16,22,10,13,1,80,1
9626,224424,270_10_53,LITHUANIA,0,TOTALS,LITHUANIA,200,26,49,53.1,22,34,64.7,4,15,26.7,18,30,60.0,7,25,32,9,22,13,4,2,74,1
9627,224437,270_10_53,SLOVENIA,0,TOTALS,SLOVENIA,200,25,68,36.8,20,45,44.4,5,23,21.7,17,27,63.0,16,21,37,8,26,7,6,3,72,0
9628,224450,270_10_54,SPAIN,0,TOTALS,SPAIN,200,22,56,39.3,17,42,40.5,5,14,35.7,15,21,71.4,12,25,37,9,15,11,10,0,64,1
9629,224463,270_10_54,MONTENEGRO,0,TOTALS,MONTENEGRO,200,18,48,37.5,10,20,50.0,8,28,28.6,6,8,75.0,3,20,23,5,22,13,8,3,50,0
9630,224475,270_10_55,CROATIA,0,TOTALS,CROATIA,200,30,65,46.2,22,43,51.2,8,22,36.4,8,12,66.7,12,16,28,10,22,13,9,1,76,1
9631,224488,270_10_55,SERBIA,0,TOTALS,SERBIA,200,25,55,45.5,18,33,54.5,7,22,31.8,18,25,72.0,13,21,34,11,19,17,6,2,75,0
9632,224501,270_10_56,ITALY,0,TOTALS,ITALY,200,23,56,41.1,15,28,53.6,8,28,28.6,24,31,77.4,9,16,25,10,22,14,13,3,78,1
9633,224514,270_10_56,LATVIA,0,TOTALS,LATVIA,200,25,52,48.1,18,33,54.5,7,19,36.8,16,22,72.7,10,27,37,7,21,23,8,3,73,0
9634,224527,270_10_57,UKRAINE,0,TOTALS,UKRAINE,200,22,46,47.8,17,36,47.2,5,10,50.0,12,17,70.6,3,20,23,5,16,14,3,2,61,0
9635,224540,270_10_57,MONTENEGRO,0,TOTALS,MONTENEGRO,200,31,60,51.7,22,36,61.1,9,24,37.5,13,18,72.2,11,20,31,9,18,7,4,2,84,1
9636,224553,270_10_58,TURKEY,0,TOTALS,TURKEY,200,23,54,42.6,15,23,65.2,8,31,25.8,20,27,74.1,11,22,33,16,19,13,13,5,74,1
9637,224566,270_10_58,GERMANY,0,TOTALS,GERMANY,200,27,56,48.2,18,33,54.5,9,23,39.1,5,10,50.0,8,18,26,16,26,17,6,3,68,0
9638,224579,270_10_59,RUSSIA,0,TOTALS,RUSSIA,200,29,68,42.6,20,39,51.3,9,29,31.0,25,29,86.2,16,28,44,11,23,14,5,2,92,1
9639,224592,270_10_59,SERBIA,0,TOTALS,SERBIA,200,27,64,42.2,23,42,54.8,4,22,18.2,22,24,91.7,8,22,30,8,27,11,5,1,80,0
9640,224603,270_10_60,CZECH REPUBLIC,0,TOTALS,CZECH REPUBLIC,200,23,54,42.6,11,30,36.7,12,24,50.0,13,24,54.2,8,22,30,18,17,22,5,1,71,0
9641,224616,270_10_60,NETHERLANDS,0,TOTALS,NETHERLANDS,200,29,67,43.3,23,43,53.5,6,24,25.0,17,20,85.0,10,24,34,11,22,12,14,1,81,1
9642,224629,270_10_61,SLOVENIA,0,TOTALS,SLOVENIA,200,26,55,47.3,13,27,48.1,13,28,46.4,8,10,80.0,7,17,24,11,20,11,5,2,73,0
9643,224642,270_10_61,LATVIA,0,TOTALS,LATVIA,200,30,53,56.6,22,32,68.8,8,21,38.1,8,19,42.1,7,18,25,12,14,12,5,4,76,1
9644,224655,270_10_62,GREECE,0,TOTALS,GREECE,200,22,47,46.8,17,31,54.8,5,16,31.2,22,30,73.3,6,27,33,12,17,20,15,1,71,1
9645,224667,270_10_62,CROATIA,0,TOTALS,CROATIA,200,21,62,33.9,18,39,46.2,3,23,13.0,11,14,78.6,8,22,30,5,25,17,10,0,56,0
9646,224680,270_10_63,LITHUANIA,0,TOTALS,LITHUANIA,200,27,54,50.0,19,33,57.6,8,21,38.1,12,25,48.0,10,28,38,8,12,18,6,2,74,1
9647,224693,270_10_63,ITALY,0,TOTALS,ITALY,200,29,61,47.5,22,37,59.5,7,24,29.2,8,13,61.5,6,19,25,14,22,11,9,2,73,0
9648,224706,270_10_64,FRANCE,0,TOTALS,FRANCE,200,31,57,54.4,22,33,66.7,9,24,37.5,15,21,71.4,10,23,33,13,27,14,6,1,86,1
9649,224719,270_10_64,SPAIN,0,TOTALS,SPAIN,200,24,51,47.1,16,32,50.0,8,19,42.1,27,34,79.4,7,13,20,10,20,12,10,3,83,0
9650,224732,270_10_65,TURKEY,0,TOTALS,TURKEY,200,27,65,41.5,23,42,54.8,4,23,17.4,14,23,60.9,18,27,45,8,20,15,5,5,72,1
9651,224743,270_10_65,CZECH REPUBLIC,0,TOTALS,CZECH REPUBLIC,200,23,59,39.0,18,39,46.2,5,20,25.0,11,16,68.8,9,20,29,13,21,12,11,3,62,0
9652,224756,270_10_66,SERBIA,0,TOTALS,SERBIA,200,40,72,55.6,23,35,65.7,17,37,45.9,10,18,55.6,6,25,31,11,19,11,9,1,107,0
9653,224769,270_10_66,UKRAINE,0,TOTALS,UKRAINE,200,34,71,47.9,21,42,50.0,13,29,44.8,12,18,66.7,11,28,39,8,13,18,8,2,93,1
9654,224782,270_10_67,GERMANY,0,TOTALS,GERMANY,200,25,52,48.1,17,32,53.1,8,20,40.0,15,19,78.9,11,27,38,14,13,17,5,3,73,1
9655,224795,270_10_67,NETHERLANDS,0,TOTALS,NETHERLANDS,200,23,65,35.4,17,43,39.5,6,22,27.3,5,9,55.6,14,15,29,9,22,13,8,2,57,0
9656,224807,270_10_68,RUSSIA,0,TOTALS,RUSSIA,200,25,63,39.7,20,42,47.6,5,21,23.8,15,22,68.2,10,22,32,8,14,13,13,1,70,1
9657,224820,270_10_68,MONTENEGRO,0,TOTALS,MONTENEGRO,200,23,54,42.6,17,36,47.2,6,18,33.3,8,12,66.7,7,22,29,9,25,18,7,2,60,0
9658,224833,270_10_69,CROATIA,0,TOTALS,CROATIA,225,28,73,38.4,16,36,44.4,12,37,32.4,11,21,52.4,8,25,33,16,30,11,9,0,79,0
9659,224846,270_10_69,SPAIN,0,TOTALS,SPAIN,225,27,61,44.3,24,42,57.1,3,19,15.8,29,41,70.7,11,31,42,7,18,11,7,2,86,1
9660,224859,270_10_70,GREECE,0,TOTALS,GREECE,200,16,40,40.0,15,27,55.6,1,13,7.7,29,35,82.9,6,13,19,8,18,18,11,1,62,0
9661,224872,270_10_70,FRANCE,0,TOTALS,FRANCE,200,23,42,54.8,13,22,59.1,10,20,50.0,17,17,100.0,2,19,21,6,26,20,12,2,73,1
9662,224885,271_10_01,ISRAEL,0,TOTALS,ISRAEL,200,26,58,44.8,20,38,52.6,6,20,30.0,9,18,50.0,8,29,37,8,20,17,7,3,67,0
9663,224898,271_10_01,SWEDEN,0,TOTALS,SWEDEN,200,26,61,42.6,15,32,46.9,11,29,37.9,8,21,38.1,10,28,38,13,16,15,6,1,71,1
9664,224911,271_10_02,BULGARIA,0,TOTALS,BULGARIA,225,28,56,50.0,16,27,59.3,12,29,41.4,23,32,71.9,8,30,38,8,15,25,5,1,91,1
9665,224924,271_10_02,PORTUGAL,0,TOTALS,PORTUGAL,225,30,68,44.1,17,34,50.0,13,34,38.2,13,18,72.2,8,19,27,13,31,21,11,1,86,0
9666,224937,271_10_03,HUNGARY,0,TOTALS,HUNGARY,200,28,61,45.9,17,37,45.9,11,24,45.8,16,23,69.6,12,22,34,18,16,18,8,5,83,1
9667,224950,271_10_03,GEORGIA,0,TOTALS,GEORGIA,200,28,69,40.6,24,48,50.0,4,21,19.0,7,12,58.3,22,21,43,15,20,23,9,2,67,0
9668,224963,271_10_04,SWITZERLAND,0,TOTALS,SWITZERLAND,200,24,60,40.0,16,44,36.4,8,16,50.0,8,11,72.7,10,25,35,5,24,21,7,2,64,0
9669,224976,271_10_04,FINLAND,0,TOTALS,FINLAND,200,31,59,52.5,17,34,50.0,14,25,56.0,16,23,69.6,8,24,32,9,14,18,7,3,92,1
9670,224989,271_10_05,BELGIUM,0,TOTALS,BELGIUM,200,31,66,47.0,22,36,61.1,9,30,30.0,8,10,80.0,6,16,22,13,17,7,7,0,79,0
9671,225002,271_10_05,AUSTRIA,0,TOTALS,AUSTRIA,200,33,55,60.0,25,37,67.6,8,18,44.4,14,15,93.3,5,27,32,11,15,15,6,3,88,1
9672,225014,271_10_06,BELARUS,0,TOTALS,BELARUS,200,14,61,23.0,14,51,27.5,0,10,0.0,7,16,43.8,16,28,44,4,16,23,8,2,35,0
9673,225027,271_10_06,NORWAY,0,TOTALS,NORWAY,200,33,65,50.8,24,41,58.5,9,24,37.5,5,9,55.6,7,32,39,9,18,15,9,0,80,1
9674,225040,271_10_07,GREAT BRITAIN,0,TOTALS,GREAT BRITAIN,200,30,60,50.0,26,43,60.5,4,17,23.5,15,23,65.2,9,24,33,8,18,14,16,4,79,1
9675,225053,271_10_07,DENMARK,0,TOTALS,DENMARK,200,24,53,45.3,16,35,45.7,8,18,44.4,9,14,64.3,8,22,30,7,17,26,4,1,65,0
9676,225066,271_10_08,SLOVAK REPUBLIC,0,TOTALS,SLOVAK REPUBLIC,200,25,57,43.9,15,34,44.1,10,23,43.5,16,22,72.7,9,30,39,18,20,14,3,3,76,1
9677,225079,271_10_08,ROMANIA,0,TOTALS,ROMANIA,200,21,60,35.0,20,44,45.5,1,16,6.2,19,24,79.2,13,24,37,11,23,18,6,3,62,0
9678,225092,271_10_09,POLAND,0,TOTALS,POLAND,200,38,66,57.6,30,43,69.8,8,23,34.8,14,28,50.0,14,29,43,14,17,11,9,4,98,1
9679,225105,271_10_09,SLOVAK REPUBLIC,0,TOTALS,SLOVAK REPUBLIC,200,21,63,33.3,14,36,38.9,7,27,25.9,5,10,50.0,12,20,32,11,27,16,2,1,54,0
9680,225118,271_10_10,ROMANIA,0,TOTALS,ROMANIA,200,17,60,28.3,14,46,30.4,3,14,21.4,23,30,76.7,15,29,44,6,20,12,8,2,60,0
9681,225130,271_10_10,BELARUS,0,TOTALS,BELARUS,200,25,73,34.2,20,52,38.5,5,21,23.8,11,20,55.0,19,26,45,11,24,15,8,9,66,1
9682,225143,271_10_11,GEORGIA,0,TOTALS,GEORGIA,200,26,59,44.1,15,30,50.0,11,29,37.9,18,28,64.3,12,18,30,10,27,13,6,2,81,0
9683,225156,271_10_11,ISRAEL,0,TOTALS,ISRAEL,200,32,58,55.2,28,45,62.2,4,13,30.8,20,27,74.1,9,20,29,9,25,13,3,0,88,1
9684,225169,271_10_12,NORWAY,0,TOTALS,NORWAY,200,22,59,37.3,14,36,38.9,8,23,34.8,18,28,64.3,12,18,30,11,23,16,11,0,70,1
9685,225182,271_10_12,ROMANIA,0,TOTALS,ROMANIA,200,20,46,43.5,13,27,48.1,7,19,36.8,16,19,84.2,9,26,35,6,25,24,5,1,63,0
9686,225195,271_10_13,SWEDEN,0,TOTALS,SWEDEN,200,33,79,41.8,23,45,51.1,10,34,29.4,11,12,91.7,15,25,40,11,16,4,12,0,87,1
9687,225208,271_10_13,HUNGARY,0,TOTALS,HUNGARY,200,26,52,50.0,23,36,63.9,3,16,18.8,12,21,57.1,3,29,32,9,15,18,0,2,67,0
9688,225220,271_10_14,BELARUS,0,TOTALS,BELARUS,200,18,59,30.5,16,44,36.4,2,15,13.3,18,37,48.6,17,26,43,8,21,18,2,5,56,0
9689,225233,271_10_14,POLAND,0,TOTALS,POLAND,200,31,75,41.3,22,50,44.0,9,25,36.0,16,26,61.5,23,34,57,9,24,16,11,2,87,1
9690,225246,271_10_15,FINLAND,0,TOTALS,FINLAND,200,17,53,32.1,9,19,47.4,8,34,23.5,7,10,70.0,8,20,28,8,24,15,5,2,49,0
9691,225259,271_10_15,BULGARIA,0,TOTALS,BULGARIA,200,23,52,44.2,22,35,62.9,1,17,5.9,16,24,66.7,13,30,43,10,18,13,3,3,63,1
9692,225272,271_10_16,DENMARK,0,TOTALS,DENMARK,200,19,63,30.2,16,48,33.3,3,15,20.0,14,20,70.0,13,23,36,2,14,8,1,0,55,0
9693,225285,271_10_16,BELGIUM,0,TOTALS,BELGIUM,200,32,74,43.2,26,49,53.1,6,25,24.0,6,8,75.0,13,31,44,9,22,8,4,2,76,1
9694,225298,271_10_17,PORTUGAL,0,TOTALS,PORTUGAL,200,25,56,44.6,18,31,58.1,7,25,28.0,13,20,65.0,17,24,41,11,25,21,10,3,70,1
9695,225311,271_10_17,SWITZERLAND,0,TOTALS,SWITZERLAND,200,20,54,37.0,10,26,38.5,10,28,35.7,18,25,72.0,12,16,28,5,22,21,6,1,68,0
9696,225324,271_10_18,AUSTRIA,0,TOTALS,AUSTRIA,200,30,58,51.7,12,28,42.9,18,30,60.0,13,23,56.5,10,27,37,13,21,15,8,1,91,1
9697,225337,271_10_18,GREAT BRITAIN,0,TOTALS,GREAT BRITAIN,200,23,52,44.2,14,29,48.3,9,23,39.1,16,26,61.5,6,21,27,10,20,15,7,2,71,0
9698,225350,271_10_19,SLOVAK REPUBLIC,0,TOTALS,SLOVAK REPUBLIC,200,22,54,40.7,15,30,50.0,7,24,29.2,13,23,56.5,16,23,39,6,24,19,9,3,64,1
9699,225362,271_10_19,BELARUS,0,TOTALS,BELARUS,200,17,51,33.3,14,38,36.8,3,13,23.1,16,29,55.2,16,19,35,4,25,21,5,2,53,0
9700,225375,271_10_20,POLAND,0,TOTALS,POLAND,200,33,63,52.4,21,36,58.3,12,27,44.4,13,19,68.4,14,29,43,12,22,16,5,3,91,1
9701,225388,271_10_20,NORWAY,0,TOTALS,NORWAY,200,24,62,38.7,17,35,48.6,7,27,25.9,15,23,65.2,7,18,25,8,23,16,10,4,70,0
9702,225401,271_10_21,BULGARIA,0,TOTALS,BULGARIA,200,37,61,60.7,26,37,70.3,11,24,45.8,19,31,61.3,10,26,36,17,12,15,16,3,104,0
9703,225414,271_10_21,SWITZERLAND,0,TOTALS,SWITZERLAND,200,24,57,42.1,20,38,52.6,4,19,21.1,7,10,70.0,7,16,23,7,20,24,9,1,59,1
9704,225427,271_10_22,BELGIUM,0,TOTALS,BELGIUM,200,13,52,25.0,3,18,16.7,10,34,29.4,16,24,66.7,12,26,38,10,21,23,2,1,52,0
9705,225440,271_10_22,GREAT BRITAIN,0,TOTALS,GREAT BRITAIN,200,27,66,40.9,25,50,50.0,2,16,12.5,17,28,60.7,18,28,46,15,20,12,12,3,73,1
9706,225453,271_10_23,FINLAND,0,TOTALS,FINLAND,250,34,71,47.9,21,40,52.5,13,31,41.9,17,27,63.0,9,31,40,14,30,17,4,0,98,0
9707,225466,271_10_23,PORTUGAL,0,TOTALS,PORTUGAL,250,35,68,51.5,21,39,53.8,14,29,48.3,15,27,55.6,6,30,36,12,25,18,8,2,99,1
9708,225479,271_10_24,DENMARK,0,TOTALS,DENMARK,200,20,48,41.7,16,34,47.1,4,14,28.6,20,37,54.1,14,27,41,8,22,19,8,1,64,1
9709,225492,271_10_24,AUSTRIA,0,TOTALS,AUSTRIA,200,21,58,36.2,13,33,39.4,8,25,32.0,13,20,65.0,14,19,33,7,31,17,8,2,63,0
9710,225505,271_10_25,ISRAEL,0,TOTALS,ISRAEL,200,29,63,46.0,21,44,47.7,8,19,42.1,20,25,80.0,12,30,42,14,25,10,7,1,86,1
9711,225518,271_10_25,HUNGARY,0,TOTALS,HUNGARY,200,27,60,45.0,20,36,55.6,7,24,29.2,17,23,73.9,6,24,30,12,22,11,5,5,78,0
9712,225531,271_10_26,NORWAY,0,TOTALS,NORWAY,200,25,53,47.2,18,31,58.1,7,22,31.8,11,16,68.8,15,24,39,14,19,18,5,1,68,1
9713,225544,271_10_26,SLOVAK REPUBLIC,0,TOTALS,SLOVAK REPUBLIC,200,19,62,30.6,10,24,41.7,9,38,23.7,11,19,57.9,19,13,32,10,20,10,10,1,58,0
9714,225557,271_10_27,GEORGIA,0,TOTALS,GEORGIA,200,25,58,43.1,18,30,60.0,7,28,25.0,22,35,62.9,13,29,42,10,19,18,7,3,79,1
9715,225570,271_10_27,SWEDEN,0,TOTALS,SWEDEN,200,27,65,41.5,21,38,55.3,6,27,22.2,13,17,76.5,12,25,37,9,28,21,6,1,73,0
9716,225583,271_10_28,ROMANIA,0,TOTALS,ROMANIA,200,25,58,43.1,21,43,48.8,4,15,26.7,19,23,82.6,9,16,25,12,20,21,7,1,73,0
9717,225596,271_10_28,POLAND,0,TOTALS,POLAND,200,37,63,58.7,26,38,68.4,11,25,44.0,11,18,61.1,11,27,38,23,21,23,11,2,96,1
9718,225609,271_10_29,PORTUGAL,0,TOTALS,PORTUGAL,200,20,63,31.7,14,34,41.2,6,29,20.7,11,22,50.0,17,18,35,4,24,15,5,0,57,0
9719,225622,271_10_29,ISRAEL,0,TOTALS,ISRAEL,200,21,58,36.2,21,46,45.7,0,12,0.0,22,24,91.7,16,28,44,7,22,18,6,2,64,1
9720,225635,271_10_30,NORWAY,0,TOTALS,NORWAY,200,18,54,33.3,13,25,52.0,5,29,17.2,6,10,60.0,4,12,16,5,20,21,8,1,47,0
9721,225648,271_10_30,GREAT BRITAIN,0,TOTALS,GREAT BRITAIN,200,30,51,58.8,21,34,61.8,9,17,52.9,14,16,87.5,7,32,39,15,19,20,14,1,83,1
9722,225661,271_10_31,FINLAND,0,TOTALS,FINLAND,200,25,58,43.1,20,34,58.8,5,24,20.8,29,42,69.0,16,29,45,7,24,10,3,1,84,1
9723,225674,271_10_31,SWEDEN,0,TOTALS,SWEDEN,200,22,59,37.3,11,32,34.4,11,27,40.7,22,34,64.7,12,23,35,5,33,8,4,2,77,0
9724,225687,271_10_32,HUNGARY,0,TOTALS,HUNGARY,200,23,48,47.9,16,29,55.2,7,19,36.8,4,8,50.0,5,16,21,11,23,24,6,1,57,0
9725,225700,271_10_32,BULGARIA,0,TOTALS,BULGARIA,200,34,63,54.0,24,36,66.7,10,27,37.0,11,21,52.4,13,18,31,12,12,13,14,1,89,1
9726,225713,271_10_33,SLOVAK REPUBLIC,0,TOTALS,SLOVAK REPUBLIC,200,24,63,38.1,16,33,48.5,8,30,26.7,9,10,90.0,14,16,30,8,28,11,3,2,65,0
9727,225726,271_10_33,AUSTRIA,0,TOTALS,AUSTRIA,200,20,42,47.6,12,28,42.9,8,14,57.1,24,33,72.7,8,25,33,9,18,19,6,0,72,1
9728,225739,271_10_34,BELGIUM,0,TOTALS,BELGIUM,200,27,65,41.5,22,43,51.2,5,22,22.7,13,18,72.2,9,24,33,14,19,19,11,2,72,0
9729,225752,271_10_34,POLAND,0,TOTALS,POLAND,200,29,62,46.8,22,42,52.4,7,20,35.0,19,23,82.6,10,30,40,7,19,15,6,4,84,1
9730,225765,271_10_35,SWEDEN,0,TOTALS,SWEDEN,200,29,60,48.3,15,32,46.9,14,28,50.0,15,20,75.0,12,26,38,16,28,22,6,0,87,1
9731,225778,271_10_35,PORTUGAL,0,TOTALS,PORTUGAL,200,28,56,50.0,20,33,60.6,8,23,34.8,15,24,62.5,4,16,20,13,23,13,6,0,79,0
9732,225791,271_10_36,SWITZERLAND,0,TOTALS,SWITZERLAND,200,22,71,31.0,10,44,22.7,12,27,44.4,6,8,75.0,13,19,32,10,23,22,15,2,62,0
9733,225804,271_10_36,ROMANIA,0,TOTALS,ROMANIA,200,32,56,57.1,27,43,62.8,5,13,38.5,19,26,73.1,9,36,45,17,14,26,8,11,88,1
9734,225817,271_10_37,FINLAND,0,TOTALS,FINLAND,200,32,63,50.8,19,31,61.3,13,32,40.6,9,12,75.0,7,26,33,12,21,9,4,1,86,1
9735,225830,271_10_37,HUNGARY,0,TOTALS,HUNGARY,200,22,55,40.0,15,34,44.1,7,21,33.3,8,14,57.1,8,23,31,8,18,14,5,1,59,0
9736,225842,271_10_38,BELARUS,0,TOTALS,BELARUS,200,19,59,32.2,17,48,35.4,2,11,18.2,30,42,71.4,16,28,44,2,28,19,8,4,70,0
9737,225855,271_10_38,DENMARK,0,TOTALS,DENMARK,200,23,57,40.4,18,46,39.1,5,11,45.5,20,33,60.6,14,27,41,4,29,22,10,1,71,1
9738,225868,271_10_39,ISRAEL,0,TOTALS,ISRAEL,200,24,52,46.2,21,36,58.3,3,16,18.8,6,15,40.0,8,28,36,9,21,19,10,2,57,0
9739,225881,271_10_39,BULGARIA,0,TOTALS,BULGARIA,200,23,55,41.8,17,34,50.0,6,21,28.6,10,20,50.0,9,24,33,13,17,17,5,1,62,1
9740,225894,271_10_40,SLOVAK REPUBLIC,0,TOTALS,SLOVAK REPUBLIC,200,30,70,42.9,22,44,50.0,8,26,30.8,8,13,61.5,10,21,31,7,14,9,5,3,76,0
9741,225907,271_10_40,BELGIUM,0,TOTALS,BELGIUM,200,31,60,51.7,21,36,58.3,10,24,41.7,10,12,83.3,8,27,35,16,15,14,3,1,82,1
9742,225920,271_10_41,AUSTRIA,0,TOTALS,AUSTRIA,200,21,56,37.5,13,31,41.9,8,25,32.0,11,18,61.1,15,29,44,15,15,19,3,3,61,1
9743,225933,271_10_41,NORWAY,0,TOTALS,NORWAY,200,21,58,36.2,12,33,36.4,9,25,36.0,5,11,45.5,11,24,35,9,21,15,7,2,56,0
9744,225946,271_10_42,GREAT BRITAIN,0,TOTALS,GREAT BRITAIN,200,37,69,53.6,27,47,57.4,10,22,45.5,14,24,58.3,9,18,27,11,21,10,15,2,98,1
9745,225959,271_10_42,POLAND,0,TOTALS,POLAND,200,30,57,52.6,17,23,73.9,13,34,38.2,16,18,88.9,6,25,31,8,26,20,4,0,89,0
9746,225972,271_10_43,ISRAEL,0,TOTALS,ISRAEL,200,32,57,56.1,22,41,53.7,10,16,62.5,4,6,66.7,3,29,32,20,20,16,8,1,78,1
9747,225985,271_10_43,FINLAND,0,TOTALS,FINLAND,200,23,59,39.0,16,33,48.5,7,26,26.9,9,13,69.2,8,22,30,14,11,16,7,2,62,0
9748,225998,271_10_44,GEORGIA,0,TOTALS,GEORGIA,200,28,57,49.1,25,41,61.0,3,16,18.8,13,18,72.2,15,30,45,7,22,22,13,6,72,1
9749,226010,271_10_44,BELARUS,0,TOTALS,BELARUS,200,25,66,37.9,23,52,44.2,2,14,14.3,10,13,76.9,11,18,29,8,22,19,10,6,62,0
9750,226023,271_10_45,PORTUGAL,0,TOTALS,PORTUGAL,200,29,62,46.8,22,40,55.0,7,22,31.8,15,26,57.7,6,15,21,11,14,9,13,1,80,1
9751,226036,271_10_45,HUNGARY,0,TOTALS,HUNGARY,200,29,55,52.7,20,35,57.1,9,20,45.0,10,12,83.3,12,31,43,15,26,25,3,1,77,0
9752,226049,271_10_46,NORWAY,0,TOTALS,NORWAY,200,24,57,42.1,20,40,50.0,4,17,23.5,17,23,73.9,10,18,28,6,20,13,7,1,69,0
9753,226062,271_10_46,BELGIUM,0,TOTALS,BELGIUM,200,27,56,48.2,13,26,50.0,14,30,46.7,17,19,89.5,12,25,37,15,22,16,4,1,85,1
9754,226075,271_10_47,BULGARIA,0,TOTALS,BULGARIA,200,24,62,38.7,19,36,52.8,5,26,19.2,8,13,61.5,16,19,35,13,14,14,7,0,61,0
9755,226088,271_10_47,SWEDEN,0,TOTALS,SWEDEN,200,27,60,45.0,16,33,48.5,11,27,40.7,9,10,90.0,14,24,38,12,19,15,5,0,74,1
9756,226101,271_10_48,GREAT BRITAIN,0,TOTALS,GREAT BRITAIN,200,32,61,52.5,25,41,61.0,7,20,35.0,11,25,44.0,14,29,43,18,15,21,18,2,82,1
9757,226114,271_10_48,SLOVAK REPUBLIC,0,TOTALS,SLOVAK REPUBLIC,200,23,60,38.3,10,31,32.3,13,29,44.8,7,13,53.8,9,22,31,12,26,25,11,2,66,0
9758,226127,271_10_49,POLAND,0,TOTALS,POLAND,200,29,62,46.8,17,32,53.1,12,30,40.0,12,16,75.0,16,18,34,9,25,15,6,1,82,1
9759,226140,271_10_49,AUSTRIA,0,TOTALS,AUSTRIA,200,28,52,53.8,22,33,66.7,6,19,31.6,16,21,76.2,8,16,24,5,19,16,5,1,78,0
9760,226153,271_10_50,DENMARK,0,TOTALS,DENMARK,200,26,60,43.3,21,42,50.0,5,18,27.8,13,24,54.2,11,44,55,9,16,19,6,1,70,1
9761,226166,271_10_50,SWITZERLAND,0,TOTALS,SWITZERLAND,200,16,68,23.5,14,46,30.4,2,22,9.1,8,12,66.7,9,27,36,6,18,13,11,3,42,0
9762,226179,271_10_51,ROMANIA,0,TOTALS,ROMANIA,225,28,69,40.6,22,51,43.1,6,18,33.3,20,26,76.9,12,30,42,8,21,16,7,3,82,1
9763,226192,271_10_51,DENMARK,0,TOTALS,DENMARK,225,25,73,34.2,17,49,34.7,8,24,33.3,20,30,66.7,20,34,54,11,22,16,10,4,78,0
9764,226205,271_10_52,SWITZERLAND,0,TOTALS,SWITZERLAND,200,26,70,37.1,17,45,37.8,9,25,36.0,12,24,50.0,20,18,38,9,17,12,8,0,73,0
9765,226218,271_10_52,GEORGIA,0,TOTALS,GEORGIA,200,30,58,51.7,20,33,60.6,10,25,40.0,11,19,57.9,15,29,44,10,22,18,4,5,81,1
9766,226230,271_10_53,BELARUS,0,TOTALS,BELARUS,200,23,76,30.3,20,55,36.4,3,21,14.3,13,16,81.2,19,28,47,14,30,20,8,2,62,0
9767,226243,271_10_53,SWITZERLAND,0,TOTALS,SWITZERLAND,200,25,57,43.9,19,40,47.5,6,17,35.3,17,28,60.7,7,33,40,9,20,21,9,5,73,1
9768,226256,271_10_54,ISRAEL,0,TOTALS,ISRAEL,200,37,68,54.4,29,51,56.9,8,17,47.1,18,22,81.8,9,23,32,9,19,9,7,1,100,0
9769,226269,271_10_54,BELGIUM,0,TOTALS,BELGIUM,200,35,64,54.7,28,40,70.0,7,24,29.2,16,16,100.0,7,24,31,10,20,12,3,2,93,1
9770,226282,271_10_55,GEORGIA,0,TOTALS,GEORGIA,200,42,68,61.8,32,41,78.0,10,27,37.0,3,8,37.5,4,26,30,18,18,11,10,2,97,1
9771,226295,271_10_55,ROMANIA,0,TOTALS,ROMANIA,200,27,65,41.5,21,42,50.0,6,23,26.1,10,16,62.5,11,20,31,9,15,20,1,0,70,0
9772,226308,271_10_56,GREAT BRITAIN,0,TOTALS,GREAT BRITAIN,200,33,57,57.9,25,40,62.5,8,17,47.1,17,28,60.7,9,35,44,10,21,20,8,4,91,1
9773,226321,271_10_56,PORTUGAL,0,TOTALS,PORTUGAL,200,24,70,34.3,18,41,43.9,6,29,20.7,12,18,66.7,13,16,29,7,23,15,12,1,66,0
9774,226334,271_10_57,FINLAND,0,TOTALS,FINLAND,200,28,66,42.4,17,38,44.7,11,28,39.3,22,30,73.3,15,35,50,16,25,13,8,1,89,1
9775,226347,271_10_57,SLOVAK REPUBLIC,0,TOTALS,SLOVAK REPUBLIC,200,18,56,32.1,15,35,42.9,3,21,14.3,22,31,71.0,8,25,33,7,24,13,8,3,61,0
9776,226360,271_10_58,SWEDEN,0,TOTALS,SWEDEN,200,32,79,40.5,26,52,50.0,6,27,22.2,9,18,50.0,17,29,46,10,19,8,12,0,79,1
9777,226373,271_10_58,POLAND,0,TOTALS,POLAND,200,24,63,38.1,17,37,45.9,7,26,26.9,14,21,66.7,14,36,50,10,20,18,3,3,69,0
9778,226386,271_10_59,NORWAY,0,TOTALS,NORWAY,200,24,58,41.4,16,33,48.5,8,25,32.0,17,21,81.0,9,18,27,10,18,11,7,2,73,1
9779,226399,271_10_59,HUNGARY,0,TOTALS,HUNGARY,200,22,50,44.0,14,28,50.0,8,22,36.4,14,16,87.5,10,29,39,12,22,20,6,5,66,0
9780,226412,271_10_60,AUSTRIA,0,TOTALS,AUSTRIA,200,29,47,61.7,21,31,67.7,8,16,50.0,10,16,62.5,4,26,30,15,15,14,3,2,76,1
9781,226425,271_10_60,BULGARIA,0,TOTALS,BULGARIA,200,26,58,44.8,16,27,59.3,10,31,32.3,9,16,56.2,9,18,27,11,18,6,6,1,71,0
9782,226438,271_10_61,DENMARK,0,TOTALS,DENMARK,200,32,75,42.7,28,53,52.8,4,22,18.2,12,15,80.0,17,28,45,13,17,17,6,1,80,0
9783,226451,271_10_61,GEORGIA,0,TOTALS,GEORGIA,200,30,65,46.2,20,32,62.5,10,33,30.3,13,19,68.4,10,27,37,14,10,16,8,4,83,1
9784,226464,271_10_62,BELGIUM,0,TOTALS,BELGIUM,200,27,74,36.5,23,48,47.9,4,26,15.4,3,10,30.0,21,38,59,14,18,19,5,1,61,0
9785,226477,271_10_62,PORTUGAL,0,TOTALS,PORTUGAL,200,21,60,35.0,15,40,37.5,6,20,30.0,16,22,72.7,6,30,36,9,11,10,8,2,64,1
9786,226490,271_10_63,SLOVAK REPUBLIC,0,TOTALS,SLOVAK REPUBLIC,200,29,63,46.0,20,36,55.6,9,27,33.3,18,20,90.0,8,29,37,17,23,15,11,4,85,0
9787,226503,271_10_63,HUNGARY,0,TOTALS,HUNGARY,200,31,69,44.9,23,51,45.1,8,18,44.4,18,29,62.1,17,26,43,11,14,13,11,2,88,1
9788,226516,271_10_64,ISRAEL,0,TOTALS,ISRAEL,200,35,68,51.5,23,47,48.9,12,21,57.1,21,23,91.3,9,34,43,19,24,16,6,3,103,0
9789,226529,271_10_64,GREAT BRITAIN,0,TOTALS,GREAT BRITAIN,200,31,71,43.7,21,45,46.7,10,26,38.5,20,28,71.4,10,25,35,21,22,11,7,4,92,1
9790,226542,271_10_65,FINLAND,0,TOTALS,FINLAND,200,23,56,41.1,15,32,46.9,8,24,33.3,11,14,78.6,11,23,34,14,20,14,9,0,65,1
9791,226555,271_10_65,NORWAY,0,TOTALS,NORWAY,200,19,44,43.2,17,31,54.8,2,13,15.4,14,22,63.6,6,23,29,6,17,15,10,5,54,0
9792,226568,271_10_66,POLAND,0,TOTALS,POLAND,200,32,57,56.1,24,34,70.6,8,23,34.8,14,19,73.7,7,21,28,14,20,16,10,2,86,1
9793,226581,271_10_66,BULGARIA,0,TOTALS,BULGARIA,200,30,57,52.6,22,35,62.9,8,22,36.4,8,12,66.7,7,20,27,16,20,24,9,0,76,0
9794,226594,271_10_67,SWEDEN,0,TOTALS,SWEDEN,200,24,63,38.1,16,33,48.5,8,30,26.7,10,17,58.8,16,17,33,12,18,16,10,5,66,0
9795,226607,271_10_67,AUSTRIA,0,TOTALS,AUSTRIA,200,28,61,45.9,23,37,62.2,5,24,20.8,10,15,66.7,16,24,40,14,17,17,9,3,71,1
9796,229316,274_10_01,SWEDEN,0,TOTALS,SWEDEN,200,20,66,30.3,14,44,31.8,6,22,27.3,12,23,52.2,14,25,39,10,21,19,6,4,58,0
9797,229329,274_10_01,LATVIA,0,TOTALS,LATVIA,200,36,77,46.8,31,59,52.5,5,18,27.8,12,18,66.7,19,36,55,17,22,15,10,3,89,1
9798,229342,274_10_02,TURKEY,0,TOTALS,TURKEY,250,34,83,41.0,18,43,41.9,16,40,40.0,13,17,76.5,17,26,43,16,19,19,16,3,97,1
9799,229355,274_10_02,RUSSIA,0,TOTALS,RUSSIA,250,38,88,43.2,35,61,57.4,3,27,11.1,9,15,60.0,23,33,56,17,15,23,13,5,88,0
9800,229368,274_10_03,SLOVENIA,0,TOTALS,SLOVENIA,200,31,78,39.7,21,58,36.2,10,20,50.0,10,14,71.4,17,21,38,12,18,14,11,0,82,0
9801,229381,274_10_03,POLAND,0,TOTALS,POLAND,200,36,69,52.2,26,43,60.5,10,26,38.5,7,11,63.6,14,32,46,20,20,23,6,9,89,1
9802,229394,274_10_04,BULGARIA,0,TOTALS,BULGARIA,200,18,55,32.7,14,32,43.8,4,23,17.4,16,26,61.5,17,22,39,9,11,24,11,1,56,0
9803,229407,274_10_04,ITALY,0,TOTALS,ITALY,200,30,59,50.8,21,36,58.3,9,23,39.1,6,11,54.5,9,25,34,18,25,21,14,2,75,1
9804,229420,274_10_05,LITHUANIA,0,TOTALS,LITHUANIA,200,31,64,48.4,22,41,53.7,9,23,39.1,10,15,66.7,15,32,47,20,16,21,9,5,81,1
9805,229433,274_10_05,UKRAINE,0,TOTALS,UKRAINE,200,22,67,32.8,11,40,27.5,11,27,40.7,6,12,50.0,13,21,34,10,16,19,13,5,61,0
9806,229446,274_10_06,SERBIA,0,TOTALS,SERBIA,200,26,68,38.2,21,47,44.7,5,21,23.8,8,22,36.4,17,27,44,18,17,11,9,8,65,1
9807,229459,274_10_06,CROATIA,0,TOTALS,CROATIA,200,21,58,36.2,16,36,44.4,5,22,22.7,10,16,62.5,13,28,41,12,22,19,5,4,57,0
9808,229472,274_10_07,FRANCE,0,TOTALS,FRANCE,200,17,54,31.5,16,40,40.0,1,14,7.1,22,33,66.7,17,31,48,7,17,22,5,0,57,0
9809,229485,274_10_07,SPAIN,0,TOTALS,SPAIN,200,23,66,34.8,18,41,43.9,5,25,20.0,10,15,66.7,13,22,35,9,24,12,10,3,61,1
9810,229498,274_10_08,GERMANY,0,TOTALS,GERMANY,200,20,54,37.0,17,37,45.9,3,17,17.6,12,17,70.6,10,25,35,11,24,20,8,4,55,0
9811,229511,274_10_08,GREECE,0,TOTALS,GREECE,200,22,61,36.1,12,39,30.8,10,22,45.5,11,16,68.8,14,26,40,12,16,14,7,3,65,1
9812,229524,274_10_09,UKRAINE,0,TOTALS,UKRAINE,200,24,74,32.4,20,50,40.0,4,24,16.7,7,13,53.8,16,25,41,18,15,18,6,10,59,0
9813,229537,274_10_09,SLOVENIA,0,TOTALS,SLOVENIA,200,30,63,47.6,24,41,58.5,6,22,27.3,13,20,65.0,10,32,42,15,19,16,14,3,79,1
9814,229550,274_10_10,RUSSIA,0,TOTALS,RUSSIA,200,33,72,45.8,24,47,51.1,9,25,36.0,13,16,81.2,19,26,45,15,13,13,12,2,88,1
9815,229563,274_10_10,BULGARIA,0,TOTALS,BULGARIA,200,24,67,35.8,18,34,52.9,6,33,18.2,3,8,37.5,19,20,39,14,17,22,5,3,57,0
9816,229576,274_10_11,LATVIA,0,TOTALS,LATVIA,200,22,61,36.1,17,36,47.2,5,25,20.0,12,19,63.2,12,33,45,9,16,17,6,8,61,1
9817,229589,274_10_11,FRANCE,0,TOTALS,FRANCE,200,23,63,36.5,19,41,46.3,4,22,18.2,8,16,50.0,11,32,43,14,20,13,11,4,58,0
9818,229602,274_10_12,GREECE,0,TOTALS,GREECE,200,19,56,33.9,15,39,38.5,4,17,23.5,17,22,77.3,7,23,30,7,22,10,8,2,59,1
9819,229615,274_10_12,SERBIA,0,TOTALS,SERBIA,200,19,56,33.9,16,35,45.7,3,21,14.3,16,25,64.0,18,32,50,8,23,21,5,3,57,0
9820,229628,274_10_13,POLAND,0,TOTALS,POLAND,200,21,67,31.3,18,50,36.0,3,17,17.6,21,30,70.0,13,24,37,16,14,15,10,5,66,0
9821,229641,274_10_13,LITHUANIA,0,TOTALS,LITHUANIA,200,34,77,44.2,24,40,60.0,10,37,27.0,9,12,75.0,17,36,53,14,26,24,9,6,87,1
9822,229654,274_10_14,CROATIA,0,TOTALS,CROATIA,200,20,50,40.0,11,34,32.4,9,16,56.2,32,40,80.0,9,24,33,13,22,14,12,2,81,1
9823,229667,274_10_14,GERMANY,0,TOTALS,GERMANY,200,24,54,44.4,16,34,47.1,8,20,40.0,17,22,77.3,8,25,33,10,27,19,4,4,73,0
9824,229680,274_10_15,SPAIN,0,TOTALS,SPAIN,200,31,71,43.7,24,45,53.3,7,26,26.9,26,37,70.3,18,30,48,20,19,10,18,2,95,1
9825,229693,274_10_15,SWEDEN,0,TOTALS,SWEDEN,200,21,62,33.9,19,49,38.8,2,13,15.4,13,21,61.9,14,28,42,8,27,26,6,3,57,0
9826,229706,274_10_16,ITALY,0,TOTALS,ITALY,200,32,54,59.3,20,33,60.6,12,21,57.1,23,29,79.3,7,23,30,22,18,14,11,1,99,1
9827,229719,274_10_16,TURKEY,0,TOTALS,TURKEY,200,27,63,42.9,24,47,51.1,3,16,18.8,17,21,81.0,15,17,32,14,21,18,7,1,74,0
9828,229732,274_10_17,POLAND,0,TOTALS,POLAND,200,27,62,43.5,18,35,51.4,9,27,33.3,13,22,59.1,5,29,34,19,19,15,15,4,76,1
9829,229745,274_10_17,UKRAINE,0,TOTALS,UKRAINE,200,23,65,35.4,15,40,37.5,8,25,32.0,13,17,76.5,14,30,44,16,23,22,9,7,67,0
9830,229758,274_10_18,SERBIA,0,TOTALS,SERBIA,200,21,59,35.6,12,33,36.4,9,26,34.6,17,26,65.4,13,28,41,16,26,13,11,6,68,1
9831,229771,274_10_18,GERMANY,0,TOTALS,GERMANY,200,24,57,42.1,21,36,58.3,3,21,14.3,10,22,45.5,10,28,38,7,24,18,6,3,61,0
9832,229784,274_10_19,LATVIA,0,TOTALS,LATVIA,200,24,62,38.7,12,32,37.5,12,30,40.0,15,21,71.4,8,33,41,16,25,19,5,3,75,1
9833,229797,274_10_19,SPAIN,0,TOTALS,SPAIN,200,24,67,35.8,20,45,44.4,4,22,18.2,18,24,75.0,12,30,42,10,23,16,11,2,70,0
9834,229810,274_10_20,GREECE,0,TOTALS,GREECE,200,22,62,35.5,18,44,40.9,4,18,22.2,13,24,54.2,13,21,34,10,20,16,12,2,61,0
9835,229823,274_10_20,CROATIA,0,TOTALS,CROATIA,200,25,54,46.3,15,33,45.5,10,21,47.6,13,18,72.2,9,30,39,14,20,23,12,2,73,1
9836,229836,274_10_21,LITHUANIA,0,TOTALS,LITHUANIA,200,30,53,56.6,20,31,64.5,10,22,45.5,20,27,74.1,9,30,39,15,19,20,8,2,90,1
9837,229849,274_10_21,SLOVENIA,0,TOTALS,SLOVENIA,200,25,66,37.9,21,44,47.7,4,22,18.2,14,18,77.8,12,14,26,12,25,14,6,1,68,0
9838,229862,274_10_22,TURKEY,0,TOTALS,TURKEY,200,27,61,44.3,19,36,52.8,8,25,32.0,4,10,40.0,10,34,44,14,21,13,5,2,66,1
9839,229875,274_10_22,BULGARIA,0,TOTALS,BULGARIA,200,19,61,31.1,14,33,42.4,5,28,17.9,9,17,52.9,11,27,38,6,12,13,3,1,52,0
9840,229888,274_10_23,FRANCE,0,TOTALS,FRANCE,200,23,60,38.3,20,40,50.0,3,20,15.0,8,10,80.0,13,44,57,8,15,22,7,7,57,1
9841,229901,274_10_23,SWEDEN,0,TOTALS,SWEDEN,200,16,70,22.9,13,49,26.5,3,21,14.3,7,9,77.8,11,22,33,7,16,11,9,1,42,0
9842,229914,274_10_24,ITALY,0,TOTALS,ITALY,200,31,55,56.4,21,38,55.3,10,17,58.8,14,18,77.8,6,22,28,18,25,22,6,0,86,0
9843,229927,274_10_24,RUSSIA,0,TOTALS,RUSSIA,200,31,65,47.7,21,37,56.8,10,28,35.7,15,21,71.4,15,18,33,18,19,18,12,4,87,1
9844,229940,274_10_25,UKRAINE,0,TOTALS,UKRAINE,200,23,80,28.7,21,53,39.6,2,27,7.4,11,18,61.1,21,37,58,7,24,21,13,11,59,0
9845,229953,274_10_25,GERMANY,0,TOTALS,GERMANY,200,29,71,40.8,26,57,45.6,3,14,21.4,12,16,75.0,7,38,45,16,14,18,13,3,73,1
9846,229966,274_10_26,SWEDEN,0,TOTALS,SWEDEN,200,35,74,47.3,25,41,61.0,10,33,30.3,8,10,80.0,9,40,49,21,23,16,7,6,88,1
9847,229979,274_10_26,BULGARIA,0,TOTALS,BULGARIA,200,21,67,31.3,16,45,35.6,5,22,22.7,19,29,65.5,13,31,44,11,15,15,12,1,66,0
9848,229992,274_10_27,GREECE,0,TOTALS,GREECE,200,35,61,57.4,27,42,64.3,8,19,42.1,19,28,67.9,12,29,41,20,20,19,8,3,97,1
9849,230005,274_10_27,ITALY,0,TOTALS,ITALY,200,33,68,48.5,26,40,65.0,7,28,25.0,15,21,71.4,11,19,30,12,23,13,9,0,88,0
9850,230018,274_10_28,SLOVENIA,0,TOTALS,SLOVENIA,200,26,64,40.6,20,38,52.6,6,26,23.1,18,29,62.1,15,24,39,10,24,13,5,3,76,1
9851,230031,274_10_28,LATVIA,0,TOTALS,LATVIA,200,23,63,36.5,16,39,41.0,7,24,29.2,21,26,80.8,17,26,43,11,27,15,9,1,74,0
9852,230044,274_10_29,CROATIA,0,TOTALS,CROATIA,200,16,50,32.0,13,37,35.1,3,13,23.1,20,30,66.7,8,24,32,11,20,18,6,0,55,0
9853,230057,274_10_29,RUSSIA,0,TOTALS,RUSSIA,200,33,60,55.0,25,36,69.4,8,24,33.3,4,9,44.4,5,30,35,16,24,15,12,1,78,1
9854,230070,274_10_30,FRANCE,0,TOTALS,FRANCE,200,25,63,39.7,19,47,40.4,6,16,37.5,7,11,63.6,10,16,26,11,16,18,6,1,63,1
9855,230083,274_10_30,LITHUANIA,0,TOTALS,LITHUANIA,200,41,63,65.1,31,41,75.6,10,22,45.5,12,18,66.7,8,29,37,23,13,13,10,7,104,0
9856,230096,274_10_31,SPAIN,0,TOTALS,SPAIN,200,28,73,38.4,24,46,52.2,4,27,14.8,7,13,53.8,14,16,30,7,26,16,9,4,67,0
9857,230109,274_10_31,POLAND,0,TOTALS,POLAND,200,30,62,48.4,24,47,51.1,6,15,40.0,15,23,65.2,18,34,52,19,23,28,5,4,81,1
9858,230122,274_10_32,TURKEY,0,TOTALS,TURKEY,200,19,60,31.7,15,37,40.5,4,23,17.4,7,14,50.0,11,31,42,9,25,19,5,3,49,0
9859,230135,274_10_32,SERBIA,0,TOTALS,SERBIA,200,22,68,32.4,19,50,38.0,3,18,16.7,16,22,72.7,20,28,48,12,17,14,9,6,63,1
9860,230148,274_10_33,BULGARIA,0,TOTALS,BULGARIA,200,26,70,37.1,16,38,42.1,10,32,31.2,13,17,76.5,10,25,35,16,22,15,9,3,75,0
9861,230161,274_10_33,UKRAINE,0,TOTALS,UKRAINE,200,31,78,39.7,27,51,52.9,4,27,14.8,13,17,76.5,22,35,57,16,20,18,8,4,79,1
9862,230174,274_10_34,GERMANY,0,TOTALS,GERMANY,200,27,61,44.3,21,42,50.0,6,19,31.6,13,18,72.2,12,36,48,12,15,17,6,4,73,1
9863,230187,274_10_34,SWEDEN,0,TOTALS,SWEDEN,200,25,75,33.3,16,43,37.2,9,32,28.1,7,10,70.0,16,23,39,13,14,10,7,1,66,0
9864,230200,274_10_35,ITALY,0,TOTALS,ITALY,200,22,62,35.5,15,40,37.5,7,22,31.8,10,14,71.4,8,29,37,7,20,17,6,5,61,0
9865,230213,274_10_35,CROATIA,0,TOTALS,CROATIA,200,29,69,42.0,24,49,49.0,5,20,25.0,9,12,75.0,12,32,44,13,19,15,8,2,72,1
9866,230226,274_10_36,FRANCE,0,TOTALS,FRANCE,200,28,53,52.8,18,32,56.2,10,21,47.6,9,16,56.2,12,24,36,15,15,16,11,4,75,1
9867,230239,274_10_36,SLOVENIA,0,TOTALS,SLOVENIA,200,19,57,33.3,11,36,30.6,8,21,38.1,5,6,83.3,15,13,28,16,20,20,8,2,51,0
9868,230252,274_10_37,LITHUANIA,0,TOTALS,LITHUANIA,200,27,52,51.9,18,32,56.2,9,20,45.0,14,24,58.3,9,34,43,24,19,20,4,2,77,1
9869,230265,274_10_37,SPAIN,0,TOTALS,SPAIN,200,23,66,34.8,21,48,43.8,2,18,11.1,10,15,66.7,10,21,31,15,18,13,11,1,58,0
9870,230278,274_10_38,GREECE,0,TOTALS,GREECE,200,28,58,48.3,19,36,52.8,9,22,40.9,14,26,53.8,12,28,40,16,16,12,3,12,79,1
9871,230291,274_10_38,TURKEY,0,TOTALS,TURKEY,200,24,60,40.0,19,46,41.3,5,14,35.7,12,15,80.0,7,22,29,6,24,9,7,0,65,0
9872,230304,274_10_39,POLAND,0,TOTALS,POLAND,200,23,62,37.1,18,39,46.2,5,23,21.7,8,12,66.7,7,26,33,16,18,19,11,5,59,0
9873,230317,274_10_39,LATVIA,0,TOTALS,LATVIA,200,19,62,30.6,11,32,34.4,8,30,26.7,17,26,65.4,19,32,51,13,18,22,13,2,63,1
9874,230330,274_10_40,RUSSIA,0,TOTALS,RUSSIA,200,28,58,48.3,22,39,56.4,6,19,31.6,13,18,72.2,7,24,31,17,20,18,12,0,75,1
9875,230343,274_10_40,SERBIA,0,TOTALS,SERBIA,200,17,54,31.5,9,27,33.3,8,27,29.6,19,25,76.0,13,25,38,8,21,24,8,6,61,0
9876,230356,274_10_41,UKRAINE,0,TOTALS,UKRAINE,200,31,75,41.3,24,50,48.0,7,25,28.0,7,13,53.8,14,28,42,21,10,14,7,9,76,0
9877,230369,274_10_41,SWEDEN,0,TOTALS,SWEDEN,200,32,82,39.0,25,57,43.9,7,25,28.0,10,11,90.9,21,33,54,18,16,15,8,2,81,1
9878,230382,274_10_42,BULGARIA,0,TOTALS,BULGARIA,200,21,58,36.2,11,25,44.0,10,33,30.3,6,14,42.9,13,25,38,9,17,15,5,1,58,0
9879,230395,274_10_42,GERMANY,0,TOTALS,GERMANY,200,21,60,35.0,18,35,51.4,3,25,12.0,20,25,80.0,13,27,40,15,21,13,10,6,65,1
9880,230408,274_10_43,SPAIN,0,TOTALS,SPAIN,200,31,61,50.8,28,47,59.6,3,14,21.4,8,15,53.3,8,28,36,18,19,15,11,3,73,1
9881,230421,274_10_43,SLOVENIA,0,TOTALS,SLOVENIA,200,25,66,37.9,22,44,50.0,3,22,13.6,16,22,72.7,15,27,42,15,20,18,10,2,69,0
9882,230434,274_10_44,CROATIA,0,TOTALS,CROATIA,200,30,54,55.6,25,39,64.1,5,15,33.3,17,23,73.9,4,32,36,18,15,17,1,6,82,1
9883,230447,274_10_44,TURKEY,0,TOTALS,TURKEY,200,31,75,41.3,24,48,50.0,7,27,25.9,8,13,61.5,13,23,36,12,23,11,12,2,77,0
9884,230460,274_10_45,LATVIA,0,TOTALS,LATVIA,200,29,66,43.9,17,41,41.5,12,25,48.0,5,9,55.6,8,26,34,14,22,18,10,3,75,0
9885,230473,274_10_45,LITHUANIA,0,TOTALS,LITHUANIA,200,28,71,39.4,24,42,57.1,4,29,13.8,18,24,75.0,22,29,51,15,16,18,8,7,78,1
9886,230486,274_10_46,SERBIA,0,TOTALS,SERBIA,200,36,63,57.1,30,45,66.7,6,18,33.3,19,24,79.2,16,37,53,23,18,19,9,3,97,1
9887,230499,274_10_46,ITALY,0,TOTALS,ITALY,200,19,59,32.2,14,33,42.4,5,26,19.2,9,16,56.2,6,12,18,10,18,13,9,1,52,0
9888,230512,274_10_47,POLAND,0,TOTALS,POLAND,200,23,55,41.8,14,28,50.0,9,27,33.3,10,19,52.6,6,29,35,13,14,20,8,4,65,0
9889,230525,274_10_47,FRANCE,0,TOTALS,FRANCE,200,28,63,44.4,23,43,53.5,5,20,25.0,8,13,61.5,11,28,39,12,17,17,10,0,69,1
9890,230538,274_10_48,RUSSIA,0,TOTALS,RUSSIA,200,26,63,41.3,18,41,43.9,8,22,36.4,9,12,75.0,16,28,44,16,15,20,11,5,69,1
9891,230551,274_10_48,GREECE,0,TOTALS,GREECE,200,21,59,35.6,16,40,40.0,5,19,26.3,5,8,62.5,11,22,33,10,14,21,12,5,52,0
9892,230564,274_10_49,RUSSIA,0,TOTALS,RUSSIA,225,25,75,33.3,14,42,33.3,11,33,33.3,12,21,57.1,15,26,41,17,17,13,17,4,73,1
9893,230577,274_10_49,FRANCE,0,TOTALS,FRANCE,225,24,58,41.4,18,38,47.4,6,20,30.0,14,21,66.7,7,40,47,11,19,26,6,4,68,0
9894,230590,274_10_50,GERMANY,0,TOTALS,GERMANY,200,17,67,25.4,10,42,23.8,7,25,28.0,18,25,72.0,13,36,49,9,22,19,11,3,59,0
9895,230603,274_10_50,UKRAINE,0,TOTALS,UKRAINE,200,26,65,40.0,19,46,41.3,7,19,36.8,15,21,71.4,9,38,47,15,21,19,10,3,74,1
9896,230616,274_10_51,BULGARIA,0,TOTALS,BULGARIA,200,24,65,36.9,10,30,33.3,14,35,40.0,11,15,73.3,11,33,44,16,17,10,2,2,73,1
9897,230629,274_10_51,SWEDEN,0,TOTALS,SWEDEN,200,25,74,33.8,15,50,30.0,10,24,41.7,10,16,62.5,17,30,47,18,14,5,4,4,70,0
9898,230642,274_10_52,LATVIA,0,TOTALS,LATVIA,200,27,70,38.6,17,37,45.9,10,33,30.3,14,16,87.5,20,30,50,11,19,11,9,4,78,1
9899,230655,274_10_52,CROATIA,0,TOTALS,CROATIA,200,20,62,32.3,13,42,31.0,7,20,35.0,9,19,47.4,16,22,38,9,17,12,8,4,56,0
9900,230668,274_10_53,LITHUANIA,0,TOTALS,LITHUANIA,200,28,67,41.8,21,44,47.7,7,23,30.4,21,28,75.0,16,38,54,19,17,11,11,3,84,1
9901,230681,274_10_53,GREECE,0,TOTALS,GREECE,200,20,65,30.8,17,47,36.2,3,18,16.7,8,15,53.3,11,28,39,9,22,16,7,6,51,0
9902,230694,274_10_54,SPAIN,0,TOTALS,SPAIN,200,18,55,32.7,12,32,37.5,6,23,26.1,18,23,78.3,10,20,30,11,16,20,7,2,60,0
9903,230707,274_10_54,TURKEY,0,TOTALS,TURKEY,200,25,54,46.3,18,36,50.0,7,18,38.9,9,12,75.0,11,28,39,15,24,27,15,3,66,1
9904,230720,274_10_55,SERBIA,0,TOTALS,SERBIA,200,33,83,39.8,29,54,53.7,4,29,13.8,5,12,41.7,20,23,43,9,19,14,16,1,75,1
9905,230733,274_10_55,POLAND,0,TOTALS,POLAND,200,21,53,39.6,17,34,50.0,4,19,21.1,11,17,64.7,11,31,42,12,13,31,8,4,57,0
9906,230746,274_10_56,ITALY,0,TOTALS,ITALY,225,28,65,43.1,20,43,46.5,8,22,36.4,27,37,73.0,9,25,34,12,31,12,9,7,91,0
9907,230759,274_10_56,SLOVENIA,0,TOTALS,SLOVENIA,225,29,70,41.4,20,41,48.8,9,29,31.0,29,39,74.4,20,33,53,18,32,16,7,4,96,1
9908,230770,274_10_57,SWEDEN,0,TOTALS,SWEDEN,200,19,59,32.2,16,46,34.8,3,13,23.1,8,13,61.5,10,28,38,11,10,23,10,4,49,0
9909,230783,274_10_57,GERMANY,0,TOTALS,GERMANY,200,32,75,42.7,23,42,54.8,9,33,27.3,5,7,71.4,14,31,45,16,18,15,9,7,78,1
9910,230796,274_10_58,GREECE,0,TOTALS,GREECE,200,22,68,32.4,15,42,35.7,7,26,26.9,4,4,100.0,11,28,39,14,20,13,8,4,55,0
9911,230809,274_10_58,POLAND,0,TOTALS,POLAND,200,25,60,41.7,14,39,35.9,11,21,52.4,13,19,68.4,11,33,44,19,9,13,5,4,74,1
9912,230822,274_10_59,UKRAINE,0,TOTALS,UKRAINE,200,40,66,60.6,32,44,72.7,8,22,36.4,16,22,72.7,10,39,49,26,16,15,12,7,104,0
9913,230835,274_10_59,BULGARIA,0,TOTALS,BULGARIA,200,21,69,30.4,10,35,28.6,11,34,32.4,10,13,76.9,13,18,31,14,23,18,9,0,63,1
9914,230848,274_10_60,CROATIA,0,TOTALS,CROATIA,200,26,59,44.1,18,41,43.9,8,18,44.4,7,9,77.8,6,29,35,17,16,15,7,1,67,1
9915,230861,274_10_60,FRANCE,0,TOTALS,FRANCE,200,23,66,34.8,18,43,41.9,5,23,21.7,10,15,66.7,17,27,44,8,14,18,7,4,61,0
9916,230874,274_10_61,LITHUANIA,0,TOTALS,LITHUANIA,200,22,54,40.7,19,35,54.3,3,19,15.8,20,31,64.5,13,30,43,6,23,17,5,8,67,1
9917,230887,274_10_61,SERBIA,0,TOTALS,SERBIA,200,23,61,37.7,21,47,44.7,2,14,14.3,18,22,81.8,10,22,32,8,25,11,7,1,66,0
9918,230900,274_10_62,SPAIN,0,TOTALS,SPAIN,200,28,57,49.1,22,37,59.5,6,20,30.0,22,34,64.7,11,28,39,24,23,18,13,3,84,1
9919,230913,274_10_62,ITALY,0,TOTALS,ITALY,200,19,56,33.9,16,37,43.2,3,19,15.8,18,28,64.3,12,22,34,9,25,22,11,0,59,0
9920,230926,274_10_63,LATVIA,0,TOTALS,LATVIA,200,13,54,24.1,8,27,29.6,5,27,18.5,11,18,61.1,10,29,39,7,18,20,8,5,42,0
9921,230939,274_10_63,RUSSIA,0,TOTALS,RUSSIA,200,26,68,38.2,18,43,41.9,8,25,32.0,13,18,72.2,14,32,46,17,18,14,13,4,73,1
9922,230952,274_10_64,TURKEY,0,TOTALS,TURKEY,200,30,68,44.1,23,43,53.5,7,25,28.0,7,12,58.3,13,20,33,15,17,9,9,3,74,1
9923,230965,274_10_64,SLOVENIA,0,TOTALS,SLOVENIA,200,29,64,45.3,22,44,50.0,7,20,35.0,6,9,66.7,17,27,44,18,19,19,2,2,71,0
9924,230977,274_10_65,SWEDEN,0,TOTALS,SWEDEN,200,26,78,33.3,15,49,30.6,11,29,37.9,10,15,66.7,16,28,44,19,22,13,10,5,73,0
9925,230990,274_10_65,UKRAINE,0,TOTALS,UKRAINE,200,28,77,36.4,23,61,37.7,5,16,31.2,18,31,58.1,27,37,64,16,15,17,11,10,79,1
9926,231003,274_10_66,GREECE,0,TOTALS,GREECE,200,31,66,47.0,24,46,52.2,7,20,35.0,6,10,60.0,7,22,29,14,18,8,9,2,75,0
9927,231016,274_10_66,FRANCE,0,TOTALS,FRANCE,200,26,63,41.3,17,39,43.6,9,24,37.5,16,19,84.2,16,29,45,13,8,16,4,1,77,1
9928,231029,274_10_67,GERMANY,0,TOTALS,GERMANY,200,26,61,42.6,15,36,41.7,11,25,44.0,9,10,90.0,14,25,39,16,17,17,9,2,72,1
9929,231042,274_10_67,BULGARIA,0,TOTALS,BULGARIA,200,24,57,42.1,14,29,48.3,10,28,35.7,9,14,64.3,9,20,29,15,16,15,9,2,67,0
9930,231055,274_10_68,POLAND,0,TOTALS,POLAND,200,30,75,40.0,25,48,52.1,5,27,18.5,12,17,70.6,16,21,37,19,15,19,11,2,77,0
9931,231068,274_10_68,CROATIA,0,TOTALS,CROATIA,200,37,68,54.4,32,50,64.0,5,18,27.8,13,18,72.2,11,29,40,16,16,21,13,1,92,1
9932,231081,274_10_69,SERBIA,0,TOTALS,SERBIA,200,15,55,27.3,11,34,32.4,4,21,19.0,15,24,62.5,11,32,43,8,18,20,3,3,49,0
9933,231094,274_10_69,LATVIA,0,TOTALS,LATVIA,200,25,70,35.7,11,40,27.5,14,30,46.7,11,14,78.6,13,32,45,17,21,12,7,4,75,1
9934,231107,274_10_70,LITHUANIA,0,TOTALS,LITHUANIA,200,35,75,46.7,27,46,58.7,8,29,27.6,12,20,60.0,25,34,59,16,18,12,3,1,90,1
9935,231120,274_10_70,RUSSIA,0,TOTALS,RUSSIA,200,23,68,33.8,17,38,44.7,6,30,20.0,9,13,69.2,13,20,33,15,20,8,2,5,61,0
9936,231133,275_10_01,SWITZERLAND,0,TOTALS,SWITZERLAND,200,33,61,54.1,32,54,59.3,1,7,14.3,7,13,53.8,7,23,30,15,21,10,8,1,74,0
9937,231146,275_10_01,CZECH REPUBLIC,0,TOTALS,CZECH REPUBLIC,200,31,57,54.4,22,35,62.9,9,22,40.9,14,24,58.3,12,27,39,15,12,13,5,2,85,1
9938,231159,275_10_02,MONTENEGRO,0,TOTALS,MONTENEGRO,200,36,68,52.9,29,47,61.7,7,21,33.3,10,16,62.5,11,25,36,27,19,12,14,1,89,1
9939,231172,275_10_02,AUSTRIA,0,TOTALS,AUSTRIA,200,22,53,41.5,19,38,50.0,3,15,20.0,10,18,55.6,10,24,34,9,18,27,5,1,57,0
9940,231185,275_10_03,BELGIUM,0,TOTALS,BELGIUM,200,31,69,44.9,27,49,55.1,4,20,20.0,11,14,78.6,24,29,53,16,17,16,12,4,77,1
9941,231198,275_10_03,HUNGARY,0,TOTALS,HUNGARY,200,25,61,41.0,25,54,46.3,0,7,0.0,5,12,41.7,10,13,23,15,17,15,8,4,55,0
9942,231211,275_10_04,BELARUS,0,TOTALS,BELARUS,200,28,71,39.4,24,57,42.1,4,14,28.6,12,20,60.0,15,30,45,13,21,20,9,7,72,1
9943,231224,275_10_04,DENMARK,0,TOTALS,DENMARK,200,26,75,34.7,25,62,40.3,1,13,7.7,7,16,43.8,20,32,52,13,25,18,10,1,60,0
9944,231237,275_10_05,ENGLAND,0,TOTALS,ENGLAND,200,19,59,32.2,14,38,36.8,5,21,23.8,14,21,66.7,18,33,51,12,16,23,3,3,57,0
9945,231250,275_10_05,ISRAEL,0,TOTALS,ISRAEL,200,26,63,41.3,18,43,41.9,8,20,40.0,11,21,52.4,7,25,32,24,17,9,18,2,71,1
9946,231263,275_10_06,BOSNIA AND HERZEGOVINA,0,TOTALS,BOSNIA AND HERZEGOVINA,200,20,54,37.0,17,41,41.5,3,13,23.1,18,32,56.2,12,27,39,13,20,27,6,2,61,0
9947,231276,275_10_06,PORTUGAL,0,TOTALS,PORTUGAL,200,28,75,37.3,21,56,37.5,7,19,36.8,10,17,58.8,21,25,46,15,24,18,15,2,73,1
9948,231289,275_10_07,ESTONIA,0,TOTALS,ESTONIA,200,22,57,38.6,19,34,55.9,3,23,13.0,12,26,46.2,16,20,36,13,21,21,14,4,59,1
9949,231302,275_10_07,GEORGIA,0,TOTALS,GEORGIA,200,20,53,37.7,14,34,41.2,6,19,31.6,9,15,60.0,15,22,37,15,27,27,11,2,55,0
9950,231315,275_10_08,FINLAND,0,TOTALS,FINLAND,200,24,63,38.1,18,37,48.6,6,26,23.1,11,16,68.8,12,22,34,13,15,8,5,3,65,0
9951,231328,275_10_08,NETHERLANDS,0,TOTALS,NETHERLANDS,200,32,65,49.2,24,41,58.5,8,24,33.3,8,13,61.5,16,31,47,12,15,10,7,0,80,1
9952,231341,275_10_09,SCOTLAND,0,TOTALS,SCOTLAND,200,28,60,46.7,24,48,50.0,4,12,33.3,7,15,46.7,13,16,29,14,16,17,6,1,67,0
9953,231354,275_10_09,BOSNIA AND HERZEGOVINA,0,TOTALS,BOSNIA AND HERZEGOVINA,200,30,63,47.6,23,42,54.8,7,21,33.3,16,22,72.7,18,26,44,21,20,18,7,7,83,1
9954,231367,275_10_10,DENMARK,0,TOTALS,DENMARK,200,20,70,28.6,17,47,36.2,3,23,13.0,1,8,12.5,19,31,50,13,19,19,6,4,44,0
9955,231380,275_10_10,ENGLAND,0,TOTALS,ENGLAND,200,27,71,38.0,23,52,44.2,4,19,21.1,15,18,83.3,15,34,49,18,15,11,12,5,73,1
9956,231393,275_10_11,SLOVAK REPUBLIC,0,TOTALS,SLOVAK REPUBLIC,200,18,51,35.3,16,37,43.2,2,14,14.3,9,24,37.5,14,23,37,9,27,27,17,4,47,0
9957,231406,275_10_11,FINLAND,0,TOTALS,FINLAND,200,16,51,31.4,8,27,29.6,8,24,33.3,23,32,71.9,16,26,42,10,22,26,16,2,63,1
9958,231419,275_10_12,LUXEMBOURG,0,TOTALS,LUXEMBOURG,200,12,70,17.1,8,47,17.0,4,23,17.4,8,11,72.7,12,22,34,6,19,20,9,4,36,0
9959,231432,275_10_12,MONTENEGRO,0,TOTALS,MONTENEGRO,200,38,72,52.8,35,62,56.5,3,10,30.0,19,28,67.9,16,46,62,22,13,16,15,4,98,1
9960,231445,275_10_13,NETHERLANDS,0,TOTALS,NETHERLANDS,200,24,60,40.0,18,39,46.2,6,21,28.6,9,21,42.9,8,25,33,17,16,15,13,4,63,1
9961,231458,275_10_13,SWITZERLAND,0,TOTALS,SWITZERLAND,200,22,58,37.9,14,40,35.0,8,18,44.4,5,15,33.3,19,29,48,13,22,29,9,2,57,0
9962,231471,275_10_14,AUSTRIA,0,TOTALS,AUSTRIA,200,18,55,32.7,16,36,44.4,2,19,10.5,19,28,67.9,14,28,42,7,22,22,5,0,57,0
9963,231484,275_10_14,ESTONIA,0,TOTALS,ESTONIA,200,34,80,42.5,28,48,58.3,6,32,18.8,13,22,59.1,21,26,47,16,23,10,12,2,87,1
9964,231497,275_10_15,PORTUGAL,0,TOTALS,PORTUGAL,200,17,57,29.8,16,41,39.0,1,16,6.2,9,15,60.0,14,23,37,6,20,26,11,3,44,0
9965,231510,275_10_15,BELGIUM,0,TOTALS,BELGIUM,200,29,58,50.0,23,40,57.5,6,18,33.3,17,21,81.0,9,29,38,17,22,20,10,9,81,1
9966,231523,275_10_16,ROMANIA,0,TOTALS,ROMANIA,200,18,68,26.5,14,48,29.2,4,20,20.0,8,15,53.3,14,24,38,11,29,22,12,2,48,0
9967,231536,275_10_16,BELARUS,0,TOTALS,BELARUS,200,21,57,36.8,17,38,44.7,4,19,21.1,23,39,59.0,19,40,59,14,21,23,15,1,69,1
9968,231549,275_10_17,SWITZERLAND,0,TOTALS,SWITZERLAND,200,20,63,31.7,15,44,34.1,5,19,26.3,18,24,75.0,15,32,47,14,25,8,17,3,63,1
9969,231562,275_10_17,SLOVAK REPUBLIC,0,TOTALS,SLOVAK REPUBLIC,200,19,55,34.5,16,39,41.0,3,16,18.8,14,25,56.0,14,41,55,11,20,20,4,9,55,0
9970,231575,275_10_18,ESTONIA,0,TOTALS,ESTONIA,200,29,67,43.3,22,42,52.4,7,25,28.0,21,28,75.0,18,31,49,12,18,18,11,3,86,1
9971,231588,275_10_18,LUXEMBOURG,0,TOTALS,LUXEMBOURG,200,25,65,38.5,15,43,34.9,10,22,45.5,11,17,64.7,12,22,34,10,24,15,9,1,71,0
9972,231601,275_10_19,HUNGARY,0,TOTALS,HUNGARY,200,27,63,42.9,21,43,48.8,6,20,30.0,11,21,52.4,17,30,47,22,20,22,14,6,71,1
9973,231614,275_10_19,PORTUGAL,0,TOTALS,PORTUGAL,200,18,54,33.3,15,38,39.5,3,16,18.8,17,24,70.8,7,23,30,15,20,17,13,0,56,0
9974,231627,275_10_20,ENGLAND,0,TOTALS,ENGLAND,200,31,58,53.4,25,41,61.0,6,17,35.3,5,9,55.6,11,34,45,26,18,26,11,5,73,1
9975,231640,275_10_20,ROMANIA,0,TOTALS,ROMANIA,200,19,59,32.2,14,38,36.8,5,21,23.8,10,24,41.7,11,18,29,12,15,20,12,2,53,0
9976,231653,275_10_21,BELGIUM,0,TOTALS,BELGIUM,200,30,71,42.3,23,44,52.3,7,27,25.9,6,13,46.2,19,25,44,17,17,12,9,7,73,1
9977,231666,275_10_21,SCOTLAND,0,TOTALS,SCOTLAND,200,21,56,37.5,17,50,34.0,4,6,66.7,10,18,55.6,12,23,35,14,18,15,6,1,56,0
9978,231679,275_10_22,GEORGIA,0,TOTALS,GEORGIA,200,26,71,36.6,17,41,41.5,9,30,30.0,11,20,55.0,16,21,37,14,24,13,12,4,72,0
9979,231692,275_10_22,AUSTRIA,0,TOTALS,AUSTRIA,200,31,56,55.4,25,45,55.6,6,11,54.5,16,25,64.0,10,33,43,20,22,20,7,0,84,1
9980,231705,275_10_23,CZECH REPUBLIC,0,TOTALS,CZECH REPUBLIC,200,25,52,48.1,21,33,63.6,4,19,21.1,14,18,77.8,10,40,50,16,15,22,6,5,68,1
9981,231718,275_10_23,NETHERLANDS,0,TOTALS,NETHERLANDS,200,20,69,29.0,16,41,39.0,4,28,14.3,8,16,50.0,12,20,32,11,22,9,7,1,52,0
9982,231731,275_10_24,ISRAEL,0,TOTALS,ISRAEL,200,32,69,46.4,24,44,54.5,8,25,32.0,13,22,59.1,14,29,43,16,22,18,14,6,85,1
9983,231744,275_10_24,DENMARK,0,TOTALS,DENMARK,200,26,60,43.3,16,37,43.2,10,23,43.5,10,18,55.6,9,29,38,13,19,23,8,2,72,0
9984,231757,275_10_25,FINLAND,0,TOTALS,FINLAND,200,26,59,44.1,19,35,54.3,7,24,29.2,12,17,70.6,10,25,35,11,15,16,8,2,71,1
9985,231770,275_10_25,SWITZERLAND,0,TOTALS,SWITZERLAND,200,26,60,43.3,23,45,51.1,3,15,20.0,11,16,68.8,12,24,36,13,19,18,7,4,66,0
9986,231783,275_10_26,LUXEMBOURG,0,TOTALS,LUXEMBOURG,200,26,67,38.8,21,46,45.7,5,21,23.8,15,28,53.6,17,30,47,9,15,17,9,3,72,1
9987,231796,275_10_26,GEORGIA,0,TOTALS,GEORGIA,200,29,69,42.0,23,43,53.5,6,26,23.1,4,10,40.0,13,31,44,16,23,20,11,6,68,0
9988,231809,275_10_27,BOSNIA AND HERZEGOVINA,0,TOTALS,BOSNIA AND HERZEGOVINA,200,18,57,31.6,15,40,37.5,3,17,17.6,11,20,55.0,19,28,47,9,20,24,7,6,50,0
9989,231822,275_10_27,BELGIUM,0,TOTALS,BELGIUM,200,24,59,40.7,21,40,52.5,3,19,15.8,15,23,65.2,11,23,34,17,19,14,14,4,66,1
9990,231835,275_10_28,BELARUS,0,TOTALS,BELARUS,200,29,78,37.2,23,54,42.6,6,24,25.0,4,11,36.4,15,35,50,13,23,16,7,3,68,0
9991,231848,275_10_28,ENGLAND,0,TOTALS,ENGLAND,200,24,73,32.9,20,56,35.7,4,17,23.5,18,28,64.3,19,36,55,18,16,16,9,4,70,1
9992,231861,275_10_29,SCOTLAND,0,TOTALS,SCOTLAND,200,16,58,27.6,11,36,30.6,5,22,22.7,9,16,56.2,13,28,41,12,12,15,12,3,46,1
9993,231874,275_10_29,HUNGARY,0,TOTALS,HUNGARY,200,16,55,29.1,12,35,34.3,4,20,20.0,2,5,40.0,13,31,44,11,20,22,7,5,38,0
9994,231887,275_10_30,ROMANIA,0,TOTALS,ROMANIA,200,18,72,25.0,16,52,30.8,2,20,10.0,14,28,50.0,25,19,44,9,19,20,14,1,52,0
9995,231900,275_10_30,ISRAEL,0,TOTALS,ISRAEL,200,30,53,56.6,22,32,68.8,8,21,38.1,12,23,52.2,10,38,48,27,24,30,10,5,80,1
9996,231913,275_10_31,SLOVAK REPUBLIC,0,TOTALS,SLOVAK REPUBLIC,200,18,56,32.1,18,42,42.9,0,14,0.0,10,22,45.5,11,19,30,11,21,19,14,4,46,0
9997,231926,275_10_31,CZECH REPUBLIC,0,TOTALS,CZECH REPUBLIC,200,35,66,53.0,31,52,59.6,4,14,28.6,14,28,50.0,20,33,53,17,19,20,15,8,88,1
9998,231939,275_10_32,MONTENEGRO,0,TOTALS,MONTENEGRO,200,35,58,60.3,23,37,62.2,12,21,57.1,21,33,63.6,13,30,43,23,19,23,16,1,103,0
9999,231952,275_10_32,ESTONIA,0,TOTALS,ESTONIA,200,19,55,34.5,13,28,46.4,6,27,22.2,10,14,71.4,9,17,26,10,27,28,4,2,54,1
10000,231965,275_10_33,PORTUGAL,0,TOTALS,PORTUGAL,200,25,64,39.1,18,43,41.9,7,21,33.3,1,6,16.7,10,24,34,12,14,14,8,2,58,0
10001,231978,275_10_33,SCOTLAND,0,TOTALS,SCOTLAND,200,27,62,43.5,23,44,52.3,4,18,22.2,13,17,76.5,12,32,44,22,10,12,9,3,71,1
10002,231991,275_10_34,DENMARK,0,TOTALS,DENMARK,200,32,74,43.2,25,55,45.5,7,19,36.8,9,20,45.0,18,27,45,21,10,13,9,4,80,1
10003,232004,275_10_34,ROMANIA,0,TOTALS,ROMANIA,200,31,75,41.3,27,56,48.2,4,19,21.1,6,7,85.7,17,29,46,17,19,20,7,7,72,0
10004,232017,275_10_35,NETHERLANDS,0,TOTALS,NETHERLANDS,200,17,59,28.8,14,42,33.3,3,17,17.6,8,27,29.6,18,28,46,5,21,11,6,1,45,0
10005,232030,275_10_35,SLOVAK REPUBLIC,0,TOTALS,SLOVAK REPUBLIC,200,18,58,31.0,17,42,40.5,1,16,6.2,10,20,50.0,17,33,50,5,24,17,6,10,47,1
10006,232043,275_10_36,AUSTRIA,0,TOTALS,AUSTRIA,200,27,62,43.5,24,44,54.5,3,18,16.7,17,21,81.0,14,44,58,17,13,22,3,6,74,1
10007,232056,275_10_36,LUXEMBOURG,0,TOTALS,LUXEMBOURG,200,27,83,32.5,20,52,38.5,7,31,22.6,5,6,83.3,10,21,31,15,21,7,14,4,66,0
10008,232069,275_10_37,CZECH REPUBLIC,0,TOTALS,CZECH REPUBLIC,200,19,59,32.2,13,27,48.1,6,32,18.8,11,15,73.3,13,34,47,10,21,17,3,5,55,0
10009,232082,275_10_37,FINLAND,0,TOTALS,FINLAND,200,22,60,36.7,10,25,40.0,12,35,34.3,9,16,56.2,8,29,37,12,17,10,5,1,65,1
10010,232095,275_10_38,ISRAEL,0,TOTALS,ISRAEL,200,32,60,53.3,25,47,53.2,7,13,53.8,24,32,75.0,7,28,35,19,28,25,20,4,95,1
10011,232108,275_10_38,BELARUS,0,TOTALS,BELARUS,200,22,64,34.4,16,36,44.4,6,28,21.4,26,45,57.8,23,25,48,8,21,32,9,1,76,0
10012,232121,275_10_39,HUNGARY,0,TOTALS,HUNGARY,200,25,58,43.1,18,35,51.4,7,23,30.4,2,5,40.0,14,26,40,16,21,24,11,3,59,0
10013,232134,275_10_39,BOSNIA AND HERZEGOVINA,0,TOTALS,BOSNIA AND HERZEGOVINA,200,20,52,38.5,11,26,42.3,9,26,34.6,12,19,63.2,7,19,26,15,16,17,13,4,61,1
10014,232147,275_10_40,GEORGIA,0,TOTALS,GEORGIA,200,23,62,37.1,18,44,40.9,5,18,27.8,9,11,81.8,8,21,29,11,18,10,10,2,60,0
10015,232160,275_10_40,MONTENEGRO,0,TOTALS,MONTENEGRO,200,28,57,49.1,25,41,61.0,3,16,18.8,9,17,52.9,12,30,42,16,16,17,2,2,68,1
10016,232173,275_10_41,SLOVAK REPUBLIC,0,TOTALS,SLOVAK REPUBLIC,200,26,56,46.4,19,38,50.0,7,18,38.9,19,28,67.9,16,32,48,21,21,19,5,5,78,1
10017,232186,275_10_41,GEORGIA,0,TOTALS,GEORGIA,200,19,67,28.4,13,45,28.9,6,22,27.3,20,26,76.9,16,16,32,9,20,10,11,2,64,0
10018,232199,275_10_42,PORTUGAL,0,TOTALS,PORTUGAL,200,33,64,51.6,27,51,52.9,6,13,46.2,5,7,71.4,13,27,40,18,17,23,16,4,77,1
10019,232212,275_10_42,ROMANIA,0,TOTALS,ROMANIA,200,20,62,32.3,17,49,34.7,3,13,23.1,6,15,40.0,20,18,38,11,15,27,10,5,49,0
10020,232225,275_10_43,SWITZERLAND,0,TOTALS,SWITZERLAND,200,22,58,37.9,16,41,39.0,6,17,35.3,2,9,22.2,9,32,41,15,17,19,9,5,52,1
10021,232238,275_10_43,SCOTLAND,0,TOTALS,SCOTLAND,200,18,63,28.6,16,53,30.2,2,10,20.0,12,18,66.7,15,30,45,14,10,15,6,0,50,0
10022,232251,275_10_44,FINLAND,0,TOTALS,FINLAND,200,24,57,42.1,14,25,56.0,10,32,31.2,4,6,66.7,13,27,40,15,22,19,5,2,62,1
10023,232264,275_10_44,BOSNIA AND HERZEGOVINA,0,TOTALS,BOSNIA AND HERZEGOVINA,200,18,53,34.0,13,34,38.2,5,19,26.3,14,22,63.6,9,19,28,9,15,11,10,2,55,0
10024,232277,275_10_45,DENMARK,0,TOTALS,DENMARK,200,29,63,46.0,23,50,46.0,6,13,46.2,6,12,50.0,7,35,42,11,22,19,8,3,70,0
10025,232290,275_10_45,AUSTRIA,0,TOTALS,AUSTRIA,200,28,79,35.4,26,52,50.0,2,27,7.4,14,21,66.7,19,32,51,10,14,16,11,5,72,1
10026,232303,275_10_46,CZECH REPUBLIC,0,TOTALS,CZECH REPUBLIC,200,30,60,50.0,23,38,60.5,7,22,31.8,8,11,72.7,12,20,32,16,16,12,12,2,75,1
10027,232316,275_10_46,BELGIUM,0,TOTALS,BELGIUM,200,26,53,49.1,21,37,56.8,5,16,31.2,8,14,57.1,10,19,29,14,12,18,4,5,65,0
10028,232329,275_10_47,NETHERLANDS,0,TOTALS,NETHERLANDS,225,28,80,35.0,22,57,38.6,6,23,26.1,14,25,56.0,16,27,43,10,23,9,11,1,76,1
10029,232342,275_10_47,HUNGARY,0,TOTALS,HUNGARY,225,28,64,43.8,23,46,50.0,5,18,27.8,8,29,27.6,18,40,58,19,19,29,4,4,69,0
10030,232355,275_10_48,ISRAEL,0,TOTALS,ISRAEL,200,28,79,35.4,23,54,42.6,5,25,20.0,15,23,65.2,20,32,52,14,15,11,21,6,76,1
10031,232368,275_10_48,ESTONIA,0,TOTALS,ESTONIA,200,18,57,31.6,15,35,42.9,3,22,13.6,8,13,61.5,11,34,45,8,18,26,7,8,47,0
10032,232381,275_10_49,BELARUS,0,TOTALS,BELARUS,200,28,69,40.6,21,48,43.8,7,21,33.3,21,40,52.5,19,33,52,17,23,13,10,2,84,1
10033,232394,275_10_49,LUXEMBOURG,0,TOTALS,LUXEMBOURG,200,24,68,35.3,19,46,41.3,5,22,22.7,15,22,68.2,14,31,45,6,27,20,10,4,68,0
10034,232407,275_10_50,ENGLAND,0,TOTALS,ENGLAND,200,21,61,34.4,17,43,39.5,4,18,22.2,4,5,80.0,9,24,33,8,16,21,8,4,50,0
10035,232420,275_10_50,MONTENEGRO,0,TOTALS,MONTENEGRO,200,30,61,49.2,21,43,48.8,9,18,50.0,8,19,42.1,12,29,41,18,13,18,14,3,77,1
10036,232433,275_10_51,ROMANIA,0,TOTALS,ROMANIA,200,31,67,46.3,28,57,49.1,3,10,30.0,8,20,40.0,19,29,48,18,14,19,7,8,73,0
10037,232446,275_10_51,SLOVAK REPUBLIC,0,TOTALS,SLOVAK REPUBLIC,200,30,71,42.3,20,44,45.5,10,27,37.0,11,15,73.3,16,23,39,22,19,18,10,2,81,1
10038,232459,275_10_52,GEORGIA,0,TOTALS,GEORGIA,200,21,64,32.8,17,37,45.9,4,27,14.8,12,16,75.0,10,33,43,15,17,14,11,5,58,0
10039,232472,275_10_52,PORTUGAL,0,TOTALS,PORTUGAL,200,22,66,33.3,19,48,39.6,3,18,16.7,13,26,50.0,16,35,51,13,19,16,6,2,60,1
10040,232485,275_10_53,LUXEMBOURG,0,TOTALS,LUXEMBOURG,200,24,71,33.8,14,41,34.1,10,30,33.3,5,9,55.6,9,20,29,12,20,16,9,3,63,0
10041,232498,275_10_53,DENMARK,0,TOTALS,DENMARK,200,38,73,52.1,28,52,53.8,10,21,47.6,13,21,61.9,17,40,57,28,12,16,10,5,99,1
10042,232511,275_10_54,SCOTLAND,0,TOTALS,SCOTLAND,200,23,56,41.1,21,42,50.0,2,14,14.3,11,20,55.0,8,27,35,15,20,16,9,3,59,0
10043,232524,275_10_54,NETHERLANDS,0,TOTALS,NETHERLANDS,200,26,61,42.6,22,48,45.8,4,13,30.8,10,29,34.5,17,26,43,10,18,14,8,1,66,1
10044,232537,275_10_55,HUNGARY,0,TOTALS,HUNGARY,200,25,56,44.6,23,49,46.9,2,7,28.6,6,10,60.0,11,34,45,16,7,30,8,5,58,0
10045,232550,275_10_55,SWITZERLAND,0,TOTALS,SWITZERLAND,200,26,76,34.2,14,46,30.4,12,30,40.0,3,6,50.0,14,22,36,20,13,15,23,4,67,1
10046,232563,275_10_56,AUSTRIA,0,TOTALS,AUSTRIA,200,26,69,37.7,24,53,45.3,2,16,12.5,11,19,57.9,15,26,41,14,17,22,10,4,65,1
10047,232576,275_10_56,BELARUS,0,TOTALS,BELARUS,200,25,71,35.2,20,56,35.7,5,15,33.3,9,20,45.0,22,34,56,9,21,25,12,6,64,0
10048,232589,275_10_57,BELGIUM,0,TOTALS,BELGIUM,225,21,74,28.4,16,53,30.2,5,21,23.8,8,16,50.0,22,27,49,8,22,20,12,0,55,1
10049,232602,275_10_57,FINLAND,0,TOTALS,FINLAND,225,16,49,32.7,11,24,45.8,5,25,20.0,16,27,59.3,10,35,45,7,20,25,7,1,53,0
10050,232615,275_10_58,MONTENEGRO,0,TOTALS,MONTENEGRO,200,26,66,39.4,14,38,36.8,12,28,42.9,11,16,68.8,14,22,36,16,17,11,5,3,75,1
10051,232628,275_10_58,ISRAEL,0,TOTALS,ISRAEL,200,28,49,57.1,22,32,68.8,6,17,35.3,8,19,42.1,5,28,33,17,21,17,9,6,70,0
10052,232641,275_10_59,BOSNIA AND HERZEGOVINA,0,TOTALS,BOSNIA AND HERZEGOVINA,200,20,56,35.7,15,34,44.1,5,22,22.7,8,14,57.1,13,19,32,9,21,17,9,3,53,0
10053,232654,275_10_59,CZECH REPUBLIC,0,TOTALS,CZECH REPUBLIC,200,26,53,49.1,18,30,60.0,8,23,34.8,12,19,63.2,8,28,36,15,18,18,5,3,72,1
10054,232667,275_10_60,ESTONIA,0,TOTALS,ESTONIA,200,26,68,38.2,20,44,45.5,6,24,25.0,12,19,63.2,16,31,47,12,29,20,5,2,70,1
10055,232680,275_10_60,ENGLAND,0,TOTALS,ENGLAND,200,33,71,46.5,18,43,41.9,15,28,53.6,21,43,48.8,18,29,47,24,18,7,10,1,102,0
10056,232693,275_10_61,SLOVAK REPUBLIC,0,TOTALS,SLOVAK REPUBLIC,200,28,58,48.3,22,36,61.1,6,22,27.3,9,22,40.9,12,22,34,21,22,18,14,5,71,1
10057,232706,275_10_61,PORTUGAL,0,TOTALS,PORTUGAL,200,23,49,46.9,19,38,50.0,4,11,36.4,15,29,51.7,11,25,36,12,20,21,8,1,65,0
10058,232719,275_10_62,ROMANIA,0,TOTALS,ROMANIA,200,23,59,39.0,20,46,43.5,3,13,23.1,7,11,63.6,13,27,40,16,12,25,6,4,56,0
10059,232732,275_10_62,GEORGIA,0,TOTALS,GEORGIA,200,26,68,38.2,18,40,45.0,8,28,28.6,11,14,78.6,16,22,38,16,17,16,10,4,71,1
10060,232745,275_10_63,SCOTLAND,0,TOTALS,SCOTLAND,200,30,71,42.3,27,53,50.9,3,18,16.7,7,20,35.0,21,43,64,21,7,18,5,2,70,1
10061,232758,275_10_63,LUXEMBOURG,0,TOTALS,LUXEMBOURG,200,18,67,26.9,14,38,36.8,4,29,13.8,5,8,62.5,9,25,34,11,23,14,12,2,45,0
10062,232771,275_10_64,NETHERLANDS,0,TOTALS,NETHERLANDS,200,26,69,37.7,25,60,41.7,1,9,11.1,3,6,50.0,11,21,32,7,16,16,9,5,56,0
10063,232784,275_10_64,BELARUS,0,TOTALS,BELARUS,200,29,69,42.0,26,55,47.3,3,14,21.4,7,13,53.8,21,33,54,16,10,20,8,8,68,1
10064,232797,275_10_65,DENMARK,0,TOTALS,DENMARK,200,23,62,37.1,20,49,40.8,3,13,23.1,12,16,75.0,10,25,35,19,12,19,14,4,61,0
10065,232810,275_10_65,HUNGARY,0,TOTALS,HUNGARY,200,29,71,40.8,20,48,41.7,9,23,39.1,3,9,33.3,17,30,47,17,14,22,9,5,70,1
10066,232823,275_10_66,AUSTRIA,0,TOTALS,AUSTRIA,200,24,59,40.7,20,42,47.6,4,17,23.5,17,25,68.0,16,27,43,19,17,23,8,3,69,1
10067,232836,275_10_66,SWITZERLAND,0,TOTALS,SWITZERLAND,200,26,67,38.8,20,48,41.7,6,19,31.6,9,13,69.2,12,25,37,16,24,14,11,5,67,0
10068,232849,275_10_67,BELGIUM,0,TOTALS,BELGIUM,200,20,55,36.4,16,40,40.0,4,15,26.7,13,22,59.1,11,30,41,9,22,22,8,6,57,0
10069,232862,275_10_67,ESTONIA,0,TOTALS,ESTONIA,200,23,66,34.8,20,47,42.6,3,19,15.8,10,18,55.6,17,30,47,10,22,17,15,4,59,1
10070,232875,275_10_68,MONTENEGRO,0,TOTALS,MONTENEGRO,200,17,46,37.0,13,25,52.0,4,21,19.0,16,23,69.6,13,18,31,14,16,16,7,1,54,0
10071,232888,275_10_68,CZECH REPUBLIC,0,TOTALS,CZECH REPUBLIC,200,19,53,35.8,12,29,41.4,7,24,29.2,11,15,73.3,15,18,33,9,20,19,4,2,56,1
10072,232901,275_10_69,ENGLAND,0,TOTALS,ENGLAND,200,25,58,43.1,15,38,39.5,10,20,50.0,8,22,36.4,12,23,35,13,15,14,10,0,68,1
10073,232914,275_10_69,BOSNIA AND HERZEGOVINA,0,TOTALS,BOSNIA AND HERZEGOVINA,200,27,61,44.3,19,29,65.5,8,32,25.0,3,6,50.0,13,28,41,18,23,20,6,1,65,0
10074,232927,275_10_70,FINLAND,0,TOTALS,FINLAND,200,23,62,37.1,15,25,60.0,8,37,21.6,7,12,58.3,14,33,47,11,22,18,6,4,61,1
10075,232940,275_10_70,ISRAEL,0,TOTALS,ISRAEL,200,23,65,35.4,21,47,44.7,2,18,11.1,11,21,52.4,15,26,41,10,15,8,8,2,59,0
10076,232953,275_10_71,LUXEMBOURG,0,TOTALS,LUXEMBOURG,200,27,82,32.9,21,46,45.7,6,36,16.7,7,11,63.6,11,24,35,12,14,11,13,1,67,0
10077,232965,275_10_71,DENMARK,0,TOTALS,DENMARK,200,38,76,50.0,36,64,56.2,2,12,16.7,14,19,73.7,19,43,62,25,10,18,8,4,92,1
10078,232978,275_10_72,SCOTLAND,0,TOTALS,SCOTLAND,200,23,69,33.3,17,50,34.0,6,19,31.6,3,8,37.5,11,19,30,20,12,17,9,5,55,0
10079,232991,275_10_72,HUNGARY,0,TOTALS,HUNGARY,200,35,64,54.7,26,46,56.5,9,18,50.0,5,6,83.3,11,36,47,23,5,17,6,3,84,1
10080,233004,275_10_73,NETHERLANDS,0,TOTALS,NETHERLANDS,200,22,67,32.8,19,53,35.8,3,14,21.4,6,10,60.0,20,31,51,11,13,24,11,3,53,0
10081,233017,275_10_73,SWITZERLAND,0,TOTALS,SWITZERLAND,200,22,60,36.7,17,42,40.5,5,18,27.8,10,22,45.5,14,28,42,13,11,20,11,8,59,1
10082,233030,275_10_74,BELARUS,0,TOTALS,BELARUS,200,37,83,44.6,32,62,51.6,5,21,23.8,15,21,71.4,29,45,74,23,15,23,6,7,94,1
10083,233043,275_10_74,AUSTRIA,0,TOTALS,AUSTRIA,200,25,77,32.5,18,51,35.3,7,26,26.9,9,15,60.0,10,18,28,19,20,12,17,4,66,0
10084,233056,275_10_75,BELGIUM,0,TOTALS,BELGIUM,200,39,72,54.2,35,58,60.3,4,14,28.6,15,20,75.0,18,26,44,21,21,14,17,2,97,1
10085,233069,275_10_75,BOSNIA AND HERZEGOVINA,0,TOTALS,BOSNIA AND HERZEGOVINA,200,22,53,41.5,15,33,45.5,7,20,35.0,6,18,33.3,11,18,29,10,16,20,6,4,57,0
10086,233082,275_10_76,ISRAEL,0,TOTALS,ISRAEL,200,22,59,37.3,16,44,36.4,6,15,40.0,10,16,62.5,9,17,26,13,28,17,15,2,60,0
10087,233095,275_10_76,MONTENEGRO,0,TOTALS,MONTENEGRO,200,23,47,48.9,14,28,50.0,9,19,47.4,20,35,57.1,13,30,43,21,17,22,10,3,75,1
10088,233108,275_10_77,ESTONIA,0,TOTALS,ESTONIA,200,27,64,42.2,22,39,56.4,5,25,20.0,11,14,78.6,11,27,38,11,18,19,11,3,70,1
10089,233121,275_10_77,ENGLAND,0,TOTALS,ENGLAND,200,23,58,39.7,16,38,42.1,7,20,35.0,10,16,62.5,11,24,35,19,11,21,12,2,63,0
10090,233134,275_10_78,FINLAND,0,TOTALS,FINLAND,200,17,50,34.0,11,23,47.8,6,27,22.2,6,13,46.2,6,20,26,8,15,16,3,1,46,0
10091,233147,275_10_78,CZECH REPUBLIC,0,TOTALS,CZECH REPUBLIC,200,32,70,45.7,24,42,57.1,8,28,28.6,6,10,60.0,20,29,49,18,17,9,6,4,78,1
10092,236642,278_10_01,BULGARIA,0,TOTALS,BULGARIA,200,28,61,45.9,21,43,48.8,7,18,38.9,16,21,76.2,20,29,49,16,21,18,8,1,79,1
10093,236655,278_10_01,POLAND,0,TOTALS,POLAND,200,21,64,32.8,17,33,51.5,4,31,12.9,7,20,35.0,19,12,31,10,18,19,10,1,53,0
10094,236668,278_10_02,GERMANY,0,TOTALS,GERMANY,200,20,49,40.8,16,38,42.1,4,11,36.4,10,17,58.8,8,26,34,10,18,25,8,2,54,0
10095,236681,278_10_02,ITALY,0,TOTALS,ITALY,200,27,69,39.1,20,42,47.6,7,27,25.9,12,16,75.0,15,21,36,13,18,12,11,1,73,1
10096,236694,278_10_03,LATVIA,0,TOTALS,LATVIA,200,12,41,29.3,10,27,37.0,2,14,14.3,6,12,50.0,2,29,31,4,19,29,1,4,32,0
10097,236707,278_10_03,SPAIN,0,TOTALS,SPAIN,200,25,59,42.4,20,43,46.5,5,16,31.2,10,15,66.7,8,26,34,7,16,12,15,2,65,1
10098,236720,278_10_04,RUSSIA,0,TOTALS,RUSSIA,200,14,56,25.0,8,25,32.0,6,31,19.4,16,28,57.1,11,22,33,7,17,15,7,6,50,0
10099,236733,278_10_04,TURKEY,0,TOTALS,TURKEY,200,29,69,42.0,25,52,48.1,4,17,23.5,9,12,75.0,25,32,57,8,27,18,9,0,71,1
10100,236746,278_10_05,CROATIA,0,TOTALS,CROATIA,200,29,67,43.3,22,45,48.9,7,22,31.8,4,10,40.0,10,32,42,13,25,19,13,3,69,1
10101,236759,278_10_05,SERBIA,0,TOTALS,SERBIA,200,21,60,35.0,15,39,38.5,6,21,28.6,16,25,64.0,7,33,40,6,15,17,6,4,64,0
10102,236772,278_10_06,DENMARK,0,TOTALS,DENMARK,200,21,58,36.2,15,37,40.5,6,21,28.6,7,17,41.2,18,34,52,9,10,19,8,2,55,1
10103,236785,278_10_06,GREECE,0,TOTALS,GREECE,200,23,70,32.9,20,49,40.8,3,21,14.3,4,8,50.0,17,27,44,7,18,11,7,3,53,0
10104,236798,278_10_07,FRANCE,0,TOTALS,FRANCE,200,24,60,40.0,17,37,45.9,7,23,30.4,11,19,57.9,15,27,42,10,20,9,6,0,66,1
10105,236811,278_10_07,LITHUANIA,0,TOTALS,LITHUANIA,200,18,49,36.7,13,28,46.4,5,21,23.8,5,12,41.7,6,19,25,10,18,16,2,0,46,0
10106,236824,278_10_08,MONTENEGRO,0,TOTALS,MONTENEGRO,200,32,61,52.5,30,51,58.8,2,10,20.0,15,22,68.2,14,34,48,15,15,27,10,4,81,1
10107,236837,278_10_08,ISRAEL,0,TOTALS,ISRAEL,200,28,67,41.8,21,49,42.9,7,18,38.9,8,12,66.7,6,18,24,15,20,22,15,1,71,0
10108,236850,278_10_09,ITALY,0,TOTALS,ITALY,200,24,68,35.3,17,37,45.9,7,31,22.6,6,10,60.0,16,23,39,11,25,21,13,2,61,0
10109,236863,278_10_09,CROATIA,0,TOTALS,CROATIA,200,23,46,50.0,18,29,62.1,5,17,29.4,21,30,70.0,7,29,36,14,16,24,11,2,72,1
10110,236876,278_10_10,POLAND,0,TOTALS,POLAND,200,22,58,37.9,19,37,51.4,3,21,14.3,25,30,83.3,17,33,50,13,15,19,10,6,72,1
10111,236889,278_10_10,LATVIA,0,TOTALS,LATVIA,200,18,65,27.7,15,40,37.5,3,25,12.0,6,13,46.2,16,22,38,5,26,19,9,4,45,0
10112,236902,278_10_11,SPAIN,0,TOTALS,SPAIN,200,33,64,51.6,29,51,56.9,4,13,30.8,9,19,47.4,13,40,53,15,20,13,9,6,79,1
10113,236915,278_10_11,BULGARIA,0,TOTALS,BULGARIA,200,13,70,18.6,12,54,22.2,1,16,6.2,13,20,65.0,20,22,42,9,13,14,6,3,40,0
10114,236928,278_10_12,ISRAEL,0,TOTALS,ISRAEL,200,21,52,40.4,17,39,43.6,4,13,30.8,12,21,57.1,5,23,28,4,28,19,10,1,58,0
10115,236941,278_10_12,RUSSIA,0,TOTALS,RUSSIA,200,24,62,38.7,20,45,44.4,4,17,23.5,24,35,68.6,22,29,51,15,18,18,16,0,76,1
10116,236954,278_10_13,SERBIA,0,TOTALS,SERBIA,200,26,61,42.6,18,32,56.2,8,29,27.6,18,27,66.7,12,31,43,12,17,17,15,2,78,1
10117,236967,278_10_13,GERMANY,0,TOTALS,GERMANY,200,21,60,35.0,19,45,42.2,2,15,13.3,5,13,38.5,13,27,40,7,26,30,10,0,49,0
10118,236980,278_10_14,LITHUANIA,0,TOTALS,LITHUANIA,200,33,69,47.8,23,40,57.5,10,29,34.5,16,24,66.7,16,30,46,16,17,10,11,6,92,1
10119,236993,278_10_14,DENMARK,0,TOTALS,DENMARK,200,16,52,30.8,12,34,35.3,4,18,22.2,11,18,61.1,14,23,37,8,22,17,7,1,47,0
10120,237006,278_10_15,GREECE,0,TOTALS,GREECE,200,19,52,36.5,16,39,41.0,3,13,23.1,11,17,64.7,14,28,42,6,19,23,9,5,52,0
10121,237019,278_10_15,FRANCE,0,TOTALS,FRANCE,200,19,52,36.5,13,28,46.4,6,24,25.0,11,22,50.0,13,24,37,9,18,19,16,2,55,1
10122,237032,278_10_16,TURKEY,0,TOTALS,TURKEY,200,22,59,37.3,17,37,45.9,5,22,22.7,5,15,33.3,13,21,34,7,22,16,8,1,54,0
10123,237045,278_10_16,MONTENEGRO,0,TOTALS,MONTENEGRO,200,25,49,51.0,21,34,61.8,4,15,26.7,13,22,59.1,7,29,36,14,24,18,6,1,67,1
10124,237058,278_10_17,GERMANY,0,TOTALS,GERMANY,200,28,54,51.9,21,37,56.8,7,17,41.2,6,9,66.7,12,25,37,15,13,20,11,1,69,1
10125,237071,278_10_17,CROATIA,0,TOTALS,CROATIA,200,16,49,32.7,12,28,42.9,4,21,19.0,8,10,80.0,11,16,27,9,9,21,9,1,44,0
10126,237084,278_10_18,BULGARIA,0,TOTALS,BULGARIA,200,21,59,35.6,11,38,28.9,10,21,47.6,17,20,85.0,10,23,33,10,14,10,8,2,69,1
10127,237097,278_10_18,LATVIA,0,TOTALS,LATVIA,200,27,64,42.2,19,37,51.4,8,27,29.6,4,11,36.4,17,29,46,11,18,15,7,2,66,0
10128,237110,278_10_19,SPAIN,0,TOTALS,SPAIN,200,28,70,40.0,20,47,42.6,8,23,34.8,12,21,57.1,18,37,55,18,11,12,4,3,76,1
10129,237123,278_10_19,POLAND,0,TOTALS,POLAND,200,20,69,29.0,16,40,40.0,4,29,13.8,8,11,72.7,13,28,41,8,21,12,10,0,52,0
10130,237136,278_10_20,TURKEY,0,TOTALS,TURKEY,200,22,53,41.5,20,38,52.6,2,15,13.3,12,22,54.5,6,29,35,13,21,16,9,1,58,0
10131,237149,278_10_20,ISRAEL,0,TOTALS,ISRAEL,200,21,58,36.2,13,37,35.1,8,21,38.1,11,19,57.9,15,32,47,12,20,17,6,0,61,1
10132,237162,278_10_21,SERBIA,0,TOTALS,SERBIA,200,29,60,48.3,26,43,60.5,3,17,17.6,12,23,52.2,13,22,35,16,16,17,13,4,73,1
10133,237175,278_10_21,ITALY,0,TOTALS,ITALY,200,24,62,38.7,17,44,38.6,7,18,38.9,6,10,60.0,15,23,38,8,22,25,7,2,61,0
10134,237188,278_10_22,DENMARK,0,TOTALS,DENMARK,200,11,44,25.0,5,22,22.7,6,22,27.3,7,16,43.8,7,21,28,7,11,15,0,2,35,0
10135,237201,278_10_22,FRANCE,0,TOTALS,FRANCE,200,32,69,46.4,26,43,60.5,6,26,23.1,3,3,100.0,16,33,49,18,17,4,8,1,73,1
10136,237214,278_10_23,LITHUANIA,0,TOTALS,LITHUANIA,200,22,53,41.5,16,34,47.1,6,19,31.6,13,23,56.5,9,30,39,7,21,23,9,1,63,0
10137,237227,278_10_23,GREECE,0,TOTALS,GREECE,200,24,57,42.1,22,44,50.0,2,13,15.4,16,27,59.3,10,25,35,12,24,20,10,1,66,1
10138,237240,278_10_24,MONTENEGRO,0,TOTALS,MONTENEGRO,200,25,58,43.1,23,41,56.1,2,17,11.8,13,20,65.0,10,30,40,9,17,9,6,1,65,1
10139,237253,278_10_24,RUSSIA,0,TOTALS,RUSSIA,200,21,57,36.8,11,35,31.4,10,22,45.5,8,10,80.0,8,28,36,9,22,14,8,5,60,0
10140,237266,278_10_25,GERMANY,0,TOTALS,GERMANY,200,21,54,38.9,17,41,41.5,4,13,30.8,16,30,53.3,6,26,32,12,14,16,9,1,62,1
10141,237279,278_10_25,ISRAEL,0,TOTALS,ISRAEL,200,21,54,38.9,14,31,45.2,7,23,30.4,10,14,71.4,9,35,44,12,22,25,7,1,59,0
10142,237292,278_10_26,DENMARK,0,TOTALS,DENMARK,200,19,60,31.7,15,46,32.6,4,14,28.6,4,13,30.8,12,24,36,4,13,16,6,6,46,0
10143,237305,278_10_26,LATVIA,0,TOTALS,LATVIA,200,26,64,40.6,16,39,41.0,10,25,40.0,3,5,60.0,15,35,50,10,14,20,7,2,65,1
10144,237318,278_10_27,ITALY,0,TOTALS,ITALY,200,27,75,36.0,22,46,47.8,5,29,17.2,6,7,85.7,10,36,46,15,22,23,13,3,65,0
10145,237331,278_10_27,FRANCE,0,TOTALS,FRANCE,200,25,67,37.3,19,43,44.2,6,24,25.0,11,22,50.0,14,37,51,9,13,24,11,0,67,1
10146,237344,278_10_28,TURKEY,0,TOTALS,TURKEY,200,34,75,45.3,29,55,52.7,5,20,25.0,4,9,44.4,19,29,48,13,19,11,11,1,77,1
10147,237357,278_10_28,BULGARIA,0,TOTALS,BULGARIA,200,20,54,37.0,16,35,45.7,4,19,21.1,16,23,69.6,9,25,34,12,12,17,7,1,60,0
10148,237370,278_10_29,GREECE,0,TOTALS,GREECE,200,18,60,30.0,16,41,39.0,2,19,10.5,11,20,55.0,19,24,43,4,20,22,5,6,49,0
10149,237383,278_10_29,CROATIA,0,TOTALS,CROATIA,200,26,66,39.4,20,39,51.3,6,27,22.2,12,19,63.2,16,26,42,12,17,16,13,1,70,1
10150,237396,278_10_30,RUSSIA,0,TOTALS,RUSSIA,200,24,52,46.2,20,35,57.1,4,17,23.5,13,18,72.2,11,22,33,6,17,22,8,1,65,0
10151,237409,278_10_30,SPAIN,0,TOTALS,SPAIN,200,31,57,54.4,24,40,60.0,7,17,41.2,8,18,44.4,9,21,30,9,20,17,15,3,77,1
10152,237422,278_10_31,LITHUANIA,0,TOTALS,LITHUANIA,200,24,61,39.3,21,47,44.7,3,14,21.4,23,34,67.6,14,22,36,9,23,16,8,4,74,0
10153,237435,278_10_31,SERBIA,0,TOTALS,SERBIA,200,25,56,44.6,21,36,58.3,4,20,20.0,22,31,71.0,11,28,39,10,31,17,11,3,76,1
10154,237448,278_10_32,POLAND,0,TOTALS,POLAND,200,27,68,39.7,25,46,54.3,2,22,9.1,13,16,81.2,17,16,33,17,19,15,11,2,69,0
10155,237461,278_10_32,MONTENEGRO,0,TOTALS,MONTENEGRO,200,34,57,59.6,26,37,70.3,8,20,40.0,19,27,70.4,12,26,38,22,14,18,10,3,95,1
10156,237474,278_10_33,LATVIA,0,TOTALS,LATVIA,200,17,58,29.3,10,33,30.3,7,25,28.0,13,28,46.4,19,25,44,4,23,14,5,2,54,0
10157,237487,278_10_33,GERMANY,0,TOTALS,GERMANY,200,18,57,31.6,16,49,32.7,2,8,25.0,18,29,62.1,18,29,47,5,18,13,10,1,56,1
10158,237500,278_10_34,ISRAEL,0,TOTALS,ISRAEL,200,26,67,38.8,22,44,50.0,4,23,17.4,7,12,58.3,20,26,46,8,12,14,17,2,63,1
10159,237513,278_10_34,DENMARK,0,TOTALS,DENMARK,200,24,60,40.0,15,36,41.7,9,24,37.5,4,9,44.4,12,29,41,13,13,24,9,7,61,0
10160,237526,278_10_35,GREECE,0,TOTALS,GREECE,200,21,48,43.8,17,35,48.6,4,13,30.8,13,27,48.1,8,32,40,6,21,27,8,5,59,0
10161,237539,278_10_35,ITALY,0,TOTALS,ITALY,200,27,67,40.3,23,44,52.3,4,23,17.4,13,24,54.2,16,27,43,12,22,15,13,3,71,1
10162,237552,278_10_36,SPAIN,0,TOTALS,SPAIN,200,23,76,30.3,20,58,34.5,3,18,16.7,25,47,53.2,30,34,64,7,19,14,8,5,74,1
10163,237565,278_10_36,TURKEY,0,TOTALS,TURKEY,200,26,67,38.8,21,53,39.6,5,14,35.7,12,22,54.5,13,34,47,9,33,16,8,1,69,0
10164,237578,278_10_37,SERBIA,0,TOTALS,SERBIA,225,26,77,33.8,18,39,46.2,8,38,21.1,9,13,69.2,19,35,54,11,18,12,7,2,69,1
10165,237591,278_10_37,FRANCE,0,TOTALS,FRANCE,225,24,69,34.8,20,45,44.4,4,24,16.7,9,17,52.9,15,34,49,11,16,16,5,2,61,0
10166,237604,278_10_38,RUSSIA,0,TOTALS,RUSSIA,200,32,71,45.1,24,40,60.0,8,31,25.8,17,24,70.8,22,28,50,16,21,22,12,1,89,1
10167,237617,278_10_38,POLAND,0,TOTALS,POLAND,200,35,74,47.3,25,48,52.1,10,26,38.5,7,17,41.2,15,23,38,19,22,21,13,1,87,0
10168,237630,278_10_39,CROATIA,0,TOTALS,CROATIA,200,26,54,48.1,19,34,55.9,7,20,35.0,19,29,65.5,9,35,44,15,18,16,8,1,78,1
10169,237643,278_10_39,LITHUANIA,0,TOTALS,LITHUANIA,200,24,69,34.8,12,32,37.5,12,37,32.4,8,13,61.5,13,25,38,11,27,13,4,1,68,0
10170,237656,278_10_40,BULGARIA,0,TOTALS,BULGARIA,200,28,65,43.1,20,41,48.8,8,24,33.3,8,14,57.1,15,28,43,15,15,16,7,3,72,1
10171,237669,278_10_40,MONTENEGRO,0,TOTALS,MONTENEGRO,200,25,58,43.1,19,36,52.8,6,22,27.3,5,11,45.5,11,26,37,16,18,15,9,2,61,0
10172,237682,278_10_41,GERMANY,0,TOTALS,GERMANY,200,26,67,38.8,21,50,42.0,5,17,29.4,11,13,84.6,15,28,43,10,9,13,16,3,68,1
10173,237695,278_10_41,DENMARK,0,TOTALS,DENMARK,200,15,51,29.4,8,24,33.3,7,27,25.9,3,4,75.0,8,26,34,7,14,24,5,4,40,0
10174,237708,278_10_42,LATVIA,0,TOTALS,LATVIA,200,20,63,31.7,14,40,35.0,6,23,26.1,17,23,73.9,19,29,48,9,17,17,6,2,63,1
10175,237721,278_10_42,ISRAEL,0,TOTALS,ISRAEL,200,22,57,38.6,18,43,41.9,4,14,28.6,10,14,71.4,6,28,34,7,19,12,8,4,58,0
10176,237734,278_10_43,SERBIA,0,TOTALS,SERBIA,200,30,74,40.5,26,54,48.1,4,20,20.0,18,26,69.2,13,34,47,19,23,6,9,2,82,1
10177,237747,278_10_43,GREECE,0,TOTALS,GREECE,200,25,64,39.1,22,49,44.9,3,15,20.0,16,29,55.2,12,33,45,12,22,15,5,1,69,0
10178,237760,278_10_44,BULGARIA,0,TOTALS,BULGARIA,200,17,53,32.1,12,29,41.4,5,24,20.8,10,15,66.7,9,29,38,7,12,20,9,2,49,0
10179,237773,278_10_44,RUSSIA,0,TOTALS,RUSSIA,200,24,72,33.3,16,41,39.0,8,31,25.8,8,8,100.0,19,30,49,15,16,14,14,3,64,1
10180,237786,278_10_45,LITHUANIA,0,TOTALS,LITHUANIA,200,30,56,53.6,26,40,65.0,4,16,25.0,16,27,59.3,10,41,51,8,13,26,11,7,80,1
10181,237799,278_10_45,ITALY,0,TOTALS,ITALY,200,25,70,35.7,18,46,39.1,7,24,29.2,4,9,44.4,15,23,38,10,24,16,11,3,61,0
10182,237812,278_10_46,TURKEY,0,TOTALS,TURKEY,200,34,71,47.9,27,51,52.9,7,20,35.0,14,21,66.7,20,33,53,22,12,18,10,1,89,1
10183,237825,278_10_46,POLAND,0,TOTALS,POLAND,200,26,64,40.6,22,41,53.7,4,23,17.4,4,10,40.0,7,21,28,13,18,19,10,1,60,0
10184,237838,278_10_47,FRANCE,0,TOTALS,FRANCE,200,23,51,45.1,13,25,52.0,10,26,38.5,8,14,57.1,6,27,33,15,21,15,6,1,64,1
10185,237851,278_10_47,CROATIA,0,TOTALS,CROATIA,200,22,59,37.3,15,31,48.4,7,28,25.0,12,20,60.0,15,24,39,11,16,14,3,1,63,0
10186,237864,278_10_48,MONTENEGRO,0,TOTALS,MONTENEGRO,200,24,47,51.1,20,33,60.6,4,14,28.6,16,21,76.2,9,28,37,13,22,26,8,2,68,1
10187,237877,278_10_48,SPAIN,0,TOTALS,SPAIN,200,22,59,37.3,16,42,38.1,6,17,35.3,13,23,56.5,11,14,25,11,18,16,13,3,63,0
10188,237890,278_10_49,ISRAEL,0,TOTALS,ISRAEL,200,21,52,40.4,17,33,51.5,4,19,21.1,14,21,66.7,4,31,35,7,18,16,10,1,60,1
10189,237903,278_10_49,GERMANY,0,TOTALS,GERMANY,200,16,57,28.1,14,46,30.4,2,11,18.2,15,20,75.0,13,30,43,10,20,18,12,0,49,0
10190,237916,278_10_50,CROATIA,0,TOTALS,CROATIA,200,27,63,42.9,16,31,51.6,11,32,34.4,16,21,76.2,14,22,36,11,16,10,7,4,81,1
10191,237929,278_10_50,RUSSIA,0,TOTALS,RUSSIA,200,23,54,42.6,13,22,59.1,10,32,31.2,9,11,81.8,11,22,33,10,21,12,4,2,65,0
10192,237942,278_10_51,LATVIA,0,TOTALS,LATVIA,200,15,51,29.4,6,25,24.0,9,26,34.6,10,16,62.5,14,28,42,9,18,15,8,1,49,1
10193,237955,278_10_51,DENMARK,0,TOTALS,DENMARK,200,18,60,30.0,17,49,34.7,1,11,9.1,10,16,62.5,18,26,44,10,20,14,7,4,47,0
10194,237968,278_10_52,SERBIA,0,TOTALS,SERBIA,200,22,52,42.3,16,31,51.6,6,21,28.6,12,21,57.1,9,25,34,8,24,25,7,2,62,0
10195,237981,278_10_52,TURKEY,0,TOTALS,TURKEY,200,24,61,39.3,21,49,42.9,3,12,25.0,13,21,61.9,15,24,39,8,25,19,15,2,64,1
10196,237994,278_10_53,SPAIN,0,TOTALS,SPAIN,200,16,51,31.4,8,26,30.8,8,25,32.0,17,21,81.0,9,20,29,11,18,20,11,0,57,1
10197,238007,278_10_53,FRANCE,0,TOTALS,FRANCE,200,19,46,41.3,14,28,50.0,5,18,27.8,13,19,68.4,9,28,37,7,23,27,7,2,56,0
10198,238020,278_10_54,ITALY,0,TOTALS,ITALY,200,33,64,51.6,28,48,58.3,5,16,31.2,5,9,55.6,11,23,34,16,22,23,12,5,76,1
10199,238033,278_10_54,POLAND,0,TOTALS,POLAND,200,21,51,41.2,15,28,53.6,6,23,26.1,13,22,59.1,11,21,32,12,11,28,11,0,61,0
10200,238046,278_10_55,MONTENEGRO,0,TOTALS,MONTENEGRO,200,23,60,38.3,22,47,46.8,1,13,7.7,8,8,100.0,14,21,35,12,16,18,13,2,55,0
10201,238059,278_10_55,LITHUANIA,0,TOTALS,LITHUANIA,200,18,48,37.5,12,30,40.0,6,18,33.3,14,20,70.0,11,23,34,12,14,19,8,4,56,1
10202,238072,278_10_56,BULGARIA,0,TOTALS,BULGARIA,200,23,61,37.7,11,29,37.9,12,32,37.5,9,16,56.2,9,21,30,14,17,16,11,1,67,0
10203,238085,278_10_56,GREECE,0,TOTALS,GREECE,200,31,58,53.4,25,42,59.5,6,16,37.5,10,17,58.8,9,31,40,13,13,20,11,3,78,1
10204,238098,278_10_57,DENMARK,0,TOTALS,DENMARK,200,20,57,35.1,11,30,36.7,9,27,33.3,13,17,76.5,12,28,40,13,14,21,5,0,62,0
10205,238111,278_10_57,ISRAEL,0,TOTALS,ISRAEL,200,29,65,44.6,16,37,43.2,13,28,46.4,4,8,50.0,9,24,33,18,18,15,12,1,75,1
10206,238124,278_10_58,RUSSIA,0,TOTALS,RUSSIA,200,20,55,36.4,13,27,48.1,7,28,25.0,4,8,50.0,9,20,29,7,18,14,6,3,51,0
10207,238137,278_10_58,FRANCE,0,TOTALS,FRANCE,200,23,53,43.4,20,34,58.8,3,19,15.8,19,29,65.5,16,29,45,12,11,15,8,0,68,1
10208,238150,278_10_59,GERMANY,0,TOTALS,GERMANY,200,25,59,42.4,21,46,45.7,4,13,30.8,9,14,64.3,10,28,38,11,16,10,8,7,63,1
10209,238163,278_10_59,LATVIA,0,TOTALS,LATVIA,200,16,57,28.1,11,31,35.5,5,26,19.2,9,15,60.0,14,26,40,9,16,14,3,3,46,0
10210,238176,278_10_60,SERBIA,0,TOTALS,SERBIA,200,27,62,43.5,22,38,57.9,5,24,20.8,19,28,67.9,16,32,48,17,23,30,12,2,78,1
10211,238189,278_10_60,MONTENEGRO,0,TOTALS,MONTENEGRO,200,31,67,46.3,28,55,50.9,3,12,25.0,9,22,40.9,11,21,32,12,18,21,15,5,74,0
10212,238202,278_10_61,CROATIA,0,TOTALS,CROATIA,200,26,54,48.1,14,28,50.0,12,26,46.2,22,35,62.9,11,24,35,12,25,19,9,6,86,1
10213,238215,278_10_61,SPAIN,0,TOTALS,SPAIN,200,28,63,44.4,21,43,48.8,7,20,35.0,19,26,73.1,13,23,36,11,28,17,9,1,82,0
10214,238228,278_10_62,POLAND,0,TOTALS,POLAND,200,30,61,49.2,28,46,60.9,2,15,13.3,6,10,60.0,13,32,45,20,9,18,9,3,68,1
10215,238241,278_10_62,BULGARIA,0,TOTALS,BULGARIA,200,18,53,34.0,16,38,42.1,2,15,13.3,5,6,83.3,4,20,24,11,11,17,6,0,43,0
10216,238254,278_10_63,ITALY,0,TOTALS,ITALY,200,25,62,40.3,16,41,39.0,9,21,42.9,8,12,66.7,17,23,40,13,27,14,8,2,67,1
10217,238267,278_10_63,GREECE,0,TOTALS,GREECE,200,17,39,43.6,13,32,40.6,4,7,57.1,15,30,50.0,8,21,29,10,11,19,7,1,53,0
10218,238280,278_10_64,TURKEY,0,TOTALS,TURKEY,200,25,65,38.5,17,38,44.7,8,27,29.6,7,15,46.7,15,22,37,12,17,8,3,2,65,0
10219,238293,278_10_64,LITHUANIA,0,TOTALS,LITHUANIA,200,29,61,47.5,19,39,48.7,10,22,45.5,12,18,66.7,14,30,44,18,15,10,3,4,80,1
10220,238306,278_10_65,DENMARK,0,TOTALS,DENMARK,200,26,56,46.4,16,30,53.3,10,26,38.5,15,24,62.5,11,25,36,13,20,14,4,3,77,1
10221,238319,278_10_65,GERMANY,0,TOTALS,GERMANY,200,24,64,37.5,18,47,38.3,6,17,35.3,18,20,90.0,14,22,36,12,17,9,8,0,72,0
10222,238332,278_10_66,RUSSIA,0,TOTALS,RUSSIA,200,30,63,47.6,22,39,56.4,8,24,33.3,10,15,66.7,14,26,40,13,20,16,7,3,78,1
10223,238345,278_10_66,MONTENEGRO,0,TOTALS,MONTENEGRO,200,25,60,41.7,21,44,47.7,4,16,25.0,10,17,58.8,11,21,32,11,16,13,9,1,64,0
10224,238358,278_10_67,ISRAEL,0,TOTALS,ISRAEL,200,20,57,35.1,15,38,39.5,5,19,26.3,17,26,65.4,10,21,31,7,22,11,12,2,62,0
10225,238371,278_10_67,LATVIA,0,TOTALS,LATVIA,200,20,57,35.1,12,32,37.5,8,25,32.0,17,21,81.0,17,31,48,11,21,19,5,2,65,1
10226,238384,278_10_68,FRANCE,0,TOTALS,FRANCE,200,15,52,28.8,13,32,40.6,2,20,10.0,13,24,54.2,14,30,44,5,12,17,9,2,45,0
10227,238397,278_10_68,SERBIA,0,TOTALS,SERBIA,200,20,58,34.5,13,32,40.6,7,26,26.9,8,10,80.0,8,32,40,16,21,13,10,3,55,1
10228,238410,278_10_69,SPAIN,0,TOTALS,SPAIN,200,21,56,37.5,17,37,45.9,4,19,21.1,18,29,62.1,13,23,36,8,25,17,7,4,64,0
10229,238423,278_10_69,TURKEY,0,TOTALS,TURKEY,200,24,54,44.4,18,38,47.4,6,16,37.5,21,33,63.6,13,25,38,14,28,17,6,2,75,1
10230,238436,278_10_70,CROATIA,0,TOTALS,CROATIA,200,34,59,57.6,25,42,59.5,9,17,52.9,3,7,42.9,10,34,44,17,7,27,14,5,80,1
10231,238449,278_10_70,LITHUANIA,0,TOTALS,LITHUANIA,200,20,72,27.8,16,51,31.4,4,21,19.0,8,9,88.9,17,17,34,9,14,20,16,5,52,0
10232,238462,279_10_01,PORTUGAL,0,TOTALS,PORTUGAL,200,23,62,37.1,14,38,36.8,9,24,37.5,10,19,52.6,17,29,46,11,16,22,12,2,65,1
10233,238475,279_10_01,SWEDEN,0,TOTALS,SWEDEN,200,20,54,37.0,13,34,38.2,7,20,35.0,10,13,76.9,7,26,33,11,18,24,13,4,57,0
10234,238488,279_10_02,BELARUS,0,TOTALS,BELARUS,200,25,62,40.3,20,45,44.4,5,17,29.4,6,9,66.7,17,34,51,8,13,29,8,1,61,0
10235,238501,279_10_02,ENGLAND,0,TOTALS,ENGLAND,200,26,73,35.6,21,55,38.2,5,18,27.8,5,10,50.0,15,21,36,15,14,14,22,5,62,1
10236,238514,279_10_03,AUSTRIA,0,TOTALS,AUSTRIA,200,17,58,29.3,13,46,28.3,4,12,33.3,7,18,38.9,16,25,41,8,20,25,11,1,45,0
10237,238527,279_10_03,UKRAINE,0,TOTALS,UKRAINE,200,29,65,44.6,25,46,54.3,4,19,21.1,15,24,62.5,15,30,45,11,16,19,16,7,77,1
10238,238540,279_10_04,SLOVAK REPUBLIC,0,TOTALS,SLOVAK REPUBLIC,200,21,69,30.4,18,45,40.0,3,24,12.5,12,23,52.2,18,28,46,10,25,21,6,2,57,0
10239,238553,279_10_04,CZECH REPUBLIC,0,TOTALS,CZECH REPUBLIC,200,27,65,41.5,23,48,47.9,4,17,23.5,19,23,82.6,11,35,46,11,21,18,14,5,77,1
10240,238566,279_10_05,BELGIUM,0,TOTALS,BELGIUM,200,17,51,33.3,14,36,38.9,3,15,20.0,12,15,80.0,11,18,29,10,19,24,12,3,49,0
10241,238579,279_10_05,SLOVENIA,0,TOTALS,SLOVENIA,200,28,53,52.8,20,31,64.5,8,22,36.4,7,12,58.3,10,24,34,17,21,21,12,1,71,1
10242,238592,279_10_06,NETHERLANDS,0,TOTALS,NETHERLANDS,200,25,63,39.7,23,48,47.9,2,15,13.3,8,14,57.1,16,32,48,5,13,17,9,5,60,1
10243,238605,279_10_06,FINLAND,0,TOTALS,FINLAND,200,19,64,29.7,8,31,25.8,11,33,33.3,4,4,100.0,13,25,38,7,20,18,8,3,53,0
10244,238618,279_10_07,ROMANIA,0,TOTALS,ROMANIA,200,22,74,29.7,14,53,26.4,8,21,38.1,9,25,36.0,24,26,50,3,20,18,9,3,61,0
10245,238631,279_10_07,GEORGIA,0,TOTALS,GEORGIA,200,31,79,39.2,24,51,47.1,7,28,25.0,14,17,82.4,22,34,56,11,20,16,9,7,83,1
10246,238644,279_10_08,ESTONIA,0,TOTALS,ESTONIA,200,23,60,38.3,21,46,45.7,2,14,14.3,8,10,80.0,12,23,35,7,18,21,9,4,56,0
10247,238657,279_10_08,HUNGARY,0,TOTALS,HUNGARY,200,25,70,35.7,23,55,41.8,2,15,13.3,9,19,47.4,27,26,53,5,18,21,11,3,61,1
10248,238670,279_10_09,SWITZERLAND,0,TOTALS,SWITZERLAND,200,19,44,43.2,17,31,54.8,2,13,15.4,17,32,53.1,14,24,38,9,29,30,15,2,57,0
10249,238683,279_10_09,AUSTRIA,0,TOTALS,AUSTRIA,200,24,60,40.0,22,50,44.0,2,10,20.0,11,26,42.3,20,17,37,10,24,26,15,2,61,1
10250,238696,279_10_10,IRELAND,0,TOTALS,IRELAND,200,14,68,20.6,9,45,20.0,5,23,21.7,6,13,46.2,20,18,38,6,15,23,12,2,39,0
10251,238709,279_10_10,SLOVAK REPUBLIC,0,TOTALS,SLOVAK REPUBLIC,200,33,62,53.2,29,51,56.9,4,11,36.4,9,12,75.0,13,36,49,17,19,24,12,8,79,1
10252,238722,279_10_11,UKRAINE,0,TOTALS,UKRAINE,200,19,51,37.3,15,35,42.9,4,16,25.0,19,28,67.9,8,39,47,5,22,18,4,5,61,1
10253,238735,279_10_11,PORTUGAL,0,TOTALS,PORTUGAL,200,16,62,25.8,10,41,24.4,6,21,28.6,11,21,52.4,12,27,39,9,22,16,7,0,49,0
10254,238748,279_10_12,CZECH REPUBLIC,0,TOTALS,CZECH REPUBLIC,200,38,73,52.1,35,57,61.4,3,16,18.8,14,23,60.9,19,34,53,17,23,22,11,5,93,1
10255,238761,279_10_12,BELARUS,0,TOTALS,BELARUS,200,19,62,30.6,18,46,39.1,1,16,6.2,10,21,47.6,15,19,34,3,20,26,8,1,49,0
10256,238774,279_10_13,LUXEMBOURG,0,TOTALS,LUXEMBOURG,200,26,69,37.7,23,49,46.9,3,20,15.0,11,17,64.7,17,34,51,8,16,13,6,1,66,1
10257,238787,279_10_13,ROMANIA,0,TOTALS,ROMANIA,200,27,81,33.3,20,48,41.7,7,33,21.2,3,10,30.0,25,30,55,13,17,16,7,5,64,0
10258,238800,279_10_14,NORWAY,0,TOTALS,NORWAY,200,24,64,37.5,16,41,39.0,8,23,34.8,10,16,62.5,11,31,42,5,15,17,6,1,66,0
10259,238813,279_10_14,ESTONIA,0,TOTALS,ESTONIA,200,29,75,38.7,23,46,50.0,6,29,20.7,7,13,53.8,17,32,49,16,18,14,10,1,71,1
10260,238826,279_10_15,GEORGIA,0,TOTALS,GEORGIA,225,22,57,38.6,14,34,41.2,8,23,34.8,13,23,56.5,5,31,36,8,21,24,11,7,65,1
10261,238839,279_10_15,BELGIUM,0,TOTALS,BELGIUM,225,23,68,33.8,22,50,44.0,1,18,5.6,17,22,77.3,15,32,47,4,23,22,15,3,64,0
10262,238852,279_10_16,HUNGARY,0,TOTALS,HUNGARY,200,16,71,22.5,13,55,23.6,3,16,18.8,9,19,47.4,18,21,39,6,13,16,17,1,44,0
10263,238865,279_10_16,NETHERLANDS,0,TOTALS,NETHERLANDS,200,23,57,40.4,19,37,51.4,4,20,20.0,12,17,70.6,14,42,56,14,19,27,7,8,62,1
10264,238878,279_10_17,SWEDEN,0,TOTALS,SWEDEN,200,24,62,38.7,18,34,52.9,6,28,21.4,8,16,50.0,17,28,45,15,22,17,3,1,62,0
10265,238891,279_10_17,UKRAINE,0,TOTALS,UKRAINE,200,22,55,40.0,13,34,38.2,9,21,42.9,16,26,61.5,10,25,35,8,18,11,8,2,69,1
10266,238904,279_10_18,BELARUS,0,TOTALS,BELARUS,200,21,60,35.0,20,41,48.8,1,19,5.3,15,25,60.0,17,27,44,8,24,23,9,3,58,0
10267,238917,279_10_18,IRELAND,0,TOTALS,IRELAND,200,24,58,41.4,17,41,41.5,7,17,41.2,12,18,66.7,10,26,36,9,24,20,7,1,67,1
10268,238930,279_10_19,BELGIUM,0,TOTALS,BELGIUM,200,25,66,37.9,14,33,42.4,11,33,33.3,12,18,66.7,16,22,38,9,29,20,18,3,73,0
10269,238943,279_10_19,LUXEMBOURG,0,TOTALS,LUXEMBOURG,200,24,55,43.6,16,37,43.2,8,18,44.4,22,32,68.8,13,26,39,4,21,24,9,1,78,1
10270,238956,279_10_20,FINLAND,0,TOTALS,FINLAND,200,22,63,34.9,16,41,39.0,6,22,27.3,15,25,60.0,15,25,40,9,26,20,14,3,65,0
10271,238969,279_10_20,HUNGARY,0,TOTALS,HUNGARY,200,29,59,49.2,27,47,57.4,2,12,16.7,12,15,80.0,9,29,38,13,21,24,10,5,72,1
10272,238982,279_10_21,SLOVENIA,0,TOTALS,SLOVENIA,225,24,67,35.8,13,36,36.1,11,31,35.5,10,17,58.8,12,36,48,6,19,16,12,1,69,0
10273,238995,279_10_21,GEORGIA,0,TOTALS,GEORGIA,225,23,70,32.9,15,45,33.3,8,25,32.0,16,20,80.0,14,36,50,12,16,14,11,2,70,1
10274,239008,279_10_22,NETHERLANDS,0,TOTALS,NETHERLANDS,200,23,67,34.3,16,43,37.2,7,24,29.2,6,9,66.7,20,34,54,4,13,9,2,2,59,1
10275,239021,279_10_22,NORWAY,0,TOTALS,NORWAY,200,20,58,34.5,17,38,44.7,3,20,15.0,3,9,33.3,9,25,34,7,12,6,3,2,46,0
10276,239034,279_10_23,PORTUGAL,0,TOTALS,PORTUGAL,200,21,62,33.9,16,45,35.6,5,17,29.4,7,12,58.3,7,22,29,10,23,15,15,1,54,0
10277,239047,279_10_23,SWITZERLAND,0,TOTALS,SWITZERLAND,200,19,44,43.2,12,22,54.5,7,22,31.8,12,24,50.0,9,32,41,10,15,25,6,6,57,1
10278,239060,279_10_24,ENGLAND,0,TOTALS,ENGLAND,200,15,54,27.8,10,41,24.4,5,13,38.5,18,25,72.0,10,33,43,2,20,24,9,2,53,0
10279,239073,279_10_24,CZECH REPUBLIC,0,TOTALS,CZECH REPUBLIC,200,28,73,38.4,21,48,43.8,7,25,28.0,14,26,53.8,16,31,47,12,18,16,10,2,77,1
10280,239086,279_10_25,ROMANIA,0,TOTALS,ROMANIA,200,16,48,33.3,14,36,38.9,2,12,16.7,6,15,40.0,13,22,35,3,12,33,10,4,40,0
10281,239099,279_10_25,BELGIUM,0,TOTALS,BELGIUM,200,33,66,50.0,28,51,54.9,5,15,33.3,11,18,61.1,15,24,39,15,16,19,21,5,82,1
10282,239112,279_10_26,NORWAY,0,TOTALS,NORWAY,200,22,66,33.3,14,46,30.4,8,20,40.0,5,13,38.5,14,32,46,5,18,24,4,2,57,0
10283,239125,279_10_26,FINLAND,0,TOTALS,FINLAND,200,36,84,42.9,31,56,55.4,5,28,17.9,11,16,68.8,19,35,54,14,16,13,12,4,88,1
10284,239138,279_10_27,SWITZERLAND,0,TOTALS,SWITZERLAND,225,21,54,38.9,16,36,44.4,5,18,27.8,28,39,71.8,17,32,49,8,17,28,9,7,75,1
10285,239151,279_10_27,SWEDEN,0,TOTALS,SWEDEN,225,29,83,34.9,24,55,43.6,5,28,17.9,6,11,54.5,22,21,43,8,27,18,17,1,69,0
10286,239164,279_10_28,LUXEMBOURG,0,TOTALS,LUXEMBOURG,200,16,62,25.8,9,37,24.3,7,25,28.0,3,5,60.0,14,18,32,3,14,21,5,3,42,0
10287,239177,279_10_28,SLOVENIA,0,TOTALS,SLOVENIA,200,33,69,47.8,17,30,56.7,16,39,41.0,11,15,73.3,20,34,54,21,17,16,11,4,93,1
10288,239190,279_10_29,IRELAND,0,TOTALS,IRELAND,200,21,64,32.8,16,46,34.8,5,18,27.8,6,8,75.0,14,29,43,7,21,29,5,0,53,0
10289,239203,279_10_29,ENGLAND,0,TOTALS,ENGLAND,200,36,71,50.7,35,58,60.3,1,13,7.7,13,23,56.5,10,28,38,11,15,17,17,5,86,1
10290,239216,279_10_30,ESTONIA,0,TOTALS,ESTONIA,200,20,64,31.2,17,50,34.0,3,14,21.4,16,23,69.6,12,33,45,5,21,12,11,2,59,1
10291,239229,279_10_30,NETHERLANDS,0,TOTALS,NETHERLANDS,200,17,56,30.4,14,37,37.8,3,19,15.8,13,21,61.9,10,35,45,4,24,20,4,8,50,0
10292,239242,279_10_31,AUSTRIA,0,TOTALS,AUSTRIA,200,13,43,30.2,10,33,30.3,3,10,30.0,3,11,27.3,4,21,25,6,19,24,9,0,32,0
10293,239255,279_10_31,PORTUGAL,0,TOTALS,PORTUGAL,200,23,54,42.6,18,42,42.9,5,12,41.7,14,18,77.8,11,29,40,9,10,17,15,1,65,1
10294,239268,279_10_32,SLOVAK REPUBLIC,0,TOTALS,SLOVAK REPUBLIC,200,32,78,41.0,22,59,37.3,10,19,52.6,11,15,73.3,20,31,51,10,24,17,16,1,85,1
10295,239281,279_10_32,BELARUS,0,TOTALS,BELARUS,200,22,62,35.5,13,39,33.3,9,23,39.1,12,26,46.2,16,26,42,5,12,26,8,4,65,0
10296,239294,279_10_33,SLOVENIA,0,TOTALS,SLOVENIA,200,21,68,30.9,11,29,37.9,10,39,25.6,10,17,58.8,13,23,36,12,17,6,7,1,62,1
10297,239307,279_10_33,ROMANIA,0,TOTALS,ROMANIA,200,24,59,40.7,20,41,48.8,4,18,22.2,8,14,57.1,15,36,51,7,17,16,3,1,60,0
10298,239320,279_10_34,GEORGIA,0,TOTALS,GEORGIA,200,36,74,48.6,28,41,68.3,8,33,24.2,23,29,79.3,15,27,42,20,18,20,16,2,103,0
10299,239333,279_10_34,LUXEMBOURG,0,TOTALS,LUXEMBOURG,200,34,71,47.9,21,41,51.2,13,30,43.3,17,22,77.3,11,25,36,21,26,21,9,1,98,1
10300,239346,279_10_35,ENGLAND,0,TOTALS,ENGLAND,200,25,60,41.7,18,40,45.0,7,20,35.0,15,17,88.2,17,24,41,14,12,21,7,4,72,0
10301,239359,279_10_35,SLOVAK REPUBLIC,0,TOTALS,SLOVAK REPUBLIC,200,27,56,48.2,17,38,44.7,10,18,55.6,9,11,81.8,7,18,25,13,19,18,12,1,73,1
10302,239371,279_10_36,CZECH REPUBLIC,0,TOTALS,CZECH REPUBLIC,200,32,63,50.8,25,47,53.2,7,16,43.8,15,19,78.9,13,26,39,22,22,22,19,5,86,1
10303,239384,279_10_36,IRELAND,0,TOTALS,IRELAND,200,14,49,28.6,14,39,35.9,0,10,0.0,13,21,61.9,11,20,31,6,17,32,7,2,41,0
10304,239397,279_10_37,FINLAND,0,TOTALS,FINLAND,200,21,62,33.9,16,43,37.2,5,19,26.3,26,32,81.2,8,22,30,8,18,17,16,5,73,1
10305,239410,279_10_37,ESTONIA,0,TOTALS,ESTONIA,200,27,63,42.9,22,50,44.0,5,13,38.5,13,19,68.4,17,33,50,15,24,29,10,3,72,0
10306,239423,279_10_38,HUNGARY,0,TOTALS,HUNGARY,200,33,72,45.8,31,61,50.8,2,11,18.2,8,13,61.5,15,26,41,10,7,9,17,2,76,1
10307,239436,279_10_38,NORWAY,0,TOTALS,NORWAY,200,21,62,33.9,15,40,37.5,6,22,27.3,1,1,100.0,15,26,41,10,13,26,4,0,49,0
10308,239449,279_10_39,SWEDEN,0,TOTALS,SWEDEN,250,29,66,43.9,21,42,50.0,8,24,33.3,15,25,60.0,18,31,49,8,24,32,10,5,81,1
10309,239462,279_10_39,AUSTRIA,0,TOTALS,AUSTRIA,250,32,69,46.4,30,56,53.6,2,13,15.4,12,21,57.1,11,24,35,10,23,25,14,3,78,0
10310,239475,279_10_40,UKRAINE,0,TOTALS,UKRAINE,200,33,67,49.3,31,51,60.8,2,16,12.5,10,22,45.5,15,34,49,7,11,14,15,6,78,1
10311,239488,279_10_40,SWITZERLAND,0,TOTALS,SWITZERLAND,200,14,61,23.0,7,29,24.1,7,32,21.9,2,3,66.7,13,24,37,1,20,25,7,3,37,0
10312,239501,279_10_41,AUSTRIA,0,TOTALS,AUSTRIA,200,24,63,38.1,19,37,51.4,5,26,19.2,2,5,40.0,14,27,41,15,17,19,11,1,55,1
10313,239514,279_10_41,NORWAY,0,TOTALS,NORWAY,200,20,54,37.0,16,28,57.1,4,26,15.4,9,14,64.3,8,27,35,6,11,17,10,2,53,0
10314,239527,279_10_42,BELARUS,0,TOTALS,BELARUS,200,25,82,30.5,20,53,37.7,5,29,17.2,9,19,47.4,20,25,45,12,18,11,12,2,64,0
10315,239540,279_10_42,ROMANIA,0,TOTALS,ROMANIA,200,29,71,40.8,23,56,41.1,6,15,40.0,15,24,62.5,21,40,61,12,19,21,7,7,79,1
10316,239553,279_10_43,SWEDEN,0,TOTALS,SWEDEN,200,20,57,35.1,16,35,45.7,4,22,18.2,14,22,63.6,15,33,48,10,16,21,6,4,58,0
10317,239566,279_10_43,ENGLAND,0,TOTALS,ENGLAND,200,24,70,34.3,20,46,43.5,4,24,16.7,9,17,52.9,17,22,39,8,20,13,16,3,61,1
10318,239579,279_10_44,SWITZERLAND,0,TOTALS,SWITZERLAND,200,19,52,36.5,15,34,44.1,4,18,22.2,16,19,84.2,10,22,32,5,15,25,4,4,58,0
10319,239592,279_10_44,CZECH REPUBLIC,0,TOTALS,CZECH REPUBLIC,200,34,65,52.3,28,44,63.6,6,21,28.6,7,15,46.7,10,24,34,8,21,13,14,4,81,1
10320,239605,279_10_45,PORTUGAL,0,TOTALS,PORTUGAL,200,30,66,45.5,23,47,48.9,7,19,36.8,11,16,68.8,16,22,38,14,25,17,12,2,78,1
10321,239618,279_10_45,IRELAND,0,TOTALS,IRELAND,200,20,45,44.4,17,36,47.2,3,9,33.3,18,30,60.0,10,23,33,5,16,25,7,0,61,0
10322,239631,279_10_46,UKRAINE,0,TOTALS,UKRAINE,200,18,57,31.6,14,39,35.9,4,18,22.2,27,34,79.4,16,34,50,11,18,17,5,5,67,0
10323,239644,279_10_46,SLOVAK REPUBLIC,0,TOTALS,SLOVAK REPUBLIC,200,27,69,39.1,22,50,44.0,5,19,26.3,10,16,62.5,12,22,34,15,25,7,8,3,69,1
10324,239657,279_10_47,BELGIUM,0,TOTALS,BELGIUM,200,23,69,33.3,19,54,35.2,4,15,26.7,11,14,78.6,22,26,48,9,22,25,16,7,61,0
10325,239670,279_10_47,FINLAND,0,TOTALS,FINLAND,200,24,52,46.2,19,37,51.4,5,15,33.3,15,22,68.2,6,24,30,12,13,22,9,3,68,1
10326,239683,279_10_48,SLOVENIA,0,TOTALS,SLOVENIA,200,30,52,57.7,17,26,65.4,13,26,50.0,6,8,75.0,9,24,33,15,15,12,6,0,79,1
10327,239696,279_10_48,NETHERLANDS,0,TOTALS,NETHERLANDS,200,25,60,41.7,19,35,54.3,6,25,24.0,6,9,66.7,13,12,25,7,12,10,3,1,62,0
10328,239709,279_10_49,LUXEMBOURG,0,TOTALS,LUXEMBOURG,200,29,67,43.3,23,46,50.0,6,21,28.6,19,27,70.4,15,26,41,5,17,16,14,1,83,1
10329,239722,279_10_49,ESTONIA,0,TOTALS,ESTONIA,200,31,66,47.0,17,27,63.0,14,39,35.9,4,9,44.4,10,27,37,19,22,23,9,6,80,0
10330,239735,279_10_50,GEORGIA,0,TOTALS,GEORGIA,200,34,69,49.3,28,50,56.0,6,19,31.6,9,11,81.8,13,20,33,15,18,18,24,1,83,1
10331,239748,279_10_50,HUNGARY,0,TOTALS,HUNGARY,200,21,52,40.4,17,34,50.0,4,18,22.2,10,18,55.6,14,22,36,7,9,29,11,2,56,0
10332,239761,279_10_51,IRELAND,0,TOTALS,IRELAND,200,15,62,24.2,9,38,23.7,6,24,25.0,11,21,52.4,16,14,30,6,20,18,8,1,47,0
10333,239774,279_10_51,SWEDEN,0,TOTALS,SWEDEN,200,38,77,49.4,37,61,60.7,1,16,6.2,13,16,81.2,25,37,62,12,18,18,12,4,90,1
10334,239787,279_10_52,SLOVAK REPUBLIC,0,TOTALS,SLOVAK REPUBLIC,200,36,65,55.4,26,44,59.1,10,21,47.6,7,15,46.7,11,29,40,19,20,19,13,3,89,1
10335,239800,279_10_52,SWITZERLAND,0,TOTALS,SWITZERLAND,200,24,57,42.1,20,37,54.1,4,20,20.0,12,24,50.0,11,20,31,9,18,19,12,2,64,0
10336,239813,279_10_53,ENGLAND,0,TOTALS,ENGLAND,200,27,53,50.9,20,37,54.1,7,16,43.8,16,24,66.7,11,23,34,11,17,17,12,6,77,1
10337,239826,279_10_53,PORTUGAL,0,TOTALS,PORTUGAL,200,24,62,38.7,18,39,46.2,6,23,26.1,11,16,68.8,17,20,37,9,23,18,7,1,65,0
10338,239839,279_10_54,CZECH REPUBLIC,0,TOTALS,CZECH REPUBLIC,200,21,54,38.9,11,23,47.8,10,31,32.3,13,16,81.2,7,22,29,11,17,16,7,1,65,0
10339,239852,279_10_54,UKRAINE,0,TOTALS,UKRAINE,200,28,63,44.4,25,46,54.3,3,17,17.6,8,14,57.1,13,27,40,12,18,13,8,1,67,1
10340,239865,279_10_55,ESTONIA,0,TOTALS,ESTONIA,200,17,59,28.8,14,43,32.6,3,16,18.8,12,16,75.0,12,19,31,7,25,17,6,2,49,0
10341,239878,279_10_55,BELGIUM,0,TOTALS,BELGIUM,200,31,60,51.7,29,49,59.2,2,11,18.2,14,26,53.8,17,31,48,9,17,16,11,9,78,1
10342,239891,279_10_56,HUNGARY,0,TOTALS,HUNGARY,200,22,57,38.6,20,46,43.5,2,11,18.2,3,5,60.0,15,18,33,8,14,18,10,1,49,0
10343,239904,279_10_56,SLOVENIA,0,TOTALS,SLOVENIA,200,24,53,45.3,13,25,52.0,11,28,39.3,6,9,66.7,11,21,32,12,17,17,9,3,65,1
10344,239917,279_10_57,FINLAND,0,TOTALS,FINLAND,225,26,85,30.6,17,36,47.2,9,49,18.4,17,22,77.3,18,30,48,7,20,19,13,2,78,0
10345,239930,279_10_57,LUXEMBOURG,0,TOTALS,LUXEMBOURG,225,31,73,42.5,26,58,44.8,5,15,33.3,20,24,83.3,13,44,57,13,23,23,9,1,87,1
10346,239943,279_10_58,NETHERLANDS,0,TOTALS,NETHERLANDS,200,28,59,47.5,18,38,47.4,10,21,47.6,19,24,79.2,11,26,37,16,17,10,7,9,85,1
10347,239956,279_10_58,GEORGIA,0,TOTALS,GEORGIA,200,23,66,34.8,9,35,25.7,14,31,45.2,12,21,57.1,20,22,42,15,19,13,7,2,72,0
10348,239969,279_10_59,ROMANIA,0,TOTALS,ROMANIA,200,24,49,49.0,19,38,50.0,5,11,45.5,18,40,45.0,19,33,52,8,16,22,5,5,71,1
10349,239982,279_10_59,AUSTRIA,0,TOTALS,AUSTRIA,200,25,77,32.5,20,51,39.2,5,26,19.2,9,13,69.2,22,18,40,12,33,13,15,1,64,0
10350,239995,279_10_60,NORWAY,0,TOTALS,NORWAY,200,17,50,34.0,12,30,40.0,5,20,25.0,6,13,46.2,13,27,40,9,12,22,9,2,45,1
10351,240008,279_10_60,BELARUS,0,TOTALS,BELARUS,200,16,63,25.4,11,36,30.6,5,27,18.5,6,13,46.2,23,24,47,10,14,19,11,0,43,0
10352,240021,279_10_61,SWEDEN,0,TOTALS,SWEDEN,200,26,59,44.1,23,48,47.9,3,11,27.3,27,40,67.5,14,24,38,8,20,13,6,1,82,1
10353,240034,279_10_61,ESTONIA,0,TOTALS,ESTONIA,200,29,56,51.8,20,32,62.5,9,24,37.5,12,21,57.1,7,23,30,8,29,17,4,2,79,0
10354,240047,279_10_62,SLOVAK REPUBLIC,0,TOTALS,SLOVAK REPUBLIC,200,28,60,46.7,22,40,55.0,6,20,30.0,6,10,60.0,10,21,31,19,18,25,11,7,68,0
10355,240060,279_10_62,HUNGARY,0,TOTALS,HUNGARY,200,29,62,46.8,26,53,49.1,3,9,33.3,13,17,76.5,14,24,38,11,16,23,13,0,74,1
10356,240073,279_10_63,BELGIUM,0,TOTALS,BELGIUM,200,27,53,50.9,21,37,56.8,6,16,37.5,14,19,73.7,9,23,32,8,23,18,15,3,74,1
10357,240086,279_10_63,IRELAND,0,TOTALS,IRELAND,200,17,51,33.3,13,41,31.7,4,10,40.0,9,19,47.4,15,18,33,4,20,29,7,1,47,0
10358,240099,279_10_64,GEORGIA,0,TOTALS,GEORGIA,200,28,60,46.7,23,43,53.5,5,17,29.4,14,27,51.9,9,26,35,12,17,18,14,1,75,1
10359,240112,279_10_64,SWITZERLAND,0,TOTALS,SWITZERLAND,200,20,59,33.9,15,40,37.5,5,19,26.3,15,21,71.4,17,30,47,9,25,25,10,2,60,0
10360,240125,279_10_65,ENGLAND,0,TOTALS,ENGLAND,200,22,64,34.4,18,47,38.3,4,17,23.5,10,18,55.6,13,23,36,6,19,23,19,4,58,0
10361,240138,279_10_65,FINLAND,0,TOTALS,FINLAND,200,24,55,43.6,21,46,45.7,3,9,33.3,13,19,68.4,10,31,41,9,18,29,10,1,64,1
10362,240151,279_10_66,CZECH REPUBLIC,0,TOTALS,CZECH REPUBLIC,200,29,65,44.6,22,39,56.4,7,26,26.9,5,8,62.5,11,34,45,11,20,11,7,1,70,1
10363,240164,279_10_66,NETHERLANDS,0,TOTALS,NETHERLANDS,200,16,67,23.9,14,47,29.8,2,20,10.0,13,16,81.2,15,26,41,8,17,14,5,1,47,0
10364,240177,279_10_67,LUXEMBOURG,0,TOTALS,LUXEMBOURG,200,16,48,33.3,13,26,50.0,3,22,13.6,19,19,100.0,5,31,36,6,13,23,8,2,54,0
10365,240190,279_10_67,PORTUGAL,0,TOTALS,PORTUGAL,200,22,69,31.9,14,32,43.8,8,37,21.6,8,12,66.7,17,27,44,14,18,19,14,2,60,1
10366,240203,279_10_68,SLOVENIA,0,TOTALS,SLOVENIA,200,31,73,42.5,20,37,54.1,11,36,30.6,8,10,80.0,13,23,36,9,27,11,8,0,81,0
10367,240216,279_10_68,UKRAINE,0,TOTALS,UKRAINE,200,28,56,50.0,20,39,51.3,8,17,47.1,19,34,55.9,10,32,42,14,22,17,5,2,83,1
10368,240229,279_10_69,ROMANIA,0,TOTALS,ROMANIA,200,40,75,53.3,34,57,59.6,6,18,33.3,12,16,75.0,15,40,55,15,9,12,6,7,98,1
10369,240242,279_10_69,NORWAY,0,TOTALS,NORWAY,200,27,81,33.3,17,51,33.3,10,30,33.3,7,13,53.8,15,22,37,12,14,10,8,1,71,0
10370,240255,279_10_70,AUSTRIA,0,TOTALS,AUSTRIA,200,26,68,38.2,21,54,38.9,5,14,35.7,7,21,33.3,17,20,37,7,27,21,15,2,64,0
10371,240268,279_10_70,BELARUS,0,TOTALS,BELARUS,200,25,58,43.1,21,46,45.7,4,12,33.3,19,31,61.3,19,31,50,9,21,27,14,4,73,1
10372,240281,279_10_71,ESTONIA,0,TOTALS,ESTONIA,200,28,65,43.1,21,38,55.3,7,27,25.9,12,16,75.0,8,24,32,11,20,14,9,0,75,0
10373,240294,279_10_71,IRELAND,0,TOTALS,IRELAND,200,31,64,48.4,24,52,46.2,7,12,58.3,11,18,61.1,13,29,42,12,19,18,7,0,80,1
10374,240307,279_10_72,SLOVAK REPUBLIC,0,TOTALS,SLOVAK REPUBLIC,200,29,71,40.8,25,49,51.0,4,22,18.2,9,14,64.3,11,25,36,12,20,6,10,0,71,0
10375,240320,279_10_72,SWITZERLAND,0,TOTALS,SWITZERLAND,200,24,66,36.4,18,39,46.2,6,27,22.2,18,23,78.3,21,32,53,8,13,17,5,5,72,1
10376,240333,279_10_73,SWEDEN,0,TOTALS,SWEDEN,200,23,56,41.1,20,43,46.5,3,13,23.1,15,15,100.0,15,26,41,9,15,15,5,5,64,0
10377,240346,279_10_73,BELGIUM,0,TOTALS,BELGIUM,200,27,71,38.0,23,56,41.1,4,15,26.7,7,15,46.7,23,18,41,9,20,8,7,2,65,1
10378,240359,279_10_74,HUNGARY,0,TOTALS,HUNGARY,200,30,74,40.5,25,56,44.6,5,18,27.8,6,8,75.0,15,24,39,14,20,15,13,1,71,0
10379,240372,279_10_74,GEORGIA,0,TOTALS,GEORGIA,200,29,59,49.2,25,37,67.6,4,22,18.2,14,23,60.9,11,30,41,11,13,19,9,2,76,1
10380,240385,279_10_75,ENGLAND,0,TOTALS,ENGLAND,200,33,74,44.6,25,52,48.1,8,22,36.4,10,17,58.8,15,40,55,18,16,14,10,6,84,1
10381,240398,279_10_75,LUXEMBOURG,0,TOTALS,LUXEMBOURG,200,22,71,31.0,12,43,27.9,10,28,35.7,11,14,78.6,11,29,40,12,11,15,5,0,65,0
10382,240411,279_10_76,NETHERLANDS,0,TOTALS,NETHERLANDS,200,24,58,41.4,18,36,50.0,6,22,27.3,6,9,66.7,11,30,41,10,13,14,8,3,60,0
10383,240424,279_10_76,SLOVENIA,0,TOTALS,SLOVENIA,200,24,64,37.5,16,37,43.2,8,27,29.6,6,7,85.7,10,25,35,12,13,10,10,1,62,1
10384,240437,279_10_77,FINLAND,0,TOTALS,FINLAND,200,24,56,42.9,16,34,47.1,8,22,36.4,15,17,88.2,12,33,45,9,14,22,8,4,71,1
10385,240450,279_10_77,PORTUGAL,0,TOTALS,PORTUGAL,200,20,71,28.2,16,52,30.8,4,19,21.1,9,11,81.8,19,22,41,7,21,15,13,3,53,0
10386,240463,279_10_78,CZECH REPUBLIC,0,TOTALS,CZECH REPUBLIC,200,24,68,35.3,14,38,36.8,10,30,33.3,3,5,60.0,18,28,46,10,17,10,5,1,61,1
10387,240476,279_10_78,UKRAINE,0,TOTALS,UKRAINE,200,17,60,28.3,13,42,31.0,4,18,22.2,15,21,71.4,17,27,44,5,10,9,6,6,53,0
10388,240489,280_10_01,CYPRUS,0,TOTALS,CYPRUS,200,45,80,56.2,41,64,64.1,4,16,25.0,20,35,57.1,18,45,63,29,26,21,22,7,114,0
10389,240502,280_10_01,SAN MARINO,0,TOTALS,SAN MARINO,200,11,60,18.3,9,45,20.0,2,15,13.3,19,26,73.1,4,20,24,4,26,31,12,1,43,1
10390,240515,280_10_02,SCOTLAND,0,TOTALS,SCOTLAND,200,35,75,46.7,33,62,53.2,2,13,15.4,9,29,31.0,22,38,60,18,12,29,18,7,81,1
10391,240526,280_10_02,PRINCIPALITY OF MONACO,0,TOTALS,PRINCIPALITY OF MONACO,200,13,65,20.0,9,49,18.4,4,16,25.0,3,8,37.5,7,25,32,7,21,34,13,0,33,0
10392,240537,280_10_03,MALTA,0,TOTALS,MALTA,200,27,71,38.0,22,55,40.0,5,16,31.2,4,18,22.2,18,40,58,12,11,35,21,1,63,1
10393,240550,280_10_03,GIBRALTAR,0,TOTALS,GIBRALTAR,200,15,65,23.1,12,43,27.9,3,22,13.6,2,5,40.0,6,25,31,7,18,32,16,1,35,0
10394,240563,280_10_04,ANDORRA,0,TOTALS,ANDORRA,200,28,80,35.0,27,62,43.5,1,18,5.6,15,38,39.5,19,37,56,6,23,33,22,5,72,1
10395,240576,280_10_04,WALES,0,TOTALS,WALES,200,21,78,26.9,21,59,35.6,0,19,0.0,10,35,28.6,19,38,57,7,27,38,20,2,52,0
10396,240589,280_10_05,SAN MARINO,0,TOTALS,SAN MARINO,200,22,77,28.6,18,56,32.1,4,21,19.0,20,34,58.8,14,27,41,6,16,24,25,1,68,1
10397,240600,280_10_05,MALTA,0,TOTALS,MALTA,200,23,72,31.9,22,59,37.3,1,13,7.7,4,12,33.3,18,41,59,5,28,41,12,6,51,0
10398,240613,280_10_06,WALES,0,TOTALS,WALES,200,17,63,27.0,14,49,28.6,3,14,21.4,9,28,32.1,14,23,37,6,17,34,16,2,46,0
10399,240626,280_10_06,SCOTLAND,0,TOTALS,SCOTLAND,200,32,66,48.5,25,53,47.2,7,13,53.8,8,15,53.3,13,36,49,18,24,36,17,4,79,1
10400,240639,280_10_07,GIBRALTAR,0,TOTALS,GIBRALTAR,200,13,62,21.0,11,41,26.8,2,21,9.5,6,12,50.0,9,21,30,6,21,34,7,1,34,1
10401,240652,280_10_07,CYPRUS,0,TOTALS,CYPRUS,200,50,87,57.5,41,60,68.3,9,27,33.3,14,31,45.2,22,40,62,25,14,17,20,1,123,0
10402,240663,280_10_08,PRINCIPALITY OF MONACO,0,TOTALS,PRINCIPALITY OF MONACO,200,11,46,23.9,7,32,21.9,4,14,28.6,7,26,26.9,7,27,34,3,25,51,14,5,33,0
10403,240676,280_10_08,ANDORRA,0,TOTALS,ANDORRA,200,35,84,41.7,34,69,49.3,1,15,6.7,10,29,34.5,25,31,56,10,23,35,30,3,81,1
10404,240689,280_10_09,SAN MARINO,0,TOTALS,SAN MARINO,200,35,84,41.7,33,72,45.8,2,12,16.7,15,27,55.6,19,36,55,11,16,16,22,3,87,1
10405,240702,280_10_09,GIBRALTAR,0,TOTALS,GIBRALTAR,200,18,65,27.7,18,55,32.7,0,10,0.0,5,13,38.5,7,29,36,4,20,32,7,5,41,0
10406,240713,280_10_10,MALTA,0,TOTALS,MALTA,200,14,49,28.6,11,39,28.2,3,10,30.0,17,30,56.7,2,18,20,10,26,27,8,2,48,0
10407,240726,280_10_10,CYPRUS,0,TOTALS,CYPRUS,200,35,84,41.7,27,53,50.9,8,31,25.8,16,35,45.7,28,33,61,17,25,22,19,3,94,1
10408,240737,280_10_11,PRINCIPALITY OF MONACO,0,TOTALS,PRINCIPALITY OF MONACO,200,9,57,15.8,7,34,20.6,2,23,8.7,9,28,32.1,5,27,32,0,20,38,15,2,29,0
10409,240750,280_10_11,WALES,0,TOTALS,WALES,200,27,83,32.5,24,66,36.4,3,17,17.6,12,29,41.4,30,40,70,11,25,30,18,5,69,1
10410,240763,280_10_12,ANDORRA,0,TOTALS,ANDORRA,200,27,72,37.5,23,55,41.8,4,17,23.5,13,28,46.4,11,21,32,16,27,27,16,2,71,0
10411,240776,280_10_12,SCOTLAND,0,TOTALS,SCOTLAND,200,27,57,47.4,26,48,54.2,1,9,11.1,21,30,70.0,13,26,39,6,21,36,12,4,76,1
10412,240787,280_10_13,MALTA,0,TOTALS,MALTA,200,21,57,36.8,19,41,46.3,2,16,12.5,18,32,56.2,20,39,59,7,21,32,14,0,62,1
10413,240798,280_10_13,PRINCIPALITY OF MONACO,0,TOTALS,PRINCIPALITY OF MONACO,200,15,72,20.8,14,50,28.0,1,22,4.5,6,26,23.1,13,19,32,3,25,24,23,1,37,0
10414,240811,280_10_14,WALES,0,TOTALS,WALES,200,37,89,41.6,36,80,45.0,1,9,11.1,14,37,37.8,29,45,74,8,18,31,24,7,89,1
10415,240824,280_10_14,GIBRALTAR,0,TOTALS,GIBRALTAR,200,16,74,21.6,13,57,22.8,3,17,17.6,8,20,40.0,16,27,43,3,29,39,9,3,43,0
10416,240837,280_10_15,GIBRALTAR,0,TOTALS,GIBRALTAR,200,14,67,20.9,12,52,23.1,2,15,13.3,6,29,20.7,20,35,55,4,22,30,13,7,36,0
10417,240848,280_10_15,PRINCIPALITY OF MONACO,0,TOTALS,PRINCIPALITY OF MONACO,200,20,85,23.5,19,75,25.3,1,10,10.0,8,25,32.0,29,34,63,8,24,25,13,2,49,1
10418,240861,280_10_16,SCOTLAND,0,TOTALS,SCOTLAND,200,28,70,40.0,26,62,41.9,2,8,25.0,13,32,40.6,17,45,62,10,22,27,11,3,71,1
10419,240874,280_10_16,SAN MARINO,0,TOTALS,SAN MARINO,200,18,72,25.0,15,51,29.4,3,21,14.3,13,25,52.0,10,28,38,8,21,19,12,2,52,0
10420,240887,280_10_17,CYPRUS,0,TOTALS,CYPRUS,200,34,83,41.0,29,63,46.0,5,20,25.0,14,25,56.0,27,34,61,14,22,22,15,1,87,1
10421,240900,280_10_17,ANDORRA,0,TOTALS,ANDORRA,200,16,62,25.8,11,40,27.5,5,22,22.7,8,24,33.3,10,23,33,10,22,27,9,3,45,0
10422,240913,280_10_18,WALES,0,TOTALS,WALES,200,21,77,27.3,20,58,34.5,1,19,5.3,10,24,41.7,19,23,42,8,19,20,23,4,53,1
10423,240924,280_10_18,MALTA,0,TOTALS,MALTA,200,15,64,23.4,15,56,26.8,0,8,0.0,7,24,29.2,19,37,56,3,24,39,9,3,37,0
10424,240937,280_10_19,SAN MARINO,0,TOTALS,SAN MARINO,200,19,63,30.2,18,51,35.3,1,12,8.3,15,34,44.1,9,22,31,5,28,33,16,0,54,0
10425,240950,280_10_19,ANDORRA,0,TOTALS,ANDORRA,200,29,75,38.7,24,62,38.7,5,13,38.5,23,42,54.8,28,33,61,13,22,32,15,7,86,1
10426,240963,280_10_20,SCOTLAND,0,TOTALS,SCOTLAND,200,12,52,23.1,10,40,25.0,2,12,16.7,4,6,66.7,7,22,29,8,17,37,8,2,30,0
10427,240976,280_10_20,CYPRUS,0,TOTALS,CYPRUS,200,28,69,40.6,21,44,47.7,7,25,28.0,11,20,55.0,16,27,43,13,10,21,21,4,74,1
10428,244945,285_11_01,AUSTRALIA,0,TOTALS,AUSTRALIA,200,27,58,46.6,20,39,51.3,7,19,36.8,10,13,76.9,10,33,43,17,21,14,7,3,71,1
10429,244957,285_11_01,CHINA,0,TOTALS,CHINA,200,14,45,31.1,8,31,25.8,6,14,42.9,9,27,33.3,7,19,26,7,16,14,4,1,43,0
10430,244970,285_11_02,SERBIA,0,TOTALS,SERBIA,200,26,59,44.1,19,38,50.0,7,21,33.3,12,24,50.0,12,19,31,11,27,16,3,1,71,0
10431,244983,285_11_02,CROATIA,0,TOTALS,CROATIA,200,28,55,50.9,21,40,52.5,7,15,46.7,20,25,80.0,8,25,33,14,26,18,6,1,83,1
10432,244996,285_11_03,GREAT BRITAIN,0,TOTALS,GREAT BRITAIN,200,21,64,32.8,17,42,40.5,4,22,18.2,14,24,58.3,9,23,32,5,18,13,5,2,60,0
10433,245009,285_11_03,FRANCE,0,TOTALS,FRANCE,200,34,65,52.3,31,53,58.5,3,12,25.0,11,18,61.1,10,39,49,14,27,17,7,6,82,1
10434,245021,285_11_04,CHINA,0,TOTALS,CHINA,200,20,62,32.3,15,44,34.1,5,18,27.8,8,11,72.7,10,22,32,8,12,18,9,3,53,0
10435,245034,285_11_04,SERBIA,0,TOTALS,SERBIA,200,38,71,53.5,31,45,68.9,7,26,26.9,4,10,40.0,14,31,45,19,14,13,4,5,87,1
10436,245047,285_11_05,FRANCE,0,TOTALS,FRANCE,200,24,55,43.6,23,45,51.1,1,10,10.0,22,34,64.7,14,32,46,7,23,22,10,3,71,1
10437,245060,285_11_05,AUSTRALIA,0,TOTALS,AUSTRALIA,200,23,60,38.3,14,32,43.8,9,28,32.1,12,19,63.2,9,18,27,15,28,18,7,1,67,0
10438,245073,285_11_06,CROATIA,0,TOTALS,CROATIA,200,28,56,50.0,19,34,55.9,9,22,40.9,10,12,83.3,4,29,33,10,23,20,6,3,75,1
10439,245086,285_11_06,GREAT BRITAIN,0,TOTALS,GREAT BRITAIN,200,24,67,35.8,20,44,45.5,4,23,17.4,18,22,81.8,14,25,39,9,17,15,10,0,70,0
10440,245098,285_11_07,FRANCE,0,TOTALS,FRANCE,200,30,61,49.2,25,42,59.5,5,19,26.3,11,16,68.8,18,25,43,17,19,17,12,0,76,1
10441,245110,285_11_07,CHINA,0,TOTALS,CHINA,200,20,45,44.4,16,32,50.0,4,13,30.8,15,23,65.2,6,14,20,5,18,17,9,1,59,0
10442,245123,285_11_08,AUSTRALIA,0,TOTALS,AUSTRALIA,200,28,64,43.8,21,42,50.0,7,22,31.8,15,21,71.4,10,31,41,23,21,12,7,4,78,1
10443,245136,285_11_08,CROATIA,0,TOTALS,CROATIA,200,23,66,34.8,16,50,32.0,7,16,43.8,13,19,68.4,14,27,41,17,23,17,4,3,66,0
10444,245149,285_11_09,SERBIA,0,TOTALS,SERBIA,200,33,58,56.9,29,46,63.0,4,12,33.3,27,40,67.5,8,30,38,21,24,16,8,5,97,1
10445,245162,285_11_09,GREAT BRITAIN,0,TOTALS,GREAT BRITAIN,200,35,82,42.7,27,59,45.8,8,23,34.8,17,25,68.0,18,23,41,19,32,13,9,3,95,0
10446,245175,285_11_10,CROATIA,0,TOTALS,CROATIA,200,19,57,33.3,18,40,45.0,1,17,5.9,21,28,75.0,12,17,29,9,19,12,3,1,60,0
10447,245188,285_11_10,FRANCE,0,TOTALS,FRANCE,200,33,57,57.9,29,45,64.4,4,12,33.3,13,17,76.5,7,26,33,15,24,13,8,5,83,1
10448,245201,285_11_11,GREAT BRITAIN,0,TOTALS,GREAT BRITAIN,200,21,63,33.3,15,35,42.9,6,28,21.4,16,25,64.0,17,34,51,11,17,16,4,5,64,1
10449,245213,285_11_11,CHINA,0,TOTALS,CHINA,200,19,65,29.2,13,47,27.7,6,18,33.3,12,16,75.0,13,27,40,8,24,17,5,7,56,0
10450,245226,285_11_12,SERBIA,0,TOTALS,SERBIA,200,23,60,38.3,20,44,45.5,3,16,18.8,20,25,80.0,11,26,37,19,16,12,4,2,69,0
10451,245239,285_11_12,AUSTRALIA,0,TOTALS,AUSTRALIA,200,32,69,46.4,26,51,51.0,6,18,33.3,8,10,80.0,12,29,41,14,25,13,5,2,78,1
10452,245249,285_11_13,CHINA,0,TOTALS,CHINA,200,16,50,32.0,13,33,39.4,3,17,17.6,18,27,66.7,8,27,35,10,12,19,5,1,53,0
10453,245261,285_11_13,CROATIA,0,TOTALS,CROATIA,200,33,65,50.8,23,37,62.2,10,28,35.7,7,9,77.8,6,28,34,26,20,9,9,1,83,1
10454,245274,285_11_14,AUSTRALIA,0,TOTALS,AUSTRALIA,225,32,75,42.7,25,53,47.2,7,22,31.8,20,35,57.1,12,30,42,22,34,14,4,0,91,1
10455,245287,285_11_14,GREAT BRITAIN,0,TOTALS,GREAT BRITAIN,225,27,60,45.0,22,43,51.2,5,17,29.4,31,46,67.4,5,35,40,15,29,14,4,7,90,0
10456,245300,285_11_15,FRANCE,0,TOTALS,FRANCE,200,33,61,54.1,28,53,52.8,5,8,62.5,9,11,81.8,6,27,33,8,15,10,7,5,80,1
10457,245313,285_11_15,SERBIA,0,TOTALS,SERBIA,200,31,75,41.3,23,53,43.4,8,22,36.4,7,12,58.3,17,22,39,21,18,11,5,2,77,0
10458,245326,288_11_01,POLAND,0,TOTALS,POLAND,200,35,74,47.3,30,56,53.6,5,18,27.8,10,23,43.5,16,34,50,19,12,8,6,8,85,1
10459,245339,288_11_01,TUNISIA,0,TOTALS,TUNISIA,200,23,72,31.9,17,49,34.7,6,23,26.1,5,9,55.6,9,20,29,11,19,13,5,4,57,0
10460,245352,288_11_02,CHINA,0,TOTALS,CHINA,200,27,60,45.0,20,41,48.8,7,19,36.8,12,18,66.7,5,22,27,12,22,16,4,0,73,0
10461,245365,288_11_02,SERBIA,0,TOTALS,SERBIA,200,29,61,47.5,24,47,51.1,5,14,35.7,15,21,71.4,9,24,33,11,18,12,7,1,78,1
10462,245378,288_11_03,RUSSIA,0,TOTALS,RUSSIA,200,30,61,49.2,19,36,52.8,11,25,44.0,10,15,66.7,6,18,24,20,20,13,6,2,81,1
10463,245391,288_11_03,BRAZIL,0,TOTALS,BRAZIL,200,29,59,49.2,21,39,53.8,8,20,40.0,12,19,63.2,8,22,30,10,22,12,2,3,78,0
10464,245404,288_11_04,USA,0,TOTALS,USA,200,43,76,56.6,30,52,57.7,13,24,54.2,16,29,55.2,18,34,52,32,19,12,7,10,115,0
10465,245417,288_11_04,EGYPT,0,TOTALS,EGYPT,200,21,73,28.8,15,56,26.8,6,17,35.3,12,18,66.7,14,21,35,8,22,15,5,2,60,1
10466,245430,288_11_05,ARGENTINA,0,TOTALS,ARGENTINA,200,19,59,32.2,17,36,47.2,2,23,8.7,9,13,69.2,9,21,30,7,25,13,3,5,49,0
10467,245443,288_11_05,AUSTRALIA,0,TOTALS,AUSTRALIA,200,24,56,42.9,14,37,37.8,10,19,52.6,15,28,53.6,8,26,34,16,23,6,7,2,73,1
10468,245456,288_11_06,KOREA,0,TOTALS,KOREA,200,40,71,56.3,31,48,64.6,9,23,39.1,4,6,66.7,5,20,25,16,30,21,11,4,93,1
10469,245469,288_11_06,CANADA,0,TOTALS,CANADA,200,40,87,46.0,37,71,52.1,3,16,18.8,26,37,70.3,31,26,57,15,13,21,11,2,109,0
10470,245482,288_11_07,LATVIA,0,TOTALS,LATVIA,200,34,68,50.0,29,46,63.0,5,22,22.7,12,30,40.0,24,33,57,13,26,25,5,2,85,1
10471,245495,288_11_07,CHINESE TAIPEI,0,TOTALS,CHINESE TAIPEI,200,23,63,36.5,22,49,44.9,1,14,7.1,20,30,66.7,6,11,17,8,25,14,12,2,67,0
10472,245508,288_11_08,CROATIA,0,TOTALS,CROATIA,200,33,71,46.5,23,51,45.1,10,20,50.0,12,20,60.0,9,24,33,12,23,13,7,2,88,1
10473,245521,288_11_08,LITHUANIA,0,TOTALS,LITHUANIA,200,27,71,38.0,25,54,46.3,2,17,11.8,19,26,73.1,15,25,40,6,25,16,5,6,75,0
10474,245534,288_11_09,TUNISIA,0,TOTALS,TUNISIA,200,22,67,32.8,19,53,35.8,3,14,21.4,8,11,72.7,9,17,26,11,22,16,7,4,55,1
10475,245547,288_11_09,RUSSIA,0,TOTALS,RUSSIA,200,37,70,52.9,30,44,68.2,7,26,26.9,20,29,69.0,13,33,46,24,14,10,10,3,101,0
10476,245559,288_11_10,EGYPT,0,TOTALS,EGYPT,250,40,82,48.8,35,66,53.0,5,16,31.2,15,32,46.9,17,30,47,19,27,22,14,5,100,0
10477,245572,288_11_10,CHINA,0,TOTALS,CHINA,250,32,90,35.6,19,43,44.2,13,47,27.7,19,27,70.4,22,26,48,21,26,26,10,3,96,1
10478,245585,288_11_11,CHINESE TAIPEI,0,TOTALS,CHINESE TAIPEI,200,21,48,43.8,16,29,55.2,5,19,26.3,22,30,73.3,4,17,21,7,29,24,8,4,69,0
10479,245598,288_11_11,ARGENTINA,0,TOTALS,ARGENTINA,200,24,55,43.6,17,32,53.1,7,23,30.4,25,29,86.2,10,23,33,15,31,24,8,2,80,1
10480,245611,288_11_12,SERBIA,0,TOTALS,SERBIA,200,24,55,43.6,19,41,46.3,5,14,35.7,25,33,75.8,9,17,26,8,24,15,9,2,78,0
10481,245624,288_11_12,USA,0,TOTALS,USA,200,27,63,42.9,26,50,52.0,1,13,7.7,25,27,92.6,13,26,39,10,25,19,9,6,80,1
10482,245637,288_11_13,BRAZIL,0,TOTALS,BRAZIL,200,30,66,45.5,24,45,53.3,6,21,28.6,13,15,86.7,9,31,40,15,24,17,8,4,79,1
10483,245650,288_11_13,POLAND,0,TOTALS,POLAND,200,25,63,39.7,18,42,42.9,7,21,33.3,13,25,52.0,12,20,32,10,20,15,4,2,70,0
10484,245663,288_11_14,LITHUANIA,0,TOTALS,LITHUANIA,200,49,75,65.3,46,66,69.7,3,9,33.3,16,23,69.6,16,47,63,28,14,24,6,7,117,0
10485,245676,288_11_14,KOREA,0,TOTALS,KOREA,200,28,88,31.8,25,61,41.0,3,27,11.1,5,6,83.3,9,10,19,15,21,13,14,3,64,1
10486,245689,288_11_15,AUSTRALIA,0,TOTALS,AUSTRALIA,200,24,60,40.0,20,42,47.6,4,18,22.2,16,29,55.2,11,21,32,13,23,13,8,0,68,0
10487,245701,288_11_15,LATVIA,0,TOTALS,LATVIA,200,27,56,48.2,19,35,54.3,8,21,38.1,16,21,76.2,4,25,29,13,26,13,4,2,78,1
10488,245713,288_11_16,CANADA,0,TOTALS,CANADA,200,31,73,42.5,22,41,53.7,9,32,28.1,13,24,54.2,7,29,36,12,23,9,5,5,84,0
10489,245726,288_11_16,CROATIA,0,TOTALS,CROATIA,200,34,74,45.9,27,50,54.0,7,24,29.2,13,25,52.0,9,32,41,14,20,10,6,1,88,1
10490,245739,288_11_17,POLAND,0,TOTALS,POLAND,200,30,57,52.6,24,41,58.5,6,16,37.5,21,29,72.4,7,31,38,11,8,14,2,8,87,1
10491,245752,288_11_17,RUSSIA,0,TOTALS,RUSSIA,200,29,78,37.2,21,52,40.4,8,26,30.8,4,5,80.0,13,20,33,20,20,10,6,4,70,0
10492,245765,288_11_18,SERBIA,0,TOTALS,SERBIA,200,31,70,44.3,26,50,52.0,5,20,25.0,18,30,60.0,16,27,43,18,19,15,8,3,85,1
10493,245778,288_11_18,EGYPT,0,TOTALS,EGYPT,200,23,68,33.8,20,55,36.4,3,13,23.1,18,28,64.3,12,24,36,11,23,14,7,4,67,0
10494,245791,288_11_19,CHINESE TAIPEI,0,TOTALS,CHINESE TAIPEI,200,25,63,39.7,23,55,41.8,2,8,25.0,13,17,76.5,14,13,27,9,21,10,6,1,65,0
10495,245804,288_11_19,AUSTRALIA,0,TOTALS,AUSTRALIA,200,31,65,47.7,22,45,48.9,9,20,45.0,22,26,84.6,19,22,41,19,21,11,4,8,93,1
10496,245817,288_11_20,CROATIA,0,TOTALS,CROATIA,200,28,72,38.9,24,47,51.1,4,25,16.0,11,14,78.6,22,21,43,17,24,25,8,3,71,0
10497,245830,288_11_20,KOREA,0,TOTALS,KOREA,200,28,60,46.7,22,43,51.2,6,17,35.3,13,22,59.1,9,17,26,16,20,19,8,4,75,1
10498,245843,288_11_21,BRAZIL,0,TOTALS,BRAZIL,200,31,57,54.4,21,39,53.8,10,18,55.6,25,35,71.4,6,33,39,19,21,13,8,5,97,1
10499,245856,288_11_21,TUNISIA,0,TOTALS,TUNISIA,200,18,62,29.0,14,51,27.5,4,11,36.4,16,25,64.0,11,18,29,9,22,13,5,2,56,0
10500,245869,288_11_22,USA,0,TOTALS,USA,200,34,70,48.6,27,50,54.0,7,20,35.0,7,10,70.0,7,32,39,12,18,10,9,2,82,1
10501,245882,288_11_22,CHINA,0,TOTALS,CHINA,200,25,65,38.5,24,50,48.0,1,15,6.7,15,22,68.2,8,30,38,4,9,14,4,2,66,0
10502,245895,288_11_23,ARGENTINA,0,TOTALS,ARGENTINA,200,22,59,37.3,15,30,50.0,7,29,24.1,18,25,72.0,12,24,36,10,22,15,11,3,69,1
10503,245908,288_11_23,LATVIA,0,TOTALS,LATVIA,200,21,61,34.4,16,33,48.5,5,28,17.9,15,25,60.0,11,28,39,5,22,15,6,1,62,0
10504,245921,288_11_24,CANADA,0,TOTALS,CANADA,200,22,61,36.1,18,45,40.0,4,16,25.0,20,33,60.6,10,19,29,7,21,20,6,2,68,1
10505,245934,288_11_24,LITHUANIA,0,TOTALS,LITHUANIA,200,42,75,56.0,33,54,61.1,9,21,42.9,18,29,62.1,13,23,36,19,24,13,10,13,111,0
10506,245947,288_11_25,EGYPT,0,TOTALS,EGYPT,200,34,77,44.2,28,62,45.2,6,15,40.0,7,15,46.7,13,27,40,16,20,16,10,4,81,0
10507,245960,288_11_25,CROATIA,0,TOTALS,CROATIA,200,32,69,46.4,22,36,61.1,10,33,30.3,9,17,52.9,7,30,37,23,17,17,8,5,83,1
10508,245973,288_11_26,SERBIA,0,TOTALS,SERBIA,200,20,66,30.3,15,51,29.4,5,15,33.3,9,12,75.0,14,28,42,9,19,15,5,4,54,0
10509,245986,288_11_26,LITHUANIA,0,TOTALS,LITHUANIA,200,26,62,41.9,22,48,45.8,4,14,28.6,15,20,75.0,9,30,39,16,19,14,8,4,71,1
10510,245999,288_11_27,USA,0,TOTALS,USA,200,33,75,44.0,25,51,49.0,8,24,33.3,9,16,56.2,16,37,53,16,14,15,13,3,83,1
10511,246012,288_11_27,CANADA,0,TOTALS,CANADA,200,24,80,30.0,21,58,36.2,3,22,13.6,3,11,27.3,17,24,41,9,12,14,6,1,54,0
10512,246025,288_11_28,AUSTRALIA,0,TOTALS,AUSTRALIA,200,31,57,54.4,24,43,55.8,7,14,50.0,16,23,69.6,9,23,32,11,13,16,9,0,85,1
10513,246038,288_11_28,RUSSIA,0,TOTALS,RUSSIA,200,31,67,46.3,20,42,47.6,11,25,44.0,5,6,83.3,9,17,26,17,20,15,4,3,78,0
10514,246051,288_11_29,KOREA,0,TOTALS,KOREA,200,35,72,48.6,29,50,58.0,6,22,27.3,12,14,85.7,6,12,18,16,26,10,9,4,88,0
10515,246063,288_11_29,CHINA,0,TOTALS,CHINA,200,34,72,47.2,30,60,50.0,4,12,33.3,23,32,71.9,28,25,53,11,17,17,5,0,95,1
10516,246076,288_11_30,LATVIA,0,TOTALS,LATVIA,200,25,62,40.3,20,41,48.8,5,21,23.8,18,28,64.3,14,21,35,9,23,19,6,0,73,0
10517,246089,288_11_30,BRAZIL,0,TOTALS,BRAZIL,200,32,67,47.8,25,42,59.5,7,25,28.0,17,20,85.0,11,25,36,14,21,14,12,6,88,1
10518,246102,288_11_31,TUNISIA,0,TOTALS,TUNISIA,200,27,71,38.0,26,55,47.3,1,16,6.2,4,8,50.0,21,21,42,5,15,19,8,3,59,0
10519,246115,288_11_31,CHINESE TAIPEI,0,TOTALS,CHINESE TAIPEI,200,26,64,40.6,17,45,37.8,9,19,47.4,9,15,60.0,11,23,34,13,11,18,10,2,70,1
10520,246128,288_11_32,ARGENTINA,0,TOTALS,ARGENTINA,200,23,74,31.1,12,41,29.3,11,33,33.3,14,17,82.4,14,24,38,15,24,6,5,4,71,0
10521,246141,288_11_32,POLAND,0,TOTALS,POLAND,200,24,59,40.7,16,38,42.1,8,21,38.1,17,30,56.7,9,31,40,14,15,11,2,5,73,1
10522,246154,288_11_33,CANADA,0,TOTALS,CANADA,181,27,58,46.6,15,33,45.5,12,25,48.0,19,27,70.4,11,28,39,17,18,19,5,3,85,1
10523,246167,288_11_33,EGYPT,0,TOTALS,EGYPT,200,28,80,35.0,23,58,39.7,5,22,22.7,10,19,52.6,15,18,33,12,26,12,13,0,71,0
10524,246180,288_11_34,CROATIA,0,TOTALS,CROATIA,200,29,64,45.3,23,46,50.0,6,18,33.3,4,7,57.1,9,20,29,11,15,11,6,0,68,0
10525,246193,288_11_34,SERBIA,0,TOTALS,SERBIA,200,28,64,43.8,22,46,47.8,6,18,33.3,11,16,68.8,11,23,34,5,17,11,4,1,73,1
10526,246206,288_11_35,LITHUANIA,0,TOTALS,LITHUANIA,225,36,73,49.3,27,47,57.4,9,26,34.6,24,35,68.6,16,30,46,13,30,19,5,5,105,0
10527,246219,288_11_35,USA,0,TOTALS,USA,225,40,87,46.0,34,74,45.9,6,13,46.2,21,30,70.0,17,25,42,17,27,14,11,3,107,1
10528,246232,288_11_36,BRAZIL,0,TOTALS,BRAZIL,200,20,57,35.1,18,40,45.0,2,17,11.8,15,19,78.9,16,28,44,6,16,20,3,6,57,0
10529,246245,288_11_36,AUSTRALIA,0,TOTALS,AUSTRALIA,200,25,77,32.5,21,57,36.8,4,20,20.0,9,13,69.2,20,17,37,7,18,8,15,3,63,1
10530,246258,288_11_37,TUNISIA,0,TOTALS,TUNISIA,200,30,78,38.5,24,59,40.7,6,19,31.6,6,8,75.0,17,20,37,14,24,12,10,3,72,0
10531,246271,288_11_37,KOREA,0,TOTALS,KOREA,200,29,51,56.9,22,36,61.1,7,15,46.7,13,22,59.1,5,22,27,17,12,19,3,3,78,1
10532,246284,288_11_38,POLAND,0,TOTALS,POLAND,200,24,59,40.7,21,49,42.9,3,10,30.0,35,44,79.5,10,31,41,13,18,18,4,4,86,1
10533,246297,288_11_38,LATVIA,0,TOTALS,LATVIA,200,26,81,32.1,15,46,32.6,11,35,31.4,15,16,93.8,17,24,41,11,31,13,6,5,78,0
10534,246310,288_11_39,CHINA,0,TOTALS,CHINA,200,37,67,55.2,30,52,57.7,7,15,46.7,10,19,52.6,9,32,41,15,10,9,12,3,91,1
10535,246323,288_11_39,CHINESE TAIPEI,0,TOTALS,CHINESE TAIPEI,200,22,65,33.8,18,44,40.9,4,21,19.0,0,2,0.0,6,17,23,9,17,17,6,0,48,0
10536,246336,288_11_40,RUSSIA,0,TOTALS,RUSSIA,200,23,64,35.9,19,34,55.9,4,30,13.3,20,23,87.0,15,23,38,10,23,13,4,4,70,0
10537,246349,288_11_40,ARGENTINA,0,TOTALS,ARGENTINA,200,24,59,40.7,17,40,42.5,7,19,36.8,18,26,69.2,7,22,29,12,24,9,7,2,73,1
10538,246362,288_11_41,EGYPT,0,TOTALS,EGYPT,200,26,80,32.5,22,59,37.3,4,21,19.0,3,5,60.0,21,24,45,10,17,14,10,2,59,0
10539,246375,288_11_41,LITHUANIA,0,TOTALS,LITHUANIA,200,26,65,40.0,16,37,43.2,10,28,35.7,16,18,88.9,12,28,40,21,10,13,7,4,78,1
10540,246388,288_11_42,SERBIA,0,TOTALS,SERBIA,200,39,66,59.1,31,52,59.6,8,14,57.1,8,17,47.1,8,26,34,21,20,13,7,3,94,1
10541,246401,288_11_42,CANADA,0,TOTALS,CANADA,200,29,63,46.0,23,39,59.0,6,24,25.0,9,18,50.0,6,20,26,7,16,12,7,2,73,0
10542,246414,288_11_43,USA,0,TOTALS,USA,200,35,74,47.3,31,58,53.4,4,16,25.0,11,18,61.1,13,27,40,13,25,12,6,1,85,0
10543,246427,288_11_43,CROATIA,0,TOTALS,CROATIA,200,33,67,49.3,26,47,55.3,7,20,35.0,14,22,63.6,6,24,30,13,18,9,7,0,87,1
10544,246440,288_11_44,AUSTRALIA,0,TOTALS,AUSTRALIA,200,29,73,39.7,25,60,41.7,4,13,30.8,10,16,62.5,18,32,50,7,19,11,7,3,72,1
10545,246453,288_11_44,POLAND,0,TOTALS,POLAND,200,18,60,30.0,15,50,30.0,3,10,30.0,13,23,56.5,13,24,37,9,16,14,8,3,52,0
10546,246466,288_11_45,LATVIA,0,TOTALS,LATVIA,200,22,64,34.4,14,35,40.0,8,29,27.6,11,14,78.6,12,22,34,11,18,13,5,2,63,0
10547,246479,288_11_45,RUSSIA,0,TOTALS,RUSSIA,200,27,57,47.4,20,38,52.6,7,19,36.8,12,18,66.7,6,24,30,11,16,12,9,4,73,1
10548,246492,288_11_46,ARGENTINA,0,TOTALS,ARGENTINA,225,29,69,42.0,21,51,41.2,8,18,44.4,5,11,45.5,11,23,34,15,21,14,7,4,71,1
10549,246505,288_11_46,BRAZIL,0,TOTALS,BRAZIL,225,26,67,38.8,20,47,42.6,6,20,30.0,11,17,64.7,18,26,44,14,17,18,5,5,69,0
10550,246518,288_11_47,BRAZIL,0,TOTALS,BRAZIL,200,27,64,42.2,17,35,48.6,10,29,34.5,13,18,72.2,12,20,32,19,23,14,12,5,77,1
10551,246531,288_11_47,EGYPT,0,TOTALS,EGYPT,200,25,57,43.9,19,38,50.0,6,19,31.6,7,17,41.2,12,23,35,8,18,19,6,3,63,0
10552,246544,288_11_48,LATVIA,0,TOTALS,LATVIA,200,36,72,50.0,27,47,57.4,9,25,36.0,18,23,78.3,11,25,36,22,24,17,5,3,99,1
10553,246557,288_11_48,CANADA,0,TOTALS,CANADA,200,31,65,47.7,23,42,54.8,8,23,34.8,26,32,81.2,8,25,33,12,21,15,11,4,96,0
10554,246570,288_11_49,POLAND,0,TOTALS,POLAND,200,28,74,37.8,18,53,34.0,10,21,47.6,9,17,52.9,15,29,44,10,17,16,5,3,75,0
10555,246583,288_11_49,LITHUANIA,0,TOTALS,LITHUANIA,200,30,77,39.0,23,53,43.4,7,24,29.2,20,23,87.0,16,31,47,18,17,9,10,6,87,1
10556,246596,288_11_50,RUSSIA,0,TOTALS,RUSSIA,200,29,63,46.0,17,34,50.0,12,29,41.4,9,15,60.0,12,23,35,18,22,12,4,1,79,1
10557,246608,288_11_50,USA,0,TOTALS,USA,200,29,67,43.3,29,58,50.0,0,9,0.0,16,23,69.6,17,20,37,8,22,10,5,6,74,0
10558,246621,288_11_51,AUSTRALIA,0,TOTALS,AUSTRALIA,200,26,64,40.6,16,36,44.4,10,28,35.7,12,17,70.6,9,13,22,9,26,13,6,3,74,0
10559,246632,288_11_51,SERBIA,0,TOTALS,SERBIA,200,34,61,55.7,29,51,56.9,5,10,50.0,20,27,74.1,13,19,32,13,20,15,7,5,93,1
10560,246645,288_11_52,ARGENTINA,0,TOTALS,ARGENTINA,200,26,62,41.9,16,35,45.7,10,27,37.0,19,29,65.5,5,25,30,16,26,8,10,1,81,1
10561,246658,288_11_52,CROATIA,0,TOTALS,CROATIA,200,25,56,44.6,21,39,53.8,4,17,23.5,22,27,81.5,4,28,32,8,24,16,3,2,76,0
10562,246671,288_11_53,EGYPT,0,TOTALS,EGYPT,200,29,64,45.3,25,51,49.0,4,13,30.8,17,24,70.8,11,21,32,10,24,10,6,3,79,0
10563,246684,288_11_53,CANADA,0,TOTALS,CANADA,200,28,64,43.8,21,41,51.2,7,23,30.4,21,27,77.8,13,22,35,14,21,12,6,2,84,1
10564,246697,288_11_54,BRAZIL,0,TOTALS,BRAZIL,200,24,44,54.5,19,29,65.5,5,15,33.3,28,41,68.3,7,22,29,12,21,23,12,3,81,1
10565,246710,288_11_54,LATVIA,0,TOTALS,LATVIA,200,28,66,42.4,22,42,52.4,6,24,25.0,11,15,73.3,12,18,30,16,30,18,11,2,73,0
10566,246723,288_11_55,POLAND,0,TOTALS,POLAND,200,19,78,24.4,15,51,29.4,4,27,14.8,5,7,71.4,13,23,36,13,11,15,7,1,47,0
10567,246736,288_11_55,USA,0,TOTALS,USA,200,38,76,50.0,35,57,61.4,3,19,15.8,5,9,55.6,16,41,57,19,12,16,9,10,84,1
10568,246749,288_11_56,AUSTRALIA,0,TOTALS,AUSTRALIA,200,39,76,51.3,31,56,55.4,8,20,40.0,4,9,44.4,20,26,46,21,11,11,9,2,90,1
10569,246762,288_11_56,CROATIA,0,TOTALS,CROATIA,200,25,58,43.1,18,37,48.6,7,21,33.3,6,6,100.0,2,17,19,12,12,13,4,3,63,0
10570,246775,288_11_57,LITHUANIA,0,TOTALS,LITHUANIA,200,29,64,45.3,23,39,59.0,6,25,24.0,21,25,84.0,16,27,43,17,19,13,6,0,85,1
10571,246788,288_11_57,RUSSIA,0,TOTALS,RUSSIA,200,26,61,42.6,18,37,48.6,8,24,33.3,8,12,66.7,5,17,22,13,24,14,4,3,68,0
10572,246801,288_11_58,SERBIA,0,TOTALS,SERBIA,200,26,63,41.3,20,46,43.5,6,17,35.3,18,20,90.0,9,25,34,11,18,9,6,5,76,1
10573,246814,288_11_58,ARGENTINA,0,TOTALS,ARGENTINA,200,24,55,43.6,18,44,40.9,6,11,54.5,17,21,81.0,5,26,31,7,22,13,6,3,71,0
10574,246827,288_11_59,CROATIA,0,TOTALS,CROATIA,200,26,70,37.1,19,44,43.2,7,26,26.9,11,16,68.8,11,21,32,17,25,14,9,3,70,0
10575,246840,288_11_59,POLAND,0,TOTALS,POLAND,200,29,59,49.2,26,48,54.2,3,11,27.3,21,29,72.4,7,26,33,12,16,14,8,2,82,1
10576,246852,288_11_60,AUSTRALIA,0,TOTALS,AUSTRALIA,200,30,71,42.3,22,48,45.8,8,23,34.8,9,15,60.0,14,24,38,13,15,10,5,5,77,0
10577,246865,288_11_60,USA,0,TOTALS,USA,200,33,75,44.0,29,57,50.9,4,18,22.2,8,19,42.1,16,22,38,15,14,8,4,5,78,1
10578,246878,288_11_61,ARGENTINA,0,TOTALS,ARGENTINA,200,28,56,50.0,17,34,50.0,11,22,50.0,5,7,71.4,1,25,26,13,22,13,3,2,72,0
10579,246891,288_11_61,RUSSIA,0,TOTALS,RUSSIA,200,27,68,39.7,19,42,45.2,8,26,30.8,15,16,93.8,9,23,32,13,16,8,7,5,77,1
10580,246904,288_11_62,SERBIA,0,TOTALS,SERBIA,200,22,57,38.6,18,46,39.1,4,11,36.4,19,24,79.2,7,20,27,10,26,16,6,3,67,0
10581,246917,288_11_62,LITHUANIA,0,TOTALS,LITHUANIA,200,31,65,47.7,29,52,55.8,2,13,15.4,21,27,77.8,11,22,33,13,20,12,9,4,85,1
10582,248399,290_11_01,COTE D'IVOIRE,0,TOTALS,COTE D'IVOIRE,200,40,74,54.1,31,52,59.6,9,22,40.9,16,27,59.3,17,20,37,28,12,19,9,4,105,0
10583,248412,290_11_01,SOUTH AFRICA,0,TOTALS,SOUTH AFRICA,200,20,60,33.3,17,47,36.2,3,13,23.1,10,13,76.9,13,18,31,13,20,31,7,1,53,1
10584,248425,290_11_02,NIGERIA,0,TOTALS,NIGERIA,200,25,58,43.1,17,39,43.6,8,19,42.1,26,37,70.3,18,24,42,7,20,16,9,1,84,1
10585,248438,290_11_02,MALI,0,TOTALS,MALI,200,18,52,34.6,12,35,34.3,6,17,35.3,17,21,81.0,8,15,23,5,31,22,7,2,59,0
10586,248451,290_11_03,MADAGASCAR,0,TOTALS,MADAGASCAR,200,28,74,37.8,24,51,47.1,4,23,17.4,7,18,38.9,16,33,49,8,25,26,4,2,67,0
10587,248464,290_11_03,MOZAMBIQUE,0,TOTALS,MOZAMBIQUE,200,25,71,35.2,21,56,37.5,4,15,26.7,23,36,63.9,16,30,46,11,20,16,14,0,77,1
10588,248476,290_11_04,CAMEROON,0,TOTALS,CAMEROON,200,34,60,56.7,25,42,59.5,9,18,50.0,19,26,73.1,6,27,33,14,34,21,11,0,96,1
10589,248489,290_11_04,EGYPT,0,TOTALS,EGYPT,200,24,61,39.3,19,39,48.7,5,22,22.7,28,42,66.7,14,19,33,10,22,17,6,0,81,0
10590,248502,290_11_05,TUNISIA,0,TOTALS,TUNISIA,200,42,75,56.0,36,56,64.3,6,19,31.6,13,23,56.5,17,26,43,23,9,7,18,7,103,0
10591,248515,290_11_05,TOGO,0,TOTALS,TOGO,200,24,63,38.1,20,48,41.7,4,15,26.7,4,6,66.7,12,21,33,7,19,24,4,0,56,1
10592,248528,290_11_06,CENTRAL AFRICAN REPUBLIC,0,TOTALS,CENTRAL AFRICAN REPUBLIC,200,32,70,45.7,23,52,44.2,9,18,50.0,16,27,59.3,15,40,55,15,22,18,6,1,89,1
10593,248541,290_11_06,RWANDA,0,TOTALS,RWANDA,200,20,66,30.3,16,43,37.2,4,23,17.4,17,23,73.9,10,20,30,4,18,12,3,4,61,0
10594,248554,290_11_07,MOROCCO,0,TOTALS,MOROCCO,200,23,63,36.5,19,45,42.2,4,18,22.2,15,21,71.4,12,26,38,12,24,13,4,1,65,0
10595,248567,290_11_07,SENEGAL,0,TOTALS,SENEGAL,200,24,54,44.4,17,35,48.6,7,19,36.8,24,30,80.0,7,28,35,16,21,12,4,3,79,1
10596,248580,290_11_08,ANGOLA,0,TOTALS,ANGOLA,200,37,75,49.3,24,38,63.2,13,37,35.1,28,35,80.0,15,39,54,13,17,24,16,3,115,0
10597,248593,290_11_08,CHAD,0,TOTALS,CHAD,200,21,77,27.3,19,58,32.8,2,19,10.5,12,20,60.0,15,22,37,8,28,30,12,1,56,1
10598,248606,290_11_09,SOUTH AFRICA,0,TOTALS,SOUTH AFRICA,200,20,45,44.4,16,32,50.0,4,13,30.8,21,36,58.3,9,28,37,10,35,33,7,2,65,0
10599,248618,290_11_09,CAMEROON,0,TOTALS,CAMEROON,200,24,67,35.8,23,50,46.0,1,17,5.9,38,49,77.6,17,23,40,9,26,16,20,2,87,1
10600,248631,290_11_10,MOZAMBIQUE,0,TOTALS,MOZAMBIQUE,200,22,64,34.4,16,47,34.0,6,17,35.3,13,22,59.1,7,21,28,4,16,11,8,1,63,0
10601,248644,290_11_10,NIGERIA,0,TOTALS,NIGERIA,200,28,59,47.5,15,29,51.7,13,30,43.3,9,17,52.9,13,37,50,22,22,20,6,2,78,1
10602,248657,290_11_11,MADAGASCAR,0,TOTALS,MADAGASCAR,200,25,64,39.1,18,44,40.9,7,20,35.0,6,13,46.2,8,22,30,13,31,20,8,1,63,0
10603,248670,290_11_11,MALI,0,TOTALS,MALI,200,21,58,36.2,15,37,40.5,6,21,28.6,26,37,70.3,14,32,46,10,19,23,7,2,74,1
10604,248683,290_11_12,COTE D'IVOIRE,0,TOTALS,COTE D'IVOIRE,200,26,73,35.6,23,46,50.0,3,27,11.1,20,30,66.7,17,28,45,6,29,19,10,1,75,0
10605,248696,290_11_12,EGYPT,0,TOTALS,EGYPT,200,28,64,43.8,25,46,54.3,3,18,16.7,23,37,62.2,11,32,43,10,28,19,11,0,82,1
10606,248709,290_11_13,CHAD,0,TOTALS,CHAD,200,23,65,35.4,16,42,38.1,7,23,30.4,4,8,50.0,10,21,31,13,25,30,8,3,57,0
10607,248722,290_11_13,MOROCCO,0,TOTALS,MOROCCO,200,33,65,50.8,30,46,65.2,3,19,15.8,20,31,64.5,16,27,43,17,12,23,14,5,89,1
10608,248735,290_11_14,TOGO,0,TOTALS,TOGO,200,19,54,35.2,17,40,42.5,2,14,14.3,17,25,68.0,13,23,36,7,20,29,8,0,57,0
10609,248748,290_11_14,CENTRAL AFRICAN REPUBLIC,0,TOTALS,CENTRAL AFRICAN REPUBLIC,200,28,64,43.8,16,32,50.0,12,32,37.5,14,24,58.3,13,25,38,19,23,20,15,1,82,1
10610,248761,290_11_15,TUNISIA,0,TOTALS,TUNISIA,200,24,60,40.0,23,47,48.9,1,13,7.7,20,27,74.1,11,34,45,11,10,18,13,3,69,1
10611,248774,290_11_15,RWANDA,0,TOTALS,RWANDA,200,16,61,26.2,13,41,31.7,3,20,15.0,2,2,100.0,10,24,34,2,25,25,5,3,37,0
10612,248787,290_11_16,ANGOLA,0,TOTALS,ANGOLA,200,26,66,39.4,16,31,51.6,10,35,28.6,16,20,80.0,16,23,39,10,26,21,5,1,78,0
10613,248800,290_11_16,SENEGAL,0,TOTALS,SENEGAL,200,30,64,46.9,25,46,54.3,5,18,27.8,20,24,83.3,11,23,34,12,22,14,8,4,85,1
10614,248813,290_11_17,MALI,0,TOTALS,MALI,250,24,50,48.0,23,41,56.1,1,9,11.1,23,36,63.9,15,38,53,10,26,36,11,5,72,1
10615,248826,290_11_17,MOZAMBIQUE,0,TOTALS,MOZAMBIQUE,250,22,81,27.2,16,45,35.6,6,36,16.7,19,27,70.4,23,15,38,8,25,20,15,2,69,0
10616,248839,290_11_18,EGYPT,0,TOTALS,EGYPT,200,23,65,35.4,14,28,50.0,9,37,24.3,13,19,68.4,11,38,49,13,28,20,7,1,68,0
10617,248852,290_11_18,SOUTH AFRICA,0,TOTALS,SOUTH AFRICA,200,27,72,37.5,23,53,43.4,4,19,21.1,13,28,46.4,13,32,45,12,18,13,12,2,71,1
10618,248865,290_11_19,NIGERIA,0,TOTALS,NIGERIA,200,36,79,45.6,31,62,50.0,5,17,29.4,35,45,77.8,22,31,53,18,20,15,16,2,112,0
10619,248878,290_11_19,MADAGASCAR,0,TOTALS,MADAGASCAR,200,29,59,49.2,25,46,54.3,4,13,30.8,19,27,70.4,2,24,26,10,34,22,5,0,81,1
10620,248890,290_11_20,CAMEROON,0,TOTALS,CAMEROON,200,28,60,46.7,24,41,58.5,4,19,21.1,16,23,69.6,9,27,36,5,26,17,12,1,76,1
10621,248903,290_11_20,COTE D'IVOIRE,0,TOTALS,COTE D'IVOIRE,200,26,65,40.0,21,46,45.7,5,19,26.3,13,21,61.9,13,21,34,17,21,19,4,1,70,0
10622,248916,290_11_21,RWANDA,0,TOTALS,RWANDA,200,32,67,47.8,25,47,53.2,7,20,35.0,16,24,66.7,9,29,38,21,20,16,12,1,87,1
10623,248929,290_11_21,TOGO,0,TOTALS,TOGO,200,25,59,42.4,19,42,45.2,6,17,35.3,11,18,61.1,7,28,35,14,20,24,5,0,67,0
10624,248942,290_11_22,SENEGAL,0,TOTALS,SENEGAL,200,34,66,51.5,30,49,61.2,4,17,23.5,20,29,69.0,14,34,48,16,17,19,13,3,92,1
10625,248955,290_11_22,CHAD,0,TOTALS,CHAD,200,21,64,32.8,18,50,36.0,3,14,21.4,9,17,52.9,13,22,35,9,20,22,7,2,54,0
10626,248968,290_11_23,CENTRAL AFRICAN REPUBLIC,0,TOTALS,CENTRAL AFRICAN REPUBLIC,200,18,49,36.7,15,34,44.1,3,15,20.0,13,20,65.0,6,24,30,5,21,20,6,2,52,0
10627,248981,290_11_23,TUNISIA,0,TOTALS,TUNISIA,200,25,63,39.7,19,46,41.3,6,17,35.3,9,12,75.0,14,26,40,13,22,17,8,4,65,1
10628,248994,290_11_24,MOROCCO,0,TOTALS,MOROCCO,200,25,69,36.2,22,48,45.8,3,21,14.3,8,13,61.5,15,26,41,14,25,17,8,2,61,0
10629,249007,290_11_24,ANGOLA,0,TOTALS,ANGOLA,200,27,61,44.3,21,41,51.2,6,20,30.0,15,23,65.2,10,30,40,13,16,19,7,1,75,1
10630,249020,290_11_25,NIGERIA,0,TOTALS,NIGERIA,200,32,70,45.7,25,41,61.0,7,29,24.1,13,27,48.1,20,34,54,24,19,15,7,0,84,1
10631,249033,290_11_25,CHAD,0,TOTALS,CHAD,200,17,62,27.4,16,45,35.6,1,17,5.9,11,16,68.8,11,24,35,9,22,15,7,2,46,0
10632,249045,290_11_26,CAMEROON,0,TOTALS,CAMEROON,200,32,72,44.4,24,49,49.0,8,23,34.8,13,24,54.2,17,25,42,16,15,16,11,1,85,1
10633,249058,290_11_26,TOGO,0,TOTALS,TOGO,200,19,58,32.8,12,33,36.4,7,25,28.0,7,10,70.0,13,27,40,10,23,30,6,1,52,0
10634,249071,290_11_27,CENTRAL AFRICAN REPUBLIC,0,TOTALS,CENTRAL AFRICAN REPUBLIC,200,21,58,36.2,12,35,34.3,9,23,39.1,20,33,60.6,13,35,48,10,22,24,7,2,71,1
10635,249084,290_11_27,EGYPT,0,TOTALS,EGYPT,200,24,72,33.3,17,41,41.5,7,31,22.6,11,23,47.8,16,28,44,8,35,19,9,0,66,0
10636,249097,290_11_28,ANGOLA,0,TOTALS,ANGOLA,200,25,62,40.3,17,31,54.8,8,31,25.8,24,33,72.7,14,37,51,17,26,23,4,5,82,1
10637,249110,290_11_28,MOZAMBIQUE,0,TOTALS,MOZAMBIQUE,200,25,68,36.8,21,48,43.8,4,20,20.0,17,25,68.0,9,20,29,16,28,12,9,2,71,0
10638,249123,290_11_29,COTE D'IVOIRE,0,TOTALS,COTE D'IVOIRE,200,26,62,41.9,19,38,50.0,7,24,29.2,21,25,84.0,12,24,36,15,20,18,10,2,80,1
10639,249136,290_11_29,RWANDA,0,TOTALS,RWANDA,200,24,66,36.4,13,32,40.6,11,34,32.4,13,14,92.9,15,25,40,13,16,19,7,3,72,0
10640,249149,290_11_30,TUNISIA,0,TOTALS,TUNISIA,200,34,70,48.6,23,41,56.1,11,29,37.9,15,24,62.5,19,30,49,25,8,20,11,6,94,1
10641,249162,290_11_30,SOUTH AFRICA,0,TOTALS,SOUTH AFRICA,200,20,62,32.3,16,50,32.0,4,12,33.3,6,8,75.0,13,20,33,4,23,27,13,1,50,0
10642,249175,290_11_31,SENEGAL,0,TOTALS,SENEGAL,200,36,75,48.0,31,58,53.4,5,17,29.4,15,18,83.3,14,37,51,20,20,17,7,5,92,1
10643,249188,290_11_31,MADAGASCAR,0,TOTALS,MADAGASCAR,200,27,73,37.0,23,59,39.0,4,14,28.6,17,25,68.0,13,21,34,11,15,15,6,2,75,0
10644,249201,290_11_32,MALI,0,TOTALS,MALI,200,23,66,34.8,16,45,35.6,7,21,33.3,6,11,54.5,22,25,47,10,14,19,3,1,59,0
10645,249214,290_11_32,MOROCCO,0,TOTALS,MOROCCO,200,32,68,47.1,26,47,55.3,6,21,28.6,10,14,71.4,13,24,37,19,12,11,13,2,80,1
10646,249227,290_11_33,TOGO,0,TOTALS,TOGO,200,18,58,31.0,15,41,36.6,3,17,17.6,23,30,76.7,14,39,53,14,12,28,9,1,62,0
10647,249240,290_11_33,CHAD,0,TOTALS,CHAD,200,27,76,35.5,26,56,46.4,1,20,5.0,8,15,53.3,14,25,39,19,22,12,12,3,63,1
10648,249253,290_11_34,EGYPT,0,TOTALS,EGYPT,200,30,72,41.7,26,50,52.0,4,22,18.2,12,22,54.5,16,39,55,10,16,15,7,2,76,1
10649,249266,290_11_34,RWANDA,0,TOTALS,RWANDA,200,25,83,30.1,19,58,32.8,6,25,24.0,10,19,52.6,23,26,49,17,17,11,6,2,66,0
10650,249279,290_11_35,NIGERIA,0,TOTALS,NIGERIA,200,32,58,55.2,21,39,53.8,11,19,57.9,19,24,79.2,9,23,32,17,14,24,11,0,94,1
10651,249292,290_11_35,CENTRAL AFRICAN REPUBLIC,0,TOTALS,CENTRAL AFRICAN REPUBLIC,200,31,65,47.7,21,36,58.3,10,29,34.5,14,16,87.5,11,16,27,14,18,22,7,1,86,0
10652,249305,290_11_36,MALI,0,TOTALS,MALI,200,23,59,39.0,18,42,42.9,5,17,29.4,10,22,45.5,20,36,56,13,15,28,12,8,61,1
10653,249318,290_11_36,MOZAMBIQUE,0,TOTALS,MOZAMBIQUE,200,19,65,29.2,14,39,35.9,5,26,19.2,12,19,63.2,13,19,32,12,16,18,9,3,55,0
10654,249331,290_11_37,SENEGAL,0,TOTALS,SENEGAL,200,21,71,29.6,16,47,34.0,5,24,20.8,12,18,66.7,18,22,40,9,16,13,7,5,59,0
10655,249344,290_11_37,COTE D'IVOIRE,0,TOTALS,COTE D'IVOIRE,200,26,67,38.8,20,51,39.2,6,16,37.5,17,21,81.0,21,33,54,16,21,16,8,2,75,1
10656,249357,290_11_38,SOUTH AFRICA,0,TOTALS,SOUTH AFRICA,200,23,79,29.1,20,60,33.3,3,19,15.8,12,21,57.1,21,29,50,4,25,20,10,0,61,0
10657,249370,290_11_38,MADAGASCAR,0,TOTALS,MADAGASCAR,200,27,67,40.3,21,44,47.7,6,23,26.1,22,38,57.9,13,39,52,16,19,21,9,2,82,1
10658,249383,290_11_39,TUNISIA,0,TOTALS,TUNISIA,200,26,59,44.1,23,41,56.1,3,18,16.7,31,44,70.5,15,34,49,13,19,15,6,2,86,1
10659,249396,290_11_39,MOROCCO,0,TOTALS,MOROCCO,200,20,57,35.1,12,39,30.8,8,18,44.4,19,29,65.5,8,23,31,11,33,15,5,1,67,0
10660,249408,290_11_40,CAMEROON,0,TOTALS,CAMEROON,225,26,76,34.2,15,49,30.6,11,27,40.7,20,28,71.4,19,32,51,13,26,23,10,2,83,0
10661,249421,290_11_40,ANGOLA,0,TOTALS,ANGOLA,225,27,76,35.5,18,48,37.5,9,28,32.1,21,26,80.8,18,33,51,15,23,21,10,2,84,1
10662,249434,290_11_41,SENEGAL,0,TOTALS,SENEGAL,200,38,72,52.8,25,45,55.6,13,27,48.1,7,7,100.0,15,27,42,24,8,21,12,4,96,1
10663,249447,290_11_41,MOROCCO,0,TOTALS,MOROCCO,200,32,80,40.0,26,56,46.4,6,24,25.0,5,11,45.5,21,17,38,14,4,17,12,1,75,0
10664,249459,290_11_42,CAMEROON,0,TOTALS,CAMEROON,200,25,62,40.3,19,39,48.7,6,23,26.1,13,16,81.2,11,39,50,10,17,17,5,0,69,1
10665,249472,290_11_42,MOROCCO,0,TOTALS,MOROCCO,200,23,69,33.3,16,42,38.1,7,27,25.9,14,21,66.7,11,25,36,13,15,10,7,0,67,0
10666,249485,290_11_43,CENTRAL AFRICAN REPUBLIC,0,TOTALS,CENTRAL AFRICAN REPUBLIC,200,28,64,43.8,24,46,52.2,4,18,22.2,11,25,44.0,8,22,30,14,30,15,7,0,71,0
10667,249498,290_11_43,SENEGAL,0,TOTALS,SENEGAL,200,30,68,44.1,21,46,45.7,9,22,40.9,24,35,68.6,17,34,51,20,19,17,6,1,93,1
10668,249511,290_11_44,COTE D'IVOIRE,0,TOTALS,COTE D'IVOIRE,200,22,58,37.9,16,44,36.4,6,14,42.9,7,14,50.0,13,20,33,8,22,13,8,1,57,0
10669,249524,290_11_44,TUNISIA,0,TOTALS,TUNISIA,200,19,54,35.2,12,31,38.7,7,23,30.4,15,23,65.2,18,27,45,10,20,19,5,5,60,1
10670,249537,290_11_45,NIGERIA,0,TOTALS,NIGERIA,200,25,66,37.9,19,41,46.3,6,25,24.0,12,17,70.6,13,25,38,12,24,11,8,3,68,0
10671,249550,290_11_45,ANGOLA,0,TOTALS,ANGOLA,200,25,60,41.7,20,41,48.8,5,19,26.3,21,29,72.4,14,29,43,16,19,13,8,3,76,1
10672,249563,290_11_46,NIGERIA,0,TOTALS,NIGERIA,200,29,69,42.0,23,50,46.0,6,19,31.6,13,16,81.2,24,30,54,15,19,19,8,0,77,1
10673,249576,290_11_46,COTE D'IVOIRE,0,TOTALS,COTE D'IVOIRE,200,23,59,39.0,18,41,43.9,5,18,27.8,16,25,64.0,9,18,27,12,13,12,12,4,67,0
10674,249589,290_11_47,ANGOLA,0,TOTALS,ANGOLA,200,21,64,32.8,14,31,45.2,7,33,21.2,7,12,58.3,11,28,39,7,23,13,3,2,56,0
10675,249602,290_11_47,TUNISIA,0,TOTALS,TUNISIA,200,23,58,39.7,13,31,41.9,10,27,37.0,11,23,47.8,13,34,47,10,18,16,6,4,67,1
10676,250808,296_11_01,SYRIA,0,TOTALS,SYRIA,200,21,60,35.0,15,39,38.5,6,21,28.6,10,19,52.6,16,31,47,8,22,19,1,5,58,0
10677,250821,296_11_01,JORDAN,0,TOTALS,JORDAN,200,25,68,36.8,20,50,40.0,5,18,27.8,16,27,59.3,15,21,36,11,18,9,6,2,71,1
10678,250834,296_11_02,CHINESE TAIPEI,0,TOTALS,CHINESE TAIPEI,200,12,56,21.4,10,36,27.8,2,20,10.0,11,13,84.6,5,22,27,9,11,14,9,2,37,0
10679,250847,296_11_02,IRAN,0,TOTALS,IRAN,200,21,64,32.8,18,37,48.6,3,27,11.1,4,10,40.0,23,37,60,13,14,23,6,6,49,1
10680,250860,296_11_03,JAPAN,0,TOTALS,JAPAN,200,29,61,47.5,22,41,53.7,7,20,35.0,16,24,66.7,10,33,43,21,12,16,11,2,81,1
10681,250873,296_11_03,INDONESIA,0,TOTALS,INDONESIA,200,23,65,35.4,15,37,40.5,8,28,28.6,5,6,83.3,10,25,35,10,18,19,10,2,59,0
10682,250886,296_11_04,MALAYSIA,0,TOTALS,MALAYSIA,200,17,63,27.0,14,45,31.1,3,18,16.7,5,6,83.3,12,24,36,10,17,23,5,2,42,0
10683,250899,296_11_04,KOREA,0,TOTALS,KOREA,200,33,73,45.2,20,38,52.6,13,35,37.1,10,19,52.6,16,35,51,27,15,14,16,3,89,1
10684,250907,296_11_05,QATAR,0,TOTALS,QATAR,25,5,15,33.3,3,8,37.5,2,7,28.6,0,4,0.0,3,3,6,0,20,7,0,0,12,0
10685,250920,296_11_05,UZBEKISTAN,0,TOTALS,UZBEKISTAN,25,2,3,66.7,1,1,100.0,1,2,50.0,22,31,71.0,0,8,8,1,2,1,4,0,27,1
10686,250931,296_11_06,PHILIPPINES,0,TOTALS,PHILIPPINES,200,39,67,58.2,36,49,73.5,3,18,16.7,11,19,57.9,8,44,52,19,16,19,6,5,92,1
10687,250944,296_11_06,UNITED ARAB EMIRATES,0,TOTALS,UNITED ARAB EMIRATES,200,21,77,27.3,17,56,30.4,4,21,19.0,6,11,54.5,15,26,41,10,21,14,10,1,52,0
10688,250957,296_11_07,LEBANON,0,TOTALS,LEBANON,200,26,66,39.4,20,40,50.0,6,26,23.1,13,25,52.0,19,27,46,15,17,15,5,3,71,1
10689,250970,296_11_07,INDIA,0,TOTALS,INDIA,200,23,59,39.0,15,38,39.5,8,21,38.1,14,18,77.8,8,21,29,12,22,16,6,3,68,0
10690,250983,296_11_08,BAHRAIN,0,TOTALS,BAHRAIN,200,17,67,25.4,12,43,27.9,5,24,20.8,10,13,76.9,6,19,25,7,20,15,2,2,49,1
10691,250996,296_11_08,CHINA,0,TOTALS,CHINA,200,37,76,48.7,26,47,55.3,11,29,37.9,16,22,72.7,22,42,64,13,15,15,10,3,101,0
10692,251009,296_11_09,INDONESIA,0,TOTALS,INDONESIA,200,22,62,35.5,16,42,38.1,6,20,30.0,11,16,68.8,10,24,34,11,25,12,7,1,61,0
10693,251022,296_11_09,SYRIA,0,TOTALS,SYRIA,200,21,47,44.7,12,27,44.4,9,20,45.0,23,35,65.7,10,29,39,20,12,16,5,0,74,1
10694,251035,296_11_10,UZBEKISTAN,0,TOTALS,UZBEKISTAN,200,27,59,45.8,19,33,57.6,8,26,30.8,9,12,75.0,7,29,36,15,20,23,4,0,71,0
10695,251048,296_11_10,CHINESE TAIPEI,0,TOTALS,CHINESE TAIPEI,200,32,67,47.8,27,48,56.2,5,19,26.3,12,25,48.0,12,25,37,19,9,16,16,0,81,1
10696,251061,296_11_11,JORDAN,0,TOTALS,JORDAN,200,30,67,44.8,23,44,52.3,7,23,30.4,20,30,66.7,17,24,41,15,24,15,8,4,87,0
10697,251074,296_11_11,JAPAN,0,TOTALS,JAPAN,200,31,68,45.6,18,39,46.2,13,29,44.8,17,31,54.8,19,24,43,16,22,15,6,0,92,1
10698,251087,296_11_12,LEBANON,0,TOTALS,LEBANON,200,23,56,41.1,19,36,52.8,4,20,20.0,12,19,63.2,12,20,32,7,16,22,8,3,62,0
10699,251100,296_11_12,KOREA,0,TOTALS,KOREA,200,28,59,47.5,21,44,47.7,7,15,46.7,17,24,70.8,9,24,33,19,18,14,8,2,80,1
10700,251113,296_11_13,INDIA,0,TOTALS,INDIA,200,23,64,35.9,18,48,37.5,5,16,31.2,16,24,66.7,17,29,46,15,18,16,7,6,67,0
10701,251126,296_11_13,MALAYSIA,0,TOTALS,MALAYSIA,200,28,68,41.2,18,42,42.9,10,26,38.5,5,12,41.7,14,27,41,14,23,17,9,4,71,1
10702,251134,296_11_14,QATAR,0,TOTALS,QATAR,34,1,13,7.7,1,4,25.0,0,9,0.0,2,3,66.7,1,7,8,0,21,10,1,0,4,0
10703,251147,296_11_14,IRAN,0,TOTALS,IRAN,38,9,14,64.3,5,5,100.0,4,9,44.4,18,28,64.3,5,11,16,9,2,1,5,0,40,1
10704,251158,296_11_15,PHILIPPINES,0,TOTALS,PHILIPPINES,200,20,58,34.5,16,43,37.2,4,15,26.7,16,26,61.5,10,30,40,14,23,14,4,4,60,0
10705,251171,296_11_15,CHINA,0,TOTALS,CHINA,200,28,72,38.9,24,56,42.9,4,16,25.0,15,25,60.0,15,34,49,22,21,7,10,5,75,1
10706,251184,296_11_16,UNITED ARAB EMIRATES,0,TOTALS,UNITED ARAB EMIRATES,200,31,54,57.4,24,40,60.0,7,14,50.0,22,38,57.9,10,47,57,18,13,26,6,1,91,1
10707,251197,296_11_16,BAHRAIN,0,TOTALS,BAHRAIN,200,21,66,31.8,13,44,29.5,8,22,36.4,3,8,37.5,3,23,26,12,28,21,14,1,53,0
10708,251210,296_11_17,SYRIA,0,TOTALS,SYRIA,200,21,58,36.2,15,32,46.9,6,26,23.1,7,14,50.0,13,18,31,6,19,16,4,4,55,0
10709,251223,296_11_17,JAPAN,0,TOTALS,JAPAN,200,30,59,50.8,27,44,61.4,3,15,20.0,14,20,70.0,12,27,39,18,14,13,4,0,77,1
10710,251236,296_11_18,BAHRAIN,0,TOTALS,BAHRAIN,200,28,64,43.8,20,40,50.0,8,24,33.3,7,19,36.8,4,11,15,13,23,13,10,1,71,1
10711,251247,296_11_18,PHILIPPINES,0,TOTALS,PHILIPPINES,200,41,65,63.1,37,55,67.3,4,10,40.0,27,33,81.8,17,37,54,33,19,18,10,2,113,0
10712,251260,296_11_19,KOREA,0,TOTALS,KOREA,200,30,78,38.5,15,35,42.9,15,43,34.9,9,11,81.8,9,35,44,20,13,6,5,0,84,1
10713,251273,296_11_19,INDIA,0,TOTALS,INDIA,200,24,69,34.8,21,56,37.5,3,13,23.1,2,5,40.0,11,40,51,10,10,18,4,2,53,0
10714,251286,296_11_20,CHINESE TAIPEI,0,TOTALS,CHINESE TAIPEI,200,33,71,46.5,19,35,54.3,14,36,38.9,14,17,82.4,8,30,38,22,15,9,9,0,94,1
10715,251294,296_11_20,QATAR,0,TOTALS,QATAR,200,28,78,35.9,19,54,35.2,9,24,37.5,13,18,72.2,21,34,55,12,13,16,3,1,78,0
10716,251307,296_11_21,IRAN,0,TOTALS,IRAN,200,53,86,61.6,42,59,71.2,11,27,40.7,15,30,50.0,17,50,67,27,11,11,14,6,132,0
10717,251320,296_11_21,UZBEKISTAN,0,TOTALS,UZBEKISTAN,200,14,70,20.0,12,51,23.5,2,19,10.5,8,10,80.0,7,22,29,9,22,21,3,1,38,1
10718,251333,296_11_22,JORDAN,0,TOTALS,JORDAN,200,31,80,38.8,21,50,42.0,10,30,33.3,17,24,70.8,24,39,63,21,15,10,5,1,89,1
10719,251346,296_11_22,INDONESIA,0,TOTALS,INDONESIA,200,22,74,29.7,13,36,36.1,9,38,23.7,6,6,100.0,13,24,37,14,19,12,3,4,59,0
10720,251359,296_11_23,MALAYSIA,0,TOTALS,MALAYSIA,200,21,50,42.0,16,40,40.0,5,10,50.0,12,17,70.6,3,21,24,11,17,20,6,3,59,0
10721,251372,296_11_23,LEBANON,0,TOTALS,LEBANON,200,32,81,39.5,21,46,45.7,11,35,31.4,12,20,60.0,25,24,49,26,13,11,13,3,87,1
10722,251385,296_11_24,CHINA,0,TOTALS,CHINA,200,29,71,40.8,19,45,42.2,10,26,38.5,7,13,53.8,19,29,48,14,20,14,10,1,75,1
10723,251398,296_11_24,UNITED ARAB EMIRATES,0,TOTALS,UNITED ARAB EMIRATES,200,21,55,38.2,16,36,44.4,5,19,26.3,13,20,65.0,8,24,32,7,17,16,7,0,60,0
10724,251411,296_11_25,MALAYSIA,0,TOTALS,MALAYSIA,200,13,52,25.0,11,40,27.5,2,12,16.7,8,14,57.1,3,20,23,6,24,31,6,1,36,1
10725,251424,296_11_25,IRAN,0,TOTALS,IRAN,200,44,80,55.0,34,58,58.6,10,22,45.5,23,31,74.2,19,39,58,35,12,14,17,1,121,0
10726,251437,296_11_26,LEBANON,0,TOTALS,LEBANON,200,21,72,29.2,13,40,32.5,8,32,25.0,8,13,61.5,19,27,46,14,17,17,10,3,58,0
10727,251450,296_11_26,CHINESE TAIPEI,0,TOTALS,CHINESE TAIPEI,200,23,56,41.1,20,50,40.0,3,6,50.0,11,19,57.9,5,25,30,17,12,18,13,2,60,1
10728,251463,296_11_27,KOREA,0,TOTALS,KOREA,200,33,63,52.4,14,26,53.8,19,37,51.4,21,27,77.8,11,28,39,28,11,17,14,5,106,0
10729,251476,296_11_27,UZBEKISTAN,0,TOTALS,UZBEKISTAN,200,21,66,31.8,16,47,34.0,5,19,26.3,10,14,71.4,14,19,33,9,21,22,10,0,57,1
10730,251489,296_11_28,JORDAN,0,TOTALS,JORDAN,200,23,73,31.5,19,47,40.4,4,26,15.4,14,23,60.9,22,31,53,8,23,19,6,3,64,0
10731,251502,296_11_28,PHILIPPINES,0,TOTALS,PHILIPPINES,200,24,67,35.8,16,37,43.2,8,30,26.7,16,19,84.2,12,31,43,15,26,14,5,2,72,1
10732,251515,296_11_29,INDONESIA,0,TOTALS,INDONESIA,200,32,80,40.0,23,41,56.1,9,39,23.1,12,20,60.0,24,32,56,27,21,16,13,3,85,1
10733,251528,296_11_29,BAHRAIN,0,TOTALS,BAHRAIN,200,24,60,40.0,19,42,45.2,5,18,27.8,9,15,60.0,8,27,35,14,20,23,5,1,62,0
10734,251541,296_11_30,JAPAN,0,TOTALS,JAPAN,200,40,71,56.3,29,43,67.4,11,28,39.3,10,13,76.9,7,32,39,25,22,18,17,2,101,0
10735,251554,296_11_30,UNITED ARAB EMIRATES,0,TOTALS,UNITED ARAB EMIRATES,200,21,59,35.6,18,45,40.0,3,14,21.4,16,24,66.7,10,25,35,8,20,25,10,1,61,1
10736,251567,296_11_31,SYRIA,0,TOTALS,SYRIA,200,22,61,36.1,13,39,33.3,9,22,40.9,18,26,69.2,11,20,31,8,19,14,6,1,71,0
10737,251580,296_11_31,CHINA,0,TOTALS,CHINA,200,33,58,56.9,26,45,57.8,7,13,53.8,17,23,73.9,6,31,37,18,20,12,9,2,90,1
10738,251593,296_11_32,UZBEKISTAN,0,TOTALS,UZBEKISTAN,200,28,72,38.9,17,40,42.5,11,32,34.4,8,14,57.1,18,25,43,17,21,21,10,0,75,0
10739,251606,296_11_32,MALAYSIA,0,TOTALS,MALAYSIA,200,26,52,50.0,20,33,60.6,6,19,31.6,22,30,73.3,4,30,34,20,15,16,9,0,80,1
10740,251619,296_11_33,UNITED ARAB EMIRATES,0,TOTALS,UNITED ARAB EMIRATES,200,26,67,38.8,16,42,38.1,10,25,40.0,11,17,64.7,9,21,30,7,27,7,6,0,73,0
10741,251632,296_11_33,SYRIA,0,TOTALS,SYRIA,200,24,64,37.5,16,35,45.7,8,29,27.6,24,37,64.9,26,34,60,12,15,19,2,1,80,1
10742,251645,296_11_34,IRAN,0,TOTALS,IRAN,200,31,61,50.8,28,50,56.0,3,11,27.3,11,22,50.0,9,35,44,17,17,16,9,7,76,1
10743,251658,296_11_34,LEBANON,0,TOTALS,LEBANON,200,17,64,26.6,13,48,27.1,4,16,25.0,7,10,70.0,10,23,33,9,20,19,12,1,45,0
10744,251671,296_11_35,CHINESE TAIPEI,0,TOTALS,CHINESE TAIPEI,200,26,74,35.1,25,58,43.1,1,16,6.2,8,12,66.7,16,24,40,11,18,9,4,1,61,0
10745,251684,296_11_35,KOREA,0,TOTALS,KOREA,200,31,66,47.0,26,42,61.9,5,24,20.8,15,22,68.2,14,33,47,19,17,9,7,5,82,1
10746,251697,296_11_36,INDONESIA,0,TOTALS,INDONESIA,200,28,68,41.2,20,38,52.6,8,30,26.7,20,28,71.4,15,29,44,15,24,15,3,2,84,1
10747,251710,296_11_36,INDIA,0,TOTALS,INDIA,200,25,62,40.3,18,43,41.9,7,19,36.8,18,32,56.2,12,28,40,16,22,14,5,0,75,0
10748,251723,296_11_37,PHILIPPINES,0,TOTALS,PHILIPPINES,200,33,65,50.8,28,50,56.0,5,15,33.3,12,17,70.6,14,30,44,15,20,13,4,3,83,1
10749,251736,296_11_37,JAPAN,0,TOTALS,JAPAN,200,24,62,38.7,12,29,41.4,12,33,36.4,16,28,57.1,11,20,31,14,19,11,5,2,76,0
10750,251749,296_11_38,CHINA,0,TOTALS,CHINA,200,34,65,52.3,23,43,53.5,11,22,50.0,14,21,66.7,14,34,48,13,25,16,8,10,93,1
10751,251762,296_11_38,JORDAN,0,TOTALS,JORDAN,200,18,66,27.3,13,43,30.2,5,23,21.7,19,31,61.3,19,22,41,10,19,15,6,6,60,0
10752,251775,296_11_39,LEBANON,0,TOTALS,LEBANON,200,37,75,49.3,22,46,47.8,15,29,51.7,12,16,75.0,19,41,60,21,9,18,8,5,101,0
10753,251788,296_11_39,UZBEKISTAN,0,TOTALS,UZBEKISTAN,200,20,68,29.4,14,50,28.0,6,18,33.3,7,13,53.8,9,20,29,9,18,15,6,0,53,1
10754,251801,296_11_40,MALAYSIA,0,TOTALS,MALAYSIA,200,23,74,31.1,15,45,33.3,8,29,27.6,8,10,80.0,15,33,48,13,13,22,3,2,62,1
10755,251814,296_11_40,CHINESE TAIPEI,0,TOTALS,CHINESE TAIPEI,200,43,86,50.0,27,48,56.2,16,38,42.1,7,13,53.8,13,37,50,28,14,9,12,2,109,0
10756,251827,296_11_41,JORDAN,0,TOTALS,JORDAN,200,37,66,56.1,31,45,68.9,6,21,28.6,14,21,66.7,8,32,40,26,11,21,14,5,94,1
10757,251840,296_11_41,UNITED ARAB EMIRATES,0,TOTALS,UNITED ARAB EMIRATES,200,28,69,40.6,16,44,36.4,12,25,48.0,12,13,92.3,8,22,30,12,21,22,11,0,80,0
10758,251853,296_11_42,KOREA,0,TOTALS,KOREA,200,21,51,41.2,17,36,47.2,4,15,26.7,16,22,72.7,4,21,25,13,19,17,9,1,62,0
10759,251866,296_11_42,IRAN,0,TOTALS,IRAN,200,30,61,49.2,23,45,51.1,7,16,43.8,12,20,60.0,12,28,40,17,18,17,9,5,79,1
10760,251879,296_11_43,SYRIA,0,TOTALS,SYRIA,200,19,60,31.7,15,39,38.5,4,21,19.0,10,16,62.5,10,28,38,9,20,16,3,4,52,0
10761,251892,296_11_43,PHILIPPINES,0,TOTALS,PHILIPPINES,200,30,72,41.7,24,50,48.0,6,22,27.3,9,17,52.9,16,32,48,18,15,8,6,3,75,1
10762,251905,296_11_44,JAPAN,0,TOTALS,JAPAN,200,20,59,33.9,14,39,35.9,6,20,30.0,12,18,66.7,8,23,31,11,16,14,8,3,58,0
10763,251918,296_11_44,CHINA,0,TOTALS,CHINA,200,33,71,46.5,25,44,56.8,8,27,29.6,10,14,71.4,16,34,50,17,16,16,9,4,84,1
10764,251931,296_11_45,MALAYSIA,0,TOTALS,MALAYSIA,200,34,74,45.9,28,55,50.9,6,19,31.6,13,16,81.2,13,35,48,15,23,19,10,2,87,0
10765,251944,296_11_45,UNITED ARAB EMIRATES,0,TOTALS,UNITED ARAB EMIRATES,200,31,76,40.8,22,51,43.1,9,25,36.0,18,30,60.0,16,28,44,18,20,12,11,1,89,1
10766,251957,296_11_46,UZBEKISTAN,0,TOTALS,UZBEKISTAN,200,25,71,35.2,19,54,35.2,6,17,35.3,9,16,56.2,9,24,33,13,25,7,6,0,65,0
10767,251970,296_11_46,SYRIA,0,TOTALS,SYRIA,200,34,64,53.1,25,43,58.1,9,21,42.9,20,32,62.5,11,40,51,21,16,14,5,4,97,1
10768,251983,296_11_47,JORDAN,0,TOTALS,JORDAN,200,31,66,47.0,21,43,48.8,10,23,43.5,16,20,80.0,5,24,29,18,26,11,8,3,88,1
10769,251996,296_11_47,IRAN,0,TOTALS,IRAN,200,28,68,41.2,20,42,47.6,8,26,30.8,20,33,60.6,21,31,52,22,19,17,6,5,84,0
10770,252009,296_11_48,KOREA,0,TOTALS,KOREA,200,34,73,46.6,23,44,52.3,11,29,37.9,7,17,41.2,20,27,47,24,19,9,2,5,86,1
10771,252022,296_11_48,JAPAN,0,TOTALS,JAPAN,200,25,63,39.7,18,43,41.9,7,20,35.0,10,18,55.6,13,22,35,13,18,13,5,2,67,0
10772,252035,296_11_49,PHILIPPINES,0,TOTALS,PHILIPPINES,200,36,69,52.2,29,51,56.9,7,18,38.9,16,23,69.6,14,24,38,16,22,9,4,2,95,1
10773,252048,296_11_49,CHINESE TAIPEI,0,TOTALS,CHINESE TAIPEI,200,29,66,43.9,19,33,57.6,10,33,30.3,10,17,58.8,14,24,38,16,16,13,5,0,78,0
10774,252061,296_11_50,LEBANON,0,TOTALS,LEBANON,200,17,61,27.9,15,40,37.5,2,21,9.5,12,19,63.2,14,20,34,7,16,16,4,1,48,0
10775,252074,296_11_50,CHINA,0,TOTALS,CHINA,200,24,52,46.2,20,40,50.0,4,12,33.3,16,23,69.6,9,30,39,8,16,16,8,2,68,1
10776,252087,296_11_51,MALAYSIA,0,TOTALS,MALAYSIA,200,31,72,43.1,20,46,43.5,11,26,42.3,9,17,52.9,12,36,48,21,16,15,7,2,82,1
10777,252100,296_11_51,UZBEKISTAN,0,TOTALS,UZBEKISTAN,200,27,80,33.8,17,45,37.8,10,35,28.6,12,20,60.0,20,34,54,13,18,15,9,5,76,0
10778,252113,296_11_52,UNITED ARAB EMIRATES,0,TOTALS,UNITED ARAB EMIRATES,200,26,65,40.0,19,44,43.2,7,21,33.3,13,25,52.0,11,31,42,11,18,12,7,3,72,0
10779,252126,296_11_52,SYRIA,0,TOTALS,SYRIA,200,29,63,46.0,22,40,55.0,7,23,30.4,11,20,55.0,9,30,39,18,18,11,5,3,76,1
10780,252139,296_11_53,IRAN,0,TOTALS,IRAN,200,37,70,52.9,28,47,59.6,9,23,39.1,15,27,55.6,22,32,54,21,21,12,2,5,98,1
10781,252152,296_11_53,CHINESE TAIPEI,0,TOTALS,CHINESE TAIPEI,200,21,59,35.6,13,36,36.1,8,23,34.8,16,20,80.0,7,17,24,15,21,12,2,2,66,0
10782,252165,296_11_54,JORDAN,0,TOTALS,JORDAN,200,22,51,43.1,17,35,48.6,5,16,31.2,26,37,70.3,13,31,44,11,17,17,8,2,75,1
10783,252178,296_11_54,PHILIPPINES,0,TOTALS,PHILIPPINES,200,22,70,31.4,19,47,40.4,3,23,13.0,14,18,77.8,17,25,42,10,29,16,4,2,61,0
10784,252191,296_11_55,JAPAN,0,TOTALS,JAPAN,200,30,62,48.4,23,43,53.5,7,19,36.8,11,15,73.3,9,32,41,20,17,15,1,0,78,0
10785,252204,296_11_55,LEBANON,0,TOTALS,LEBANON,200,30,70,42.9,21,38,55.3,9,32,28.1,11,16,68.8,8,24,32,10,18,7,6,0,80,1
10786,252217,296_11_56,KOREA,0,TOTALS,KOREA,200,16,60,26.7,15,40,37.5,1,20,5.0,10,15,66.7,8,35,43,6,21,14,4,4,43,0
10787,252230,296_11_56,CHINA,0,TOTALS,CHINA,200,16,58,27.6,13,43,30.2,3,15,20.0,21,25,84.0,9,36,45,10,19,10,8,2,56,1
10788,252243,296_11_57,CHINESE TAIPEI,0,TOTALS,CHINESE TAIPEI,200,26,66,39.4,23,47,48.9,3,19,15.8,17,28,60.7,11,26,37,10,14,8,9,3,72,0
10789,252256,296_11_57,JAPAN,0,TOTALS,JAPAN,200,29,68,42.6,18,45,40.0,11,23,47.8,12,14,85.7,14,34,48,14,20,16,4,1,81,1
10790,252269,296_11_58,PHILIPPINES,0,TOTALS,PHILIPPINES,200,22,65,33.8,15,45,33.3,7,20,35.0,17,29,58.6,14,37,51,10,22,13,2,4,68,0
10791,252282,296_11_58,KOREA,0,TOTALS,KOREA,200,26,75,34.7,19,51,37.3,7,24,29.2,11,18,61.1,14,33,47,14,24,9,10,6,70,1
10792,252295,296_11_59,IRAN,0,TOTALS,IRAN,200,32,65,49.2,27,51,52.9,5,14,35.7,18,22,81.8,9,32,41,17,18,15,11,2,87,1
10793,252308,296_11_59,LEBANON,0,TOTALS,LEBANON,200,24,66,36.4,22,42,52.4,2,24,8.3,15,24,62.5,12,24,36,11,17,14,7,2,65,0
10794,252321,296_11_60,JORDAN,0,TOTALS,JORDAN,200,27,76,35.5,21,58,36.2,6,18,33.3,9,13,69.2,18,26,44,12,22,9,8,3,69,0
10795,252334,296_11_60,CHINA,0,TOTALS,CHINA,200,24,67,35.8,19,47,40.4,5,20,25.0,17,22,77.3,19,30,49,9,15,15,4,11,70,1
10796,252347,300_11_01,DOMINICAN REPUBLIC,0,TOTALS,DOMINICAN REPUBLIC,200,37,76,48.7,30,57,52.6,7,19,36.8,9,17,52.9,13,34,47,14,15,10,6,0,90,1
10797,252360,300_11_01,CUBA,0,TOTALS,CUBA,200,21,57,36.8,16,39,41.0,5,18,27.8,13,19,68.4,4,30,34,7,19,18,6,1,60,0
10798,252373,300_11_02,BRAZIL,0,TOTALS,BRAZIL,200,35,63,55.6,26,41,63.4,9,22,40.9,13,21,61.9,8,32,40,22,21,8,5,4,92,1
10799,252386,300_11_02,VENEZUELA,0,TOTALS,VENEZUELA,200,31,66,47.0,23,46,50.0,8,20,40.0,13,19,68.4,7,24,31,17,17,7,4,0,83,0
10800,252399,300_11_03,PARAGUAY,0,TOTALS,PARAGUAY,200,19,63,30.2,17,45,37.8,2,18,11.1,12,15,80.0,9,23,32,11,16,15,5,4,52,0
10801,252412,300_11_03,ARGENTINA,0,TOTALS,ARGENTINA,200,31,60,51.7,26,49,53.1,5,11,45.5,17,21,81.0,8,36,44,18,14,10,7,5,84,1
10802,252425,300_11_04,PANAMA,0,TOTALS,PANAMA,200,23,65,35.4,21,54,38.9,2,11,18.2,18,27,66.7,13,18,31,6,15,17,10,1,66,0
10803,252438,300_11_04,PUERTO RICO,0,TOTALS,PUERTO RICO,200,37,66,56.1,27,48,56.2,10,18,55.6,15,15,100.0,9,30,39,25,21,18,9,4,99,1
10804,252451,300_11_05,VENEZUELA,0,TOTALS,VENEZUELA,200,30,70,42.9,21,46,45.7,9,24,37.5,20,25,80.0,14,25,39,18,17,11,1,4,89,0
10805,252464,300_11_05,DOMINICAN REPUBLIC,0,TOTALS,DOMINICAN REPUBLIC,200,34,71,47.9,28,49,57.1,6,22,27.3,18,22,81.8,13,23,36,14,18,4,6,1,92,1
10806,252477,300_11_06,PUERTO RICO,0,TOTALS,PUERTO RICO,200,41,81,50.6,36,61,59.0,5,20,25.0,14,19,73.7,23,25,48,23,24,7,11,6,101,0
10807,252490,300_11_06,PARAGUAY,0,TOTALS,PARAGUAY,200,15,43,34.9,9,28,32.1,6,15,40.0,19,29,65.5,6,18,24,5,17,23,3,0,55,1
10808,252503,300_11_07,ARGENTINA,0,TOTALS,ARGENTINA,200,35,63,55.6,27,44,61.4,8,19,42.1,8,10,80.0,6,29,35,22,17,19,11,2,86,1
10809,252516,300_11_07,URUGUAY,0,TOTALS,URUGUAY,200,19,52,36.5,13,38,34.2,6,14,42.9,7,16,43.8,7,22,29,7,15,27,14,1,51,0
10810,252529,300_11_08,CANADA,0,TOTALS,CANADA,200,21,64,32.8,15,49,30.6,6,15,40.0,9,13,69.2,7,30,37,7,16,11,7,2,57,0
10811,252542,300_11_08,BRAZIL,0,TOTALS,BRAZIL,200,26,58,44.8,19,37,51.4,7,21,33.3,10,17,58.8,3,37,40,14,20,13,5,2,69,1
10812,252555,300_11_09,PARAGUAY,0,TOTALS,PARAGUAY,200,30,62,48.4,21,41,51.2,9,21,42.9,17,21,81.0,9,20,29,19,23,13,5,5,86,0
10813,252568,300_11_09,PANAMA,0,TOTALS,PANAMA,200,34,74,45.9,31,60,51.7,3,14,21.4,18,26,69.2,22,22,44,10,17,12,8,0,89,1
10814,252581,300_11_10,CUBA,0,TOTALS,CUBA,200,26,83,31.3,17,61,27.9,9,22,40.9,8,16,50.0,23,19,42,9,24,13,11,2,69,1
10815,252594,300_11_10,VENEZUELA,0,TOTALS,VENEZUELA,200,36,59,61.0,28,44,63.6,8,15,53.3,26,38,68.4,10,38,48,13,15,19,7,4,106,0
10816,252607,300_11_11,DOMINICAN REPUBLIC,0,TOTALS,DOMINICAN REPUBLIC,200,23,68,33.8,17,46,37.0,6,22,27.3,20,30,66.7,18,27,45,11,23,15,7,5,72,0
10817,252620,300_11_11,CANADA,0,TOTALS,CANADA,200,24,57,42.1,14,34,41.2,10,23,43.5,15,21,71.4,7,31,38,11,25,13,7,4,73,1
10818,252633,300_11_12,URUGUAY,0,TOTALS,URUGUAY,200,22,56,39.3,16,37,43.2,6,19,31.6,14,18,77.8,5,26,31,9,25,15,4,1,64,0
10819,252646,300_11_12,PUERTO RICO,0,TOTALS,PUERTO RICO,200,24,64,37.5,20,48,41.7,4,16,25.0,22,33,66.7,17,29,46,14,21,11,3,1,74,1
10820,252659,300_11_13,CANADA,0,TOTALS,CANADA,200,28,51,54.9,24,36,66.7,4,15,26.7,24,35,68.6,8,31,39,15,28,17,5,4,84,1
10821,252672,300_11_13,CUBA,0,TOTALS,CUBA,200,20,58,34.5,19,44,43.2,1,14,7.1,21,30,70.0,9,21,30,7,29,11,5,1,62,0
10822,252685,300_11_14,PANAMA,0,TOTALS,PANAMA,200,23,61,37.7,18,44,40.9,5,17,29.4,10,13,76.9,15,19,34,8,15,19,9,2,61,0
10823,252698,300_11_14,URUGUAY,0,TOTALS,URUGUAY,200,31,66,47.0,27,48,56.2,4,18,22.2,11,11,100.0,16,23,39,15,17,14,11,3,77,1
10824,252711,300_11_15,BRAZIL,0,TOTALS,BRAZIL,200,30,63,47.6,25,41,61.0,5,22,22.7,9,16,56.2,11,25,36,13,16,15,8,2,74,0
10825,252724,300_11_15,DOMINICAN REPUBLIC,0,TOTALS,DOMINICAN REPUBLIC,200,31,65,47.7,23,52,44.2,8,13,61.5,9,12,75.0,11,24,35,14,18,15,8,4,79,1
10826,252737,300_11_16,PUERTO RICO,0,TOTALS,PUERTO RICO,200,28,65,43.1,23,49,46.9,5,16,31.2,13,16,81.2,9,31,40,9,21,20,4,3,74,0
10827,252750,300_11_16,ARGENTINA,0,TOTALS,ARGENTINA,200,29,67,43.3,23,47,48.9,6,20,30.0,17,25,68.0,8,28,36,14,19,10,11,4,81,1
10828,252763,300_11_17,VENEZUELA,0,TOTALS,VENEZUELA,225,35,74,47.3,28,54,51.9,7,20,35.0,26,31,83.9,15,30,45,18,23,14,6,2,103,0
10829,252776,300_11_17,CANADA,0,TOTALS,CANADA,225,32,72,44.4,22,45,48.9,10,27,37.0,24,29,82.8,12,25,37,9,25,11,6,4,98,1
10830,252789,300_11_18,URUGUAY,0,TOTALS,URUGUAY,200,26,55,47.3,15,36,41.7,11,19,57.9,16,21,76.2,9,32,41,13,20,15,6,2,79,1
10831,252802,300_11_18,PARAGUAY,0,TOTALS,PARAGUAY,200,23,61,37.7,18,39,46.2,5,22,22.7,15,20,75.0,10,26,36,8,23,10,4,5,66,0
10832,252815,300_11_19,CUBA,0,TOTALS,CUBA,200,23,54,42.6,22,42,52.4,1,12,8.3,36,42,85.7,6,22,28,9,17,14,10,1,83,0
10833,252828,300_11_19,BRAZIL,0,TOTALS,BRAZIL,200,37,67,55.2,30,48,62.5,7,19,36.8,12,15,80.0,10,30,40,21,30,19,5,2,93,1
10834,252841,300_11_20,ARGENTINA,0,TOTALS,ARGENTINA,200,34,80,42.5,22,47,46.8,12,33,36.4,10,12,83.3,14,31,45,24,18,7,9,3,90,1
10835,252854,300_11_20,PANAMA,0,TOTALS,PANAMA,200,27,69,39.1,25,60,41.7,2,9,22.2,15,19,78.9,14,32,46,5,13,16,4,1,71,0
10836,252867,300_11_21,DOMINICAN REPUBLIC,0,TOTALS,DOMINICAN REPUBLIC,200,37,75,49.3,25,45,55.6,12,30,40.0,6,8,75.0,10,30,40,24,16,8,6,3,92,1
10837,252880,300_11_21,PANAMA,0,TOTALS,PANAMA,200,25,67,37.3,19,49,38.8,6,18,33.3,12,19,63.2,13,29,42,7,12,13,6,0,68,0
10838,252893,300_11_22,VENEZUELA,0,TOTALS,VENEZUELA,200,25,62,40.3,18,46,39.1,7,16,43.8,25,29,86.2,11,23,34,12,22,16,7,2,82,0
10839,252906,300_11_22,PUERTO RICO,0,TOTALS,PUERTO RICO,200,35,68,51.5,26,43,60.5,9,25,36.0,15,20,75.0,9,27,36,17,24,14,9,2,94,1
10840,252919,300_11_23,CANADA,0,TOTALS,CANADA,200,17,61,27.9,12,42,28.6,5,19,26.3,14,18,77.8,11,32,43,4,20,22,5,3,53,0
10841,252932,300_11_23,ARGENTINA,0,TOTALS,ARGENTINA,200,27,63,42.9,21,47,44.7,6,16,37.5,19,24,79.2,7,33,40,17,16,12,13,2,79,1
10842,252945,300_11_24,BRAZIL,0,TOTALS,BRAZIL,200,34,59,57.6,24,41,58.5,10,18,55.6,15,18,83.3,7,27,34,21,17,13,9,5,93,1
10843,252958,300_11_24,URUGUAY,0,TOTALS,URUGUAY,200,25,63,39.7,18,41,43.9,7,22,31.8,9,13,69.2,12,21,33,13,18,16,6,1,66,0
10844,252971,300_11_25,PUERTO RICO,0,TOTALS,PUERTO RICO,200,26,57,45.6,18,37,48.6,8,20,40.0,19,23,82.6,6,23,29,13,16,10,9,0,79,1
10845,252984,300_11_25,CANADA,0,TOTALS,CANADA,200,28,60,46.7,20,41,48.8,8,19,42.1,10,10,100.0,9,26,35,12,24,12,4,1,74,0
10846,252997,300_11_26,URUGUAY,0,TOTALS,URUGUAY,200,29,68,42.6,25,45,55.6,4,23,17.4,14,20,70.0,9,22,31,14,23,13,16,1,76,0
10847,253010,300_11_26,DOMINICAN REPUBLIC,0,TOTALS,DOMINICAN REPUBLIC,200,28,59,47.5,20,34,58.8,8,25,32.0,20,28,71.4,13,32,45,14,17,20,7,4,84,1
10848,253023,300_11_27,ARGENTINA,0,TOTALS,ARGENTINA,200,41,65,63.1,23,37,62.2,18,28,64.3,11,13,84.6,8,20,28,22,15,16,10,1,111,0
10849,253036,300_11_27,VENEZUELA,0,TOTALS,VENEZUELA,200,36,66,54.5,32,51,62.7,4,15,26.7,17,20,85.0,11,18,29,21,14,16,10,1,93,1
10850,253049,300_11_28,PANAMA,0,TOTALS,PANAMA,200,17,56,30.4,12,46,26.1,5,10,50.0,26,30,86.7,11,26,37,3,10,16,3,3,65,0
10851,253062,300_11_28,BRAZIL,0,TOTALS,BRAZIL,200,37,66,56.1,26,42,61.9,11,24,45.8,5,9,55.6,4,30,34,25,23,9,7,4,90,1
10852,253075,300_11_29,CANADA,0,TOTALS,CANADA,200,24,52,46.2,15,34,44.1,9,18,50.0,13,18,72.2,6,32,38,13,17,18,4,7,70,1
10853,253088,300_11_29,URUGUAY,0,TOTALS,URUGUAY,200,21,65,32.3,14,42,33.3,7,23,30.4,19,23,82.6,15,23,38,7,19,11,10,2,68,0
10854,253101,300_11_30,VENEZUELA,0,TOTALS,VENEZUELA,200,43,78,55.1,27,46,58.7,16,32,50.0,8,10,80.0,16,18,34,32,11,8,9,3,110,0
10855,253114,300_11_30,PANAMA,0,TOTALS,PANAMA,200,29,56,51.8,20,36,55.6,9,20,45.0,7,12,58.3,11,20,31,6,13,22,4,6,74,1
10856,253127,300_11_31,BRAZIL,0,TOTALS,BRAZIL,200,28,64,43.8,21,39,53.8,7,25,28.0,10,12,83.3,8,28,36,8,18,13,5,2,73,1
10857,253140,300_11_31,ARGENTINA,0,TOTALS,ARGENTINA,200,29,66,43.9,24,50,48.0,5,16,31.2,8,13,61.5,13,28,41,12,17,15,7,3,71,0
10858,253153,300_11_32,DOMINICAN REPUBLIC,0,TOTALS,DOMINICAN REPUBLIC,200,23,64,35.9,19,44,43.2,4,20,20.0,12,20,60.0,12,25,37,8,16,17,4,3,62,0
10859,253166,300_11_32,PUERTO RICO,0,TOTALS,PUERTO RICO,200,30,67,44.8,23,44,52.3,7,23,30.4,12,13,92.3,11,31,42,15,19,15,7,1,79,1
10860,253179,300_11_33,PANAMA,0,TOTALS,PANAMA,200,32,59,54.2,25,44,56.8,7,15,46.7,20,25,80.0,11,30,41,9,16,15,4,1,91,1
10861,253192,300_11_33,CANADA,0,TOTALS,CANADA,200,29,67,43.3,20,40,50.0,9,27,33.3,22,25,88.0,10,18,28,8,18,7,8,1,89,0
10862,253205,300_11_34,URUGUAY,0,TOTALS,URUGUAY,200,29,63,46.0,19,35,54.3,10,28,35.7,12,21,57.1,15,16,31,15,19,11,4,1,80,0
10863,253218,300_11_34,VENEZUELA,0,TOTALS,VENEZUELA,200,38,58,65.5,29,36,80.6,9,22,40.9,7,11,63.6,4,21,25,10,21,11,6,0,92,1
10864,253231,300_11_35,ARGENTINA,0,TOTALS,ARGENTINA,200,32,63,50.8,25,49,51.0,7,14,50.0,13,16,81.2,11,28,39,17,13,10,11,4,84,1
10865,253244,300_11_35,DOMINICAN REPUBLIC,0,TOTALS,DOMINICAN REPUBLIC,200,24,65,36.9,21,51,41.2,3,14,21.4,7,9,77.8,14,23,37,8,14,15,4,7,58,0
10866,253257,300_11_36,PUERTO RICO,0,TOTALS,PUERTO RICO,200,27,66,40.9,22,50,44.0,5,16,31.2,13,15,86.7,8,18,26,10,15,8,11,2,72,0
10867,253270,300_11_36,BRAZIL,0,TOTALS,BRAZIL,200,34,59,57.6,19,34,55.9,15,25,60.0,11,14,78.6,8,32,40,22,19,15,5,1,94,1
10868,253283,300_11_37,BRAZIL,0,TOTALS,BRAZIL,200,29,66,43.9,19,41,46.3,10,25,40.0,15,20,75.0,11,25,36,13,23,6,1,1,83,1
10869,253296,300_11_37,DOMINICAN REPUBLIC,0,TOTALS,DOMINICAN REPUBLIC,200,26,62,41.9,21,50,42.0,5,12,41.7,19,23,82.6,12,28,40,4,17,7,2,4,76,0
10870,253309,300_11_38,ARGENTINA,0,TOTALS,ARGENTINA,200,30,57,52.6,17,29,58.6,13,28,46.4,8,11,72.7,6,22,28,20,21,15,4,5,81,1
10871,253322,300_11_38,PUERTO RICO,0,TOTALS,PUERTO RICO,200,28,65,43.1,20,49,40.8,8,16,50.0,15,22,68.2,16,22,38,7,22,14,6,2,79,0
10872,253335,300_11_39,DOMINICAN REPUBLIC,0,TOTALS,DOMINICAN REPUBLIC,200,37,54,68.5,26,36,72.2,11,18,61.1,18,25,72.0,6,28,34,23,19,16,3,7,103,0
10873,253348,300_11_39,PUERTO RICO,0,TOTALS,PUERTO RICO,200,32,76,42.1,24,54,44.4,8,22,36.4,17,19,89.5,18,14,32,15,20,9,8,1,89,1
10874,253361,300_11_40,BRAZIL,0,TOTALS,BRAZIL,200,27,56,48.2,19,41,46.3,8,15,53.3,13,21,61.9,3,29,32,13,24,14,2,0,75,0
10875,253374,300_11_40,ARGENTINA,0,TOTALS,ARGENTINA,200,25,58,43.1,19,43,44.2,6,15,40.0,24,30,80.0,6,30,36,15,24,15,8,4,80,1
10876,254007,302_11_01,PUERTO RICO,0,TOTALS,PUERTO RICO,200,34,62,54.8,27,44,61.4,7,18,38.9,24,26,92.3,6,25,31,22,29,7,3,1,99,1
10877,254020,302_11_01,DOMINICAN REPUBLIC,0,TOTALS,DOMINICAN REPUBLIC,200,24,61,39.3,21,46,45.7,3,15,20.0,26,37,70.3,17,23,40,14,23,13,3,4,77,0
10878,254033,302_11_02,PUERTO RICO,0,TOTALS,PUERTO RICO,200,26,56,46.4,18,36,50.0,8,20,40.0,14,17,82.4,8,29,37,15,17,20,6,5,74,1
10879,254046,302_11_02,CANADA,0,TOTALS,CANADA,200,23,60,38.3,14,39,35.9,9,21,42.9,8,10,80.0,9,21,30,19,23,16,6,2,63,0
10880,254059,302_11_03,DOMINICAN REPUBLIC,0,TOTALS,DOMINICAN REPUBLIC,200,23,55,41.8,19,42,45.2,4,13,30.8,14,23,60.9,10,38,48,10,23,14,4,6,64,0
10881,254072,302_11_03,BRAZIL,0,TOTALS,BRAZIL,200,25,58,43.1,18,38,47.4,7,20,35.0,13,28,46.4,2,26,28,12,21,6,5,1,70,1
10882,254085,302_11_04,CANADA,0,TOTALS,CANADA,200,24,64,37.5,16,41,39.0,8,23,34.8,6,8,75.0,8,24,32,14,20,12,11,3,62,0
10883,254098,302_11_04,DOMINICAN REPUBLIC,0,TOTALS,DOMINICAN REPUBLIC,200,24,55,43.6,21,41,51.2,3,14,21.4,13,20,65.0,11,33,44,11,13,16,2,4,64,1
10884,254111,302_11_05,BRAZIL,0,TOTALS,BRAZIL,200,30,57,52.6,20,36,55.6,10,21,47.6,19,23,82.6,7,36,43,20,26,17,3,3,89,1
10885,254124,302_11_05,PUERTO RICO,0,TOTALS,PUERTO RICO,200,27,73,37.0,23,60,38.3,4,13,30.8,21,29,72.4,14,23,37,16,22,7,11,4,79,0
10886,254134,303_11_01,BERMUDA,0,TOTALS,BERMUDA,200,26,63,41.3,22,49,44.9,4,14,28.6,19,32,59.4,12,23,35,14,13,11,14,2,75,1
10887,254144,303_11_01,ST.VINCENT AND THE GRENADINES,0,TOTALS,ST.VINCENT AND THE GRENADINES,200,24,59,40.7,22,44,50.0,2,15,13.3,6,10,60.0,10,26,36,12,25,23,5,1,56,0
10888,254153,303_11_02,JAMAICA,0,TOTALS,JAMAICA,200,33,76,43.4,28,54,51.9,5,22,22.7,21,29,72.4,15,32,47,14,18,16,8,7,92,1
10889,254165,303_11_02,ANTIGUA,0,TOTALS,ANTIGUA,200,32,70,45.7,28,57,49.1,4,13,30.8,10,20,50.0,8,24,32,15,25,17,7,4,78,0
10890,254178,303_11_03,BAHAMAS,0,TOTALS,BAHAMAS,200,38,71,53.5,30,52,57.7,8,19,42.1,10,18,55.6,17,34,51,16,11,23,15,5,94,1
10891,254191,303_11_03,CAYMAN ISLANDS,0,TOTALS,CAYMAN ISLANDS,200,18,70,25.7,16,46,34.8,2,24,8.3,3,10,30.0,13,12,25,7,17,22,17,2,41,0
10892,254203,303_11_04,CAYMAN ISLANDS,0,TOTALS,CAYMAN ISLANDS,200,19,68,27.9,13,43,30.2,6,25,24.0,10,13,76.9,13,21,34,6,20,20,13,2,54,0
10893,254214,303_11_04,BRITISH VIRGIN ISLANDS,0,TOTALS,BRITISH VIRGIN ISLANDS,200,26,51,51.0,23,38,60.5,3,13,23.1,11,24,45.8,6,31,37,14,13,24,10,7,66,1
10894,254225,303_11_05,ANTIGUA,0,TOTALS,ANTIGUA,200,28,71,39.4,23,60,38.3,5,11,45.5,12,22,54.5,12,28,40,9,26,17,10,2,73,0
10895,254235,303_11_05,VIRGIN ISLANDS,0,TOTALS,VIRGIN ISLANDS,200,30,69,43.5,27,53,50.9,3,16,18.8,21,31,67.7,14,29,43,17,20,12,8,7,84,1
10896,254247,303_11_06,BERMUDA,0,TOTALS,BERMUDA,200,13,51,25.5,11,30,36.7,2,21,9.5,13,25,52.0,9,18,27,7,23,28,11,4,41,0
10897,254260,303_11_06,BAHAMAS,0,TOTALS,BAHAMAS,200,30,60,50.0,26,46,56.5,4,14,28.6,11,24,45.8,14,28,42,17,22,24,14,4,75,1
10898,254271,303_11_07,BRITISH VIRGIN ISLANDS,0,TOTALS,BRITISH VIRGIN ISLANDS,200,25,56,44.6,22,48,45.8,3,8,37.5,13,22,59.1,7,16,23,17,16,18,8,11,66,1
10899,254280,303_11_07,BERMUDA,0,TOTALS,BERMUDA,200,26,75,34.7,17,55,30.9,9,20,45.0,2,7,28.6,20,16,36,16,17,18,6,5,63,0
10900,254292,303_11_08,GUYANA,0,TOTALS,GUYANA,200,14,50,28.0,9,39,23.1,5,11,45.5,10,21,47.6,9,17,26,6,13,17,11,2,43,0
10901,254305,303_11_08,JAMAICA,0,TOTALS,JAMAICA,200,33,74,44.6,29,51,56.9,4,23,17.4,5,9,55.6,15,30,45,19,17,20,15,5,75,1
10902,254316,303_11_09,BAHAMAS,0,TOTALS,BAHAMAS,200,42,79,53.2,35,60,58.3,7,19,36.8,15,26,57.7,19,22,41,24,19,4,11,3,106,0
10903,254327,303_11_09,ST.VINCENT AND THE GRENADINES,0,TOTALS,ST.VINCENT AND THE GRENADINES,200,19,54,35.2,13,40,32.5,6,14,42.9,14,22,63.6,14,21,35,7,19,19,4,0,58,1
10904,254338,303_11_10,VIRGIN ISLANDS,0,TOTALS,VIRGIN ISLANDS,200,42,76,55.3,37,63,58.7,5,13,38.5,22,30,73.3,16,40,56,21,18,14,11,10,111,0
10905,254349,303_11_10,GUYANA,0,TOTALS,GUYANA,200,19,73,26.0,12,50,24.0,7,23,30.4,6,16,37.5,12,18,30,6,20,14,8,3,51,1
10906,254358,303_11_11,ST.VINCENT AND THE GRENADINES,0,TOTALS,ST.VINCENT AND THE GRENADINES,200,29,57,50.9,23,45,51.1,6,12,50.0,8,22,36.4,10,31,41,9,16,22,13,4,72,1
10907,254371,303_11_11,CAYMAN ISLANDS,0,TOTALS,CAYMAN ISLANDS,200,27,90,30.0,20,58,34.5,7,32,21.9,9,20,45.0,30,19,49,10,18,16,14,2,70,0
10908,254384,303_11_12,BAHAMAS,0,TOTALS,BAHAMAS,200,31,72,43.1,28,58,48.3,3,14,21.4,15,26,57.7,14,31,45,14,13,21,15,1,80,1
10909,254395,303_11_12,BRITISH VIRGIN ISLANDS,0,TOTALS,BRITISH VIRGIN ISLANDS,200,27,74,36.5,27,58,46.6,0,16,0.0,7,10,70.0,11,19,30,11,20,18,15,5,61,0
10910,254407,303_11_13,GUYANA,0,TOTALS,GUYANA,200,16,64,25.0,9,39,23.1,7,25,28.0,12,20,60.0,16,30,46,7,25,22,3,0,51,0
10911,254419,303_11_13,ANTIGUA,0,TOTALS,ANTIGUA,200,30,76,39.5,28,60,46.7,2,16,12.5,14,27,51.9,21,26,47,17,18,15,13,0,76,1
10912,254428,303_11_14,BERMUDA,0,TOTALS,BERMUDA,200,18,51,35.3,16,34,47.1,2,17,11.8,16,27,59.3,10,28,38,11,17,20,14,2,54,1
10913,254440,303_11_14,CAYMAN ISLANDS,0,TOTALS,CAYMAN ISLANDS,200,20,69,29.0,15,51,29.4,5,18,27.8,3,9,33.3,18,18,36,9,26,20,10,3,48,0
10914,254451,303_11_15,BRITISH VIRGIN ISLANDS,0,TOTALS,BRITISH VIRGIN ISLANDS,200,28,64,43.8,23,46,50.0,5,18,27.8,10,13,76.9,13,19,32,12,13,11,10,9,71,1
10915,254461,303_11_15,ST.VINCENT AND THE GRENADINES,0,TOTALS,ST.VINCENT AND THE GRENADINES,200,27,67,40.3,21,45,46.7,6,22,27.3,3,8,37.5,12,13,25,9,14,14,5,1,63,0
10916,254472,303_11_16,VIRGIN ISLANDS,0,TOTALS,VIRGIN ISLANDS,200,30,68,44.1,26,47,55.3,4,21,19.0,22,23,95.7,10,27,37,18,16,15,14,4,86,1
10917,254484,303_11_16,JAMAICA,0,TOTALS,JAMAICA,200,22,67,32.8,17,50,34.0,5,17,29.4,12,20,60.0,16,26,42,8,16,20,12,1,61,0
10918,254494,303_11_17,ANTIGUA,0,TOTALS,ANTIGUA,200,33,70,47.1,30,56,53.6,3,14,21.4,13,23,56.5,14,30,44,18,11,17,11,3,82,1
10919,254504,303_11_17,ST.VINCENT AND THE GRENADINES,0,TOTALS,ST.VINCENT AND THE GRENADINES,200,27,72,37.5,20,50,40.0,7,22,31.8,5,9,55.6,13,21,34,11,18,19,6,2,66,0
10920,254514,303_11_18,BERMUDA,0,TOTALS,BERMUDA,200,25,67,37.3,17,41,41.5,8,26,30.8,10,21,47.6,17,24,41,15,10,24,10,1,68,1
10921,254526,303_11_18,GUYANA,0,TOTALS,GUYANA,200,24,53,45.3,19,36,52.8,5,17,29.4,5,12,41.7,5,24,29,13,21,20,16,2,58,0
10922,254536,303_11_19,VIRGIN ISLANDS,0,TOTALS,VIRGIN ISLANDS,200,29,72,40.3,24,58,41.4,5,14,35.7,16,21,76.2,19,25,44,12,15,13,6,5,79,1
10923,254546,303_11_19,BRITISH VIRGIN ISLANDS,0,TOTALS,BRITISH VIRGIN ISLANDS,200,30,74,40.5,24,56,42.9,6,18,33.3,7,12,58.3,13,19,32,10,18,15,8,6,73,0
10924,254558,303_11_20,BAHAMAS,0,TOTALS,BAHAMAS,225,30,86,34.9,27,63,42.9,3,23,13.0,15,27,55.6,25,36,61,12,21,17,6,2,78,1
10925,254569,303_11_20,JAMAICA,0,TOTALS,JAMAICA,225,29,74,39.2,22,44,50.0,7,30,23.3,10,18,55.6,8,30,38,13,24,15,8,4,75,0
10926,254577,303_11_21,ST.VINCENT AND THE GRENADINES,0,TOTALS,ST.VINCENT AND THE GRENADINES,200,24,64,37.5,19,46,41.3,5,18,27.8,11,23,47.8,20,25,45,9,16,31,6,1,64,0
10927,254588,303_11_21,GUYANA,0,TOTALS,GUYANA,200,38,91,41.8,28,53,52.8,10,38,26.3,7,16,43.8,23,23,46,7,21,13,19,1,93,1
10928,254598,303_11_22,ANTIGUA,0,TOTALS,ANTIGUA,200,30,70,42.9,23,53,43.4,7,17,41.2,11,17,64.7,11,23,34,15,21,14,11,2,78,0
10929,254607,303_11_22,BERMUDA,0,TOTALS,BERMUDA,200,29,64,45.3,19,42,45.2,10,22,45.5,18,26,69.2,10,27,37,17,17,14,10,3,86,1
10930,254618,303_11_23,BRITISH VIRGIN ISLANDS,0,TOTALS,BRITISH VIRGIN ISLANDS,200,23,62,37.1,21,49,42.9,2,13,15.4,6,8,75.0,10,24,34,10,16,11,4,2,54,0
10931,254628,303_11_23,JAMAICA,0,TOTALS,JAMAICA,200,19,62,30.6,16,45,35.6,3,17,17.6,14,21,66.7,12,23,35,6,11,11,4,2,55,1
10932,254638,303_11_24,VIRGIN ISLANDS,0,TOTALS,VIRGIN ISLANDS,200,31,62,50.0,27,48,56.2,4,14,28.6,25,43,58.1,9,26,35,13,19,15,13,2,91,1
10933,254651,303_11_24,BAHAMAS,0,TOTALS,BAHAMAS,200,31,79,39.2,21,55,38.2,10,24,41.7,17,27,63.0,18,23,41,12,28,21,6,3,89,0
10934,254968,305_11_01,ARGENTINA,0,TOTALS,ARGENTINA,200,29,66,43.9,20,44,45.5,9,22,40.9,4,8,50.0,5,30,35,22,12,13,8,1,71,1
10935,254980,305_11_01,VENEZUELA,0,TOTALS,VENEZUELA,200,23,68,33.8,20,50,40.0,3,18,16.7,8,15,53.3,16,29,45,13,14,15,9,5,57,0
10936,254991,305_11_02,URUGUAY,0,TOTALS,URUGUAY,200,21,45,46.7,17,32,53.1,4,13,30.8,21,27,77.8,7,24,31,12,20,19,6,3,67,1
10937,255001,305_11_02,CUBA,0,TOTALS,CUBA,200,25,54,46.3,20,41,48.8,5,13,38.5,10,16,62.5,7,15,22,9,23,14,11,1,65,0
10938,255013,305_11_03,CUBA,0,TOTALS,CUBA,200,23,57,40.4,20,42,47.6,3,15,20.0,5,13,38.5,8,17,25,7,13,15,6,2,54,0
10939,255025,305_11_03,ARGENTINA,0,TOTALS,ARGENTINA,200,33,62,53.2,24,46,52.2,9,16,56.2,9,10,90.0,12,28,40,24,18,17,9,1,84,1
10940,255037,305_11_04,VENEZUELA,0,TOTALS,VENEZUELA,200,29,62,46.8,25,49,51.0,4,13,30.8,21,28,75.0,10,26,36,14,23,13,9,5,83,1
10941,255049,305_11_04,URUGUAY,0,TOTALS,URUGUAY,200,22,60,36.7,13,26,50.0,9,34,26.5,21,32,65.6,13,25,38,16,28,18,8,3,74,0
10942,255060,305_11_05,CUBA,0,TOTALS,CUBA,200,28,70,40.0,23,45,51.1,5,25,20.0,7,11,63.6,12,21,33,14,19,17,15,1,68,0
10943,255073,305_11_05,VENEZUELA,0,TOTALS,VENEZUELA,200,31,52,59.6,28,38,73.7,3,14,21.4,19,24,79.2,3,29,32,20,14,22,5,1,84,1
10944,255084,305_11_06,URUGUAY,0,TOTALS,URUGUAY,200,30,60,50.0,22,40,55.0,8,20,40.0,19,23,82.6,6,25,31,15,18,12,8,5,87,1
10945,255095,305_11_06,ARGENTINA,0,TOTALS,ARGENTINA,200,21,49,42.9,18,34,52.9,3,15,20.0,20,24,83.3,5,19,24,12,22,17,5,3,65,0
10946,255108,306_11_01,CHILE,0,TOTALS,CHILE,200,20,69,29.0,17,46,37.0,3,23,13.0,8,16,50.0,8,14,22,11,20,18,13,1,51,0
10947,255121,306_11_01,CANADA,0,TOTALS,CANADA,200,34,62,54.8,20,41,48.8,14,21,66.7,14,24,58.3,13,40,53,19,16,24,10,4,96,1
10948,255134,306_11_02,ARGENTINA,0,TOTALS,ARGENTINA,200,49,100,49.0,43,74,58.1,6,26,23.1,26,41,63.4,29,34,63,20,14,7,30,9,130,0
10949,255147,306_11_02,COSTA RICA,0,TOTALS,COSTA RICA,200,10,51,19.6,8,39,20.5,2,12,16.7,6,16,37.5,6,26,32,4,26,42,4,3,28,1
10950,255160,306_11_03,BRAZIL,0,TOTALS,BRAZIL,200,26,60,43.3,23,43,53.5,3,17,17.6,15,35,42.9,12,25,37,11,31,31,9,2,70,1
10951,255173,306_11_03,USA,0,TOTALS,USA,200,37,70,52.9,34,55,61.8,3,15,20.0,28,40,70.0,14,32,46,15,24,23,21,3,105,0
10952,255186,306_11_04,MEXICO,0,TOTALS,MEXICO,200,29,65,44.6,28,60,46.7,1,5,20.0,9,15,60.0,13,24,37,13,12,23,12,4,68,0
10953,255199,306_11_04,PUERTO RICO,0,TOTALS,PUERTO RICO,200,32,72,44.4,26,46,56.5,6,26,23.1,8,8,100.0,16,27,43,15,16,20,17,4,78,1
10954,255212,306_11_05,COSTA RICA,0,TOTALS,COSTA RICA,200,16,60,26.7,13,46,28.3,3,14,21.4,18,31,58.1,12,22,34,8,16,29,14,2,53,0
10955,255225,306_11_05,BRAZIL,0,TOTALS,BRAZIL,200,38,74,51.4,35,63,55.6,3,11,27.3,13,22,59.1,18,36,54,20,30,27,20,7,92,1
10956,255238,306_11_06,CANADA,0,TOTALS,CANADA,200,29,67,43.3,21,44,47.7,8,23,34.8,20,35,57.1,17,28,45,16,29,24,14,6,86,0
10957,255251,306_11_06,PUERTO RICO,0,TOTALS,PUERTO RICO,200,27,66,40.9,20,48,41.7,7,18,38.9,29,37,78.4,14,26,40,16,25,22,9,2,90,1
10958,255264,306_11_07,USA,0,TOTALS,USA,200,40,76,52.6,37,64,57.8,3,12,25.0,19,27,70.4,19,40,59,19,23,20,17,7,102,0
10959,255277,306_11_07,ARGENTINA,0,TOTALS,ARGENTINA,200,32,86,37.2,24,58,41.4,8,28,28.6,9,19,47.4,22,21,43,13,21,21,11,1,81,1
10960,255290,306_11_08,CHILE,0,TOTALS,CHILE,200,29,64,45.3,19,43,44.2,10,21,47.6,12,16,75.0,10,31,41,19,19,19,19,1,80,1
10961,255303,306_11_08,MEXICO,0,TOTALS,MEXICO,200,21,59,35.6,19,48,39.6,2,11,18.2,10,17,58.8,11,26,37,9,20,27,9,7,54,0
10962,255316,306_11_09,COSTA RICA,0,TOTALS,COSTA RICA,200,17,80,21.2,13,70,18.6,4,10,40.0,8,14,57.1,14,21,35,4,8,18,6,1,46,1
10963,255329,306_11_09,USA,0,TOTALS,USA,200,53,89,59.6,46,68,67.6,7,21,33.3,5,7,71.4,17,49,66,35,13,15,11,22,118,0
10964,255342,306_11_10,PUERTO RICO,0,TOTALS,PUERTO RICO,200,31,71,43.7,28,60,46.7,3,11,27.3,15,24,62.5,25,33,58,14,19,22,16,6,80,1
10965,255355,306_11_10,CHILE,0,TOTALS,CHILE,200,18,59,30.5,15,48,31.2,3,11,27.3,16,23,69.6,13,17,30,9,19,19,12,4,55,0
10966,255368,306_11_11,BRAZIL,0,TOTALS,BRAZIL,200,26,60,43.3,21,45,46.7,5,15,33.3,20,33,60.6,11,21,32,13,31,16,10,2,77,0
10967,255381,306_11_11,ARGENTINA,0,TOTALS,ARGENTINA,200,24,59,40.7,16,37,43.2,8,22,36.4,29,42,69.0,16,33,49,15,26,18,11,2,85,1
10968,255394,306_11_12,MEXICO,0,TOTALS,MEXICO,200,20,55,36.4,18,40,45.0,2,15,13.3,14,22,63.6,9,21,30,10,11,21,7,4,56,0
10969,255407,306_11_12,CANADA,0,TOTALS,CANADA,200,34,80,42.5,24,50,48.0,10,30,33.3,10,17,58.8,28,33,61,18,17,17,11,7,88,1
10970,255420,306_11_13,CHILE,0,TOTALS,CHILE,200,39,87,44.8,25,54,46.3,14,33,42.4,13,15,86.7,20,37,57,24,25,10,18,4,105,0
10971,255433,306_11_13,COSTA RICA,0,TOTALS,COSTA RICA,200,17,58,29.3,15,47,31.9,2,11,18.2,12,31,38.7,13,29,42,8,15,23,7,3,48,1
10972,255446,306_11_14,BRAZIL,0,TOTALS,BRAZIL,200,28,70,40.0,25,46,54.3,3,24,12.5,12,19,63.2,20,35,55,14,18,23,9,4,71,1
10973,255459,306_11_14,MEXICO,0,TOTALS,MEXICO,200,23,63,36.5,18,48,37.5,5,15,33.3,6,10,60.0,6,27,33,14,16,16,14,2,57,0
10974,255472,306_11_15,USA,0,TOTALS,USA,200,46,88,52.3,39,71,54.9,7,17,41.2,14,24,58.3,18,32,50,30,10,13,16,21,113,0
10975,255485,306_11_15,CANADA,0,TOTALS,CANADA,200,27,80,33.8,22,61,36.1,5,19,26.3,11,15,73.3,21,29,50,9,16,24,7,2,70,1
10976,255498,306_11_16,PUERTO RICO,0,TOTALS,PUERTO RICO,200,30,82,36.6,26,69,37.7,4,13,30.8,26,34,76.5,17,23,40,12,26,15,16,7,90,0
10977,255511,306_11_16,ARGENTINA,0,TOTALS,ARGENTINA,200,32,66,48.5,27,54,50.0,5,12,41.7,27,33,81.8,14,39,53,24,27,26,12,5,96,1
10978,255524,306_11_17,COSTA RICA,0,TOTALS,COSTA RICA,200,26,75,34.7,24,62,38.7,2,13,15.4,12,19,63.2,21,30,51,12,20,23,14,2,66,0
10979,255537,306_11_17,MEXICO,0,TOTALS,MEXICO,200,27,65,41.5,23,48,47.9,4,17,23.5,18,21,85.7,10,30,40,9,15,25,15,5,76,1
10980,255550,306_11_18,CHILE,0,TOTALS,CHILE,200,20,60,33.3,12,35,34.3,8,25,32.0,6,18,33.3,13,24,37,14,18,19,12,3,54,0
10981,255563,306_11_18,BRAZIL,0,TOTALS,BRAZIL,200,21,58,36.2,18,45,40.0,3,13,23.1,17,19,89.5,13,31,44,10,16,23,12,3,62,1
10982,255576,306_11_19,CANADA,0,TOTALS,CANADA,200,32,67,47.8,26,51,51.0,6,16,37.5,16,22,72.7,16,40,56,14,22,21,8,9,86,1
10983,255589,306_11_19,PUERTO RICO,0,TOTALS,PUERTO RICO,200,25,75,33.3,21,57,36.8,4,18,22.2,11,22,50.0,18,20,38,9,20,15,9,2,65,0
10984,255602,306_11_20,USA,0,TOTALS,USA,200,42,75,56.0,35,59,59.3,7,16,43.8,13,27,48.1,17,40,57,24,17,16,9,7,104,0
10985,255615,306_11_20,ARGENTINA,0,TOTALS,ARGENTINA,200,25,77,32.5,17,53,32.1,8,24,33.3,6,13,46.2,15,24,39,13,23,15,8,1,64,1
10986,256148,308_11_01,BRAZIL,0,TOTALS,BRAZIL,200,27,60,45.0,23,42,54.8,4,18,22.2,11,24,45.8,8,30,38,5,24,19,14,3,69,1
10987,256161,308_11_01,PARAGUAY,0,TOTALS,PARAGUAY,200,13,64,20.3,12,49,24.5,1,15,6.7,13,25,52.0,7,25,32,3,17,19,6,0,40,0
10988,256174,308_11_02,CHILE,0,TOTALS,CHILE,200,17,56,30.4,12,36,33.3,5,20,25.0,12,24,50.0,5,25,30,1,25,20,3,1,51,0
10989,256186,308_11_02,ARGENTINA,0,TOTALS,ARGENTINA,200,25,73,34.2,22,44,50.0,3,29,10.3,14,27,51.9,14,24,38,8,16,7,12,3,67,1
10990,256198,308_11_03,URUGUAY,0,TOTALS,URUGUAY,200,24,57,42.1,21,45,46.7,3,12,25.0,16,30,53.3,10,17,27,9,18,22,4,4,67,1
10991,256211,308_11_03,VENEZUELA,0,TOTALS,VENEZUELA,200,25,77,32.5,22,60,36.7,3,17,17.6,11,20,55.0,18,15,33,1,27,16,12,2,64,0
10992,256224,308_11_04,COLOMBIA,0,TOTALS,COLOMBIA,200,28,75,37.3,26,63,41.3,2,12,16.7,16,29,55.2,18,32,50,7,22,18,2,2,74,1
10993,256236,308_11_04,ECUADOR,0,TOTALS,ECUADOR,200,19,70,27.1,17,52,32.7,2,18,11.1,12,33,36.4,15,17,32,0,21,13,4,1,52,0
10994,256248,308_11_05,ECUADOR,0,TOTALS,ECUADOR,200,18,59,30.5,13,42,31.0,5,17,29.4,8,19,42.1,11,17,28,2,19,18,5,3,49,0
10995,256261,308_11_05,ARGENTINA,0,TOTALS,ARGENTINA,200,22,56,39.3,18,39,46.2,4,17,23.5,15,24,62.5,6,22,28,7,18,15,9,2,63,1
10996,256274,308_11_06,PARAGUAY,0,TOTALS,PARAGUAY,200,20,68,29.4,13,46,28.3,7,22,31.8,4,10,40.0,10,24,34,3,21,17,13,1,51,0
10997,256287,308_11_06,VENEZUELA,0,TOTALS,VENEZUELA,200,25,84,29.8,21,67,31.3,4,17,23.5,14,28,50.0,28,28,56,8,11,20,6,9,68,1
10998,256300,308_11_07,BRAZIL,0,TOTALS,BRAZIL,200,29,74,39.2,22,46,47.8,7,28,25.0,9,22,40.9,13,20,33,17,20,6,5,4,74,1
10999,256313,308_11_07,CHILE,0,TOTALS,CHILE,200,14,60,23.3,11,46,23.9,3,14,21.4,13,20,65.0,12,20,32,2,20,16,1,1,44,0
11000,256324,308_11_08,COLOMBIA,0,TOTALS,COLOMBIA,200,13,56,23.2,10,44,22.7,3,12,25.0,14,26,53.8,6,27,33,4,12,13,3,5,43,1
11001,256336,308_11_08,URUGUAY,0,TOTALS,URUGUAY,200,16,57,28.1,12,38,31.6,4,19,21.1,5,7,71.4,7,25,32,5,22,11,5,1,41,0
11002,256347,308_11_09,ECUADOR,0,TOTALS,ECUADOR,200,27,75,36.0,24,61,39.3,3,14,21.4,8,23,34.8,14,25,39,12,20,14,4,2,65,1
11003,256359,308_11_09,PARAGUAY,0,TOTALS,PARAGUAY,200,17,59,28.8,13,37,35.1,4,22,18.2,9,22,40.9,14,22,36,0,20,18,7,4,47,0
11004,256371,308_11_10,BRAZIL,0,TOTALS,BRAZIL,200,41,81,50.6,36,65,55.4,5,16,31.2,13,13,100.0,14,33,47,14,15,11,9,4,100,0
11005,256384,308_11_10,VENEZUELA,0,TOTALS,VENEZUELA,200,19,80,23.8,17,64,26.6,2,16,12.5,7,16,43.8,19,14,33,2,14,15,4,4,47,1
11006,256396,308_11_11,ARGENTINA,0,TOTALS,ARGENTINA,200,15,56,26.8,11,35,31.4,4,21,19.0,4,7,57.1,6,19,25,5,17,19,8,4,38,0
11007,256407,308_11_11,URUGUAY,0,TOTALS,URUGUAY,200,19,64,29.7,14,45,31.1,5,19,26.3,17,24,70.8,11,26,37,4,14,17,8,4,60,1
11008,256420,308_11_12,COLOMBIA,0,TOTALS,COLOMBIA,200,23,70,32.9,20,47,42.6,3,23,13.0,17,24,70.8,17,21,38,7,11,6,6,2,66,1
11009,256432,308_11_12,CHILE,0,TOTALS,CHILE,200,26,69,37.7,19,45,42.2,7,24,29.2,2,7,28.6,13,22,35,3,23,11,4,0,61,0
11010,256443,308_11_13,ECUADOR,0,TOTALS,ECUADOR,200,17,76,22.4,12,53,22.6,5,23,21.7,9,23,39.1,23,26,49,5,15,8,5,0,48,0
11011,256454,308_11_13,CHILE,0,TOTALS,CHILE,200,19,56,33.9,8,27,29.6,11,29,37.9,7,11,63.6,4,27,31,8,16,13,4,4,56,1
11012,256467,308_11_14,PARAGUAY,0,TOTALS,PARAGUAY,200,12,71,16.9,9,60,15.0,3,11,27.3,6,18,33.3,8,14,22,1,17,16,7,1,33,0
11013,256480,308_11_14,ARGENTINA,0,TOTALS,ARGENTINA,200,31,68,45.6,24,52,46.2,7,16,43.8,15,22,68.2,10,34,44,19,16,16,8,11,84,1
11014,256491,308_11_15,URUGUAY,0,TOTALS,URUGUAY,200,15,56,26.8,12,38,31.6,3,18,16.7,12,21,57.1,12,26,38,4,22,19,2,1,45,0
11015,256504,308_11_15,BRAZIL,0,TOTALS,BRAZIL,200,23,72,31.9,23,56,41.1,0,16,0.0,8,22,36.4,16,21,37,7,20,10,9,3,54,1
11016,256516,308_11_16,COLOMBIA,0,TOTALS,COLOMBIA,200,33,77,42.9,33,68,48.5,0,9,0.0,13,27,48.1,19,33,52,12,17,23,7,4,79,1
11017,256529,308_11_16,VENEZUELA,0,TOTALS,VENEZUELA,200,28,85,32.9,25,67,37.3,3,18,16.7,11,19,57.9,11,13,24,5,22,14,13,5,70,0
11018,256542,308_11_17,URUGUAY,0,TOTALS,URUGUAY,200,24,77,31.2,22,58,37.9,2,19,10.5,10,17,58.8,16,28,44,4,15,18,13,2,60,1
11019,256552,308_11_17,ECUADOR,0,TOTALS,ECUADOR,200,18,67,26.9,14,47,29.8,4,20,20.0,7,12,58.3,12,26,38,6,19,20,7,2,47,0
11020,256564,308_11_18,PARAGUAY,0,TOTALS,PARAGUAY,200,19,61,31.1,16,42,38.1,3,19,15.8,11,23,47.8,5,24,29,6,22,16,9,2,52,0
11021,256577,308_11_18,CHILE,0,TOTALS,CHILE,200,23,65,35.4,17,44,38.6,6,21,28.6,14,26,53.8,10,25,35,10,16,20,9,4,66,1
11022,256589,308_11_19,ARGENTINA,0,TOTALS,ARGENTINA,200,37,74,50.0,34,60,56.7,3,14,21.4,16,33,48.5,14,26,40,13,26,13,7,4,93,1
11023,256602,308_11_19,VENEZUELA,0,TOTALS,VENEZUELA,200,22,77,28.6,22,68,32.4,0,9,0.0,13,22,59.1,15,19,34,2,23,20,4,5,57,0
11024,256612,308_11_20,COLOMBIA,0,TOTALS,COLOMBIA,200,19,62,30.6,15,50,30.0,4,12,33.3,11,21,52.4,12,25,37,5,17,22,5,3,53,0
11025,256625,308_11_20,BRAZIL,0,TOTALS,BRAZIL,200,24,77,31.2,18,51,35.3,6,26,23.1,9,22,40.9,19,22,41,12,18,9,10,3,63,1
11026,256638,308_11_21,VENEZUELA,0,TOTALS,VENEZUELA,200,23,61,37.7,17,48,35.4,6,13,46.2,7,19,36.8,15,31,46,4,10,24,3,8,59,1
11027,256649,308_11_21,ECUADOR,0,TOTALS,ECUADOR,200,22,84,26.2,15,50,30.0,7,34,20.6,2,8,25.0,22,18,40,12,15,8,8,5,53,0
11028,256658,308_11_22,CHILE,0,TOTALS,CHILE,200,23,59,39.0,15,38,39.5,8,21,38.1,17,26,65.4,4,26,30,11,20,13,7,3,71,1
11029,256670,308_11_22,URUGUAY,0,TOTALS,URUGUAY,200,21,80,26.2,15,48,31.2,6,32,18.8,12,27,44.4,19,27,46,8,21,14,5,3,60,0
11030,256681,308_11_23,BRAZIL,0,TOTALS,BRAZIL,200,24,69,34.8,23,58,39.7,1,11,9.1,7,19,36.8,15,21,36,7,14,12,10,3,56,1
11031,256693,308_11_23,ARGENTINA,0,TOTALS,ARGENTINA,200,21,53,39.6,17,35,48.6,4,18,22.2,5,9,55.6,3,24,27,6,17,19,4,5,51,0
11032,256706,308_11_24,COLOMBIA,0,TOTALS,COLOMBIA,200,20,67,29.9,19,60,31.7,1,7,14.3,18,29,62.1,21,25,46,8,13,25,12,4,59,1
11033,256718,308_11_24,PARAGUAY,0,TOTALS,PARAGUAY,200,19,55,34.5,16,35,45.7,3,20,15.0,7,14,50.0,3,18,21,2,19,20,15,1,48,0
11034,256731,308_11_25,URUGUAY,0,TOTALS,URUGUAY,200,29,71,40.8,25,59,42.4,4,12,33.3,28,41,68.3,8,30,38,14,19,15,7,4,90,1
11035,256744,308_11_25,PARAGUAY,0,TOTALS,PARAGUAY,200,22,64,34.4,15,42,35.7,7,22,31.8,10,21,47.6,5,20,25,8,31,19,10,3,61,0
11036,256755,308_11_26,ECUADOR,0,TOTALS,ECUADOR,200,14,66,21.2,10,43,23.3,4,23,17.4,7,17,41.2,16,14,30,3,6,16,14,4,39,0
11037,256766,308_11_26,BRAZIL,0,TOTALS,BRAZIL,200,24,61,39.3,17,37,45.9,7,24,29.2,2,4,50.0,15,25,40,19,14,25,8,0,57,1
11038,256778,308_11_27,VENEZUELA,0,TOTALS,VENEZUELA,200,27,68,39.7,24,55,43.6,3,13,23.1,12,22,54.5,15,32,47,6,11,13,4,6,69,1
11039,256788,308_11_27,CHILE,0,TOTALS,CHILE,200,22,69,31.9,11,34,32.4,11,35,31.4,9,14,64.3,5,20,25,14,17,9,6,0,64,0
11040,256799,308_11_28,COLOMBIA,0,TOTALS,COLOMBIA,200,21,62,33.9,19,47,40.4,2,15,13.3,9,20,45.0,12,25,37,4,16,20,4,4,53,0
11041,256811,308_11_28,ARGENTINA,0,TOTALS,ARGENTINA,200,23,59,39.0,17,39,43.6,6,20,30.0,8,19,42.1,7,25,32,11,18,16,10,1,60,1
11042,256823,308_11_29,PARAGUAY,0,TOTALS,PARAGUAY,200,24,54,44.4,19,39,48.7,5,15,33.3,6,14,42.9,4,24,28,9,16,13,12,1,59,1
11043,256834,308_11_29,ECUADOR,0,TOTALS,ECUADOR,200,18,61,29.5,17,53,32.1,1,8,12.5,5,13,38.5,14,23,37,5,13,16,6,2,42,0
11044,256844,308_11_30,CHILE,0,TOTALS,CHILE,200,23,62,37.1,16,37,43.2,7,25,28.0,12,16,75.0,11,27,38,9,15,19,6,0,65,1
11045,256856,308_11_30,VENEZUELA,0,TOTALS,VENEZUELA,200,22,71,31.0,22,55,40.0,0,16,0.0,9,13,69.2,11,22,33,6,14,15,8,3,53,0
11046,256867,308_11_31,URUGUAY,0,TOTALS,URUGUAY,200,15,58,25.9,10,36,27.8,5,22,22.7,8,15,53.3,11,25,36,5,12,18,5,3,43,0
11047,256879,308_11_31,COLOMBIA,0,TOTALS,COLOMBIA,200,21,67,31.3,21,54,38.9,0,13,0.0,9,11,81.8,15,33,48,10,11,15,9,5,51,1
11048,256892,308_11_32,BRAZIL,0,TOTALS,BRAZIL,200,27,67,40.3,23,53,43.4,4,14,28.6,16,25,64.0,14,23,37,5,21,10,4,5,74,1
11049,256905,308_11_32,ARGENTINA,0,TOTALS,ARGENTINA,200,16,58,27.6,10,39,25.6,6,19,31.6,10,19,52.6,15,18,33,5,20,14,2,0,48,0
11050,257451,310_11_01,VENEZUELA,0,TOTALS,VENEZUELA,200,33,87,37.9,27,62,43.5,6,25,24.0,8,12,66.7,24,32,56,7,5,19,19,3,80,1
11051,257462,310_11_01,BOLIVIA,0,TOTALS,BOLIVIA,200,10,52,19.2,8,41,19.5,2,11,18.2,0,2,0.0,6,24,30,2,8,35,8,2,22,0
11052,257475,310_11_02,ARGENTINA,0,TOTALS,ARGENTINA,200,26,65,40.0,23,50,46.0,3,15,20.0,19,26,73.1,12,25,37,12,19,21,19,3,74,1
11053,257488,310_11_02,COLOMBIA,0,TOTALS,COLOMBIA,200,14,53,26.4,13,41,31.7,1,12,8.3,8,25,32.0,9,23,32,5,17,30,9,6,37,0
11054,257501,310_11_03,BRAZIL,0,TOTALS,BRAZIL,200,12,60,20.0,8,37,21.6,4,23,17.4,25,29,86.2,12,27,39,2,22,21,7,2,53,1
11055,257511,310_11_03,URUGUAY,0,TOTALS,URUGUAY,200,19,58,32.8,15,43,34.9,4,15,26.7,8,17,47.1,10,30,40,2,23,28,5,4,50,0
11056,257524,310_11_04,CHILE,0,TOTALS,CHILE,200,26,63,41.3,23,55,41.8,3,8,37.5,9,23,39.1,13,37,50,9,24,21,14,0,64,1
11057,257536,310_11_04,PARAGUAY,0,TOTALS,PARAGUAY,200,16,59,27.1,11,34,32.4,5,25,20.0,11,27,40.7,12,27,39,6,23,24,15,7,48,0
11058,257549,310_11_05,COLOMBIA,0,TOTALS,COLOMBIA,200,33,98,33.7,22,60,36.7,11,38,28.9,12,24,50.0,35,24,59,15,12,8,19,3,89,1
11059,257560,310_11_05,BOLIVIA,0,TOTALS,BOLIVIA,200,15,46,32.6,11,36,30.6,4,10,40.0,3,9,33.3,4,25,29,6,17,30,6,3,37,0
11060,257573,310_11_06,ARGENTINA,0,TOTALS,ARGENTINA,200,30,83,36.1,27,56,48.2,3,27,11.1,12,16,75.0,25,23,48,11,15,15,23,3,75,1
11061,257584,310_11_06,VENEZUELA,0,TOTALS,VENEZUELA,200,14,56,25.0,13,51,25.5,1,5,20.0,8,14,57.1,13,22,35,1,14,33,10,5,37,0
11062,257595,310_11_07,BRAZIL,0,TOTALS,BRAZIL,200,29,69,42.0,22,49,44.9,7,20,35.0,7,11,63.6,13,33,46,8,18,23,8,3,72,1
11063,257607,310_11_07,CHILE,0,TOTALS,CHILE,200,19,64,29.7,14,45,31.1,5,19,26.3,8,18,44.4,11,23,34,3,14,17,9,1,51,0
11064,257619,310_11_08,URUGUAY,0,TOTALS,URUGUAY,200,16,63,25.4,16,48,33.3,0,15,0.0,19,33,57.6,21,29,50,1,10,18,8,1,51,0
11065,257629,310_11_08,PARAGUAY,0,TOTALS,PARAGUAY,200,22,66,33.3,17,45,37.8,5,21,23.8,3,10,30.0,12,29,41,12,24,17,10,3,52,1
11066,257642,310_11_09,ARGENTINA,0,TOTALS,ARGENTINA,200,40,88,45.5,27,58,46.6,13,30,43.3,12,22,54.5,31,16,47,19,8,17,29,1,105,0
11067,257653,310_11_09,BOLIVIA,0,TOTALS,BOLIVIA,200,8,29,27.6,6,25,24.0,2,4,50.0,1,2,50.0,4,17,21,1,14,47,5,1,19,1
11068,257663,310_11_10,VENEZUELA,0,TOTALS,VENEZUELA,200,20,76,26.3,18,58,31.0,2,18,11.1,11,20,55.0,14,19,33,3,10,17,16,3,53,0
11069,257676,310_11_10,COLOMBIA,0,TOTALS,COLOMBIA,200,29,67,43.3,21,46,45.7,8,21,38.1,5,16,31.2,15,37,52,9,18,26,7,6,71,1
11070,257685,310_11_11,CHILE,0,TOTALS,CHILE,200,24,50,48.0,18,36,50.0,6,14,42.9,5,11,45.5,4,16,20,9,15,14,8,2,59,0
11071,257694,310_11_11,URUGUAY,0,TOTALS,URUGUAY,200,22,53,41.5,14,28,50.0,8,25,32.0,8,11,72.7,10,20,30,8,11,14,7,2,60,1
11072,257707,310_11_12,BRAZIL,0,TOTALS,BRAZIL,200,25,71,35.2,21,53,39.6,4,18,22.2,17,24,70.8,19,34,53,7,18,21,5,2,71,1
11073,257719,310_11_12,PARAGUAY,0,TOTALS,PARAGUAY,200,25,76,32.9,22,56,39.3,3,20,15.0,4,15,26.7,20,27,47,2,17,19,9,2,57,0
11074,257732,310_11_13,BRAZIL,0,TOTALS,BRAZIL,200,30,64,46.9,25,47,53.2,5,17,29.4,6,15,40.0,14,32,46,15,4,27,17,2,71,1
11075,257743,310_11_13,BOLIVIA,0,TOTALS,BOLIVIA,200,13,56,23.2,12,44,27.3,1,12,8.3,0,6,0.0,8,20,28,2,9,29,20,1,27,0
11076,257756,310_11_14,ARGENTINA,0,TOTALS,ARGENTINA,200,44,89,49.4,39,72,54.2,5,17,29.4,19,31,61.3,17,30,47,18,17,13,24,3,112,0
11077,257768,310_11_14,PARAGUAY,0,TOTALS,PARAGUAY,200,13,56,23.2,12,47,25.5,1,9,11.1,8,13,61.5,9,25,34,3,20,47,6,3,35,1
11078,257779,310_11_15,COLOMBIA,0,TOTALS,COLOMBIA,200,25,72,34.7,19,45,42.2,6,27,22.2,2,5,40.0,8,22,30,3,19,9,16,1,58,0
11079,257787,310_11_15,URUGUAY,0,TOTALS,URUGUAY,200,22,53,41.5,16,34,47.1,6,19,31.6,9,17,52.9,11,23,34,12,9,19,6,2,59,1
11080,257798,310_11_16,CHILE,0,TOTALS,CHILE,200,19,45,42.2,14,31,45.2,5,14,35.7,10,25,40.0,5,20,25,7,17,15,7,2,53,0
11081,257809,310_11_16,VENEZUELA,0,TOTALS,VENEZUELA,200,27,63,42.9,22,44,50.0,5,19,26.3,11,15,73.3,12,25,37,9,22,13,8,1,70,1
11082,257820,310_11_17,BOLIVIA,0,TOTALS,BOLIVIA,200,16,71,22.5,14,59,23.7,2,12,16.7,9,18,50.0,24,26,50,8,15,33,8,4,43,0
11083,257830,310_11_17,PARAGUAY,0,TOTALS,PARAGUAY,200,33,82,40.2,29,60,48.3,4,22,18.2,6,14,42.9,18,30,48,10,18,21,25,3,76,1
11084,257843,310_11_18,COLOMBIA,0,TOTALS,COLOMBIA,200,29,69,42.0,23,46,50.0,6,23,26.1,12,22,54.5,16,29,45,11,23,13,11,2,76,1
11085,257856,310_11_18,CHILE,0,TOTALS,CHILE,200,21,56,37.5,18,39,46.2,3,17,17.6,12,25,48.0,11,23,34,4,15,19,10,1,57,0
11086,257867,310_11_19,BRAZIL,0,TOTALS,BRAZIL,200,20,65,30.8,16,45,35.6,4,20,20.0,15,27,55.6,17,27,44,9,22,17,8,4,59,1
11087,257877,310_11_19,URUGUAY,0,TOTALS,URUGUAY,200,17,55,30.9,15,44,34.1,2,11,18.2,12,20,60.0,9,27,36,6,22,14,9,4,48,0
11088,257888,310_11_20,VENEZUELA,0,TOTALS,VENEZUELA,200,13,52,25.0,12,44,27.3,1,8,12.5,12,25,48.0,7,25,32,4,19,21,6,2,39,0
11089,257901,310_11_20,ARGENTINA,0,TOTALS,ARGENTINA,200,27,79,34.2,21,49,42.9,6,30,20.0,14,21,66.7,25,35,60,11,21,11,10,1,74,1
11090,257913,310_11_21,CHILE,0,TOTALS,CHILE,200,32,61,52.5,27,46,58.7,5,15,33.3,23,31,74.2,9,25,34,14,10,16,23,4,92,1
11091,257924,310_11_21,BOLIVIA,0,TOTALS,BOLIVIA,200,6,46,13.0,4,35,11.4,2,11,18.2,2,6,33.3,9,23,32,2,23,36,8,2,16,0
11092,257937,310_11_22,COLOMBIA,0,TOTALS,COLOMBIA,200,32,85,37.6,21,56,37.5,11,29,37.9,10,21,47.6,21,32,53,10,16,21,16,5,85,1
11093,257947,310_11_22,PARAGUAY,0,TOTALS,PARAGUAY,200,20,72,27.8,17,50,34.0,3,22,13.6,10,16,62.5,15,26,41,5,16,25,13,5,53,0
11094,257960,310_11_23,ARGENTINA,0,TOTALS,ARGENTINA,200,31,71,43.7,26,55,47.3,5,16,31.2,10,23,43.5,13,21,34,10,19,13,15,0,77,1
11095,257970,310_11_23,BRAZIL,0,TOTALS,BRAZIL,200,22,47,46.8,19,41,46.3,3,6,50.0,23,25,92.0,5,26,31,10,19,26,9,2,70,0
11096,258567,312_11_01,BAHAMAS,0,TOTALS,BAHAMAS,200,42,80,52.5,38,67,56.7,4,13,30.8,10,18,55.6,17,27,44,24,23,25,23,6,98,1
11097,258578,312_11_01,BELIZE,0,TOTALS,BELIZE,200,29,85,34.1,19,57,33.3,10,28,35.7,11,23,47.8,25,16,41,20,12,30,14,2,79,0
11098,258587,312_11_02,DOMINICAN REPUBLIC,0,TOTALS,DOMINICAN REPUBLIC,200,29,77,37.7,27,64,42.2,2,13,15.4,11,25,44.0,12,27,39,10,17,15,9,4,71,0
11099,258600,312_11_02,VIRGIN ISLANDS,0,TOTALS,VIRGIN ISLANDS,200,32,82,39.0,22,54,40.7,10,28,35.7,16,21,76.2,19,36,55,15,19,21,8,6,90,1
11100,258611,312_11_03,PANAMA,0,TOTALS,PANAMA,200,18,61,29.5,16,46,34.8,2,15,13.3,19,34,55.9,10,26,36,10,21,17,7,9,57,0
11101,258624,312_11_03,MEXICO,0,TOTALS,MEXICO,200,29,82,35.4,26,65,40.0,3,17,17.6,18,29,62.1,23,33,56,8,28,16,9,5,79,1
11102,258637,312_11_04,PUERTO RICO,0,TOTALS,PUERTO RICO,200,42,91,46.2,38,79,48.1,4,12,33.3,23,37,62.2,22,27,49,22,11,19,30,11,111,0
11103,258650,312_11_04,BRITISH VIRGIN ISLANDS,0,TOTALS,BRITISH VIRGIN ISLANDS,200,15,65,23.1,14,52,26.9,1,13,7.7,4,8,50.0,14,27,41,3,24,47,10,5,35,1
11104,258660,312_11_05,MEXICO,0,TOTALS,MEXICO,200,26,65,40.0,23,50,46.0,3,15,20.0,39,56,69.6,9,29,38,7,27,18,15,3,94,1
11105,258671,312_11_05,BAHAMAS,0,TOTALS,BAHAMAS,200,34,80,42.5,30,64,46.9,4,16,25.0,18,28,64.3,17,28,45,17,34,20,11,14,90,0
11106,258682,312_11_06,BRITISH VIRGIN ISLANDS,0,TOTALS,BRITISH VIRGIN ISLANDS,200,19,70,27.1,13,51,25.5,6,19,31.6,10,19,52.6,5,13,18,7,18,15,12,3,54,0
11107,258694,312_11_06,DOMINICAN REPUBLIC,0,TOTALS,DOMINICAN REPUBLIC,200,37,78,47.4,31,64,48.4,6,14,42.9,15,23,65.2,24,35,59,17,17,21,11,2,95,1
11108,258707,312_11_07,BELIZE,0,TOTALS,BELIZE,200,43,96,44.8,36,68,52.9,7,28,25.0,8,26,30.8,33,33,66,21,17,14,14,8,101,0
11109,258719,312_11_07,PANAMA,0,TOTALS,PANAMA,200,20,79,25.3,16,58,27.6,4,21,19.0,12,21,57.1,20,24,44,10,20,26,7,3,56,1
11110,258732,312_11_08,VIRGIN ISLANDS,0,TOTALS,VIRGIN ISLANDS,200,19,66,28.8,14,49,28.6,5,17,29.4,19,26,73.1,11,30,41,12,22,26,8,3,62,0
11111,258745,312_11_08,PUERTO RICO,0,TOTALS,PUERTO RICO,200,34,77,44.2,28,60,46.7,6,17,35.3,21,34,61.8,15,33,48,19,21,12,18,5,95,1
11112,258756,312_11_09,BELIZE,0,TOTALS,BELIZE,200,27,77,35.1,23,61,37.7,4,16,25.0,10,19,52.6,25,26,51,15,24,18,11,3,68,0
11113,258765,312_11_09,MEXICO,0,TOTALS,MEXICO,200,25,66,37.9,21,45,46.7,4,21,19.0,17,26,65.4,15,24,39,10,16,18,15,7,71,1
11114,258775,312_11_10,BRITISH VIRGIN ISLANDS,0,TOTALS,BRITISH VIRGIN ISLANDS,200,24,66,36.4,21,53,39.6,3,13,23.1,11,17,64.7,10,30,40,3,14,18,9,4,62,0
11115,258788,312_11_10,VIRGIN ISLANDS,0,TOTALS,VIRGIN ISLANDS,200,29,74,39.2,22,49,44.9,7,25,28.0,12,21,57.1,19,31,50,15,13,17,11,3,77,1
11116,258800,312_11_11,PANAMA,0,TOTALS,PANAMA,200,16,72,22.2,14,58,24.1,2,14,14.3,25,34,73.5,15,28,43,4,19,20,9,6,59,1
11117,258812,312_11_11,BAHAMAS,0,TOTALS,BAHAMAS,200,42,97,43.3,38,83,45.8,4,14,28.6,12,23,52.2,24,37,61,17,27,14,14,8,100,0
11118,258823,312_11_12,PUERTO RICO,0,TOTALS,PUERTO RICO,200,27,67,40.3,23,54,42.6,4,13,30.8,28,34,82.4,13,21,34,15,23,24,14,4,86,1
11119,258833,312_11_12,DOMINICAN REPUBLIC,0,TOTALS,DOMINICAN REPUBLIC,200,29,65,44.6,24,56,42.9,5,9,55.6,11,21,52.4,16,28,44,16,26,28,11,5,74,0
11120,258846,312_11_13,DOMINICAN REPUBLIC,0,TOTALS,DOMINICAN REPUBLIC,200,33,83,39.8,29,65,44.6,4,18,22.2,9,16,56.2,23,35,58,16,14,18,12,5,79,1
11121,258859,312_11_13,PANAMA,0,TOTALS,PANAMA,200,21,74,28.4,16,58,27.6,5,16,31.2,11,15,73.3,14,25,39,8,12,18,7,6,58,0
11122,258871,312_11_14,BELIZE,0,TOTALS,BELIZE,200,32,83,38.6,29,71,40.8,3,12,25.0,14,31,45.2,22,22,44,12,18,16,19,7,81,1
11123,258880,312_11_14,BRITISH VIRGIN ISLANDS,0,TOTALS,BRITISH VIRGIN ISLANDS,200,30,74,40.5,22,58,37.9,8,16,50.0,6,18,33.3,14,28,42,9,21,26,11,3,74,0
11124,258891,312_11_15,MEXICO,0,TOTALS,MEXICO,200,23,61,37.7,18,46,39.1,5,15,33.3,8,18,44.4,11,37,48,9,15,17,5,6,59,1
11125,258902,312_11_15,VIRGIN ISLANDS,0,TOTALS,VIRGIN ISLANDS,200,21,81,25.9,14,54,25.9,7,27,25.9,9,14,64.3,24,24,48,14,14,13,7,3,58,0
11126,258913,312_11_16,PUERTO RICO,0,TOTALS,PUERTO RICO,200,32,91,35.2,21,53,39.6,11,38,28.9,10,23,43.5,25,29,54,19,19,17,11,5,85,1
11127,258923,312_11_16,BAHAMAS,0,TOTALS,BAHAMAS,200,29,78,37.2,25,67,37.3,4,11,36.4,16,23,69.6,20,31,51,12,23,21,7,9,78,0
11128,258933,312_11_17,PANAMA,0,TOTALS,PANAMA,250,30,79,38.0,25,61,41.0,5,18,27.8,14,27,51.9,19,50,69,15,16,29,7,13,79,0
11129,258942,312_11_17,BRITISH VIRGIN ISLANDS,0,TOTALS,BRITISH VIRGIN ISLANDS,250,32,121,26.4,26,98,26.5,6,23,26.1,11,16,68.8,33,30,63,13,19,13,18,5,81,1
11130,258952,312_11_18,DOMINICAN REPUBLIC,0,TOTALS,DOMINICAN REPUBLIC,200,33,77,42.9,28,61,45.9,5,16,31.2,14,18,77.8,16,27,43,24,17,15,10,6,85,1
11131,258962,312_11_18,BELIZE,0,TOTALS,BELIZE,200,32,81,39.5,25,62,40.3,7,19,36.8,10,25,40.0,21,23,44,17,14,19,9,6,81,0
11132,258974,312_11_19,VIRGIN ISLANDS,0,TOTALS,VIRGIN ISLANDS,225,28,83,33.7,13,49,26.5,15,34,44.1,15,22,68.2,20,35,55,17,18,15,6,9,86,1
11133,258984,312_11_19,BAHAMAS,0,TOTALS,BAHAMAS,225,31,98,31.6,26,73,35.6,5,25,20.0,16,24,66.7,24,29,53,10,17,12,10,6,83,0
11134,258996,312_11_20,MEXICO,0,TOTALS,MEXICO,200,26,81,32.1,24,67,35.8,2,14,14.3,21,31,67.7,24,20,44,8,23,29,18,6,75,0
11135,259008,312_11_20,PUERTO RICO,0,TOTALS,PUERTO RICO,200,35,84,41.7,34,72,47.2,1,12,8.3,19,27,70.4,24,28,52,20,20,30,19,12,90,1
11136,259370,314_11_01,BELIZE,0,TOTALS,BELIZE,200,29,74,39.2,24,52,46.2,5,22,22.7,8,15,53.3,20,32,52,8,22,14,14,6,71,1
11137,259381,314_11_01,COSTA RICA,0,TOTALS,COSTA RICA,200,22,68,32.4,15,48,31.2,7,20,35.0,19,32,59.4,9,23,32,6,21,13,12,2,70,0
11138,259394,314_11_02,PUERTO RICO,0,TOTALS,PUERTO RICO,200,56,87,64.4,52,68,76.5,4,19,21.1,9,12,75.0,19,31,50,21,11,14,16,5,125,0
11139,259407,314_11_02,GUATEMALA,0,TOTALS,GUATEMALA,200,10,50,20.0,8,33,24.2,2,17,11.8,6,10,60.0,4,11,15,3,9,23,9,2,28,1
11140,259418,314_11_03,MEXICO,0,TOTALS,MEXICO,200,47,89,52.8,39,73,53.4,8,16,50.0,15,29,51.7,19,33,52,23,28,13,14,5,117,0
11141,259430,314_11_03,EL SALVADOR,0,TOTALS,EL SALVADOR,200,12,53,22.6,11,47,23.4,1,6,16.7,12,31,38.7,12,28,40,2,26,28,4,1,37,1
11142,259443,314_11_04,BELIZE,0,TOTALS,BELIZE,200,28,61,45.9,19,45,42.2,9,16,56.2,15,30,50.0,16,14,30,5,20,18,6,0,80,1
11143,259456,314_11_04,PUERTO RICO,0,TOTALS,PUERTO RICO,200,39,72,54.2,29,52,55.8,10,20,50.0,20,29,69.0,14,21,35,18,19,10,11,3,108,0
11144,259467,314_11_05,EL SALVADOR,0,TOTALS,EL SALVADOR,200,17,53,32.1,14,42,33.3,3,11,27.3,14,28,50.0,8,24,32,4,20,15,5,0,51,0
11145,259479,314_11_05,COSTA RICA,0,TOTALS,COSTA RICA,200,29,63,46.0,20,41,48.8,9,22,40.9,12,21,57.1,12,26,38,13,24,16,7,3,79,1
11146,259492,314_11_06,GUATEMALA,0,TOTALS,GUATEMALA,200,19,57,33.3,16,49,32.7,3,8,37.5,7,15,46.7,6,23,29,5,17,25,5,1,48,1
11147,259504,314_11_06,MEXICO,0,TOTALS,MEXICO,200,46,88,52.3,41,76,53.9,5,12,41.7,17,26,65.4,19,31,50,10,15,10,12,5,114,0
11148,259516,314_11_07,EL SALVADOR,0,TOTALS,EL SALVADOR,200,35,68,51.5,30,53,56.6,5,15,33.3,23,41,56.1,10,27,37,7,19,18,16,2,98,1
11149,259528,314_11_07,GUATEMALA,0,TOTALS,GUATEMALA,200,15,57,26.3,11,47,23.4,4,10,40.0,12,21,57.1,11,23,34,4,29,28,5,2,46,0
11150,259540,314_11_08,COSTA RICA,0,TOTALS,COSTA RICA,200,19,54,35.2,16,42,38.1,3,12,25.0,17,28,60.7,5,14,19,5,15,22,8,1,58,1
11151,259552,314_11_08,PUERTO RICO,0,TOTALS,PUERTO RICO,200,43,65,66.2,40,56,71.4,3,9,33.3,15,19,78.9,7,32,39,17,23,22,14,3,104,0
11152,259562,314_11_09,PUERTO RICO,0,TOTALS,PUERTO RICO,200,36,72,50.0,30,54,55.6,6,18,33.3,16,26,61.5,20,25,45,12,19,17,17,3,94,1
11153,259574,314_11_09,EL SALVADOR,0,TOTALS,EL SALVADOR,200,14,47,29.8,10,33,30.3,4,14,28.6,16,24,66.7,5,16,21,2,28,33,2,0,48,0
11154,259586,314_11_10,GUATEMALA,0,TOTALS,GUATEMALA,200,20,66,30.3,15,48,31.2,5,18,27.8,7,17,41.2,7,15,22,1,10,21,5,0,52,1
11155,259598,314_11_10,BELIZE,0,TOTALS,BELIZE,200,52,85,61.2,44,61,72.1,8,24,33.3,12,14,85.7,19,37,56,3,19,13,12,4,124,0
11156,259610,314_11_11,COSTA RICA,0,TOTALS,COSTA RICA,200,21,69,30.4,14,52,26.9,7,17,41.2,14,27,51.9,5,20,25,2,29,17,5,2,63,1
11157,259622,314_11_11,MEXICO,0,TOTALS,MEXICO,200,41,79,51.9,31,56,55.4,10,23,43.5,21,36,58.3,19,45,64,1,20,16,12,5,113,0
11158,259634,314_11_12,COSTA RICA,0,TOTALS,COSTA RICA,200,37,90,41.1,31,68,45.6,6,22,27.3,25,42,59.5,26,32,58,10,24,21,24,4,105,0
11159,259646,314_11_12,GUATEMALA,0,TOTALS,GUATEMALA,200,17,57,29.8,16,50,32.0,1,7,14.3,12,29,41.4,10,31,41,3,28,37,13,2,47,1
11160,259658,314_11_13,BELIZE,0,TOTALS,BELIZE,200,26,69,37.7,17,36,47.2,9,33,27.3,3,10,30.0,12,25,37,12,24,15,7,4,64,0
11161,259668,314_11_13,EL SALVADOR,0,TOTALS,EL SALVADOR,200,22,58,37.9,14,39,35.9,8,19,42.1,19,30,63.3,8,28,36,5,13,18,7,0,71,1
11162,259680,314_11_14,MEXICO,0,TOTALS,MEXICO,200,17,53,32.1,16,46,34.8,1,7,14.3,28,42,66.7,9,18,27,3,21,23,6,3,63,0
11163,259691,314_11_14,PUERTO RICO,0,TOTALS,PUERTO RICO,200,39,69,56.5,33,62,53.2,6,7,85.7,15,23,65.2,11,27,38,12,29,26,8,5,99,1
11164,259704,315_10_01,HUNGARY,0,TOTALS,HUNGARY,200,30,67,44.8,21,42,50.0,9,25,36.0,13,20,65.0,9,27,36,13,27,9,5,4,82,0
11165,259717,315_10_01,GREAT BRITAIN,0,TOTALS,GREAT BRITAIN,200,29,62,46.8,19,34,55.9,10,28,35.7,23,33,69.7,13,30,43,16,17,8,6,3,91,1
11166,259730,315_10_02,UKRAINE,0,TOTALS,UKRAINE,200,18,51,35.3,11,24,45.8,7,27,25.9,15,18,83.3,13,27,40,11,23,19,4,2,58,0
11167,259743,315_10_02,MKD,0,TOTALS,MKD,200,24,61,39.3,14,31,45.2,10,30,33.3,13,19,68.4,11,20,31,14,25,11,11,1,71,1
11168,259756,315_10_03,GEORGIA,0,TOTALS,GEORGIA,200,33,62,53.2,27,44,61.4,6,18,33.3,12,14,85.7,19,25,44,12,18,10,3,2,84,1
11169,259769,315_10_03,POLAND,0,TOTALS,POLAND,200,22,55,40.0,13,28,46.4,9,27,33.3,12,16,75.0,10,11,21,13,18,8,4,4,65,0
11170,259782,315_10_04,ITALY,0,TOTALS,ITALY,200,26,68,38.2,21,38,55.3,5,30,16.7,14,17,82.4,14,26,40,5,19,7,5,1,71,0
11171,259795,315_10_04,ISRAEL,0,TOTALS,ISRAEL,200,25,57,43.9,18,42,42.9,7,15,46.7,22,29,75.9,11,31,42,10,21,12,4,3,79,1
11172,259808,315_10_05,PORTUGAL,0,TOTALS,PORTUGAL,200,20,63,31.7,14,31,45.2,6,32,18.8,13,18,72.2,19,20,39,13,23,15,9,2,59,0
11173,259821,315_10_05,BULGARIA,0,TOTALS,BULGARIA,200,18,46,39.1,9,21,42.9,9,25,36.0,22,23,95.7,8,25,33,11,24,19,7,2,67,1
11174,259834,315_10_06,MONTENEGRO,0,TOTALS,MONTENEGRO,200,34,56,60.7,25,40,62.5,9,16,56.2,19,28,67.9,9,26,35,16,21,12,9,4,96,1
11175,259847,315_10_06,LATVIA,0,TOTALS,LATVIA,200,24,57,42.1,19,35,54.3,5,22,22.7,13,20,65.0,14,17,31,9,28,16,7,1,66,0
11176,259860,315_10_07,FINLAND,0,TOTALS,FINLAND,200,16,58,27.6,10,35,28.6,6,23,26.1,22,25,88.0,12,26,38,3,26,17,4,0,60,0
11177,259873,315_10_07,MONTENEGRO,0,TOTALS,MONTENEGRO,200,25,58,43.1,17,39,43.6,8,19,42.1,16,24,66.7,11,29,40,12,25,13,8,0,74,1
11178,259885,315_10_08,POLAND,0,TOTALS,POLAND,200,26,50,52.0,13,25,52.0,13,25,52.0,21,26,80.8,8,35,43,21,20,16,4,3,86,1
11179,259898,315_10_08,PORTUGAL,0,TOTALS,PORTUGAL,200,22,63,34.9,11,35,31.4,11,28,39.3,9,19,47.4,10,17,27,16,27,12,8,1,64,0
11180,259911,315_10_09,BELGIUM,0,TOTALS,BELGIUM,200,25,53,47.2,17,32,53.1,8,21,38.1,16,22,72.7,6,11,17,7,23,9,12,0,74,1
11181,259924,315_10_09,GEORGIA,0,TOTALS,GEORGIA,200,24,50,48.0,20,32,62.5,4,18,22.2,12,14,85.7,5,22,27,4,23,21,5,1,64,0
11182,259937,315_10_10,LATVIA,0,TOTALS,LATVIA,200,22,57,38.6,18,38,47.4,4,19,21.1,21,31,67.7,14,22,36,13,22,10,6,3,69,1
11183,259950,315_10_10,ITALY,0,TOTALS,ITALY,200,27,57,47.4,23,39,59.0,4,18,22.2,10,15,66.7,7,27,34,11,27,11,6,7,68,0
11184,259963,315_10_11,BOSNIA AND HERZEGOVINA,0,TOTALS,BOSNIA AND HERZEGOVINA,200,31,62,50.0,22,41,53.7,9,21,42.9,15,21,71.4,8,22,30,15,23,10,5,1,86,1
11185,259976,315_10_11,UKRAINE,0,TOTALS,UKRAINE,200,28,56,50.0,22,39,56.4,6,17,35.3,14,20,70.0,10,23,33,14,23,17,4,4,76,0
11186,259989,315_10_12,MKD,0,TOTALS,MKD,200,33,67,49.3,23,40,57.5,10,27,37.0,2,5,40.0,8,26,34,23,16,14,12,2,78,1
11187,260002,315_10_12,HUNGARY,0,TOTALS,HUNGARY,200,16,44,36.4,15,28,53.6,1,16,6.2,11,21,52.4,7,27,34,10,15,28,8,1,44,0
11188,260015,315_10_13,GREAT BRITAIN,0,TOTALS,GREAT BRITAIN,225,39,70,55.7,31,50,62.0,8,20,40.0,18,33,54.5,18,26,44,21,29,14,3,7,104,0
11189,260028,315_10_13,MKD,0,TOTALS,MKD,225,31,62,50.0,21,37,56.8,10,25,40.0,24,32,75.0,7,18,25,13,30,14,4,0,96,1
11190,260041,315_10_14,PORTUGAL,0,TOTALS,PORTUGAL,200,23,52,44.2,13,24,54.2,10,28,35.7,13,20,65.0,9,11,20,11,27,16,8,0,69,0
11191,260054,315_10_14,BELGIUM,0,TOTALS,BELGIUM,200,23,35,65.7,13,17,76.5,10,18,55.6,22,29,75.9,2,14,16,15,21,19,7,1,78,1
11192,260067,315_10_15,BULGARIA,0,TOTALS,BULGARIA,200,26,62,41.9,14,36,38.9,12,26,46.2,10,18,55.6,12,25,37,12,18,10,7,2,74,1
11193,260079,315_10_15,POLAND,0,TOTALS,POLAND,200,27,60,45.0,17,35,48.6,10,25,40.0,6,8,75.0,9,27,36,13,20,15,6,2,70,0
11194,260092,315_10_16,ISRAEL,0,TOTALS,ISRAEL,200,38,67,56.7,22,42,52.4,16,25,64.0,18,23,78.3,10,20,30,32,21,7,12,2,110,0
11195,260105,315_10_16,LATVIA,0,TOTALS,LATVIA,200,33,71,46.5,23,42,54.8,10,29,34.5,12,18,66.7,18,22,40,24,20,15,2,0,88,1
11196,260118,315_10_17,HUNGARY,0,TOTALS,HUNGARY,200,25,64,39.1,17,38,44.7,8,26,30.8,16,24,66.7,9,29,38,12,21,11,10,5,74,1
11197,260132,315_10_17,BOSNIA AND HERZEGOVINA,0,TOTALS,BOSNIA AND HERZEGOVINA,200,23,59,39.0,13,29,44.8,10,30,33.3,14,21,66.7,12,32,44,14,23,17,8,2,70,0
11198,260145,315_10_18,ITALY,0,TOTALS,ITALY,200,29,58,50.0,20,30,66.7,9,28,32.1,15,21,71.4,7,20,27,13,21,13,12,3,82,1
11199,260158,315_10_18,FINLAND,0,TOTALS,FINLAND,200,24,49,49.0,11,26,42.3,13,23,56.5,12,17,70.6,6,25,31,4,22,22,8,1,73,0
11200,260171,315_10_19,MONTENEGRO,0,TOTALS,MONTENEGRO,200,24,57,42.1,20,35,57.1,4,22,18.2,19,26,73.1,16,27,43,13,21,11,5,0,71,1
11201,260184,315_10_19,ITALY,0,TOTALS,ITALY,200,23,57,40.4,16,33,48.5,7,24,29.2,9,15,60.0,7,19,26,12,28,8,6,1,62,0
11202,260197,315_10_20,UKRAINE,0,TOTALS,UKRAINE,200,27,51,52.9,19,35,54.3,8,16,50.0,18,28,64.3,7,27,34,17,16,19,8,5,80,1
11203,260209,315_10_20,HUNGARY,0,TOTALS,HUNGARY,200,28,63,44.4,20,36,55.6,8,27,29.6,7,15,46.7,9,18,27,9,25,15,11,1,71,0
11204,260222,315_10_21,GEORGIA,0,TOTALS,GEORGIA,200,18,53,34.0,13,33,39.4,5,20,25.0,32,44,72.7,16,31,47,12,17,11,5,4,73,1
11205,260235,315_10_21,PORTUGAL,0,TOTALS,PORTUGAL,200,22,63,34.9,14,26,53.8,8,37,21.6,5,10,50.0,11,25,36,11,32,9,5,3,57,0
11206,260248,315_10_22,FINLAND,0,TOTALS,FINLAND,200,31,67,46.3,21,40,52.5,10,27,37.0,12,18,66.7,12,24,36,6,21,12,5,2,84,1
11207,260261,315_10_22,ISRAEL,0,TOTALS,ISRAEL,200,28,60,46.7,20,44,45.5,8,16,50.0,19,22,86.4,8,27,35,7,23,12,7,1,83,0
11208,260274,315_10_23,BELGIUM,0,TOTALS,BELGIUM,200,28,58,48.3,23,37,62.2,5,21,23.8,13,17,76.5,13,11,24,14,24,16,9,0,74,1
11209,260287,315_10_23,BULGARIA,0,TOTALS,BULGARIA,200,27,48,56.2,23,34,67.6,4,14,28.6,11,17,64.7,7,21,28,8,23,21,5,1,69,0
11210,260300,315_10_24,BOSNIA AND HERZEGOVINA,0,TOTALS,BOSNIA AND HERZEGOVINA,200,25,61,41.0,17,37,45.9,8,24,33.3,22,31,71.0,12,18,30,13,25,14,5,0,80,0
11211,260313,315_10_24,GREAT BRITAIN,0,TOTALS,GREAT BRITAIN,200,27,54,50.0,16,35,45.7,11,19,57.9,19,26,73.1,9,27,36,8,27,18,7,4,84,1
11212,260326,315_10_25,BULGARIA,0,TOTALS,BULGARIA,200,29,64,45.3,22,45,48.9,7,19,36.8,14,20,70.0,8,22,30,12,26,9,7,2,79,0
11213,260339,315_10_25,GEORGIA,0,TOTALS,GEORGIA,200,28,53,52.8,19,33,57.6,9,20,45.0,18,26,69.2,6,32,38,18,24,17,2,5,83,1
11214,260352,315_10_26,GREAT BRITAIN,0,TOTALS,GREAT BRITAIN,200,28,63,44.4,19,41,46.3,9,22,40.9,25,36,69.4,11,28,39,12,19,10,6,3,90,1
11215,260365,315_10_26,UKRAINE,0,TOTALS,UKRAINE,200,30,60,50.0,23,38,60.5,7,22,31.8,9,15,60.0,5,28,33,17,28,13,4,2,76,0
11216,260377,315_10_27,POLAND,0,TOTALS,POLAND,200,34,56,60.7,27,37,73.0,7,19,36.8,18,23,78.3,7,23,30,22,14,9,6,5,93,1
11217,260390,315_10_27,BELGIUM,0,TOTALS,BELGIUM,200,26,65,40.0,12,36,33.3,14,29,48.3,7,8,87.5,15,15,30,17,20,12,5,1,73,0
11218,260403,315_10_28,LATVIA,0,TOTALS,LATVIA,200,28,57,49.1,16,33,48.5,12,24,50.0,19,26,73.1,11,33,44,20,24,21,13,6,87,1
11219,260416,315_10_28,FINLAND,0,TOTALS,FINLAND,200,22,64,34.4,16,45,35.6,6,19,31.6,17,25,68.0,14,20,34,11,21,15,16,1,67,0
11220,260429,315_10_29,MKD,0,TOTALS,MKD,200,22,56,39.3,15,36,41.7,7,20,35.0,19,26,73.1,10,30,40,9,31,12,10,3,70,1
11221,260442,315_10_29,BOSNIA AND HERZEGOVINA,0,TOTALS,BOSNIA AND HERZEGOVINA,200,18,47,38.3,16,28,57.1,2,19,10.5,18,28,64.3,6,25,31,7,24,20,4,0,56,0
11222,260455,315_10_30,ISRAEL,0,TOTALS,ISRAEL,200,25,65,38.5,17,43,39.5,8,22,36.4,19,24,79.2,7,23,30,15,18,9,10,3,77,1
11223,260468,315_10_30,MONTENEGRO,0,TOTALS,MONTENEGRO,200,24,58,41.4,18,35,51.4,6,23,26.1,19,23,82.6,9,34,43,18,25,16,4,2,73,0
11224,260481,315_10_31,BULGARIA,0,TOTALS,BULGARIA,200,24,47,51.1,18,31,58.1,6,16,37.5,49,59,83.1,11,27,38,21,24,17,14,0,103,0
11225,260494,315_10_31,PORTUGAL,0,TOTALS,PORTUGAL,200,20,51,39.2,11,20,55.0,9,31,29.0,15,23,65.2,8,15,23,11,39,25,6,1,64,1
11226,260507,315_10_32,ISRAEL,0,TOTALS,ISRAEL,200,26,56,46.4,20,36,55.6,6,20,30.0,18,25,72.0,6,25,31,18,19,10,5,0,76,0
11227,260520,315_10_32,ITALY,0,TOTALS,ITALY,200,31,63,49.2,24,34,70.6,7,29,24.1,12,19,63.2,8,28,36,17,23,7,6,3,81,1
11228,260533,315_10_33,GREAT BRITAIN,0,TOTALS,GREAT BRITAIN,200,21,56,37.5,12,28,42.9,9,28,32.1,15,32,46.9,12,35,47,10,15,15,4,5,66,1
11229,260546,315_10_33,HUNGARY,0,TOTALS,HUNGARY,200,25,69,36.2,18,49,36.7,7,20,35.0,7,12,58.3,12,29,41,10,28,12,6,3,64,0
11230,260558,315_10_34,POLAND,0,TOTALS,POLAND,200,26,64,40.6,21,38,55.3,5,26,19.2,10,14,71.4,11,26,37,11,22,12,6,4,67,1
11231,260571,315_10_34,GEORGIA,0,TOTALS,GEORGIA,200,18,64,28.1,12,35,34.3,6,29,20.7,16,18,88.9,19,25,44,8,17,14,7,1,58,0
11232,260584,315_10_35,LATVIA,0,TOTALS,LATVIA,200,28,63,44.4,16,36,44.4,12,27,44.4,16,21,76.2,9,20,29,14,34,11,8,2,84,0
11233,260597,315_10_35,MONTENEGRO,0,TOTALS,MONTENEGRO,200,26,49,53.1,20,30,66.7,6,19,31.6,32,45,71.1,9,26,35,15,19,14,6,3,90,1
11234,260610,315_10_36,MKD,0,TOTALS,MKD,200,23,60,38.3,17,35,48.6,6,25,24.0,19,31,61.3,15,23,38,9,21,12,14,5,71,1
11235,260623,315_10_36,UKRAINE,0,TOTALS,UKRAINE,200,20,48,41.7,14,36,38.9,6,12,50.0,9,20,45.0,11,27,38,11,24,21,8,1,55,0
11236,260635,315_10_37,UKRAINE,0,TOTALS,UKRAINE,200,32,52,61.5,22,33,66.7,10,19,52.6,13,21,61.9,10,24,34,20,21,16,9,10,87,1
11237,260648,315_10_37,BOSNIA AND HERZEGOVINA,0,TOTALS,BOSNIA AND HERZEGOVINA,200,25,57,43.9,19,40,47.5,6,17,35.3,13,17,76.5,8,13,21,12,21,15,10,2,69,0
11238,260661,315_10_38,HUNGARY,0,TOTALS,HUNGARY,200,32,58,55.2,22,33,66.7,10,25,40.0,11,17,64.7,9,33,42,20,20,14,4,2,85,1
11239,260674,315_10_38,MKD,0,TOTALS,MKD,200,30,71,42.3,19,41,46.3,11,30,36.7,11,16,68.8,11,21,32,19,17,6,7,0,82,0
11240,260687,315_10_39,GEORGIA,0,TOTALS,GEORGIA,200,21,51,41.2,16,34,47.1,5,17,29.4,16,26,61.5,9,18,27,11,18,13,3,7,63,0
11241,260700,315_10_39,BELGIUM,0,TOTALS,BELGIUM,200,32,59,54.2,23,36,63.9,9,23,39.1,13,17,76.5,10,26,36,18,21,8,8,2,86,1
11242,260713,315_10_40,ITALY,0,TOTALS,ITALY,200,32,68,47.1,21,39,53.8,11,29,37.9,34,39,87.2,10,26,36,15,26,10,6,4,109,0
11243,260725,315_10_40,LATVIA,0,TOTALS,LATVIA,200,34,72,47.2,27,50,54.0,7,22,31.8,18,27,66.7,13,27,40,15,29,10,3,2,93,1
11244,260738,315_10_41,MONTENEGRO,0,TOTALS,MONTENEGRO,200,30,59,50.8,23,40,57.5,7,19,36.8,24,30,80.0,18,28,46,19,22,19,8,2,91,1
11245,260751,315_10_41,FINLAND,0,TOTALS,FINLAND,200,24,56,42.9,18,36,50.0,6,20,30.0,17,22,77.3,8,16,24,11,25,11,13,1,71,0
11246,260763,315_10_42,PORTUGAL,0,TOTALS,PORTUGAL,225,31,62,50.0,21,32,65.6,10,30,33.3,13,24,54.2,6,20,26,19,30,14,12,2,85,1
11247,260775,315_10_42,POLAND,0,TOTALS,POLAND,225,27,60,45.0,18,37,48.6,9,23,39.1,21,23,91.3,8,25,33,13,23,20,3,3,84,0
11248,260788,315_10_43,FINLAND,0,TOTALS,FINLAND,200,26,63,41.3,15,40,37.5,11,23,47.8,20,30,66.7,11,32,43,11,29,12,1,0,83,0
11249,260801,315_10_43,ITALY,0,TOTALS,ITALY,200,22,61,36.1,13,41,31.7,9,20,45.0,32,37,86.5,9,29,38,10,27,7,5,4,85,1
11250,260813,315_10_44,POLAND,0,TOTALS,POLAND,200,28,56,50.0,21,36,58.3,7,20,35.0,12,17,70.6,5,28,33,20,21,16,7,4,75,1
11251,260826,315_10_44,BULGARIA,0,TOTALS,BULGARIA,200,25,62,40.3,18,38,47.4,7,24,29.2,14,19,73.7,11,24,35,15,22,15,8,2,71,0
11252,260839,315_10_45,BELGIUM,0,TOTALS,BELGIUM,200,24,58,41.4,16,33,48.5,8,25,32.0,12,17,70.6,11,14,25,11,20,18,8,3,68,1
11253,260850,315_10_45,PORTUGAL,0,TOTALS,PORTUGAL,200,20,42,47.6,12,29,41.4,8,13,61.5,15,19,78.9,8,20,28,11,21,20,10,0,63,0
11254,260862,315_10_46,LATVIA,0,TOTALS,LATVIA,200,20,65,30.8,15,38,39.5,5,27,18.5,11,18,61.1,13,25,38,11,24,21,6,1,56,0
11255,260875,315_10_46,ISRAEL,0,TOTALS,ISRAEL,200,32,64,50.0,28,46,60.9,4,18,22.2,24,32,75.0,8,36,44,16,21,13,13,2,92,1
11256,260888,315_10_47,BOSNIA AND HERZEGOVINA,0,TOTALS,BOSNIA AND HERZEGOVINA,200,25,59,42.4,20,39,51.3,5,20,25.0,18,23,78.3,15,21,36,12,18,18,10,1,73,1
11257,260901,315_10_47,HUNGARY,0,TOTALS,HUNGARY,200,25,55,45.5,15,28,53.6,10,27,37.0,4,6,66.7,7,20,27,10,23,22,10,1,64,0
11258,260914,315_10_48,MKD,0,TOTALS,MKD,200,28,61,45.9,18,37,48.6,10,24,41.7,9,19,47.4,10,22,32,12,21,12,10,1,75,1
11259,260927,315_10_48,GREAT BRITAIN,0,TOTALS,GREAT BRITAIN,200,23,58,39.7,19,40,47.5,4,18,22.2,6,17,35.3,18,25,43,9,18,25,8,2,56,0
11260,260940,315_10_49,BULGARIA,0,TOTALS,BULGARIA,200,29,51,56.9,22,35,62.9,7,16,43.8,27,32,84.4,8,22,30,18,23,15,9,0,92,1
11261,260953,315_10_49,BELGIUM,0,TOTALS,BELGIUM,200,29,59,49.2,19,33,57.6,10,26,38.5,13,18,72.2,11,14,25,21,29,15,11,4,81,0
11262,260966,315_10_50,HUNGARY,0,TOTALS,HUNGARY,200,34,69,49.3,23,41,56.1,11,28,39.3,4,7,57.1,13,22,35,20,22,16,10,1,83,1
11263,260977,315_10_50,UKRAINE,0,TOTALS,UKRAINE,200,25,61,41.0,19,35,54.3,6,26,23.1,19,22,86.4,11,22,33,10,14,14,9,4,75,0
11264,260990,315_10_51,ISRAEL,0,TOTALS,ISRAEL,200,32,76,42.1,22,47,46.8,10,29,34.5,11,23,47.8,20,25,45,17,19,8,11,3,85,1
11265,261003,315_10_51,FINLAND,0,TOTALS,FINLAND,200,27,60,45.0,18,41,43.9,9,19,47.4,8,13,61.5,9,32,41,12,26,20,3,3,71,0
11266,261015,315_10_52,GREAT BRITAIN,0,TOTALS,GREAT BRITAIN,225,30,60,50.0,23,43,53.5,7,17,41.2,27,39,69.2,14,35,49,11,20,17,8,8,94,1
11267,261027,315_10_52,BOSNIA AND HERZEGOVINA,0,TOTALS,BOSNIA AND HERZEGOVINA,225,28,72,38.9,19,48,39.6,9,24,37.5,20,23,87.0,10,22,32,12,27,12,6,1,85,0
11268,261040,315_10_53,ITALY,0,TOTALS,ITALY,200,26,65,40.0,17,40,42.5,9,25,36.0,11,16,68.8,11,22,33,9,27,8,2,3,72,1
11269,261053,315_10_53,MONTENEGRO,0,TOTALS,MONTENEGRO,200,23,51,45.1,16,31,51.6,7,20,35.0,18,25,72.0,9,27,36,10,22,15,3,4,71,0
11270,261065,315_10_54,PORTUGAL,0,TOTALS,PORTUGAL,200,18,69,26.1,10,28,35.7,8,41,19.5,13,20,65.0,12,20,32,9,31,14,12,1,57,0
11271,261077,315_10_54,GEORGIA,0,TOTALS,GEORGIA,200,24,46,52.2,17,29,58.6,7,17,41.2,25,41,61.0,8,42,50,14,23,21,8,1,80,1
11272,261088,315_10_55,UKRAINE,0,TOTALS,UKRAINE,200,26,60,43.3,22,47,46.8,4,13,30.8,19,21,90.5,10,29,39,6,23,15,6,7,75,1
11273,261100,315_10_55,GREAT BRITAIN,0,TOTALS,GREAT BRITAIN,200,19,56,33.9,11,37,29.7,8,19,42.1,20,30,66.7,8,23,31,5,23,13,7,2,66,0
11274,261113,315_10_56,GEORGIA,0,TOTALS,GEORGIA,200,33,65,50.8,27,44,61.4,6,21,28.6,22,28,78.6,13,29,42,18,20,15,9,5,94,1
11275,261126,315_10_56,BULGARIA,0,TOTALS,BULGARIA,200,28,72,38.9,16,42,38.1,12,30,40.0,15,21,71.4,20,22,42,14,22,15,9,2,83,0
11276,261139,315_10_57,FINLAND,0,TOTALS,FINLAND,200,26,51,51.0,16,33,48.5,10,18,55.6,28,33,84.8,9,25,34,7,31,23,5,2,90,0
11277,261152,315_10_57,LATVIA,0,TOTALS,LATVIA,200,30,57,52.6,25,40,62.5,5,17,29.4,28,41,68.3,8,18,26,11,28,13,10,3,93,1
11278,261165,315_10_58,BELGIUM,0,TOTALS,BELGIUM,200,27,55,49.1,18,37,48.6,9,18,50.0,7,13,53.8,11,20,31,10,19,6,8,0,70,1
11279,261177,315_10_58,POLAND,0,TOTALS,POLAND,200,24,53,45.3,15,35,42.9,9,18,50.0,10,14,71.4,9,21,30,2,20,10,2,5,67,0
11280,261190,315_10_59,BOSNIA AND HERZEGOVINA,0,TOTALS,BOSNIA AND HERZEGOVINA,200,29,58,50.0,19,32,59.4,10,26,38.5,15,18,83.3,9,26,35,15,22,9,6,4,83,1
11281,261203,315_10_59,MKD,0,TOTALS,MKD,200,25,62,40.3,20,39,51.3,5,23,21.7,16,23,69.6,15,22,37,11,22,10,6,3,71,0
11282,261216,315_10_60,MONTENEGRO,0,TOTALS,MONTENEGRO,200,30,64,46.9,24,38,63.2,6,26,23.1,13,15,86.7,13,26,39,13,15,13,5,3,79,1
11283,261229,315_10_60,ISRAEL,0,TOTALS,ISRAEL,200,30,64,46.9,25,44,56.8,5,20,25.0,4,8,50.0,10,22,32,14,21,8,11,0,69,0
11284,261242,315_11_61,PORTUGAL,0,TOTALS,PORTUGAL,200,25,63,39.7,13,31,41.9,12,32,37.5,9,14,64.3,11,22,33,17,19,13,6,0,71,1
11285,261255,315_11_61,HUNGARY,0,TOTALS,HUNGARY,200,25,61,41.0,19,38,50.0,6,23,26.1,10,14,71.4,10,19,29,14,19,12,7,1,66,0
11286,261269,315_11_62,HUNGARY,0,TOTALS,HUNGARY,200,26,60,43.3,22,45,48.9,4,15,26.7,17,25,68.0,10,23,33,13,20,18,11,2,73,0
11287,261284,315_11_62,FINLAND,0,TOTALS,FINLAND,200,26,57,45.6,20,34,58.8,6,23,26.1,17,19,89.5,7,19,26,14,21,14,6,1,75,1
11288,261297,315_11_63,FINLAND,0,TOTALS,FINLAND,200,27,59,45.8,22,39,56.4,5,20,25.0,9,16,56.2,12,29,41,14,26,16,7,4,68,1
11289,261310,315_11_63,PORTUGAL,0,TOTALS,PORTUGAL,200,17,53,32.1,11,33,33.3,6,20,30.0,16,28,57.1,14,22,36,8,20,18,7,2,56,0
11290,261325,315_11_64,HUNGARY,0,TOTALS,HUNGARY,200,14,54,25.9,5,24,20.8,9,30,30.0,20,29,69.0,13,25,38,12,18,13,7,1,57,0
11291,261338,315_11_64,PORTUGAL,0,TOTALS,PORTUGAL,200,24,66,36.4,14,36,38.9,10,30,33.3,8,11,72.7,16,30,46,17,26,13,7,3,66,1
11292,261351,315_11_65,FINLAND,0,TOTALS,FINLAND,200,33,69,47.8,22,43,51.2,11,26,42.3,10,11,90.9,14,28,42,11,15,12,5,2,87,1
11293,261364,315_11_65,HUNGARY,0,TOTALS,HUNGARY,200,25,60,41.7,18,40,45.0,7,20,35.0,8,13,61.5,9,21,30,8,17,16,9,1,65,0
11294,261377,315_11_66,PORTUGAL,0,TOTALS,PORTUGAL,200,27,57,47.4,15,33,45.5,12,24,50.0,12,16,75.0,5,23,28,25,21,15,12,1,78,0
11295,261390,315_11_66,FINLAND,0,TOTALS,FINLAND,200,30,58,51.7,19,30,63.3,11,28,39.3,15,19,78.9,4,20,24,20,20,16,9,1,86,1
11296,261403,316_10_01,SWEDEN,0,TOTALS,SWEDEN,200,28,68,41.2,20,42,47.6,8,26,30.8,11,14,78.6,9,24,33,13,19,3,12,2,75,1
11297,261416,316_10_01,BELARUS,0,TOTALS,BELARUS,200,24,57,42.1,13,35,37.1,11,22,50.0,7,15,46.7,12,30,42,9,20,17,2,5,66,0
11298,261429,316_10_02,ALBANIA,0,TOTALS,ALBANIA,200,25,70,35.7,16,40,40.0,9,30,30.0,4,8,50.0,9,20,29,13,18,11,7,0,63,0
11299,261441,316_10_02,AZERBAIJAN,0,TOTALS,AZERBAIJAN,200,33,64,51.6,23,37,62.2,10,27,37.0,5,12,41.7,9,33,42,16,13,12,5,1,81,1
11300,261454,316_10_03,ROMANIA,0,TOTALS,ROMANIA,200,26,66,39.4,21,49,42.9,5,17,29.4,13,16,81.2,14,37,51,19,25,17,8,2,70,1
11301,261467,316_10_03,SWEDEN,0,TOTALS,SWEDEN,200,20,69,29.0,15,41,36.6,5,28,17.9,9,15,60.0,13,26,39,13,20,15,10,2,54,0
11302,261480,316_10_04,BELARUS,0,TOTALS,BELARUS,200,30,64,46.9,18,35,51.4,12,29,41.4,22,31,71.0,15,21,36,11,19,15,9,1,94,1
11303,261493,316_10_04,ALBANIA,0,TOTALS,ALBANIA,200,28,62,45.2,19,40,47.5,9,22,40.9,11,17,64.7,12,21,33,8,26,15,7,0,76,0
11304,261506,316_10_05,CYPRUS,0,TOTALS,CYPRUS,200,22,58,37.9,16,43,37.2,6,15,40.0,17,27,63.0,10,23,33,12,27,11,8,2,67,0
11305,261518,316_10_05,SWITZERLAND,0,TOTALS,SWITZERLAND,200,22,51,43.1,15,32,46.9,7,19,36.8,19,30,63.3,11,32,43,12,27,16,8,4,70,1
11306,261531,316_10_06,AZERBAIJAN,0,TOTALS,AZERBAIJAN,200,28,57,49.1,20,37,54.1,8,20,40.0,19,26,73.1,6,20,26,10,18,13,10,2,83,1
11307,261544,316_10_06,BELARUS,0,TOTALS,BELARUS,200,30,69,43.5,20,43,46.5,10,26,38.5,9,14,64.3,18,19,37,14,24,17,7,1,79,0
11308,261557,316_10_07,SLOVAK REPUBLIC,0,TOTALS,SLOVAK REPUBLIC,200,20,67,29.9,14,49,28.6,6,18,33.3,14,18,77.8,13,22,35,7,13,10,8,2,60,0
11309,261570,316_10_07,CZECH REPUBLIC,0,TOTALS,CZECH REPUBLIC,200,27,53,50.9,20,34,58.8,7,19,36.8,4,5,80.0,2,29,31,11,18,16,6,2,65,1
11310,261583,316_10_08,LUXEMBOURG,0,TOTALS,LUXEMBOURG,200,24,53,45.3,16,34,47.1,8,19,42.1,17,21,81.0,4,20,24,6,23,15,8,2,73,0
11311,261596,316_10_08,NETHERLANDS,0,TOTALS,NETHERLANDS,200,31,63,49.2,23,39,59.0,8,24,33.3,24,28,85.7,14,27,41,15,22,14,8,1,94,1
11312,261609,316_10_09,AUSTRIA,0,TOTALS,AUSTRIA,225,31,57,54.4,24,37,64.9,7,20,35.0,24,29,82.8,10,26,36,16,28,21,6,2,93,1
11313,261622,316_10_09,ESTONIA,0,TOTALS,ESTONIA,225,28,62,45.2,18,35,51.4,10,27,37.0,24,36,66.7,13,16,29,16,32,13,9,2,90,0
11314,261635,316_10_10,ALBANIA,0,TOTALS,ALBANIA,200,24,55,43.6,15,30,50.0,9,25,36.0,17,28,60.7,9,21,30,6,31,23,8,1,74,0
11315,261648,316_10_10,ROMANIA,0,TOTALS,ROMANIA,200,30,65,46.2,22,44,50.0,8,21,38.1,25,34,73.5,10,22,32,9,23,15,11,0,93,1
11316,261661,316_10_11,ROMANIA,0,TOTALS,ROMANIA,200,29,77,37.7,16,47,34.0,13,30,43.3,15,19,78.9,18,27,45,13,25,17,4,2,86,1
11317,261673,316_10_11,AZERBAIJAN,0,TOTALS,AZERBAIJAN,200,36,67,53.7,23,37,62.2,13,30,43.3,16,25,64.0,10,31,41,21,18,14,11,2,101,0
11318,261686,316_10_12,CZECH REPUBLIC,0,TOTALS,CZECH REPUBLIC,200,33,57,57.9,22,36,61.1,11,21,52.4,16,20,80.0,12,25,37,26,17,18,11,3,93,1
11319,261699,316_10_12,CYPRUS,0,TOTALS,CYPRUS,200,20,47,42.6,18,40,45.0,2,7,28.6,8,19,42.1,7,14,21,15,17,21,8,0,50,0
11320,261712,316_10_13,SWEDEN,0,TOTALS,SWEDEN,200,43,74,58.1,29,41,70.7,14,33,42.4,11,16,68.8,13,34,47,25,17,17,14,4,111,0
11321,261724,316_10_13,ALBANIA,0,TOTALS,ALBANIA,200,22,62,35.5,16,45,35.6,6,17,35.3,14,21,66.7,6,21,27,8,19,22,12,3,64,1
11322,261737,316_10_14,ESTONIA,0,TOTALS,ESTONIA,200,35,68,51.5,26,46,56.5,9,22,40.9,14,23,60.9,20,29,49,14,20,15,6,6,93,1
11323,261750,316_10_14,LUXEMBOURG,0,TOTALS,LUXEMBOURG,200,21,60,35.0,14,40,35.0,7,20,35.0,20,21,95.2,10,17,27,4,19,14,4,0,69,0
11324,261763,316_10_15,NETHERLANDS,0,TOTALS,NETHERLANDS,200,23,62,37.1,17,44,38.6,6,18,33.3,11,17,64.7,15,20,35,13,23,10,6,2,63,1
11325,261775,316_10_15,AUSTRIA,0,TOTALS,AUSTRIA,200,18,48,37.5,12,27,44.4,6,21,28.6,18,22,81.8,8,30,38,11,24,20,4,2,60,0
11326,261787,316_10_16,SWITZERLAND,0,TOTALS,SWITZERLAND,200,21,68,30.9,14,39,35.9,7,29,24.1,3,5,60.0,15,28,43,16,13,15,5,1,52,0
11327,261800,316_10_16,SLOVAK REPUBLIC,0,TOTALS,SLOVAK REPUBLIC,200,22,58,37.9,17,42,40.5,5,16,31.2,11,14,78.6,7,28,35,14,13,11,7,3,60,1
11328,261813,316_10_17,BELARUS,0,TOTALS,BELARUS,200,25,58,43.1,15,32,46.9,10,26,38.5,19,25,76.0,11,25,36,19,25,20,11,2,79,0
11329,261826,316_10_17,ROMANIA,0,TOTALS,ROMANIA,200,28,61,45.9,19,42,45.2,9,19,47.4,15,25,60.0,11,20,31,10,23,14,15,2,80,1
11330,261837,316_10_18,SWITZERLAND,0,TOTALS,SWITZERLAND,225,33,58,56.9,26,44,59.1,7,14,50.0,19,31,61.3,7,20,27,20,18,14,8,1,92,0
11331,261850,316_10_18,CZECH REPUBLIC,0,TOTALS,CZECH REPUBLIC,225,38,67,56.7,29,45,64.4,9,22,40.9,14,15,93.3,6,22,28,18,22,11,6,2,99,1
11332,261863,316_10_19,AZERBAIJAN,0,TOTALS,AZERBAIJAN,200,27,61,44.3,22,39,56.4,5,22,22.7,14,18,77.8,7,24,31,15,20,20,5,3,73,1
11333,261876,316_10_19,SWEDEN,0,TOTALS,SWEDEN,200,37,79,46.8,27,51,52.9,10,28,35.7,17,22,77.3,12,23,35,21,19,12,9,2,101,0
11334,261889,316_10_20,SLOVAK REPUBLIC,0,TOTALS,SLOVAK REPUBLIC,200,29,55,52.7,20,33,60.6,9,22,40.9,18,22,81.8,11,22,33,11,18,9,5,1,85,1
11335,261902,316_10_20,CYPRUS,0,TOTALS,CYPRUS,200,19,45,42.2,12,24,50.0,7,21,33.3,13,18,72.2,5,17,22,5,19,8,4,1,58,0
11336,261915,316_10_21,LUXEMBOURG,0,TOTALS,LUXEMBOURG,200,28,65,43.1,24,45,53.3,4,20,20.0,12,23,52.2,14,15,29,7,26,10,7,3,72,1
11337,261926,316_10_21,AUSTRIA,0,TOTALS,AUSTRIA,200,34,51,66.7,21,29,72.4,13,22,59.1,22,36,61.1,10,29,39,20,22,18,6,0,103,0
11338,261939,316_10_22,NETHERLANDS,0,TOTALS,NETHERLANDS,200,33,64,51.6,23,38,60.5,10,26,38.5,14,16,87.5,13,25,38,23,16,12,12,3,90,1
11339,261952,316_10_22,ESTONIA,0,TOTALS,ESTONIA,200,28,62,45.2,16,33,48.5,12,29,41.4,8,12,66.7,11,19,30,13,19,17,7,2,76,0
11340,261965,316_11_23,AZERBAIJAN,0,TOTALS,AZERBAIJAN,200,38,72,52.8,26,43,60.5,12,29,41.4,11,16,68.8,9,21,30,20,20,15,12,0,99,1
11341,261978,316_11_23,ALBANIA,0,TOTALS,ALBANIA,200,31,64,48.4,23,40,57.5,8,24,33.3,16,24,66.7,10,21,31,10,21,20,10,1,86,0
11342,261991,316_11_24,BELARUS,0,TOTALS,BELARUS,200,23,62,37.1,18,43,41.9,5,19,26.3,26,38,68.4,14,21,35,14,28,16,8,4,77,0
11343,262004,316_11_24,SWEDEN,0,TOTALS,SWEDEN,200,29,60,48.3,26,41,63.4,3,19,15.8,25,34,73.5,13,26,39,7,31,10,11,2,86,1
11344,262017,316_11_25,SWEDEN,0,TOTALS,SWEDEN,200,36,70,51.4,25,43,58.1,11,27,40.7,10,14,71.4,11,22,33,19,22,10,14,1,93,1
11345,262030,316_11_25,ROMANIA,0,TOTALS,ROMANIA,200,14,43,32.6,9,25,36.0,5,18,27.8,11,16,68.8,6,23,29,8,17,29,5,2,44,0
11346,262043,316_11_26,ALBANIA,0,TOTALS,ALBANIA,200,25,58,43.1,15,36,41.7,10,22,45.5,11,18,61.1,5,21,26,11,26,19,6,0,71,0
11347,262055,316_11_26,BELARUS,0,TOTALS,BELARUS,200,25,61,41.0,21,33,63.6,4,28,14.3,23,32,71.9,13,30,43,10,21,15,4,2,77,1
11348,262068,316_11_27,CZECH REPUBLIC,0,TOTALS,CZECH REPUBLIC,200,29,69,42.0,22,46,47.8,7,23,30.4,11,19,57.9,15,23,38,17,21,9,9,2,76,1
11349,262081,316_11_27,SLOVAK REPUBLIC,0,TOTALS,SLOVAK REPUBLIC,200,24,50,48.0,18,31,58.1,6,19,31.6,15,24,62.5,6,29,35,14,21,16,5,0,69,0
11350,262094,316_11_28,ROMANIA,0,TOTALS,ROMANIA,200,27,64,42.2,20,38,52.6,7,26,26.9,18,22,81.8,12,31,43,14,26,15,7,3,79,1
11351,262107,316_11_28,ALBANIA,0,TOTALS,ALBANIA,200,28,62,45.2,23,39,59.0,5,23,21.7,17,27,63.0,8,26,34,7,20,12,8,0,78,0
11352,262120,316_11_29,BELARUS,0,TOTALS,BELARUS,200,34,67,50.7,26,49,53.1,8,18,44.4,11,13,84.6,5,25,30,11,19,16,15,4,87,1
11353,262132,316_11_29,AZERBAIJAN,0,TOTALS,AZERBAIJAN,200,30,70,42.9,23,47,48.9,7,23,30.4,7,9,77.8,15,27,42,15,18,23,10,4,74,0
11354,262145,316_11_30,ESTONIA,0,TOTALS,ESTONIA,200,26,60,43.3,18,36,50.0,8,24,33.3,13,19,68.4,12,30,42,13,25,14,8,3,73,1
11355,262158,316_11_30,AUSTRIA,0,TOTALS,AUSTRIA,200,18,57,31.6,16,38,42.1,2,19,10.5,18,27,66.7,12,24,36,7,25,16,9,1,56,0
11356,262171,316_11_31,NETHERLANDS,0,TOTALS,NETHERLANDS,200,38,81,46.9,29,48,60.4,9,33,27.3,11,16,68.8,22,33,55,22,24,13,10,4,96,1
11357,262184,316_11_31,LUXEMBOURG,0,TOTALS,LUXEMBOURG,200,17,55,30.9,13,33,39.4,4,22,18.2,16,20,80.0,5,17,22,5,19,17,5,0,54,0
11358,262197,316_11_32,SWITZERLAND,0,TOTALS,SWITZERLAND,200,25,58,43.1,18,41,43.9,7,17,41.2,14,23,60.9,11,33,44,14,22,11,11,5,71,1
11359,262210,316_11_32,CYPRUS,0,TOTALS,CYPRUS,200,19,61,31.1,18,45,40.0,1,16,6.2,4,15,26.7,8,22,30,8,23,14,5,1,43,0
11360,262222,316_11_33,SLOVAK REPUBLIC,0,TOTALS,SLOVAK REPUBLIC,200,19,54,35.2,12,34,35.3,7,20,35.0,12,15,80.0,5,24,29,15,12,14,6,2,57,0
11361,262235,316_11_33,SWITZERLAND,0,TOTALS,SWITZERLAND,200,33,73,45.2,24,48,50.0,9,25,36.0,1,2,50.0,16,32,48,19,14,11,8,2,76,1
11362,262248,316_11_34,AZERBAIJAN,0,TOTALS,AZERBAIJAN,200,28,80,35.0,21,47,44.7,7,33,21.2,11,14,78.6,18,34,52,16,16,24,12,6,74,1
11363,262261,316_11_34,ROMANIA,0,TOTALS,ROMANIA,200,22,65,33.8,15,43,34.9,7,22,31.8,5,11,45.5,7,28,35,13,17,24,10,2,56,0
11364,262274,316_11_35,LUXEMBOURG,0,TOTALS,LUXEMBOURG,200,30,66,45.5,22,44,50.0,8,22,36.4,11,19,57.9,12,12,24,9,26,7,7,1,79,1
11365,262287,316_11_35,ESTONIA,0,TOTALS,ESTONIA,200,36,62,58.1,25,39,64.1,11,23,47.8,22,32,68.8,13,26,39,11,16,13,3,2,105,0
11366,262300,316_11_36,CYPRUS,0,TOTALS,CYPRUS,200,19,55,34.5,17,46,37.0,2,9,22.2,9,18,50.0,5,17,22,5,25,19,10,0,49,0
11367,262313,316_11_36,CZECH REPUBLIC,0,TOTALS,CZECH REPUBLIC,200,26,49,53.1,20,33,60.6,6,16,37.5,16,26,61.5,9,33,42,11,23,22,11,1,74,1
11368,262326,316_11_37,AUSTRIA,0,TOTALS,AUSTRIA,200,22,52,42.3,14,30,46.7,8,22,36.4,25,39,64.1,12,21,33,12,26,16,9,3,77,1
11369,262339,316_11_37,NETHERLANDS,0,TOTALS,NETHERLANDS,200,28,58,48.3,24,45,53.3,4,13,30.8,16,22,72.7,6,17,23,10,31,12,6,2,76,0
11370,262352,316_11_38,ALBANIA,0,TOTALS,ALBANIA,200,21,54,38.9,16,31,51.6,5,23,21.7,10,14,71.4,5,30,35,12,15,13,7,3,57,0
11371,262365,316_11_38,SWEDEN,0,TOTALS,SWEDEN,200,23,73,31.5,12,35,34.3,11,38,28.9,11,17,64.7,15,29,44,17,16,12,3,0,68,1
11372,262378,316_11_39,ROMANIA,0,TOTALS,ROMANIA,200,26,61,42.6,20,42,47.6,6,19,31.6,7,13,53.8,6,17,23,25,16,24,12,2,65,0
11373,262391,316_11_39,BELARUS,0,TOTALS,BELARUS,200,37,62,59.7,31,47,66.0,6,15,40.0,5,9,55.6,9,29,38,26,18,25,10,2,85,1
11374,262404,316_11_40,CZECH REPUBLIC,0,TOTALS,CZECH REPUBLIC,200,26,69,37.7,24,54,44.4,2,15,13.3,10,11,90.9,16,19,35,15,16,12,10,3,64,0
11375,262417,316_11_40,SWITZERLAND,0,TOTALS,SWITZERLAND,200,26,54,48.1,22,42,52.4,4,12,33.3,9,11,81.8,8,27,35,17,14,21,7,1,65,1
11376,262429,316_11_41,SWEDEN,0,TOTALS,SWEDEN,200,47,84,56.0,31,53,58.5,16,31,51.6,18,22,81.8,14,27,41,24,18,6,18,5,128,0
11377,262440,316_11_41,AZERBAIJAN,0,TOTALS,AZERBAIJAN,200,22,57,38.6,18,36,50.0,4,21,19.0,13,18,72.2,7,25,32,10,21,27,1,3,61,1
11378,262453,316_11_42,CYPRUS,0,TOTALS,CYPRUS,225,25,69,36.2,15,41,36.6,10,28,35.7,8,15,53.3,6,22,28,17,19,12,12,1,68,0
11379,262464,316_11_42,SLOVAK REPUBLIC,0,TOTALS,SLOVAK REPUBLIC,225,30,57,52.6,21,38,55.3,9,19,47.4,7,13,53.8,4,39,43,24,21,23,7,3,76,1
11380,262477,316_11_43,ESTONIA,0,TOTALS,ESTONIA,200,27,76,35.5,15,42,35.7,12,34,35.3,12,21,57.1,26,21,47,12,25,9,7,2,78,1
11381,262490,316_11_43,NETHERLANDS,0,TOTALS,NETHERLANDS,200,18,53,34.0,15,36,41.7,3,17,17.6,21,27,77.8,17,28,45,9,23,21,7,5,60,0
11382,262503,316_11_44,AUSTRIA,0,TOTALS,AUSTRIA,200,32,64,50.0,22,36,61.1,10,28,35.7,9,16,56.2,12,21,33,23,26,14,9,1,83,1
11383,262516,316_11_44,LUXEMBOURG,0,TOTALS,LUXEMBOURG,200,25,52,48.1,19,34,55.9,6,18,33.3,11,19,57.9,3,11,14,14,19,18,5,2,67,0
11384,262529,317_11_01,SPAIN,0,TOTALS,SPAIN,200,23,53,43.4,20,37,54.1,3,16,18.8,34,43,79.1,11,25,36,12,23,17,9,3,83,1
11385,262542,317_11_01,POLAND,0,TOTALS,POLAND,200,29,63,46.0,25,38,65.8,4,25,16.0,16,21,76.2,11,19,30,13,35,17,9,0,78,0
11386,262555,317_11_02,SERBIA,0,TOTALS,SERBIA,200,29,68,42.6,20,42,47.6,9,26,34.6,13,13,100.0,9,29,38,22,20,11,3,1,80,1
11387,262568,317_11_02,ITALY,0,TOTALS,ITALY,200,26,63,41.3,24,46,52.2,2,17,11.8,14,15,93.3,5,28,33,8,18,13,9,3,68,0
11388,262581,317_11_03,MONTENEGRO,0,TOTALS,MONTENEGRO,225,26,59,44.1,18,37,48.6,8,22,36.4,10,18,55.6,12,38,50,10,22,23,5,5,70,1
11389,262594,317_11_03,MKD,0,TOTALS,MKD,225,22,72,30.6,14,46,30.4,8,26,30.8,13,18,72.2,15,24,39,9,21,13,13,1,65,0
11390,262607,317_11_04,BELGIUM,0,TOTALS,BELGIUM,200,24,55,43.6,18,40,45.0,6,15,40.0,5,7,71.4,7,14,21,17,23,17,1,2,59,0
11391,262620,317_11_04,GEORGIA,0,TOTALS,GEORGIA,200,32,55,58.2,30,44,68.2,2,11,18.2,15,25,60.0,14,24,38,19,17,15,4,1,81,1
11392,262633,317_11_05,TURKEY,0,TOTALS,TURKEY,200,30,59,50.8,24,39,61.5,6,20,30.0,13,21,61.9,7,31,38,15,18,10,9,5,79,1
11393,262646,317_11_05,PORTUGAL,0,TOTALS,PORTUGAL,200,23,70,32.9,19,51,37.3,4,19,21.1,6,11,54.5,16,26,42,11,19,15,7,3,56,0
11394,262659,317_11_06,FRANCE,0,TOTALS,FRANCE,200,33,60,55.0,27,41,65.9,6,19,31.6,17,21,81.0,7,22,29,14,19,7,5,1,89,1
11395,262672,317_11_06,LATVIA,0,TOTALS,LATVIA,200,29,59,49.2,18,36,50.0,11,23,47.8,9,13,69.2,7,23,30,16,22,11,1,2,78,0
11396,262685,317_11_07,GREECE,0,TOTALS,GREECE,200,28,61,45.9,24,42,57.1,4,19,21.1,16,22,72.7,18,23,41,14,21,14,7,1,76,1
11397,262698,317_11_07,BOSNIA AND HERZEGOVINA,0,TOTALS,BOSNIA AND HERZEGOVINA,200,24,58,41.4,18,30,60.0,6,28,21.4,13,17,76.5,12,19,31,10,25,12,3,2,67,0
11398,262711,317_11_08,SLOVENIA,0,TOTALS,SLOVENIA,200,27,66,40.9,24,40,60.0,3,26,11.5,10,18,55.6,15,28,43,15,18,12,9,2,67,1
11399,262724,317_11_08,BULGARIA,0,TOTALS,BULGARIA,200,24,62,38.7,21,41,51.2,3,21,14.3,8,15,53.3,9,27,36,6,24,16,5,1,59,0
11400,262737,317_11_09,LITHUANIA,0,TOTALS,LITHUANIA,200,31,64,48.4,21,47,44.7,10,17,58.8,8,12,66.7,10,33,43,16,22,16,4,1,80,1
11401,262750,317_11_09,GREAT BRITAIN,0,TOTALS,GREAT BRITAIN,200,26,62,41.9,21,44,47.7,5,18,27.8,12,15,80.0,6,26,32,12,16,11,8,3,69,0
11402,262763,317_11_10,GERMANY,0,TOTALS,GERMANY,200,35,63,55.6,27,41,65.9,8,22,36.4,13,17,76.5,7,32,39,17,16,10,7,3,91,1
11403,262776,317_11_10,ISRAEL,0,TOTALS,ISRAEL,200,23,56,41.1,14,35,40.0,9,21,42.9,9,12,75.0,3,21,24,11,19,12,2,0,64,0
11404,262789,317_11_11,CROATIA,0,TOTALS,CROATIA,200,27,55,49.1,18,31,58.1,9,24,37.5,21,26,80.8,13,30,43,17,29,20,6,3,84,1
11405,262802,317_11_11,FINLAND,0,TOTALS,FINLAND,200,24,66,36.4,13,39,33.3,11,27,40.7,20,28,71.4,14,14,28,18,27,9,6,2,79,0
11406,262815,317_11_12,RUSSIA,0,TOTALS,RUSSIA,200,25,64,39.1,20,47,42.6,5,17,29.4,18,28,64.3,16,26,42,13,23,13,7,2,73,1
11407,262828,317_11_12,UKRAINE,0,TOTALS,UKRAINE,200,22,52,42.3,18,30,60.0,4,22,18.2,16,24,66.7,8,23,31,15,26,19,2,3,64,0
11408,262841,317_11_13,PORTUGAL,0,TOTALS,PORTUGAL,200,25,62,40.3,16,39,41.0,9,23,39.1,14,20,70.0,13,22,35,13,19,14,6,3,73,0
11409,262854,317_11_13,SPAIN,0,TOTALS,SPAIN,200,33,67,49.3,27,47,57.4,6,20,30.0,15,19,78.9,13,28,41,24,16,11,9,4,87,1
11410,262867,317_11_14,LATVIA,0,TOTALS,LATVIA,200,27,64,42.2,18,39,46.2,9,25,36.0,14,17,82.4,13,14,27,11,29,10,5,3,77,0
11411,262880,317_11_14,SERBIA,0,TOTALS,SERBIA,200,30,56,53.6,24,42,57.1,6,14,42.9,26,32,81.2,14,24,38,22,21,13,4,4,92,1
11412,262893,317_11_15,BOSNIA AND HERZEGOVINA,0,TOTALS,BOSNIA AND HERZEGOVINA,200,31,57,54.4,16,24,66.7,15,33,45.5,17,25,68.0,4,25,29,21,25,10,6,3,94,1
11413,262906,317_11_15,MONTENEGRO,0,TOTALS,MONTENEGRO,200,31,67,46.3,23,41,56.1,8,26,30.8,16,26,61.5,15,24,39,21,25,11,6,2,86,0
11414,262919,317_11_16,BULGARIA,0,TOTALS,BULGARIA,200,22,54,40.7,17,37,45.9,5,17,29.4,19,23,82.6,12,20,32,6,21,16,6,1,68,1
11415,262932,317_11_16,BELGIUM,0,TOTALS,BELGIUM,200,25,55,45.5,20,35,57.1,5,20,25.0,10,15,66.7,8,21,29,14,23,16,4,3,65,0
11416,262945,317_11_17,GREAT BRITAIN,0,TOTALS,GREAT BRITAIN,200,21,60,35.0,20,49,40.8,1,11,9.1,18,25,72.0,12,20,32,5,18,12,8,0,61,0
11417,262958,317_11_17,TURKEY,0,TOTALS,TURKEY,200,34,62,54.8,24,39,61.5,10,23,43.5,12,22,54.5,12,29,41,24,20,15,3,6,90,1
11418,262971,317_11_18,ISRAEL,0,TOTALS,ISRAEL,200,23,56,41.1,18,37,48.6,5,19,26.3,17,24,70.8,5,15,20,9,23,13,7,2,68,0
11419,262984,317_11_18,FRANCE,0,TOTALS,FRANCE,200,31,53,58.5,23,39,59.0,8,14,57.1,15,20,75.0,8,32,40,14,24,21,9,1,85,1
11420,262997,317_11_19,FINLAND,0,TOTALS,FINLAND,200,23,65,35.4,14,39,35.9,9,26,34.6,6,13,46.2,13,14,27,14,23,16,3,1,61,0
11421,263010,317_11_19,GREECE,0,TOTALS,GREECE,200,29,50,58.0,24,35,68.6,5,15,33.3,18,22,81.8,9,32,41,18,23,22,9,8,81,1
11422,263023,317_11_20,GEORGIA,0,TOTALS,GEORGIA,200,20,52,38.5,13,33,39.4,7,19,36.8,11,13,84.6,8,23,31,7,26,19,6,2,58,0
11423,263036,317_11_20,RUSSIA,0,TOTALS,RUSSIA,200,23,52,44.2,17,33,51.5,6,19,31.6,13,23,56.5,8,25,33,17,22,15,6,2,65,1
11424,263049,317_11_21,POLAND,0,TOTALS,POLAND,200,29,71,40.8,21,48,43.8,8,23,34.8,11,15,73.3,10,9,19,11,23,6,7,1,77,0
11425,263062,317_11_21,LITHUANIA,0,TOTALS,LITHUANIA,200,36,52,69.2,29,37,78.4,7,15,46.7,18,23,78.3,9,32,41,24,22,19,6,4,97,1
11426,263075,317_11_22,ITALY,0,TOTALS,ITALY,200,22,68,32.4,16,43,37.2,6,25,24.0,12,17,70.6,4,30,34,7,21,5,6,4,62,0
11427,263088,317_11_22,GERMANY,0,TOTALS,GERMANY,200,27,56,48.2,20,44,45.5,7,12,58.3,15,20,75.0,1,43,44,12,21,15,1,2,76,1
11428,263101,317_11_23,MKD,0,TOTALS,MKD,200,24,60,40.0,17,39,43.6,7,21,33.3,23,28,82.1,11,18,29,11,24,12,7,0,78,1
11429,263114,317_11_23,CROATIA,0,TOTALS,CROATIA,200,28,54,51.9,18,34,52.9,10,20,50.0,10,16,62.5,10,26,36,16,24,16,1,2,76,0
11430,263127,317_11_24,UKRAINE,0,TOTALS,UKRAINE,200,21,49,42.9,16,40,40.0,5,9,55.6,17,24,70.8,5,18,23,12,26,10,9,3,64,0
11431,263140,317_11_24,SLOVENIA,0,TOTALS,SLOVENIA,200,20,51,39.2,14,28,50.0,6,23,26.1,22,30,73.3,13,26,39,15,24,19,4,2,68,1
11432,263153,317_11_25,SPAIN,0,TOTALS,SPAIN,200,34,72,47.2,32,58,55.2,2,14,14.3,16,16,100.0,14,27,41,25,20,15,11,3,86,1
11433,263166,317_11_25,GREAT BRITAIN,0,TOTALS,GREAT BRITAIN,200,22,56,39.3,14,34,41.2,8,22,36.4,17,20,85.0,7,23,30,16,16,21,7,4,69,0
11434,263179,317_11_26,SERBIA,0,TOTALS,SERBIA,200,31,66,47.0,22,38,57.9,9,28,32.1,18,25,72.0,15,30,45,16,15,12,2,0,89,1
11435,263192,317_11_26,ISRAEL,0,TOTALS,ISRAEL,200,32,66,48.5,24,45,53.3,8,21,38.1,8,9,88.9,3,24,27,13,24,10,8,0,80,0
11436,263205,317_11_27,PORTUGAL,0,TOTALS,PORTUGAL,200,24,56,42.9,14,30,46.7,10,26,38.5,15,21,71.4,8,17,25,12,22,16,11,2,73,0
11437,263218,317_11_27,POLAND,0,TOTALS,POLAND,200,27,57,47.4,19,34,55.9,8,23,34.8,19,25,76.0,14,25,39,15,24,21,7,0,81,1
11438,263231,317_11_28,LATVIA,0,TOTALS,LATVIA,200,22,65,33.8,16,39,41.0,6,26,23.1,12,21,57.1,13,34,47,13,29,12,0,1,62,0
11439,263244,317_11_28,ITALY,0,TOTALS,ITALY,200,21,64,32.8,17,45,37.8,4,19,21.1,25,28,89.3,9,33,42,8,25,7,7,3,71,1
11440,263257,317_11_29,TURKEY,0,TOTALS,TURKEY,200,26,57,45.6,23,39,59.0,3,18,16.7,13,17,76.5,10,20,30,13,24,13,4,3,68,0
11441,263270,317_11_29,LITHUANIA,0,TOTALS,LITHUANIA,200,27,54,50.0,22,42,52.4,5,12,41.7,16,20,80.0,10,21,31,18,21,13,4,0,75,1
11442,263283,317_11_30,FRANCE,0,TOTALS,FRANCE,200,29,60,48.3,23,48,47.9,6,12,50.0,12,14,85.7,6,24,30,12,21,8,6,1,76,1
11443,263296,317_11_30,GERMANY,0,TOTALS,GERMANY,200,18,47,38.3,12,33,36.4,6,14,42.9,23,27,85.2,4,26,30,9,22,14,2,2,65,0
11444,263309,317_11_31,FINLAND,0,TOTALS,FINLAND,200,36,65,55.4,27,42,64.3,9,23,39.1,11,14,78.6,9,24,33,24,23,8,6,1,92,1
11445,263322,317_11_31,BOSNIA AND HERZEGOVINA,0,TOTALS,BOSNIA AND HERZEGOVINA,200,22,51,43.1,15,28,53.6,7,23,30.4,13,21,61.9,9,20,29,12,22,16,3,1,64,0
11446,263335,317_11_32,UKRAINE,0,TOTALS,UKRAINE,200,24,55,43.6,16,37,43.2,8,18,44.4,11,15,73.3,7,31,38,9,21,14,5,4,67,1
11447,263348,317_11_32,BULGARIA,0,TOTALS,BULGARIA,200,19,67,28.4,12,42,28.6,7,25,28.0,11,18,61.1,19,26,45,10,18,12,4,0,56,0
11448,263361,317_11_33,GREECE,0,TOTALS,GREECE,200,19,61,31.1,15,42,35.7,4,19,21.1,16,21,76.2,12,32,44,14,25,13,3,2,58,0
11449,263374,317_11_33,MKD,0,TOTALS,MKD,200,21,60,35.0,12,35,34.3,9,25,36.0,21,24,87.5,8,31,39,11,20,7,4,3,72,1
11450,263387,317_11_34,SLOVENIA,0,TOTALS,SLOVENIA,200,26,65,40.0,11,30,36.7,15,35,42.9,20,24,83.3,15,14,29,19,24,8,10,1,87,1
11451,263400,317_11_34,GEORGIA,0,TOTALS,GEORGIA,200,28,53,52.8,21,37,56.8,7,16,43.8,12,20,60.0,13,25,38,14,27,21,4,3,75,0
11452,263413,317_11_35,CROATIA,0,TOTALS,CROATIA,200,32,63,50.8,22,37,59.5,10,26,38.5,13,16,81.2,9,22,31,26,23,12,3,0,87,1
11453,263426,317_11_35,MONTENEGRO,0,TOTALS,MONTENEGRO,200,29,58,50.0,23,42,54.8,6,16,37.5,17,20,85.0,7,23,30,14,23,14,3,0,81,0
11454,263439,317_11_36,RUSSIA,0,TOTALS,RUSSIA,200,29,57,50.9,18,37,48.6,11,20,55.0,10,17,58.8,13,26,39,21,25,13,8,1,79,1
11455,263452,317_11_36,BELGIUM,0,TOTALS,BELGIUM,200,19,52,36.5,13,32,40.6,6,20,30.0,14,26,53.8,14,18,32,11,19,17,4,2,58,0
11456,263465,317_11_37,GREAT BRITAIN,0,TOTALS,GREAT BRITAIN,200,31,72,43.1,23,47,48.9,8,25,32.0,15,19,78.9,11,30,41,14,23,16,10,4,85,1
11457,263478,317_11_37,PORTUGAL,0,TOTALS,PORTUGAL,200,20,65,30.8,13,35,37.1,7,30,23.3,26,27,96.3,14,31,45,8,20,21,8,1,73,0
11458,263491,317_11_38,ISRAEL,0,TOTALS,ISRAEL,200,34,75,45.3,30,56,53.6,4,19,21.1,19,28,67.9,16,26,42,19,26,7,7,0,91,1
11459,263504,317_11_38,LATVIA,0,TOTALS,LATVIA,200,30,61,49.2,20,35,57.1,10,26,38.5,18,30,60.0,7,30,37,11,24,14,2,3,88,0
11460,263517,317_11_39,MKD,0,TOTALS,MKD,200,27,63,42.9,22,43,51.2,5,20,25.0,13,16,81.2,16,28,44,11,19,14,9,3,72,1
11461,263530,317_11_39,FINLAND,0,TOTALS,FINLAND,200,27,65,41.5,18,45,40.0,9,20,45.0,7,13,53.8,14,20,34,16,18,11,3,2,70,0
11462,263543,317_11_40,GEORGIA,0,TOTALS,GEORGIA,200,29,64,45.3,25,48,52.1,4,16,25.0,7,13,53.8,14,26,40,15,20,16,5,0,69,1
11463,263556,317_11_40,UKRAINE,0,TOTALS,UKRAINE,200,20,50,40.0,13,29,44.8,7,21,33.3,6,12,50.0,6,23,29,14,18,23,7,4,53,0
11464,263569,317_11_41,POLAND,0,TOTALS,POLAND,200,31,56,55.4,21,34,61.8,10,22,45.5,12,16,75.0,6,15,21,16,25,19,5,3,84,1
11465,263582,317_11_41,TURKEY,0,TOTALS,TURKEY,200,28,55,50.9,24,38,63.2,4,17,23.5,23,28,82.1,12,19,31,14,20,15,7,4,83,0
11466,263595,317_11_42,ITALY,0,TOTALS,ITALY,200,29,58,50.0,21,32,65.6,8,26,30.8,18,21,85.7,3,16,19,13,25,9,3,2,84,0
11467,263608,317_11_42,FRANCE,0,TOTALS,FRANCE,200,32,59,54.2,28,49,57.1,4,10,40.0,23,25,92.0,11,27,38,14,21,12,5,2,91,1
11468,263621,317_11_43,MONTENEGRO,0,TOTALS,MONTENEGRO,200,20,58,34.5,16,40,40.0,4,18,22.2,11,17,64.7,14,22,36,10,26,15,6,1,55,0
11469,263634,317_11_43,GREECE,0,TOTALS,GREECE,200,24,57,42.1,19,36,52.8,5,21,23.8,18,21,85.7,13,25,38,16,23,14,11,5,71,1
11470,263647,317_11_44,BULGARIA,0,TOTALS,BULGARIA,200,28,57,49.1,23,38,60.5,5,19,26.3,16,22,72.7,14,13,27,12,21,22,6,3,77,0
11471,263660,317_11_44,RUSSIA,0,TOTALS,RUSSIA,200,34,59,57.6,28,46,60.9,6,13,46.2,15,22,68.2,12,16,28,25,25,17,9,4,89,1
11472,263673,317_11_45,LITHUANIA,0,TOTALS,LITHUANIA,200,31,59,52.5,24,40,60.0,7,19,36.8,10,14,71.4,7,25,32,21,21,13,2,2,79,0
11473,263686,317_11_45,SPAIN,0,TOTALS,SPAIN,200,32,68,47.1,19,42,45.2,13,26,50.0,14,17,82.4,11,23,34,25,21,7,7,3,91,1
11474,263699,317_11_46,GERMANY,0,TOTALS,GERMANY,200,25,62,40.3,16,37,43.2,9,25,36.0,5,6,83.3,5,26,31,10,21,14,5,2,64,0
11475,263712,317_11_46,SERBIA,0,TOTALS,SERBIA,200,27,62,43.5,18,37,48.6,9,25,36.0,12,14,85.7,8,32,40,18,16,15,3,0,75,1
11476,263725,317_11_47,BOSNIA AND HERZEGOVINA,0,TOTALS,BOSNIA AND HERZEGOVINA,200,31,58,53.4,18,29,62.1,13,29,44.8,17,27,63.0,5,29,34,14,24,11,7,0,92,1
11477,263738,317_11_47,CROATIA,0,TOTALS,CROATIA,200,29,66,43.9,25,42,59.5,4,24,16.7,18,21,85.7,9,27,36,15,22,9,8,2,80,0
11478,263751,317_11_48,BELGIUM,0,TOTALS,BELGIUM,200,20,50,40.0,10,28,35.7,10,22,45.5,11,14,78.6,6,22,28,13,27,18,6,3,61,0
11479,263764,317_11_48,SLOVENIA,0,TOTALS,SLOVENIA,200,26,58,44.8,23,40,57.5,3,18,16.7,15,27,55.6,14,26,40,14,19,14,13,2,70,1
11480,263777,317_11_49,GREAT BRITAIN,0,TOTALS,GREAT BRITAIN,200,34,66,51.5,29,51,56.9,5,15,33.3,15,23,65.2,16,30,46,13,20,16,5,0,88,1
11481,263790,317_11_49,POLAND,0,TOTALS,POLAND,200,31,67,46.3,26,45,57.8,5,22,22.7,14,18,77.8,5,20,25,22,24,12,7,3,81,0
11482,263803,317_11_50,ISRAEL,0,TOTALS,ISRAEL,225,34,67,50.7,25,47,53.2,9,20,45.0,19,27,70.4,7,24,31,22,15,9,8,1,96,1
11483,263816,317_11_50,ITALY,0,TOTALS,ITALY,225,38,73,52.1,27,47,57.4,11,26,42.3,8,10,80.0,10,29,39,20,25,15,4,1,95,0
11484,263829,317_11_51,FINLAND,0,TOTALS,FINLAND,200,23,62,37.1,18,39,46.2,5,23,21.7,20,29,69.0,21,25,46,13,29,15,7,2,71,1
11485,263842,317_11_51,MONTENEGRO,0,TOTALS,MONTENEGRO,200,19,53,35.8,16,30,53.3,3,23,13.0,24,32,75.0,11,18,29,14,30,15,8,0,65,0
11486,263855,317_11_52,GEORGIA,0,TOTALS,GEORGIA,200,27,56,48.2,22,40,55.0,5,16,31.2,10,17,58.8,12,22,34,13,17,22,6,4,69,0
11487,263868,317_11_52,BULGARIA,0,TOTALS,BULGARIA,200,29,62,46.8,19,39,48.7,10,23,43.5,11,16,68.8,13,20,33,19,20,17,6,0,79,1
11488,263881,317_11_53,SPAIN,0,TOTALS,SPAIN,200,21,55,38.2,17,38,44.7,4,17,23.5,11,17,64.7,7,26,33,12,22,11,3,1,57,0
11489,263894,317_11_53,TURKEY,0,TOTALS,TURKEY,200,24,60,40.0,18,43,41.9,6,17,35.3,11,17,64.7,8,29,37,11,22,10,4,2,65,1
11490,263907,317_11_54,LATVIA,0,TOTALS,LATVIA,200,28,60,46.7,20,36,55.6,8,24,33.3,16,27,59.3,11,25,36,15,25,9,5,1,80,0
11491,263920,317_11_54,GERMANY,0,TOTALS,GERMANY,200,24,53,45.3,15,31,48.4,9,22,40.9,24,31,77.4,5,25,30,18,24,9,3,4,81,1
11492,263933,317_11_55,GREECE,0,TOTALS,GREECE,200,21,59,35.6,12,33,36.4,9,26,34.6,23,27,85.2,11,27,38,12,20,9,6,5,74,1
11493,263946,317_11_55,CROATIA,0,TOTALS,CROATIA,200,26,65,40.0,22,48,45.8,4,17,23.5,13,16,81.2,13,26,39,13,25,9,4,3,69,0
11494,263959,317_11_56,SLOVENIA,0,TOTALS,SLOVENIA,200,21,56,37.5,15,33,45.5,6,23,26.1,16,22,72.7,15,24,39,10,17,15,3,2,64,0
11495,263972,317_11_56,RUSSIA,0,TOTALS,RUSSIA,200,27,61,44.3,21,43,48.8,6,18,33.3,5,12,41.7,12,21,33,19,23,10,7,2,65,1
11496,263985,317_11_57,PORTUGAL,0,TOTALS,PORTUGAL,200,22,62,35.5,12,35,34.3,10,27,37.0,15,18,83.3,11,15,26,14,34,12,4,1,69,0
11497,263998,317_11_57,LITHUANIA,0,TOTALS,LITHUANIA,200,29,48,60.4,22,37,59.5,7,11,63.6,33,43,76.7,9,31,40,16,22,17,5,2,98,1
11498,264011,317_11_58,SERBIA,0,TOTALS,SERBIA,225,30,59,50.8,19,36,52.8,11,23,47.8,25,31,80.6,7,22,29,24,25,18,8,1,96,0
11499,264024,317_11_58,FRANCE,0,TOTALS,FRANCE,225,36,71,50.7,35,64,54.7,1,7,14.3,24,28,85.7,13,24,37,17,24,14,14,4,97,1
11500,264037,317_11_59,MKD,0,TOTALS,MKD,200,29,73,39.7,20,42,47.6,9,31,29.0,8,11,72.7,16,22,38,18,15,4,8,2,75,1
11501,264050,317_11_59,BOSNIA AND HERZEGOVINA,0,TOTALS,BOSNIA AND HERZEGOVINA,200,24,51,47.1,17,33,51.5,7,18,38.9,8,11,72.7,6,29,35,9,17,18,3,2,63,0
11502,264063,317_11_60,UKRAINE,0,TOTALS,UKRAINE,200,26,52,50.0,17,31,54.8,9,21,42.9,13,26,50.0,9,25,34,15,18,14,3,1,74,1
11503,264076,317_11_60,BELGIUM,0,TOTALS,BELGIUM,200,21,51,41.2,12,27,44.4,9,24,37.5,10,15,66.7,6,23,29,18,25,16,3,0,61,0
11504,264089,317_11_61,GERMANY,0,TOTALS,GERMANY,200,26,60,43.3,21,44,47.7,5,16,31.2,11,14,78.6,11,28,39,9,24,16,7,2,68,0
11505,264102,317_11_61,SPAIN,0,TOTALS,SPAIN,200,25,60,41.7,20,40,50.0,5,20,25.0,22,27,81.5,9,24,33,15,20,8,8,2,77,1
11506,264115,317_11_62,TURKEY,0,TOTALS,TURKEY,200,21,59,35.6,16,35,45.7,5,24,20.8,17,22,77.3,15,27,42,5,27,16,5,4,64,0
11507,264128,317_11_62,FRANCE,0,TOTALS,FRANCE,200,21,60,35.0,17,43,39.5,4,17,23.5,22,28,78.6,11,22,33,10,20,9,5,4,68,1
11508,264141,317_11_63,SERBIA,0,TOTALS,SERBIA,200,31,62,50.0,24,44,54.5,7,18,38.9,21,29,72.4,11,18,29,11,23,12,6,2,90,1
11509,264154,317_11_63,LITHUANIA,0,TOTALS,LITHUANIA,200,38,63,60.3,27,43,62.8,11,20,55.0,13,19,68.4,10,24,34,25,26,15,5,4,100,0
11510,264167,317_11_64,GEORGIA,0,TOTALS,GEORGIA,200,19,52,36.5,15,37,40.5,4,15,26.7,21,29,72.4,15,31,46,11,23,21,7,2,63,0
11511,264180,317_11_64,MKD,0,TOTALS,MKD,200,22,66,33.3,16,39,41.0,6,27,22.2,15,18,83.3,12,20,32,9,29,10,13,5,65,1
11512,264193,317_11_65,FINLAND,0,TOTALS,FINLAND,200,20,58,34.5,11,37,29.7,9,21,42.9,11,15,73.3,10,17,27,9,21,18,7,0,60,0
11513,264206,317_11_65,RUSSIA,0,TOTALS,RUSSIA,200,32,54,59.3,31,44,70.5,1,10,10.0,14,18,77.8,6,28,34,22,19,19,14,6,79,1
11514,264219,317_11_66,SLOVENIA,0,TOTALS,SLOVENIA,200,20,53,37.7,14,28,50.0,6,25,24.0,14,24,58.3,11,25,36,12,15,10,7,3,60,0
11515,264232,317_11_66,GREECE,0,TOTALS,GREECE,200,27,60,45.0,19,43,44.2,8,17,47.1,6,8,75.0,9,28,37,12,19,10,4,3,68,1
11516,264245,317_11_67,SPAIN,0,TOTALS,SPAIN,200,30,61,49.2,25,44,56.8,5,17,29.4,19,27,70.4,12,28,40,21,22,7,11,3,84,1
11517,264258,317_11_67,SERBIA,0,TOTALS,SERBIA,200,20,57,35.1,16,41,39.0,4,16,25.0,15,20,75.0,9,20,29,17,22,12,3,1,59,0
11518,264271,317_11_68,GERMANY,0,TOTALS,GERMANY,200,27,59,45.8,20,39,51.3,7,20,35.0,12,13,92.3,6,28,34,11,24,10,4,3,73,1
11519,264284,317_11_68,TURKEY,0,TOTALS,TURKEY,200,26,67,38.8,21,50,42.0,5,17,29.4,10,22,45.5,17,26,43,9,22,10,4,1,67,0
11520,264297,317_11_69,LITHUANIA,0,TOTALS,LITHUANIA,200,26,64,40.6,19,41,46.3,7,23,30.4,8,12,66.7,13,26,39,15,20,16,6,1,67,0
11521,264310,317_11_69,FRANCE,0,TOTALS,FRANCE,200,28,64,43.8,25,52,48.1,3,12,25.0,14,19,73.7,11,27,38,10,17,10,11,3,73,1
11522,264323,317_11_70,GEORGIA,0,TOTALS,GEORGIA,200,28,60,46.7,24,41,58.5,4,19,21.1,13,20,65.0,12,23,35,14,24,14,5,2,73,0
11523,264336,317_11_70,FINLAND,0,TOTALS,FINLAND,200,27,63,42.9,14,37,37.8,13,26,50.0,20,26,76.9,17,20,37,16,27,12,3,1,87,1
11524,264349,317_11_71,MKD,0,TOTALS,MKD,200,22,52,42.3,15,27,55.6,7,25,28.0,17,21,81.0,6,26,32,14,22,13,8,1,68,1
11525,264362,317_11_71,SLOVENIA,0,TOTALS,SLOVENIA,200,24,60,40.0,20,37,54.1,4,23,17.4,7,11,63.6,12,22,34,11,23,16,4,2,59,0
11526,264375,317_11_72,GREECE,0,TOTALS,GREECE,200,24,53,45.3,18,32,56.2,6,21,28.6,13,16,81.2,6,16,22,12,19,13,7,1,67,0
11527,264388,317_11_72,RUSSIA,0,TOTALS,RUSSIA,200,33,58,56.9,25,38,65.8,8,20,40.0,9,15,60.0,12,23,35,20,18,12,6,4,83,1
11528,264401,317_11_73,SERBIA,0,TOTALS,SERBIA,200,25,54,46.3,20,38,52.6,5,16,31.2,13,16,81.2,8,30,38,8,29,13,2,1,68,1
11529,264414,317_11_73,TURKEY,0,TOTALS,TURKEY,200,24,63,38.1,21,46,45.7,3,17,17.6,16,29,55.2,14,21,35,5,21,5,6,2,67,0
11530,264427,317_11_74,FRANCE,0,TOTALS,FRANCE,200,25,56,44.6,22,45,48.9,3,11,27.3,16,21,76.2,8,20,28,9,22,17,7,2,69,0
11531,264440,317_11_74,SPAIN,0,TOTALS,SPAIN,200,34,63,54.0,24,44,54.5,10,19,52.6,18,22,81.8,11,24,35,23,20,14,10,2,96,1
11532,264453,317_11_75,LITHUANIA,0,TOTALS,LITHUANIA,200,31,64,48.4,28,55,50.9,3,9,33.3,19,24,79.2,12,28,40,10,19,11,6,2,84,1
11533,264466,317_11_75,GERMANY,0,TOTALS,GERMANY,200,29,62,46.8,22,45,48.9,7,17,41.2,10,13,76.9,5,24,29,3,22,12,3,3,75,0
11534,264479,317_11_76,SLOVENIA,0,TOTALS,SLOVENIA,200,23,60,38.3,16,39,41.0,7,21,33.3,14,22,63.6,17,25,42,14,21,11,5,1,67,1
11535,264492,317_11_76,FINLAND,0,TOTALS,FINLAND,200,20,53,37.7,15,40,37.5,5,13,38.5,15,21,71.4,10,23,33,7,24,12,6,2,60,0
11536,264505,317_11_77,GREECE,0,TOTALS,GREECE,200,30,54,55.6,24,38,63.2,6,16,37.5,7,11,63.6,3,22,25,14,18,15,11,5,73,1
11537,264518,317_11_77,GEORGIA,0,TOTALS,GEORGIA,200,26,62,41.9,23,47,48.9,3,15,20.0,5,9,55.6,16,23,39,8,17,18,11,0,60,0
11538,264531,317_11_78,RUSSIA,0,TOTALS,RUSSIA,200,27,63,42.9,22,45,48.9,5,18,27.8,4,5,80.0,14,31,45,15,21,16,3,5,63,1
11539,264544,317_11_78,MKD,0,TOTALS,MKD,200,21,55,38.2,12,34,35.3,9,21,42.9,10,18,55.6,6,22,28,13,13,11,9,2,61,0
11540,264557,317_11_79,SPAIN,0,TOTALS,SPAIN,200,31,63,49.2,23,42,54.8,8,21,38.1,16,19,84.2,13,34,47,16,18,18,9,7,86,1
11541,264570,317_11_79,SLOVENIA,0,TOTALS,SLOVENIA,200,25,72,34.7,19,45,42.2,6,27,22.2,8,10,80.0,15,17,32,9,25,13,12,1,64,0
11542,264583,317_11_80,MKD,0,TOTALS,MKD,200,21,67,31.3,12,35,34.3,9,32,28.1,16,21,76.2,18,23,41,7,18,8,5,1,67,1
11543,264596,317_11_80,LITHUANIA,0,TOTALS,LITHUANIA,200,29,63,46.0,27,48,56.2,2,15,13.3,5,8,62.5,12,32,44,12,22,14,2,3,65,0
11544,264609,317_11_81,SLOVENIA,0,TOTALS,SLOVENIA,200,31,66,47.0,23,43,53.5,8,23,34.8,7,10,70.0,11,22,33,14,24,12,8,5,77,0
11545,264622,317_11_81,LITHUANIA,0,TOTALS,LITHUANIA,200,30,64,46.9,27,54,50.0,3,10,30.0,17,20,85.0,12,26,38,20,18,11,8,3,80,1
11546,264635,317_11_82,FRANCE,0,TOTALS,FRANCE,200,25,56,44.6,20,46,43.5,5,10,50.0,9,11,81.8,9,25,34,9,21,11,6,4,64,1
11547,264648,317_11_82,GREECE,0,TOTALS,GREECE,200,17,50,34.0,14,29,48.3,3,21,14.3,19,23,82.6,6,24,30,10,19,10,6,3,56,0
11548,264661,317_11_83,RUSSIA,0,TOTALS,RUSSIA,200,31,67,46.3,24,44,54.5,7,23,30.4,8,15,53.3,14,23,37,19,22,13,12,6,77,1
11549,264674,317_11_83,SERBIA,0,TOTALS,SERBIA,200,22,48,45.8,15,27,55.6,7,21,33.3,16,20,80.0,5,23,28,11,21,19,8,2,67,0
11550,264687,317_11_84,GREECE,0,TOTALS,GREECE,200,29,55,52.7,23,37,62.2,6,18,33.3,23,27,85.2,9,21,30,17,19,12,7,1,87,1
11551,264700,317_11_84,SERBIA,0,TOTALS,SERBIA,200,29,59,49.2,22,35,62.9,7,24,29.2,12,16,75.0,8,20,28,17,25,13,8,0,77,0
11552,264713,317_11_85,SPAIN,0,TOTALS,SPAIN,200,35,78,44.9,27,55,49.1,8,23,34.8,14,17,82.4,19,28,47,22,16,6,4,4,92,1
11553,264726,317_11_85,MKD,0,TOTALS,MKD,200,34,68,50.0,29,49,59.2,5,19,26.3,7,12,58.3,7,25,32,14,19,6,5,1,80,0
11554,264739,317_11_86,FRANCE,0,TOTALS,FRANCE,200,30,56,53.6,23,44,52.3,7,12,58.3,12,14,85.7,12,23,35,14,21,19,10,2,79,1
11555,264752,317_11_86,RUSSIA,0,TOTALS,RUSSIA,200,25,54,46.3,17,34,50.0,8,20,40.0,13,17,76.5,8,13,21,19,17,15,10,3,71,0
11556,264765,317_11_87,SLOVENIA,0,TOTALS,SLOVENIA,200,26,59,44.1,13,32,40.6,13,27,48.1,7,11,63.6,8,25,33,13,22,15,7,7,72,1
11557,264778,317_11_87,SERBIA,0,TOTALS,SERBIA,200,26,60,43.3,23,45,51.1,3,15,20.0,13,18,72.2,11,26,37,15,19,16,4,2,68,0
11558,264791,317_11_88,LITHUANIA,0,TOTALS,LITHUANIA,200,29,68,42.6,23,48,47.9,6,20,30.0,9,13,69.2,20,27,47,10,18,15,4,1,73,1
11559,264804,317_11_88,GREECE,0,TOTALS,GREECE,200,26,61,42.6,21,42,50.0,5,19,26.3,12,17,70.6,8,21,29,17,21,8,8,3,69,0
11560,264817,317_11_89,MKD,0,TOTALS,MKD,200,20,58,34.5,14,34,41.2,6,24,25.0,22,24,91.7,14,11,25,10,24,11,9,1,68,0
11561,264830,317_11_89,RUSSIA,0,TOTALS,RUSSIA,200,23,55,41.8,16,33,48.5,7,22,31.8,19,24,79.2,22,21,43,14,25,18,6,5,72,1
11562,264843,317_11_90,SPAIN,0,TOTALS,SPAIN,200,35,63,55.6,29,45,64.4,6,18,33.3,22,24,91.7,7,25,32,19,22,8,10,10,98,1
11563,264856,317_11_90,FRANCE,0,TOTALS,FRANCE,200,33,68,48.5,24,46,52.2,9,22,40.9,10,13,76.9,10,22,32,17,24,15,4,1,85,0
11564,269316,321_11_01,CROATIA,0,TOTALS,CROATIA,200,12,53,22.6,9,34,26.5,3,19,15.8,6,12,50.0,14,27,41,6,19,21,9,1,33,0
11565,269329,321_11_01,FRANCE,0,TOTALS,FRANCE,200,20,60,33.3,16,44,36.4,4,16,25.0,5,13,38.5,19,32,51,6,14,19,11,8,49,1
11566,269342,321_11_02,MONTENEGRO,0,TOTALS,MONTENEGRO,200,33,79,41.8,26,59,44.1,7,20,35.0,7,12,58.3,25,21,46,13,23,13,7,3,80,1
11567,269354,321_11_02,SLOVENIA,0,TOTALS,SLOVENIA,200,29,58,50.0,22,47,46.8,7,11,63.6,12,19,63.2,8,24,32,16,17,15,3,2,77,0
11568,269367,321_11_03,ITALY,0,TOTALS,ITALY,200,29,76,38.2,19,48,39.6,10,28,35.7,9,14,64.3,12,20,32,16,21,15,14,2,77,0
11569,269380,321_11_03,LITHUANIA,0,TOTALS,LITHUANIA,200,30,57,52.6,22,43,51.2,8,14,57.1,14,21,66.7,9,35,44,15,19,31,5,3,82,1
11570,269393,321_11_04,RUSSIA,0,TOTALS,RUSSIA,200,21,52,40.4,15,27,55.6,6,25,24.0,14,22,63.6,13,23,36,10,21,16,4,2,62,0
11571,269406,321_11_04,SERBIA,0,TOTALS,SERBIA,200,29,65,44.6,24,47,51.1,5,18,27.8,9,12,75.0,14,18,32,11,24,13,6,2,72,1
11572,269419,321_11_05,UKRAINE,0,TOTALS,UKRAINE,200,23,62,37.1,16,38,42.1,7,24,29.2,15,22,68.2,14,24,38,13,16,11,4,2,68,0
11573,269432,321_11_05,GERMANY,0,TOTALS,GERMANY,200,25,57,43.9,15,35,42.9,10,22,45.5,12,14,85.7,8,27,35,12,21,13,4,5,72,1
11574,269445,321_11_06,AUSTRIA,0,TOTALS,AUSTRIA,200,20,63,31.7,15,40,37.5,5,23,21.7,6,11,54.5,12,22,34,8,20,12,4,1,51,0
11575,269458,321_11_06,GREECE,0,TOTALS,GREECE,200,26,55,47.3,20,36,55.6,6,19,31.6,11,19,57.9,9,33,42,13,15,10,1,3,69,1
11576,269471,321_11_07,SPAIN,0,TOTALS,SPAIN,200,32,57,56.1,22,33,66.7,10,24,41.7,16,27,59.3,10,30,40,17,17,10,7,6,90,1
11577,269484,321_11_07,TURKEY,0,TOTALS,TURKEY,200,19,59,32.2,17,39,43.6,2,20,10.0,1,10,10.0,15,23,38,9,27,17,6,0,41,0
11578,269497,321_11_08,SWEDEN,0,TOTALS,SWEDEN,200,24,76,31.6,21,55,38.2,3,21,14.3,6,7,85.7,19,26,45,5,22,8,4,3,57,0
11579,269510,321_11_08,LATVIA,0,TOTALS,LATVIA,200,21,55,38.2,19,34,55.9,2,21,9.5,15,22,68.2,10,33,43,9,15,12,1,3,59,1
11580,269522,321_11_09,SLOVENIA,0,TOTALS,SLOVENIA,200,23,61,37.7,18,40,45.0,5,21,23.8,15,25,60.0,15,19,34,10,19,15,5,1,66,0
11581,269535,321_11_09,RUSSIA,0,TOTALS,RUSSIA,200,34,63,54.0,28,45,62.2,6,18,33.3,11,16,68.8,12,24,36,17,24,12,7,4,85,1
11582,269548,321_11_10,LITHUANIA,0,TOTALS,LITHUANIA,200,21,61,34.4,21,56,37.5,0,5,0.0,21,31,67.7,16,19,35,19,28,15,8,1,63,0
11583,269561,321_11_10,UKRAINE,0,TOTALS,UKRAINE,200,28,62,45.2,22,39,56.4,6,23,26.1,11,21,52.4,17,30,47,21,25,17,5,12,73,1
11584,269574,321_11_11,FRANCE,0,TOTALS,FRANCE,200,29,54,53.7,24,39,61.5,5,15,33.3,16,28,57.1,16,22,38,13,21,18,13,2,79,1
11585,269587,321_11_11,SWEDEN,0,TOTALS,SWEDEN,200,18,44,40.9,12,30,40.0,6,14,42.9,13,17,76.5,5,13,18,8,23,22,5,0,55,0
11586,269600,321_11_12,GERMANY,0,TOTALS,GERMANY,200,21,56,37.5,16,38,42.1,5,18,27.8,15,21,71.4,12,32,44,9,26,17,3,1,62,0
11587,269613,321_11_12,ITALY,0,TOTALS,ITALY,200,28,61,45.9,19,39,48.7,9,22,40.9,10,21,47.6,7,25,32,11,22,10,8,6,75,1
11588,269626,321_11_13,SERBIA,0,TOTALS,SERBIA,200,22,58,37.9,15,38,39.5,7,20,35.0,9,14,64.3,6,25,31,12,26,17,5,4,60,0
11589,269639,321_11_13,MONTENEGRO,0,TOTALS,MONTENEGRO,200,28,64,43.8,21,41,51.2,7,23,30.4,22,25,88.0,12,31,43,16,20,10,6,4,85,1
11590,269652,321_11_14,TURKEY,0,TOTALS,TURKEY,200,25,63,39.7,22,50,44.0,3,13,23.1,19,26,73.1,16,28,44,18,20,11,5,4,72,1
11591,269665,321_11_14,AUSTRIA,0,TOTALS,AUSTRIA,200,25,63,39.7,15,37,40.5,10,26,38.5,7,11,63.6,11,23,34,12,23,15,5,4,67,0
11592,269678,321_11_15,LATVIA,0,TOTALS,LATVIA,200,21,64,32.8,14,40,35.0,7,24,29.2,9,10,90.0,12,29,41,11,20,19,5,6,58,0
11593,269691,321_11_15,CROATIA,0,TOTALS,CROATIA,200,22,58,37.9,18,45,40.0,4,13,30.8,12,21,57.1,12,31,43,11,20,21,4,1,60,1
11594,269704,321_11_16,GREECE,0,TOTALS,GREECE,200,28,59,47.5,23,37,62.2,5,22,22.7,16,24,66.7,8,21,29,10,26,15,5,2,77,0
11595,269717,321_11_16,SPAIN,0,TOTALS,SPAIN,200,33,64,51.6,24,46,52.2,9,18,50.0,19,33,57.6,13,27,40,20,23,12,9,1,94,1
11596,269730,321_11_17,MONTENEGRO,0,TOTALS,MONTENEGRO,200,21,50,42.0,20,39,51.3,1,11,9.1,23,29,79.3,8,23,31,7,21,14,6,6,66,0
11597,269743,321_11_17,RUSSIA,0,TOTALS,RUSSIA,200,26,57,45.6,24,43,55.8,2,14,14.3,14,18,77.8,10,21,31,12,28,18,9,2,68,1
11598,269756,321_11_18,UKRAINE,0,TOTALS,UKRAINE,200,17,53,32.1,10,32,31.2,7,21,33.3,13,18,72.2,13,24,37,9,19,18,3,2,54,0
11599,269769,321_11_18,ITALY,0,TOTALS,ITALY,200,26,60,43.3,18,42,42.9,8,18,44.4,10,13,76.9,11,25,36,11,17,14,8,5,70,1
11600,269782,321_11_19,SWEDEN,0,TOTALS,SWEDEN,200,29,72,40.3,23,54,42.6,6,18,33.3,6,8,75.0,12,32,44,7,17,9,5,2,70,1
11601,269795,321_11_19,CROATIA,0,TOTALS,CROATIA,200,21,64,32.8,17,48,35.4,4,16,25.0,10,20,50.0,16,32,48,10,17,15,4,2,56,0
11602,269808,321_11_20,LITHUANIA,0,TOTALS,LITHUANIA,200,25,61,41.0,17,37,45.9,8,24,33.3,15,24,62.5,16,29,45,20,25,23,5,1,73,0
11603,269821,321_11_20,GERMANY,0,TOTALS,GERMANY,200,27,63,42.9,17,35,48.6,10,28,35.7,24,33,72.7,9,26,35,18,23,10,11,5,88,1
11604,269834,321_11_21,FRANCE,0,TOTALS,FRANCE,200,27,51,52.9,18,35,51.4,9,16,56.2,16,27,59.3,9,27,36,9,23,17,8,0,79,1
11605,269847,321_11_21,LATVIA,0,TOTALS,LATVIA,200,18,52,34.6,16,29,55.2,2,23,8.7,8,21,38.1,14,19,33,10,28,25,2,1,46,0
11606,269860,321_11_22,TURKEY,0,TOTALS,TURKEY,200,23,77,29.9,21,55,38.2,2,22,9.1,15,20,75.0,23,27,50,3,25,13,3,3,63,0
11607,269873,321_11_22,GREECE,0,TOTALS,GREECE,200,26,54,48.1,14,29,48.3,12,25,48.0,14,20,70.0,3,33,36,15,21,16,9,13,78,1
11608,269886,321_11_23,SERBIA,0,TOTALS,SERBIA,200,31,60,51.7,26,45,57.8,5,15,33.3,13,16,81.2,5,24,29,11,30,13,6,4,80,1
11609,269898,321_11_23,SLOVENIA,0,TOTALS,SLOVENIA,200,30,67,44.8,21,47,44.7,9,20,45.0,33,37,89.2,14,26,40,17,21,9,8,0,102,0
11610,269911,321_11_24,AUSTRIA,0,TOTALS,AUSTRIA,200,16,58,27.6,12,34,35.3,4,24,16.7,11,18,61.1,12,19,31,8,26,21,3,1,47,1
11611,269924,321_11_24,SPAIN,0,TOTALS,SPAIN,200,42,70,60.0,28,47,59.6,14,23,60.9,22,28,78.6,14,31,45,28,16,8,9,5,120,0
11612,269937,321_11_25,SERBIA,0,TOTALS,SERBIA,200,33,78,42.3,18,44,40.9,15,34,44.1,14,18,77.8,20,27,47,19,24,9,11,1,95,1
11613,269950,321_11_25,LITHUANIA,0,TOTALS,LITHUANIA,200,23,54,42.6,19,35,54.3,4,19,21.1,14,26,53.8,11,23,34,11,19,18,3,4,64,0
11614,269963,321_11_26,CROATIA,0,TOTALS,CROATIA,200,21,63,33.3,13,33,39.4,8,30,26.7,11,20,55.0,13,28,41,14,20,15,7,4,61,0
11615,269976,321_11_26,AUSTRIA,0,TOTALS,AUSTRIA,200,26,68,38.2,25,58,43.1,1,10,10.0,11,14,78.6,14,35,49,14,20,15,5,3,64,1
11616,269989,321_11_27,SWEDEN,0,TOTALS,SWEDEN,200,29,60,48.3,23,41,56.1,6,19,31.6,14,26,53.8,11,21,32,14,23,12,7,0,78,0
11617,270002,321_11_27,MONTENEGRO,0,TOTALS,MONTENEGRO,200,31,63,49.2,29,53,54.7,2,10,20.0,16,24,66.7,15,24,39,12,25,15,3,3,80,1
11618,270015,321_11_28,GERMANY,0,TOTALS,GERMANY,200,25,54,46.3,21,38,55.3,4,16,25.0,16,24,66.7,8,30,38,10,17,15,7,3,70,1
11619,270028,321_11_28,GREECE,0,TOTALS,GREECE,200,19,58,32.8,15,30,50.0,4,28,14.3,9,14,64.3,11,25,36,9,20,15,6,5,51,0
11620,270041,321_11_29,TURKEY,0,TOTALS,TURKEY,200,20,64,31.2,16,42,38.1,4,22,18.2,15,27,55.6,21,27,48,13,25,16,4,3,59,0
11621,270054,321_11_29,ITALY,0,TOTALS,ITALY,200,26,68,38.2,21,46,45.7,5,22,22.7,12,21,57.1,17,29,46,14,22,12,5,6,69,1
11622,270066,321_11_30,SLOVENIA,0,TOTALS,SLOVENIA,200,18,49,36.7,12,29,41.4,6,20,30.0,22,28,78.6,11,24,35,6,15,14,3,2,64,0
11623,270079,321_11_30,FRANCE,0,TOTALS,FRANCE,200,32,63,50.8,25,44,56.8,7,19,36.8,4,9,44.4,11,23,34,11,25,9,7,5,75,1
11624,270092,321_11_31,UKRAINE,0,TOTALS,UKRAINE,200,28,69,40.6,22,44,50.0,6,25,24.0,5,9,55.6,14,28,42,11,34,18,5,6,67,0
11625,270105,321_11_31,SPAIN,0,TOTALS,SPAIN,200,20,59,33.9,15,46,32.6,5,13,38.5,27,38,71.1,14,31,45,13,17,13,4,2,72,1
11626,270118,321_11_32,LATVIA,0,TOTALS,LATVIA,200,20,55,36.4,14,31,45.2,6,24,25.0,12,22,54.5,10,19,29,10,22,19,4,9,58,0
11627,270131,321_11_32,RUSSIA,0,TOTALS,RUSSIA,200,31,66,47.0,27,52,51.9,4,14,28.6,15,19,78.9,19,28,47,16,24,15,9,1,81,1
11628,270144,321_11_33,AUSTRIA,0,TOTALS,AUSTRIA,200,26,68,38.2,18,47,38.3,8,21,38.1,4,8,50.0,14,26,40,15,21,14,4,1,64,0
11629,270157,321_11_33,SERBIA,0,TOTALS,SERBIA,200,28,66,42.4,20,40,50.0,8,26,30.8,19,24,79.2,14,31,45,14,17,10,5,3,83,1
11630,270170,321_11_34,LITHUANIA,0,TOTALS,LITHUANIA,200,29,70,41.4,18,46,39.1,11,24,45.8,7,16,43.8,13,20,33,15,12,11,4,3,76,0
11631,270183,321_11_34,CROATIA,0,TOTALS,CROATIA,200,35,63,55.6,28,40,70.0,7,23,30.4,5,8,62.5,9,29,38,17,20,17,4,2,82,1
11632,270196,321_11_35,RUSSIA,0,TOTALS,RUSSIA,200,22,55,40.0,14,26,53.8,8,29,27.6,15,21,71.4,14,28,42,11,17,20,8,1,67,1
11633,270209,321_11_35,SWEDEN,0,TOTALS,SWEDEN,200,27,57,47.4,21,41,51.2,6,16,37.5,5,11,45.5,6,23,29,8,20,16,8,2,65,0
11634,270222,321_11_36,MONTENEGRO,0,TOTALS,MONTENEGRO,200,14,37,37.8,11,22,50.0,3,15,20.0,18,24,75.0,9,15,24,9,18,20,4,3,49,0
11635,270235,321_11_36,FRANCE,0,TOTALS,FRANCE,200,23,50,46.0,19,35,54.3,4,15,26.7,8,9,88.9,12,16,28,7,24,18,6,2,58,1
11636,270248,321_11_37,LATVIA,0,TOTALS,LATVIA,200,32,73,43.8,22,50,44.0,10,23,43.5,15,21,71.4,16,32,48,16,25,12,4,6,89,1
11637,270260,321_11_37,SLOVENIA,0,TOTALS,SLOVENIA,200,27,58,46.6,17,42,40.5,10,16,62.5,20,31,64.5,7,29,36,14,24,13,8,3,84,0
11638,270273,321_11_38,UKRAINE,0,TOTALS,UKRAINE,200,20,54,37.0,13,32,40.6,7,22,31.8,14,16,87.5,9,23,32,12,18,22,9,2,61,0
11639,270286,321_11_38,TURKEY,0,TOTALS,TURKEY,200,22,50,44.0,13,26,50.0,9,24,37.5,11,20,55.0,9,22,31,16,20,20,7,4,64,1
11640,270299,321_11_39,SPAIN,0,TOTALS,SPAIN,200,27,62,43.5,22,45,48.9,5,17,29.4,14,19,73.7,12,28,40,10,22,10,6,4,73,1
11641,270312,321_11_39,GERMANY,0,TOTALS,GERMANY,200,19,53,35.8,15,34,44.1,4,19,21.1,16,23,69.6,9,25,34,7,24,15,3,2,58,0
11642,270325,321_11_40,GREECE,0,TOTALS,GREECE,200,23,58,39.7,20,35,57.1,3,23,13.0,10,12,83.3,14,29,43,7,24,19,7,3,59,0
11643,270338,321_11_40,ITALY,0,TOTALS,ITALY,200,23,60,38.3,18,35,51.4,5,25,20.0,13,21,61.9,13,21,34,11,15,13,10,6,64,1
11644,270351,321_11_41,SERBIA,0,TOTALS,SERBIA,200,33,66,50.0,27,45,60.0,6,21,28.6,8,11,72.7,12,22,34,15,17,16,9,2,80,1
11645,270364,321_11_41,CROATIA,0,TOTALS,CROATIA,200,32,63,50.8,25,48,52.1,7,15,46.7,8,11,72.7,8,22,30,17,17,13,7,1,79,0
11646,270377,321_11_42,AUSTRIA,0,TOTALS,AUSTRIA,200,27,70,38.6,22,47,46.8,5,23,21.7,9,12,75.0,15,21,36,13,29,16,4,1,68,0
11647,270390,321_11_42,LITHUANIA,0,TOTALS,LITHUANIA,200,32,65,49.2,22,44,50.0,10,21,47.6,17,34,50.0,21,27,48,18,20,15,9,3,91,1
11648,270403,321_11_43,MONTENEGRO,0,TOTALS,MONTENEGRO,200,20,64,31.2,16,49,32.7,4,15,26.7,17,30,56.7,18,29,47,5,21,17,9,3,61,1
11649,270416,321_11_43,LATVIA,0,TOTALS,LATVIA,200,21,55,38.2,16,35,45.7,5,20,25.0,9,18,50.0,8,32,40,8,27,22,4,5,56,0
11650,270429,321_11_44,GERMANY,0,TOTALS,GERMANY,200,13,46,28.3,11,27,40.7,2,19,10.5,21,28,75.0,9,17,26,9,17,12,4,2,49,0
11651,270442,321_11_44,TURKEY,0,TOTALS,TURKEY,200,26,71,36.6,19,45,42.2,7,26,26.9,12,16,75.0,28,28,56,12,24,10,5,3,71,1
11652,270455,321_11_45,SWEDEN,0,TOTALS,SWEDEN,200,32,65,49.2,27,45,60.0,5,20,25.0,0,2,0.0,11,31,42,12,18,16,3,0,69,1
11653,270467,321_11_45,SLOVENIA,0,TOTALS,SLOVENIA,200,23,64,35.9,17,39,43.6,6,25,24.0,16,19,84.2,11,24,35,9,15,9,3,0,68,0
11654,270480,321_11_46,GREECE,0,TOTALS,GREECE,200,27,68,39.7,21,49,42.9,6,19,31.6,13,17,76.5,6,29,35,15,20,13,6,5,73,0
11655,270493,321_11_46,UKRAINE,0,TOTALS,UKRAINE,200,29,72,40.3,24,49,49.0,5,23,21.7,16,21,76.2,16,36,52,19,15,15,6,3,79,1
11656,270506,321_11_47,FRANCE,0,TOTALS,FRANCE,200,27,56,48.2,23,41,56.1,4,15,26.7,12,20,60.0,13,18,31,7,22,12,6,3,70,1
11657,270519,321_11_47,RUSSIA,0,TOTALS,RUSSIA,200,22,47,46.8,18,36,50.0,4,11,36.4,9,16,56.2,9,20,29,13,24,18,4,2,57,0
11658,270532,321_11_48,ITALY,0,TOTALS,ITALY,200,29,66,43.9,22,48,45.8,7,18,38.9,20,31,64.5,16,25,41,14,32,16,2,2,85,0
11659,270545,321_11_48,SPAIN,0,TOTALS,SPAIN,200,30,57,52.6,24,41,58.5,6,16,37.5,24,39,61.5,8,26,34,19,26,14,11,5,90,1
11660,270558,321_11_49,LITHUANIA,0,TOTALS,LITHUANIA,200,22,57,38.6,20,41,48.8,2,16,12.5,21,32,65.6,15,23,38,12,20,19,4,2,67,0
11661,270571,321_11_49,SERBIA,0,TOTALS,SERBIA,200,29,65,44.6,23,48,47.9,6,17,35.3,11,14,78.6,13,23,36,10,29,17,11,3,75,1
11662,270584,321_11_50,FRANCE,0,TOTALS,FRANCE,200,22,49,44.9,13,31,41.9,9,18,50.0,15,16,93.8,9,19,28,10,21,20,5,0,68,1
11663,270597,321_11_50,GERMANY,0,TOTALS,GERMANY,200,20,45,44.4,15,24,62.5,5,21,23.8,14,17,82.4,6,19,25,10,15,21,6,2,59,0
11664,270610,321_11_51,ITALY,0,TOTALS,ITALY,200,26,56,46.4,21,43,48.8,5,13,38.5,21,24,87.5,7,28,35,8,16,12,5,4,78,1
11665,270623,321_11_51,MONTENEGRO,0,TOTALS,MONTENEGRO,200,26,77,33.8,21,54,38.9,5,23,21.7,10,14,71.4,25,23,48,7,24,13,5,0,67,0
11666,270636,321_11_52,AUSTRIA,0,TOTALS,AUSTRIA,200,24,69,34.8,18,52,34.6,6,17,35.3,7,11,63.6,23,25,48,8,13,12,4,5,61,1
11667,270649,321_11_52,CROATIA,0,TOTALS,CROATIA,200,23,57,40.4,15,31,48.4,8,26,30.8,5,9,55.6,11,24,35,12,21,13,7,5,59,0
11668,270662,321_11_53,RUSSIA,0,TOTALS,RUSSIA,200,22,61,36.1,13,38,34.2,9,23,39.1,11,13,84.6,9,27,36,12,26,5,2,4,64,1
11669,270675,321_11_53,TURKEY,0,TOTALS,TURKEY,200,15,54,27.8,8,33,24.2,7,21,33.3,20,26,76.9,16,31,47,8,20,14,4,4,57,0
11670,270688,321_11_54,SWEDEN,0,TOTALS,SWEDEN,200,29,61,47.5,23,40,57.5,6,21,28.6,9,16,56.2,16,31,47,13,20,20,3,3,73,1
11671,270701,321_11_54,GREECE,0,TOTALS,GREECE,200,25,59,42.4,22,43,51.2,3,16,18.8,13,22,59.1,5,21,26,9,17,9,11,3,66,0
11672,270714,321_11_55,SPAIN,0,TOTALS,SPAIN,200,23,57,40.4,13,37,35.1,10,20,50.0,21,28,75.0,11,28,39,16,18,10,2,6,77,1
11673,270727,321_11_55,LATVIA,0,TOTALS,LATVIA,200,27,71,38.0,15,41,36.6,12,30,40.0,4,8,50.0,16,26,42,16,26,13,3,4,70,0
11674,270740,321_11_56,UKRAINE,0,TOTALS,UKRAINE,200,35,61,57.4,25,39,64.1,10,22,45.5,17,20,85.0,6,19,25,18,22,12,11,4,97,1
11675,270752,321_11_56,SLOVENIA,0,TOTALS,SLOVENIA,200,28,61,45.9,22,47,46.8,6,14,42.9,17,25,68.0,15,21,36,13,20,18,6,2,79,0
11676,270765,321_11_57,GERMANY,0,TOTALS,GERMANY,200,30,50,60.0,21,32,65.6,9,18,50.0,11,22,50.0,6,20,26,16,19,13,5,3,80,1
11677,270778,321_11_57,MONTENEGRO,0,TOTALS,MONTENEGRO,200,23,54,42.6,19,39,48.7,4,15,26.7,11,14,78.6,10,20,30,12,23,18,3,0,61,0
11678,270791,321_11_58,CROATIA,0,TOTALS,CROATIA,200,27,72,37.5,17,46,37.0,10,26,38.5,4,5,80.0,10,25,35,10,24,15,2,3,68,0
11679,270804,321_11_58,LITHUANIA,0,TOTALS,LITHUANIA,200,35,70,50.0,32,51,62.7,3,19,15.8,19,26,73.1,13,34,47,11,12,9,5,5,92,1
11680,270817,321_11_59,LATVIA,0,TOTALS,LATVIA,200,26,56,46.4,15,28,53.6,11,28,39.3,8,19,42.1,7,17,24,15,26,16,4,1,71,0
11681,270830,321_11_59,TURKEY,0,TOTALS,TURKEY,200,24,50,48.0,20,36,55.6,4,14,28.6,22,33,66.7,12,27,39,14,20,16,7,0,74,1
11682,270843,321_11_60,SERBIA,0,TOTALS,SERBIA,200,41,71,57.7,30,45,66.7,11,26,42.3,8,13,61.5,14,38,52,25,19,11,7,2,101,0
11683,270856,321_11_60,AUSTRIA,0,TOTALS,AUSTRIA,200,19,59,32.2,14,41,34.1,5,18,27.8,4,9,44.4,5,19,24,9,13,17,5,0,47,1
11684,270869,321_11_61,FRANCE,0,TOTALS,FRANCE,200,25,66,37.9,21,48,43.8,4,18,22.2,12,16,75.0,19,22,41,9,25,12,7,1,66,0
11685,270882,321_11_61,ITALY,0,TOTALS,ITALY,200,26,53,49.1,21,40,52.5,5,13,38.5,20,27,74.1,8,25,33,15,17,12,2,3,77,1
11686,270895,321_11_62,GREECE,0,TOTALS,GREECE,200,28,74,37.8,22,59,37.3,6,15,40.0,5,6,83.3,8,25,33,13,23,8,4,1,67,0
11687,270907,321_11_62,SLOVENIA,0,TOTALS,SLOVENIA,200,27,70,38.6,21,46,45.7,6,24,25.0,20,26,76.9,19,37,56,17,17,12,2,1,80,1
11688,270920,321_11_63,SPAIN,0,TOTALS,SPAIN,200,31,59,52.5,26,45,57.8,5,14,35.7,20,29,69.0,13,27,40,14,21,12,13,5,87,1
11689,270933,321_11_63,RUSSIA,0,TOTALS,RUSSIA,200,21,61,34.4,15,33,45.5,6,28,21.4,12,18,66.7,17,17,34,12,26,19,4,1,60,0
11690,270946,321_11_64,SWEDEN,0,TOTALS,SWEDEN,200,28,62,45.2,23,41,56.1,5,21,23.8,18,23,78.3,12,26,38,16,24,13,6,1,79,1
11691,270959,321_11_64,UKRAINE,0,TOTALS,UKRAINE,200,24,57,42.1,19,42,45.2,5,15,33.3,16,27,59.3,11,22,33,16,21,17,5,3,69,0
11692,270972,321_11_65,CROATIA,0,TOTALS,CROATIA,200,25,59,42.4,21,41,51.2,4,18,22.2,9,17,52.9,10,23,33,13,14,17,7,0,63,0
11693,270985,321_11_65,SERBIA,0,TOTALS,SERBIA,200,35,70,50.0,31,53,58.5,4,17,23.5,7,12,58.3,13,26,39,19,19,11,13,3,81,1
11694,270998,321_11_66,GERMANY,0,TOTALS,GERMANY,200,26,64,40.6,21,46,45.7,5,18,27.8,3,4,75.0,12,22,34,17,11,13,11,2,60,1
11695,271011,321_11_66,TURKEY,0,TOTALS,TURKEY,200,19,53,35.8,10,29,34.5,9,24,37.5,2,5,40.0,13,27,40,12,13,23,2,3,49,0
11696,271024,321_11_67,LITHUANIA,0,TOTALS,LITHUANIA,200,30,69,43.5,24,44,54.5,6,25,24.0,12,19,63.2,16,38,54,15,18,14,5,7,78,1
11697,271037,321_11_67,AUSTRIA,0,TOTALS,AUSTRIA,200,22,66,33.3,16,50,32.0,6,16,37.5,12,16,75.0,8,26,34,10,17,11,4,2,62,0
11698,271050,321_11_68,FRANCE,0,TOTALS,FRANCE,200,22,48,45.8,14,37,37.8,8,11,72.7,14,22,63.6,12,22,34,11,22,15,5,2,66,1
11699,271063,321_11_68,RUSSIA,0,TOTALS,RUSSIA,200,17,45,37.8,11,27,40.7,6,18,33.3,10,15,66.7,8,18,26,10,25,18,2,1,50,0
11700,271076,321_11_69,MONTENEGRO,0,TOTALS,MONTENEGRO,200,33,63,52.4,24,48,50.0,9,15,60.0,10,16,62.5,13,25,38,19,19,18,10,4,85,1
11701,271089,321_11_69,LATVIA,0,TOTALS,LATVIA,200,27,60,45.0,21,39,53.8,6,21,28.6,16,22,72.7,11,20,31,16,17,16,8,7,76,0
11702,271102,321_11_70,ITALY,0,TOTALS,ITALY,200,24,60,40.0,19,38,50.0,5,22,22.7,17,21,81.0,12,22,34,9,24,20,12,7,70,0
11703,271115,321_11_70,SPAIN,0,TOTALS,SPAIN,200,28,64,43.8,21,46,45.7,7,18,38.9,19,24,79.2,17,25,42,16,22,20,8,2,82,1
11704,271128,322_11_01,MKD,0,TOTALS,MKD,200,26,55,47.3,17,30,56.7,9,25,36.0,10,18,55.6,4,27,31,16,26,25,14,2,71,0
11705,271141,322_11_01,POLAND,0,TOTALS,POLAND,200,26,65,40.0,22,48,45.8,4,17,23.5,18,27,66.7,13,27,40,9,20,22,10,1,74,1
11706,271154,322_11_02,LUXEMBOURG,0,TOTALS,LUXEMBOURG,200,23,61,37.7,19,43,44.2,4,18,22.2,10,14,71.4,9,16,25,2,18,25,11,0,60,1
11707,271167,322_11_02,CZECH REPUBLIC,0,TOTALS,CZECH REPUBLIC,200,49,92,53.3,35,53,66.0,14,39,35.9,15,23,65.2,31,29,60,15,21,17,8,7,127,0
11708,271180,322_11_03,BELGIUM,0,TOTALS,BELGIUM,200,28,63,44.4,24,46,52.2,4,17,23.5,16,23,69.6,10,36,46,9,25,11,12,4,76,1
11709,271193,322_11_03,BELARUS,0,TOTALS,BELARUS,200,16,56,28.6,13,38,34.2,3,18,16.7,15,31,48.4,14,32,46,6,15,20,4,6,50,0
11710,271206,322_11_04,ROMANIA,0,TOTALS,ROMANIA,200,16,50,32.0,10,32,31.2,6,18,33.3,12,27,44.4,14,22,36,5,21,27,6,3,50,0
11711,271219,322_11_04,ESTONIA,0,TOTALS,ESTONIA,200,33,63,52.4,26,41,63.4,7,22,31.8,12,16,75.0,9,24,33,13,20,13,19,2,85,1
11712,271231,322_11_05,DENMARK,0,TOTALS,DENMARK,200,24,53,45.3,20,44,45.5,4,9,44.4,5,6,83.3,7,38,45,8,8,23,7,2,57,1
11713,271244,322_11_05,HUNGARY,0,TOTALS,HUNGARY,200,17,66,25.8,14,41,34.1,3,25,12.0,5,6,83.3,8,22,30,1,13,11,14,1,42,0
11714,271257,322_11_06,PORTUGAL,0,TOTALS,PORTUGAL,200,22,62,35.5,16,41,39.0,6,21,28.6,10,16,62.5,12,27,39,5,26,16,5,1,60,1
11715,271270,322_11_06,GREAT BRITAIN,0,TOTALS,GREAT BRITAIN,200,18,49,36.7,16,30,53.3,2,19,10.5,19,32,59.4,8,38,46,4,19,19,4,6,57,0
11716,271283,322_11_07,SWITZERLAND,0,TOTALS,SWITZERLAND,200,28,64,43.8,20,44,45.5,8,20,40.0,10,17,58.8,17,15,32,11,25,23,9,1,74,0
11717,271296,322_11_07,GEORGIA,0,TOTALS,GEORGIA,200,28,52,53.8,25,37,67.6,3,15,20.0,23,31,74.2,9,24,33,10,20,20,11,3,82,1
11718,271309,322_11_08,NETHERLANDS,0,TOTALS,NETHERLANDS,200,23,76,30.3,19,50,38.0,4,26,15.4,5,6,83.3,22,31,53,8,21,14,6,5,55,0
11719,271322,322_11_08,SLOVAK REPUBLIC,0,TOTALS,SLOVAK REPUBLIC,200,23,64,35.9,20,41,48.8,3,23,13.0,8,17,47.1,14,28,42,5,17,13,3,5,57,1
11720,271335,322_11_09,FINLAND,0,TOTALS,FINLAND,200,24,59,40.7,11,23,47.8,13,36,36.1,19,25,76.0,14,21,35,11,17,15,3,2,80,1
11721,271348,322_11_09,NORWAY,0,TOTALS,NORWAY,200,24,49,49.0,21,38,55.3,3,11,27.3,4,10,40.0,8,24,32,3,20,16,9,2,55,0
11722,271361,322_11_10,ICELAND,0,TOTALS,ICELAND,200,24,69,34.8,12,31,38.7,12,38,31.6,18,21,85.7,16,22,38,14,33,21,6,0,78,0
11723,271374,322_11_10,BOSNIA AND HERZEGOVINA,0,TOTALS,BOSNIA AND HERZEGOVINA,200,26,61,42.6,20,43,46.5,6,18,33.3,24,47,51.1,21,29,50,12,28,23,10,4,82,1
11724,271387,322_11_11,CZECH REPUBLIC,0,TOTALS,CZECH REPUBLIC,200,28,64,43.8,24,50,48.0,4,14,28.6,17,24,70.8,18,33,51,13,20,21,8,1,77,1
11725,271400,322_11_11,PORTUGAL,0,TOTALS,PORTUGAL,200,19,58,32.8,15,42,35.7,4,16,25.0,13,20,65.0,11,20,31,4,22,17,12,0,55,0
11726,271413,322_11_12,POLAND,0,TOTALS,POLAND,200,23,69,33.3,21,50,42.0,2,19,10.5,14,20,70.0,13,27,40,5,22,16,14,5,62,0
11727,271426,322_11_12,ROMANIA,0,TOTALS,ROMANIA,200,22,62,35.5,15,38,39.5,7,24,29.2,19,30,63.3,17,33,50,12,23,21,7,6,70,1
11728,271439,322_11_13,BULGARIA,0,TOTALS,BULGARIA,200,25,63,39.7,18,39,46.2,7,24,29.2,4,10,40.0,9,23,32,6,17,11,4,1,61,0
11729,271451,322_11_13,DENMARK,0,TOTALS,DENMARK,200,28,65,43.1,23,49,46.9,5,16,31.2,11,15,73.3,15,29,44,6,13,7,6,2,72,1
11730,271464,322_11_14,ESTONIA,0,TOTALS,ESTONIA,200,32,59,54.2,21,37,56.8,11,22,50.0,16,27,59.3,13,27,40,16,17,21,14,1,91,1
11731,271477,322_11_14,SWITZERLAND,0,TOTALS,SWITZERLAND,200,27,69,39.1,21,42,50.0,6,27,22.2,4,12,33.3,20,22,42,14,21,25,11,3,64,0
11732,271490,322_11_15,HUNGARY,0,TOTALS,HUNGARY,200,30,56,53.6,21,35,60.0,9,21,42.9,9,18,50.0,7,23,30,17,21,20,6,1,78,0
11733,271503,322_11_15,NETHERLANDS,0,TOTALS,NETHERLANDS,200,33,71,46.5,26,50,52.0,7,21,33.3,10,16,62.5,15,24,39,14,17,15,12,2,83,1
11734,271516,322_11_16,ISRAEL,0,TOTALS,ISRAEL,200,26,68,38.2,22,52,42.3,4,16,25.0,22,35,62.9,18,31,49,11,15,8,8,3,78,1
11735,271529,322_11_16,ICELAND,0,TOTALS,ICELAND,200,28,71,39.4,16,44,36.4,12,27,44.4,5,10,50.0,13,31,44,7,23,16,1,8,73,0
11736,271542,322_11_17,NORWAY,0,TOTALS,NORWAY,200,25,62,40.3,16,40,40.0,9,22,40.9,23,34,67.6,17,33,50,9,17,21,6,5,82,1
11737,271555,322_11_17,LUXEMBOURG,0,TOTALS,LUXEMBOURG,200,20,63,31.7,18,40,45.0,2,23,8.7,7,15,46.7,17,24,41,7,26,21,6,1,49,0
11738,271568,322_11_18,GREAT BRITAIN,0,TOTALS,GREAT BRITAIN,200,20,63,31.7,14,36,38.9,6,27,22.2,22,29,75.9,17,33,50,10,20,20,7,6,68,0
11739,271581,322_11_18,FINLAND,0,TOTALS,FINLAND,200,29,70,41.4,26,54,48.1,3,16,18.8,11,23,47.8,13,29,42,6,28,12,7,1,72,1
11740,271594,322_11_19,BOSNIA AND HERZEGOVINA,0,TOTALS,BOSNIA AND HERZEGOVINA,200,23,55,41.8,21,40,52.5,2,15,13.3,16,27,59.3,9,23,32,11,24,13,9,2,64,0
11741,271607,322_11_19,BELGIUM,0,TOTALS,BELGIUM,200,29,64,45.3,17,34,50.0,12,30,40.0,13,18,72.2,13,27,40,11,26,22,5,1,83,1
11742,271620,322_11_20,GEORGIA,0,TOTALS,GEORGIA,200,29,63,46.0,21,39,53.8,8,24,33.3,21,28,75.0,13,21,34,7,18,6,6,5,87,1
11743,271633,322_11_20,MKD,0,TOTALS,MKD,200,27,50,54.0,19,32,59.4,8,18,44.4,13,18,72.2,6,24,30,16,27,15,2,3,75,0
11744,271646,322_11_21,NORWAY,0,TOTALS,NORWAY,200,23,57,40.4,20,42,47.6,3,15,20.0,16,20,80.0,10,20,30,7,25,18,6,1,65,0
11745,271659,322_11_21,CZECH REPUBLIC,0,TOTALS,CZECH REPUBLIC,200,29,66,43.9,21,36,58.3,8,30,26.7,19,29,65.5,20,22,42,14,24,15,11,1,85,1
11746,271672,322_11_22,SLOVAK REPUBLIC,0,TOTALS,SLOVAK REPUBLIC,200,31,64,48.4,22,42,52.4,9,22,40.9,10,18,55.6,14,25,39,19,21,10,10,2,81,1
11747,271685,322_11_22,HUNGARY,0,TOTALS,HUNGARY,200,23,67,34.3,19,48,39.6,4,19,21.1,13,17,76.5,18,26,44,9,17,14,4,1,63,0
11748,271698,322_11_23,BELARUS,0,TOTALS,BELARUS,200,21,51,41.2,17,37,45.9,4,14,28.6,21,30,70.0,12,25,37,5,19,27,3,5,67,0
11749,271711,322_11_23,BOSNIA AND HERZEGOVINA,0,TOTALS,BOSNIA AND HERZEGOVINA,200,30,67,44.8,22,38,57.9,8,29,27.6,11,18,61.1,18,21,39,11,27,18,16,0,79,1
11750,271724,322_11_24,FINLAND,0,TOTALS,FINLAND,200,20,59,33.9,14,34,41.2,6,25,24.0,4,5,80.0,11,16,27,10,15,14,6,1,50,0
11751,271737,322_11_24,PORTUGAL,0,TOTALS,PORTUGAL,200,23,50,46.0,18,33,54.5,5,17,29.4,6,14,42.9,14,28,42,11,15,17,7,1,57,1
11752,271750,322_11_25,NETHERLANDS,0,TOTALS,NETHERLANDS,200,26,59,44.1,21,35,60.0,5,24,20.8,11,16,68.8,13,15,28,16,19,11,9,2,68,0
11753,271763,322_11_25,BULGARIA,0,TOTALS,BULGARIA,200,27,49,55.1,17,29,58.6,10,20,50.0,9,11,81.8,6,25,31,13,23,21,5,3,73,1
11754,271776,322_11_26,BELGIUM,0,TOTALS,BELGIUM,200,23,59,39.0,13,25,52.0,10,34,29.4,22,27,81.5,13,31,44,10,17,13,5,4,78,1
11755,271789,322_11_26,ISRAEL,0,TOTALS,ISRAEL,200,20,60,33.3,11,34,32.4,9,26,34.6,8,14,57.1,10,24,34,12,25,16,5,1,57,0
11756,271802,322_11_27,LUXEMBOURG,0,TOTALS,LUXEMBOURG,200,22,65,33.8,15,35,42.9,7,30,23.3,5,9,55.6,7,23,30,8,24,14,8,0,56,0
11757,271815,322_11_27,GREAT BRITAIN,0,TOTALS,GREAT BRITAIN,200,30,62,48.4,22,33,66.7,8,29,27.6,17,24,70.8,11,36,47,16,12,18,4,1,85,1
11758,271828,322_11_28,GEORGIA,0,TOTALS,GEORGIA,200,30,69,43.5,22,44,50.0,8,25,32.0,10,13,76.9,10,28,38,15,22,15,11,4,78,1
11759,271841,322_11_28,POLAND,0,TOTALS,POLAND,200,28,67,41.8,24,49,49.0,4,18,22.2,9,17,52.9,16,34,50,8,18,18,8,3,69,0
11760,271854,322_11_29,MKD,0,TOTALS,MKD,200,22,64,34.4,14,38,36.8,8,26,30.8,24,34,70.6,14,24,38,11,21,18,2,0,76,0
11761,271867,322_11_29,ESTONIA,0,TOTALS,ESTONIA,200,37,70,52.9,33,52,63.5,4,18,22.2,17,23,73.9,9,33,42,7,28,12,15,4,95,1
11762,271880,322_11_30,SWITZERLAND,0,TOTALS,SWITZERLAND,200,15,57,26.3,6,25,24.0,9,32,28.1,8,14,57.1,13,30,43,7,28,19,11,2,47,0
11763,271893,322_11_30,ROMANIA,0,TOTALS,ROMANIA,200,13,50,26.0,12,33,36.4,1,17,5.9,26,34,76.5,11,38,49,4,21,17,5,6,53,1
11764,271906,322_11_31,ICELAND,0,TOTALS,ICELAND,200,26,75,34.7,20,46,43.5,6,29,20.7,11,20,55.0,17,31,48,6,13,10,8,2,69,0
11765,271919,322_11_31,BELGIUM,0,TOTALS,BELGIUM,200,29,72,40.3,15,37,40.5,14,35,40.0,8,12,66.7,13,40,53,11,20,15,5,3,80,1
11766,271931,322_11_32,DENMARK,0,TOTALS,DENMARK,200,26,51,51.0,20,38,52.6,6,13,46.2,20,26,76.9,8,29,37,6,15,17,5,6,78,1
11767,271944,322_11_32,NETHERLANDS,0,TOTALS,NETHERLANDS,200,30,62,48.4,28,44,63.6,2,18,11.1,10,13,76.9,9,23,32,10,25,11,7,4,72,0
11768,271957,322_11_33,GREAT BRITAIN,0,TOTALS,GREAT BRITAIN,200,31,71,43.7,25,50,50.0,6,21,28.6,10,17,58.8,16,42,58,15,20,19,8,2,78,1
11769,271970,322_11_33,NORWAY,0,TOTALS,NORWAY,200,22,73,30.1,15,41,36.6,7,32,21.9,13,18,72.2,9,27,36,7,19,9,7,0,64,0
11770,271983,322_11_34,BULGARIA,0,TOTALS,BULGARIA,200,21,52,40.4,14,23,60.9,7,29,24.1,16,23,69.6,10,31,41,8,19,20,8,0,65,1
11771,271996,322_11_34,SLOVAK REPUBLIC,0,TOTALS,SLOVAK REPUBLIC,200,24,65,36.9,19,40,47.5,5,25,20.0,5,12,41.7,13,26,39,11,26,21,8,3,58,0
11772,272009,322_11_35,ROMANIA,0,TOTALS,ROMANIA,200,20,69,29.0,18,43,41.9,2,26,7.7,7,11,63.6,12,22,34,7,15,8,7,6,49,0
11773,272022,322_11_35,MKD,0,TOTALS,MKD,200,25,60,41.7,18,39,46.2,7,21,33.3,7,12,58.3,13,35,48,14,15,17,5,3,64,1
11774,272035,322_11_36,ISRAEL,0,TOTALS,ISRAEL,200,42,70,60.0,27,45,60.0,15,25,60.0,12,19,63.2,12,23,35,25,24,17,17,0,111,0
11775,272048,322_11_36,BELARUS,0,TOTALS,BELARUS,200,33,62,53.2,25,44,56.8,8,18,44.4,14,23,60.9,10,21,31,11,14,20,8,2,88,1
11776,272061,322_11_37,PORTUGAL,0,TOTALS,PORTUGAL,200,25,58,43.1,17,29,58.6,8,29,27.6,18,28,64.3,12,29,41,12,15,20,7,4,76,1
11777,272074,322_11_37,LUXEMBOURG,0,TOTALS,LUXEMBOURG,200,23,55,41.8,18,37,48.6,5,18,27.8,5,10,50.0,6,18,24,11,23,17,10,0,56,0
11778,272087,322_11_38,POLAND,0,TOTALS,POLAND,200,32,70,45.7,25,50,50.0,7,20,35.0,15,25,60.0,16,32,48,13,16,18,8,2,86,1
11779,272100,322_11_38,SWITZERLAND,0,TOTALS,SWITZERLAND,200,29,64,45.3,24,44,54.5,5,20,25.0,12,15,80.0,5,27,32,15,27,19,10,3,75,0
11780,272113,322_11_39,CZECH REPUBLIC,0,TOTALS,CZECH REPUBLIC,200,27,62,43.5,20,45,44.4,7,17,41.2,15,19,78.9,13,31,44,16,24,15,2,4,76,1
11781,272126,322_11_39,FINLAND,0,TOTALS,FINLAND,200,20,53,37.7,14,32,43.8,6,21,28.6,16,25,64.0,7,21,28,9,22,7,8,1,62,0
11782,272139,322_11_40,ESTONIA,0,TOTALS,ESTONIA,200,29,57,50.9,22,39,56.4,7,18,38.9,22,28,78.6,5,26,31,10,31,12,3,0,87,0
11783,272152,322_11_40,GEORGIA,0,TOTALS,GEORGIA,200,27,67,40.3,17,34,50.0,10,33,30.3,24,30,80.0,16,27,43,9,27,9,5,2,88,1
11784,272165,322_11_41,BOSNIA AND HERZEGOVINA,0,TOTALS,BOSNIA AND HERZEGOVINA,200,22,57,38.6,19,34,55.9,3,23,13.0,13,22,59.1,7,30,37,8,25,16,5,3,60,1
11785,272178,322_11_41,ISRAEL,0,TOTALS,ISRAEL,200,17,48,35.4,11,25,44.0,6,23,26.1,17,28,60.7,7,31,38,11,22,18,5,1,57,0
11786,272191,322_11_42,HUNGARY,0,TOTALS,HUNGARY,200,31,63,49.2,22,38,57.9,9,25,36.0,9,11,81.8,8,23,31,16,22,13,2,3,80,0
11787,272204,322_11_42,BULGARIA,0,TOTALS,BULGARIA,200,31,60,51.7,26,43,60.5,5,17,29.4,17,24,70.8,8,24,32,10,20,6,9,1,84,1
11788,272217,322_11_43,NORWAY,0,TOTALS,NORWAY,200,23,51,45.1,21,38,55.3,2,13,15.4,21,33,63.6,10,27,37,4,18,14,9,2,69,0
11789,272230,322_11_43,PORTUGAL,0,TOTALS,PORTUGAL,200,28,72,38.9,20,49,40.8,8,23,34.8,13,23,56.5,22,25,47,7,28,14,7,1,77,1
11790,272243,322_11_44,GEORGIA,0,TOTALS,GEORGIA,225,30,82,36.6,21,44,47.7,9,38,23.7,16,25,64.0,20,27,47,10,24,16,6,6,85,0
11791,272256,322_11_44,ROMANIA,0,TOTALS,ROMANIA,225,33,66,50.0,29,49,59.2,4,17,23.5,19,26,73.1,11,33,44,5,18,9,7,2,89,1
11792,272269,322_11_45,ESTONIA,0,TOTALS,ESTONIA,200,25,58,43.1,21,42,50.0,4,16,25.0,12,18,66.7,12,27,39,14,26,16,6,2,66,0
11793,272282,322_11_45,POLAND,0,TOTALS,POLAND,200,24,59,40.7,20,40,50.0,4,19,21.1,23,25,92.0,11,27,38,9,23,15,8,7,75,1
11794,272295,322_11_46,LUXEMBOURG,0,TOTALS,LUXEMBOURG,225,25,62,40.3,17,34,50.0,8,28,28.6,16,30,53.3,9,34,43,19,17,17,15,1,74,0
11795,272308,322_11_46,FINLAND,0,TOTALS,FINLAND,225,27,84,32.1,12,27,44.4,15,57,26.3,8,14,57.1,25,35,60,18,22,23,7,2,77,1
11796,272321,322_11_47,MKD,0,TOTALS,MKD,200,27,58,46.6,18,35,51.4,9,23,39.1,10,15,66.7,11,32,43,11,14,20,12,2,73,1
11797,272334,322_11_47,SWITZERLAND,0,TOTALS,SWITZERLAND,200,21,61,34.4,14,33,42.4,7,28,25.0,7,11,63.6,11,24,35,10,14,16,10,1,56,0
11798,272347,322_11_48,SLOVAK REPUBLIC,0,TOTALS,SLOVAK REPUBLIC,200,26,63,41.3,15,35,42.9,11,28,39.3,20,23,87.0,10,25,35,17,22,8,3,2,83,0
11799,272359,322_11_48,DENMARK,0,TOTALS,DENMARK,200,33,69,47.8,26,57,45.6,7,12,58.3,15,25,60.0,15,29,44,15,23,8,5,4,88,1
11800,272372,322_11_49,BELARUS,0,TOTALS,BELARUS,200,30,68,44.1,27,56,48.2,3,12,25.0,21,31,67.7,17,28,45,11,29,14,2,3,84,0
11801,272385,322_11_49,ICELAND,0,TOTALS,ICELAND,200,34,64,53.1,23,35,65.7,11,29,37.9,18,30,60.0,9,23,32,18,27,10,9,2,97,1
11802,272398,322_11_50,GREAT BRITAIN,0,TOTALS,GREAT BRITAIN,200,22,50,44.0,15,34,44.1,7,16,43.8,34,47,72.3,6,31,37,6,13,12,8,0,85,1
11803,272411,322_11_50,CZECH REPUBLIC,0,TOTALS,CZECH REPUBLIC,200,31,79,39.2,22,44,50.0,9,35,25.7,3,6,50.0,16,26,42,12,30,16,4,0,74,0
11804,272424,322_11_51,GEORGIA,0,TOTALS,GEORGIA,200,30,64,46.9,22,35,62.9,8,29,27.6,20,27,74.1,11,38,49,12,16,18,5,2,88,1
11805,272437,322_11_51,BULGARIA,0,TOTALS,BULGARIA,200,28,70,40.0,21,45,46.7,7,25,28.0,12,19,63.2,5,24,29,11,24,9,8,0,75,0
11806,272450,322_11_52,SWITZERLAND,0,TOTALS,SWITZERLAND,200,27,63,42.9,22,45,48.9,5,18,27.8,6,14,42.9,12,29,41,8,13,17,7,0,65,0
11807,272463,322_11_52,HUNGARY,0,TOTALS,HUNGARY,200,24,62,38.7,18,41,43.9,6,21,28.6,16,19,84.2,10,27,37,17,16,16,7,3,70,1
11808,272476,322_11_53,LUXEMBOURG,0,TOTALS,LUXEMBOURG,200,36,69,52.2,31,54,57.4,5,15,33.3,9,17,52.9,13,18,31,12,23,21,10,3,86,0
11809,272489,322_11_53,BELARUS,0,TOTALS,BELARUS,200,39,72,54.2,32,59,54.2,7,13,53.8,14,23,60.9,18,23,41,20,13,24,13,6,99,1
11810,272502,322_11_54,ESTONIA,0,TOTALS,ESTONIA,200,21,58,36.2,15,31,48.4,6,27,22.2,14,20,70.0,10,20,30,9,21,13,14,3,62,1
11811,272514,322_11_54,DENMARK,0,TOTALS,DENMARK,200,22,58,37.9,22,41,53.7,0,17,0.0,14,18,77.8,18,30,48,6,21,22,4,1,58,0
11812,272527,322_11_55,POLAND,0,TOTALS,POLAND,200,28,67,41.8,24,48,50.0,4,19,21.1,28,35,80.0,14,34,48,13,14,8,2,1,88,1
11813,272540,322_11_55,NETHERLANDS,0,TOTALS,NETHERLANDS,200,30,70,42.9,22,47,46.8,8,23,34.8,11,14,78.6,6,28,34,17,28,10,3,2,79,0
11814,272553,322_11_56,FINLAND,0,TOTALS,FINLAND,200,31,63,49.2,19,40,47.5,12,23,52.2,13,21,61.9,9,30,39,15,21,15,9,2,87,1
11815,272566,322_11_56,ICELAND,0,TOTALS,ICELAND,200,28,79,35.4,22,56,39.3,6,23,26.1,14,22,63.6,23,26,49,11,17,15,11,2,76,0
11816,272579,322_11_57,CZECH REPUBLIC,0,TOTALS,CZECH REPUBLIC,200,28,70,40.0,21,42,50.0,7,28,25.0,11,15,73.3,18,30,48,14,21,13,6,5,74,1
11817,272592,322_11_57,BOSNIA AND HERZEGOVINA,0,TOTALS,BOSNIA AND HERZEGOVINA,200,19,53,35.8,17,44,38.6,2,9,22.2,17,21,81.0,8,29,37,2,22,11,5,4,57,0
11818,272605,322_11_58,ROMANIA,0,TOTALS,ROMANIA,200,27,72,37.5,20,46,43.5,7,26,26.9,8,18,44.4,14,29,43,14,17,12,3,4,69,0
11819,272618,322_11_58,SLOVAK REPUBLIC,0,TOTALS,SLOVAK REPUBLIC,200,29,66,43.9,23,46,50.0,6,20,30.0,11,21,52.4,11,32,43,12,24,11,4,0,75,1
11820,272631,322_11_59,GREAT BRITAIN,0,TOTALS,GREAT BRITAIN,200,29,72,40.3,20,45,44.4,9,27,33.3,16,18,88.9,21,36,57,12,18,29,3,2,83,1
11821,272644,322_11_59,ISRAEL,0,TOTALS,ISRAEL,200,33,79,41.8,30,54,55.6,3,25,12.0,13,20,65.0,14,21,35,11,20,9,20,3,82,0
11822,272657,322_11_60,PORTUGAL,0,TOTALS,PORTUGAL,200,21,61,34.4,16,45,35.6,5,16,31.2,12,18,66.7,11,27,38,6,15,11,3,1,59,0
11823,272670,322_11_60,BELGIUM,0,TOTALS,BELGIUM,200,28,63,44.4,17,39,43.6,11,24,45.8,7,10,70.0,9,35,44,11,19,10,7,2,74,1
11824,272683,322_11_61,BELGIUM,0,TOTALS,BELGIUM,200,31,69,44.9,23,49,46.9,8,20,40.0,5,9,55.6,9,30,39,11,12,11,12,1,75,1
11825,272696,322_11_61,CZECH REPUBLIC,0,TOTALS,CZECH REPUBLIC,200,30,72,41.7,27,49,55.1,3,23,13.0,6,8,75.0,13,32,45,10,14,15,5,3,69,0
11826,272709,322_11_62,HUNGARY,0,TOTALS,HUNGARY,200,33,65,50.8,26,46,56.5,7,19,36.8,8,17,47.1,14,27,41,17,20,19,7,0,81,1
11827,272722,322_11_62,MKD,0,TOTALS,MKD,200,28,65,43.1,22,43,51.2,6,22,27.3,15,22,68.2,11,22,33,7,18,14,9,1,77,0
11828,272735,322_11_63,BELARUS,0,TOTALS,BELARUS,200,39,80,48.8,27,59,45.8,12,21,57.1,25,35,71.4,19,37,56,16,32,7,8,3,115,0
11829,272748,322_11_63,NORWAY,0,TOTALS,NORWAY,200,21,60,35.0,16,36,44.4,5,24,20.8,30,42,71.4,10,26,36,6,25,15,3,0,77,1
11830,272761,322_11_64,BOSNIA AND HERZEGOVINA,0,TOTALS,BOSNIA AND HERZEGOVINA,200,29,50,58.0,26,38,68.4,3,12,25.0,12,22,54.5,5,25,30,9,20,15,10,6,73,1
11831,272774,322_11_64,PORTUGAL,0,TOTALS,PORTUGAL,200,20,54,37.0,13,35,37.1,7,19,36.8,12,20,60.0,15,21,36,9,18,20,7,1,59,0
11832,272787,322_11_65,SLOVAK REPUBLIC,0,TOTALS,SLOVAK REPUBLIC,200,24,62,38.7,19,45,42.2,5,17,29.4,14,22,63.6,17,25,42,10,26,18,7,3,67,0
11833,272800,322_11_65,POLAND,0,TOTALS,POLAND,200,27,59,45.8,19,40,47.5,8,19,42.1,23,30,76.7,8,23,31,15,20,16,7,3,85,1
11834,272813,322_11_66,ISRAEL,0,TOTALS,ISRAEL,200,26,53,49.1,22,38,57.9,4,15,26.7,9,15,60.0,7,27,34,14,17,11,6,0,65,1
11835,272826,322_11_66,FINLAND,0,TOTALS,FINLAND,200,23,67,34.3,13,33,39.4,10,34,29.4,8,11,72.7,17,20,37,13,13,11,3,1,64,0
11836,272838,322_11_67,DENMARK,0,TOTALS,DENMARK,200,25,60,41.7,13,38,34.2,12,22,54.5,4,6,66.7,15,23,38,5,15,21,2,2,66,0
11837,272851,322_11_67,GEORGIA,0,TOTALS,GEORGIA,200,35,64,54.7,31,48,64.6,4,16,25.0,10,17,58.8,9,20,29,14,13,11,10,4,84,1
11838,272864,322_11_68,NETHERLANDS,0,TOTALS,NETHERLANDS,200,35,75,46.7,28,55,50.9,7,20,35.0,14,24,58.3,19,25,44,18,20,14,14,5,91,1
11839,272877,322_11_68,ROMANIA,0,TOTALS,ROMANIA,200,27,67,40.3,20,49,40.8,7,18,38.9,16,24,66.7,14,22,36,9,20,18,3,2,77,0
11840,272890,322_11_69,ICELAND,0,TOTALS,ICELAND,200,27,67,40.3,21,43,48.8,6,24,25.0,10,16,62.5,12,29,41,9,18,16,8,1,70,0
11841,272903,322_11_69,GREAT BRITAIN,0,TOTALS,GREAT BRITAIN,200,24,65,36.9,16,30,53.3,8,35,22.9,16,25,64.0,13,29,42,16,17,16,8,1,72,1
11842,272916,322_11_70,BULGARIA,0,TOTALS,BULGARIA,200,27,63,42.9,20,42,47.6,7,21,33.3,13,18,72.2,10,28,38,10,21,23,9,3,74,0
11843,272929,322_11_70,ESTONIA,0,TOTALS,ESTONIA,200,34,66,51.5,23,42,54.8,11,24,45.8,18,25,72.0,10,30,40,11,17,19,16,1,97,1
11844,272941,322_11_71,DENMARK,0,TOTALS,DENMARK,200,23,46,50.0,16,26,61.5,7,20,35.0,8,17,47.1,8,22,30,7,14,18,5,1,61,0
11845,272954,322_11_71,PORTUGAL,0,TOTALS,PORTUGAL,200,32,61,52.5,22,43,51.2,10,18,55.6,9,12,75.0,7,20,27,11,19,9,9,2,83,1
11846,272967,322_11_72,SWITZERLAND,0,TOTALS,SWITZERLAND,200,29,66,43.9,21,41,51.2,8,25,32.0,15,18,83.3,5,27,32,15,18,17,13,3,81,1
11847,272980,322_11_72,LUXEMBOURG,0,TOTALS,LUXEMBOURG,200,25,58,43.1,17,35,48.6,8,23,34.8,16,23,69.6,7,33,40,13,22,22,8,3,74,0
11848,272993,322_11_73,BOSNIA AND HERZEGOVINA,0,TOTALS,BOSNIA AND HERZEGOVINA,200,32,58,55.2,28,44,63.6,4,14,28.6,10,16,62.5,12,30,42,14,17,20,10,5,78,1
11849,273006,322_11_73,BULGARIA,0,TOTALS,BULGARIA,200,22,58,37.9,10,29,34.5,12,29,41.4,9,13,69.2,10,19,29,8,17,20,10,3,65,0
11850,273019,322_11_74,NETHERLANDS,0,TOTALS,NETHERLANDS,200,27,58,46.6,20,41,48.8,7,17,41.2,14,20,70.0,7,30,37,15,17,16,9,4,75,0
11851,273032,322_11_74,ICELAND,0,TOTALS,ICELAND,200,30,65,46.2,21,44,47.7,9,21,42.9,11,21,52.4,12,30,42,14,15,13,9,5,80,1
11852,273045,322_11_75,GREAT BRITAIN,0,TOTALS,GREAT BRITAIN,200,40,69,58.0,26,47,55.3,14,22,63.6,10,16,62.5,7,37,44,22,12,10,15,3,104,0
11853,273058,322_11_75,ROMANIA,0,TOTALS,ROMANIA,200,19,64,29.7,13,38,34.2,6,26,23.1,6,14,42.9,13,25,38,5,14,20,4,3,50,1
11854,273071,322_11_76,GEORGIA,0,TOTALS,GEORGIA,200,24,53,45.3,21,40,52.5,3,13,23.1,23,32,71.9,7,23,30,8,19,12,8,2,74,1
11855,273084,322_11_76,CZECH REPUBLIC,0,TOTALS,CZECH REPUBLIC,200,24,63,38.1,17,40,42.5,7,23,30.4,17,24,70.8,21,24,45,12,26,19,7,2,72,0
11856,273097,322_11_77,POLAND,0,TOTALS,POLAND,200,36,70,51.4,26,45,57.8,10,25,40.0,18,25,72.0,15,29,44,18,19,17,4,2,100,0
11857,273110,322_11_77,ISRAEL,0,TOTALS,ISRAEL,200,33,73,45.2,21,44,47.7,12,29,41.4,16,26,61.5,12,21,33,19,21,10,11,2,94,1
11858,273123,322_11_78,FINLAND,0,TOTALS,FINLAND,200,32,75,42.7,23,44,52.3,9,31,29.0,11,15,73.3,16,26,42,16,17,5,5,5,84,1
11859,273136,322_11_78,SLOVAK REPUBLIC,0,TOTALS,SLOVAK REPUBLIC,200,25,70,35.7,22,51,43.1,3,19,15.8,12,15,80.0,20,29,49,8,18,12,2,3,65,0
11860,273149,322_11_79,BELGIUM,0,TOTALS,BELGIUM,200,22,61,36.1,16,34,47.1,6,27,22.2,11,18,61.1,14,30,44,6,15,17,11,2,61,0
11861,273162,322_11_79,ESTONIA,0,TOTALS,ESTONIA,200,26,62,41.9,21,38,55.3,5,24,20.8,7,13,53.8,9,27,36,7,17,14,6,2,64,1
11862,273175,322_11_80,MKD,0,TOTALS,MKD,200,40,75,53.3,28,46,60.9,12,29,41.4,5,6,83.3,16,25,41,18,21,17,5,3,97,1
11863,273188,322_11_80,NORWAY,0,TOTALS,NORWAY,200,37,69,53.6,27,49,55.1,10,20,50.0,12,20,60.0,10,18,28,10,13,13,9,3,96,0
11864,273201,322_11_81,HUNGARY,0,TOTALS,HUNGARY,200,27,66,40.9,17,37,45.9,10,29,34.5,16,26,61.5,11,20,31,11,27,15,8,0,80,0
11865,273214,322_11_81,BELARUS,0,TOTALS,BELARUS,200,28,61,45.9,25,46,54.3,3,15,20.0,29,36,80.6,14,32,46,9,25,20,10,3,88,1
11866,273226,322_11_82,DENMARK,0,TOTALS,DENMARK,200,30,65,46.2,25,47,53.2,5,18,27.8,7,12,58.3,13,36,49,10,14,17,5,3,72,1
11867,273239,322_11_82,BULGARIA,0,TOTALS,BULGARIA,200,21,60,35.0,17,38,44.7,4,22,18.2,12,19,63.2,9,22,31,6,17,13,8,0,58,0
11868,273252,322_11_83,NETHERLANDS,0,TOTALS,NETHERLANDS,200,29,70,41.4,23,52,44.2,6,18,33.3,13,20,65.0,15,22,37,9,24,13,10,2,77,0
11869,273265,322_11_83,ROMANIA,0,TOTALS,ROMANIA,200,31,63,49.2,28,53,52.8,3,10,30.0,20,32,62.5,15,28,43,11,20,16,5,6,85,1
11870,273278,322_11_84,ICELAND,0,TOTALS,ICELAND,200,26,82,31.7,18,52,34.6,8,30,26.7,11,13,84.6,14,23,37,10,19,10,8,2,71,0
11871,273291,322_11_84,GREAT BRITAIN,0,TOTALS,GREAT BRITAIN,200,31,62,50.0,24,44,54.5,7,18,38.9,14,20,70.0,7,43,50,15,17,15,6,3,83,1
11872,273304,322_11_85,PORTUGAL,0,TOTALS,PORTUGAL,200,26,60,43.3,17,35,48.6,9,25,36.0,10,13,76.9,11,22,33,12,14,15,11,2,71,1
11873,273317,322_11_85,BOSNIA AND HERZEGOVINA,0,TOTALS,BOSNIA AND HERZEGOVINA,200,25,53,47.2,20,35,57.1,5,18,27.8,12,17,70.6,9,25,34,12,15,21,10,3,67,0
11874,273330,322_11_86,ISRAEL,0,TOTALS,ISRAEL,200,35,73,47.9,26,48,54.2,9,25,36.0,9,11,81.8,10,35,45,22,18,13,16,6,88,1
11875,273343,322_11_86,SLOVAK REPUBLIC,0,TOTALS,SLOVAK REPUBLIC,200,20,66,30.3,14,36,38.9,6,30,20.0,7,13,53.8,14,28,42,10,17,21,8,6,53,0
11876,273356,322_11_87,POLAND,0,TOTALS,POLAND,200,26,69,37.7,25,56,44.6,1,13,7.7,7,8,87.5,22,33,55,12,14,19,4,4,60,1
11877,273369,322_11_87,FINLAND,0,TOTALS,FINLAND,200,20,58,34.5,11,29,37.9,9,29,31.0,8,12,66.7,6,22,28,11,11,12,6,1,57,0
11878,273382,322_11_88,CZECH REPUBLIC,0,TOTALS,CZECH REPUBLIC,200,30,66,45.5,20,45,44.4,10,21,47.6,16,23,69.6,13,29,42,11,14,8,3,0,86,1
11879,273395,322_11_88,BELGIUM,0,TOTALS,BELGIUM,200,34,74,45.9,26,47,55.3,8,27,29.6,9,13,69.2,10,28,38,11,19,7,4,3,85,0
11880,273408,322_11_89,GEORGIA,0,TOTALS,GEORGIA,206,32,73,43.8,24,50,48.0,8,23,34.8,7,16,43.8,18,31,49,11,17,15,8,6,79,1
11881,273421,322_11_89,ESTONIA,0,TOTALS,ESTONIA,200,27,70,38.6,21,49,42.9,6,21,28.6,10,17,58.8,16,28,44,10,20,14,7,2,70,0
11882,276247,325_11_01,FINLAND,0,TOTALS,FINLAND,200,19,68,27.9,12,44,27.3,7,24,29.2,4,8,50.0,11,13,24,5,23,24,8,3,49,1
11883,276260,325_11_01,SERBIA,0,TOTALS,SERBIA,200,37,66,56.1,33,55,60.0,4,11,36.4,23,29,79.3,20,37,57,24,18,24,15,3,101,0
11884,276273,325_11_02,CZECH REPUBLIC,0,TOTALS,CZECH REPUBLIC,200,26,60,43.3,22,42,52.4,4,18,22.2,4,6,66.7,6,19,25,9,19,19,9,0,60,0
11885,276286,325_11_02,SPAIN,0,TOTALS,SPAIN,200,29,69,42.0,16,37,43.2,13,32,40.6,13,22,59.1,16,23,39,20,19,10,17,2,84,1
11886,276299,325_11_03,GERMANY,0,TOTALS,GERMANY,200,23,52,44.2,14,31,45.2,9,21,42.9,13,22,59.1,10,22,32,10,26,18,7,0,68,1
11887,276312,325_11_03,TURKEY,0,TOTALS,TURKEY,200,22,50,44.0,17,34,50.0,5,16,31.2,17,22,77.3,9,22,31,14,23,18,9,2,66,0
11888,276325,325_11_04,LATVIA,0,TOTALS,LATVIA,200,18,61,29.5,14,37,37.8,4,24,16.7,6,12,50.0,12,19,31,7,19,20,21,1,46,0
11889,276338,325_11_04,FRANCE,0,TOTALS,FRANCE,200,23,49,46.9,17,31,54.8,6,18,33.3,14,23,60.9,11,30,41,7,16,23,17,3,66,1
11890,276351,325_11_05,GREECE,0,TOTALS,GREECE,200,16,50,32.0,10,35,28.6,6,15,40.0,7,12,58.3,10,30,40,10,24,26,6,2,45,0
11891,276364,325_11_05,CROATIA,0,TOTALS,CROATIA,200,21,68,30.9,18,49,36.7,3,19,15.8,16,22,72.7,20,26,46,7,17,15,17,4,61,1
11892,276377,325_11_06,UKRAINE,0,TOTALS,UKRAINE,200,20,65,30.8,14,45,31.1,6,20,30.0,5,9,55.6,6,17,23,11,25,21,17,1,51,0
11893,276390,325_11_06,LITHUANIA,0,TOTALS,LITHUANIA,200,33,65,50.8,30,54,55.6,3,11,27.3,15,30,50.0,18,35,53,17,16,21,18,5,84,1
11894,276403,325_11_07,SLOVENIA,0,TOTALS,SLOVENIA,200,23,74,31.1,17,51,33.3,6,23,26.1,6,15,40.0,10,19,29,13,23,6,6,1,58,0
11895,276416,325_11_07,POLAND,0,TOTALS,POLAND,200,35,64,54.7,28,45,62.2,7,19,36.8,12,20,60.0,12,44,56,17,16,17,2,6,89,1
11896,276429,325_11_08,ITALY,0,TOTALS,ITALY,200,33,67,49.3,22,41,53.7,11,26,42.3,12,26,46.2,12,21,33,17,19,7,22,2,89,1
11897,276442,325_11_08,RUSSIA,0,TOTALS,RUSSIA,200,16,49,32.7,13,33,39.4,3,16,18.8,13,20,65.0,13,24,37,7,25,27,5,3,48,0
11898,276455,325_11_09,SPAIN,0,TOTALS,SPAIN,200,29,65,44.6,21,44,47.7,8,21,38.1,13,18,72.2,17,25,42,16,18,15,11,5,79,1
11899,276468,325_11_09,LATVIA,0,TOTALS,LATVIA,200,24,66,36.4,18,47,38.3,6,19,31.6,4,16,25.0,20,21,41,14,18,20,6,3,58,0
11900,276481,325_11_10,TURKEY,0,TOTALS,TURKEY,200,36,61,59.0,30,42,71.4,6,19,31.6,9,12,75.0,11,25,36,13,19,18,23,5,87,1
11901,276494,325_11_10,FINLAND,0,TOTALS,FINLAND,200,22,60,36.7,14,33,42.4,8,27,29.6,5,11,45.5,14,13,27,9,14,26,15,0,57,0
11902,276507,325_11_11,CROATIA,0,TOTALS,CROATIA,200,20,51,39.2,15,30,50.0,5,21,23.8,15,25,60.0,5,34,39,9,19,21,16,2,60,1
11903,276520,325_11_11,SLOVENIA,0,TOTALS,SLOVENIA,200,21,70,30.0,19,47,40.4,2,23,8.7,6,10,60.0,12,29,41,8,25,19,18,0,50,0
11904,276533,325_11_12,RUSSIA,0,TOTALS,RUSSIA,200,30,66,45.5,21,45,46.7,9,21,42.9,6,10,60.0,21,33,54,23,12,19,4,7,75,1
11905,276546,325_11_12,UKRAINE,0,TOTALS,UKRAINE,200,22,63,34.9,19,46,41.3,3,17,17.6,7,11,63.6,8,19,27,11,13,11,10,2,54,0
11906,276559,325_11_13,FRANCE,0,TOTALS,FRANCE,200,28,71,39.4,19,34,55.9,9,37,24.3,6,13,46.2,22,28,50,15,15,12,10,2,71,1
11907,276572,325_11_13,CZECH REPUBLIC,0,TOTALS,CZECH REPUBLIC,200,18,59,30.5,14,34,41.2,4,25,16.0,8,11,72.7,11,22,33,7,18,12,9,0,48,0
11908,276585,325_11_14,LITHUANIA,0,TOTALS,LITHUANIA,200,30,59,50.8,25,45,55.6,5,14,35.7,17,26,65.4,13,24,37,18,21,23,10,4,82,1
11909,276598,325_11_14,ITALY,0,TOTALS,ITALY,200,34,75,45.3,27,55,49.1,7,20,35.0,4,8,50.0,19,21,40,13,25,23,12,2,79,0
11910,276611,325_11_15,POLAND,0,TOTALS,POLAND,200,24,61,39.3,19,37,51.4,5,24,20.8,15,23,65.2,12,28,40,13,15,17,13,7,68,1
11911,276624,325_11_15,GREECE,0,TOTALS,GREECE,200,22,63,34.9,14,35,40.0,8,28,28.6,9,10,90.0,14,27,41,9,23,23,10,2,61,0
11912,276637,325_11_16,SERBIA,0,TOTALS,SERBIA,200,25,60,41.7,20,41,48.8,5,19,26.3,15,21,71.4,12,22,34,14,17,15,16,1,70,1
11913,276650,325_11_16,GERMANY,0,TOTALS,GERMANY,200,24,52,46.2,22,42,52.4,2,10,20.0,4,6,66.7,3,21,24,9,17,16,12,2,54,0
11914,276663,325_11_17,CZECH REPUBLIC,0,TOTALS,CZECH REPUBLIC,200,18,64,28.1,16,42,38.1,2,22,9.1,8,14,57.1,12,24,36,5,21,13,7,0,46,0
11915,276676,325_11_17,LATVIA,0,TOTALS,LATVIA,200,26,68,38.2,21,36,58.3,5,32,15.6,14,22,63.6,22,36,58,20,18,12,8,5,71,1
11916,276689,325_11_18,UKRAINE,0,TOTALS,UKRAINE,200,32,64,50.0,28,49,57.1,4,15,26.7,12,18,66.7,13,23,36,11,27,21,11,2,80,0
11917,276702,325_11_18,ITALY,0,TOTALS,ITALY,200,29,60,48.3,25,49,51.0,4,11,36.4,23,33,69.7,10,17,27,15,19,12,18,2,85,1
11918,276715,325_11_19,FINLAND,0,TOTALS,FINLAND,200,23,66,34.8,15,36,41.7,8,30,26.7,2,6,33.3,8,17,25,8,23,18,20,0,56,0
11919,276728,325_11_19,GERMANY,0,TOTALS,GERMANY,200,31,56,55.4,23,39,59.0,8,17,47.1,18,26,69.2,11,33,44,18,15,22,14,5,88,1
11920,276741,325_11_20,TURKEY,0,TOTALS,TURKEY,200,31,62,50.0,27,49,55.1,4,13,30.8,16,26,61.5,9,18,27,10,27,8,12,3,82,1
11921,276754,325_11_20,SERBIA,0,TOTALS,SERBIA,200,26,56,46.4,22,40,55.0,4,16,25.0,19,29,65.5,17,26,43,14,23,21,4,1,75,0
11922,276767,325_11_21,FRANCE,0,TOTALS,FRANCE,200,23,61,37.7,17,37,45.9,6,24,25.0,11,15,73.3,17,23,40,10,18,17,7,5,63,0
11923,276780,325_11_21,SPAIN,0,TOTALS,SPAIN,200,27,69,39.1,16,41,39.0,11,28,39.3,7,13,53.8,18,20,38,17,16,13,6,4,72,1
11924,276793,325_11_22,RUSSIA,0,TOTALS,RUSSIA,200,31,71,43.7,22,45,48.9,9,26,34.6,7,12,58.3,19,24,43,14,23,15,9,4,78,0
11925,276806,325_11_22,LITHUANIA,0,TOTALS,LITHUANIA,200,28,60,46.7,21,37,56.8,7,23,30.4,19,27,70.4,14,23,37,11,18,11,13,2,82,1
11926,276819,325_11_23,SLOVENIA,0,TOTALS,SLOVENIA,200,23,52,44.2,15,33,45.5,8,19,42.1,12,17,70.6,10,23,33,10,25,23,15,1,66,1
11927,276832,325_11_23,GREECE,0,TOTALS,GREECE,200,21,56,37.5,15,41,36.6,6,15,40.0,16,23,69.6,12,22,34,10,19,17,20,3,64,0
11928,276845,325_11_24,CROATIA,0,TOTALS,CROATIA,200,26,69,37.7,14,37,37.8,12,32,37.5,14,20,70.0,13,28,41,12,25,15,12,0,78,1
11929,276858,325_11_24,POLAND,0,TOTALS,POLAND,200,24,53,45.3,19,34,55.9,5,19,26.3,19,33,57.6,9,33,42,17,17,19,7,5,72,0
11930,276871,325_11_25,SLOVENIA,0,TOTALS,SLOVENIA,200,28,65,43.1,22,49,44.9,6,16,37.5,11,15,73.3,11,21,32,18,19,10,7,1,73,0
11931,276884,325_11_25,SERBIA,0,TOTALS,SERBIA,200,32,64,50.0,26,47,55.3,6,17,35.3,11,20,55.0,14,26,40,17,18,12,9,5,81,1
11932,276897,325_11_26,GREECE,0,TOTALS,GREECE,200,36,63,57.1,25,45,55.6,11,18,61.1,10,21,47.6,12,26,38,22,20,16,17,1,93,1
11933,276910,325_11_26,UKRAINE,0,TOTALS,UKRAINE,200,24,60,40.0,19,37,51.4,5,23,21.7,14,20,70.0,11,19,30,13,19,18,14,2,67,0
11934,276923,325_11_27,ITALY,0,TOTALS,ITALY,200,22,61,36.1,17,40,42.5,5,21,23.8,21,27,77.8,9,23,32,11,23,13,3,4,70,0
11935,276936,325_11_27,FRANCE,0,TOTALS,FRANCE,200,24,60,40.0,20,37,54.1,4,23,17.4,20,29,69.0,15,34,49,13,23,17,6,3,72,1
11936,276949,325_11_28,FINLAND,0,TOTALS,FINLAND,200,24,75,32.0,18,39,46.2,6,36,16.7,1,1,100.0,9,26,35,9,16,8,19,6,55,0
11937,276962,325_11_28,CZECH REPUBLIC,0,TOTALS,CZECH REPUBLIC,200,27,67,40.3,20,44,45.5,7,23,30.4,11,14,78.6,16,41,57,13,16,20,7,2,72,1
11938,276975,325_11_29,RUSSIA,0,TOTALS,RUSSIA,200,19,61,31.1,17,47,36.2,2,14,14.3,19,26,73.1,15,18,33,7,24,19,11,2,59,0
11939,276988,325_11_29,SPAIN,0,TOTALS,SPAIN,200,30,54,55.6,18,28,64.3,12,26,46.2,22,30,73.3,7,28,35,17,25,17,18,4,94,1
11940,277001,325_11_30,TURKEY,0,TOTALS,TURKEY,200,25,77,32.5,22,58,37.9,3,19,15.8,6,9,66.7,20,30,50,11,20,11,7,1,59,0
11941,277014,325_11_30,POLAND,0,TOTALS,POLAND,200,23,62,37.1,18,45,40.0,5,17,29.4,11,20,55.0,15,34,49,15,13,14,5,4,62,1
11942,277027,325_11_31,GERMANY,0,TOTALS,GERMANY,200,18,51,35.3,14,37,37.8,4,14,28.6,11,14,78.6,8,29,37,7,14,22,4,3,51,0
11943,277040,325_11_31,CROATIA,0,TOTALS,CROATIA,200,20,59,33.9,12,31,38.7,8,28,28.6,4,9,44.4,9,26,35,10,20,14,10,3,52,1
11944,277053,325_11_32,LATVIA,0,TOTALS,LATVIA,200,19,70,27.1,18,49,36.7,1,21,4.8,6,10,60.0,15,22,37,6,21,24,17,5,45,0
11945,277066,325_11_32,LITHUANIA,0,TOTALS,LITHUANIA,200,36,71,50.7,34,61,55.7,2,10,20.0,12,20,60.0,17,36,53,7,17,19,19,4,86,1
11946,277079,325_11_33,SPAIN,0,TOTALS,SPAIN,200,26,61,42.6,15,39,38.5,11,22,50.0,10,14,71.4,13,34,47,19,26,23,9,6,73,1
11947,277092,325_11_33,ITALY,0,TOTALS,ITALY,200,23,70,32.9,16,48,33.3,7,22,31.8,13,25,52.0,18,21,39,12,19,13,9,6,66,0
11948,277105,325_11_34,CZECH REPUBLIC,0,TOTALS,CZECH REPUBLIC,200,22,57,38.6,16,35,45.7,6,22,27.3,22,31,71.0,13,17,30,10,22,15,14,1,72,1
11949,277118,325_11_34,GREECE,0,TOTALS,GREECE,200,37,61,60.7,26,39,66.7,11,22,50.0,15,22,68.2,12,22,34,23,21,14,12,1,100,0
11950,277131,325_11_35,RUSSIA,0,TOTALS,RUSSIA,200,24,70,34.3,17,40,42.5,7,30,23.3,17,27,63.0,21,23,44,14,16,9,11,5,72,1
11951,277144,325_11_35,LATVIA,0,TOTALS,LATVIA,200,22,54,40.7,13,29,44.8,9,25,36.0,11,14,78.6,10,28,38,14,25,18,6,3,64,0
11952,277157,325_11_36,UKRAINE,0,TOTALS,UKRAINE,225,28,79,35.4,23,44,52.3,5,35,14.3,14,17,82.4,16,40,56,8,12,13,13,7,75,1
11953,277170,325_11_36,FINLAND,0,TOTALS,FINLAND,225,27,75,36.0,24,57,42.1,3,18,16.7,8,10,80.0,7,34,41,10,16,15,10,2,65,0
11954,277183,325_11_37,FRANCE,0,TOTALS,FRANCE,200,21,56,37.5,16,38,42.1,5,18,27.8,14,24,58.3,17,24,41,11,19,25,19,7,61,1
11955,277196,325_11_37,LITHUANIA,0,TOTALS,LITHUANIA,200,24,59,40.7,22,47,46.8,2,12,16.7,6,14,42.9,16,22,38,6,22,24,22,1,56,0
11956,277209,325_11_38,POLAND,0,TOTALS,POLAND,200,28,65,43.1,22,44,50.0,6,21,28.6,8,14,57.1,15,30,45,11,20,18,6,6,70,1
11957,277222,325_11_38,SERBIA,0,TOTALS,SERBIA,200,21,62,33.9,16,43,37.2,5,19,26.3,14,19,73.7,11,23,34,8,21,17,8,2,61,0
11958,277235,325_11_39,CROATIA,0,TOTALS,CROATIA,200,26,56,46.4,20,36,55.6,6,20,30.0,8,10,80.0,6,21,27,12,16,16,10,1,66,0
11959,277248,325_11_39,TURKEY,0,TOTALS,TURKEY,200,28,60,46.7,18,37,48.6,10,23,43.5,6,10,60.0,12,25,37,19,17,17,7,1,72,1
11960,277261,325_11_40,GERMANY,0,TOTALS,GERMANY,200,25,52,48.1,20,39,51.3,5,13,38.5,10,17,58.8,9,23,32,10,25,19,10,1,65,0
11961,277274,325_11_40,SLOVENIA,0,TOTALS,SLOVENIA,200,22,59,37.3,17,43,39.5,5,16,31.2,20,25,80.0,14,21,35,12,18,14,11,1,69,1
11962,277287,325_11_41,FRANCE,0,TOTALS,FRANCE,200,27,59,45.8,21,36,58.3,6,23,26.1,11,14,78.6,10,29,39,14,16,19,10,1,71,1
11963,277300,325_11_41,RUSSIA,0,TOTALS,RUSSIA,200,25,60,41.7,20,40,50.0,5,20,25.0,7,11,63.6,7,23,30,13,14,16,7,3,62,0
11964,277313,325_11_42,GREECE,0,TOTALS,GREECE,200,25,58,43.1,18,38,47.4,7,20,35.0,21,29,72.4,13,25,38,11,27,23,16,4,78,0
11965,277326,325_11_42,FINLAND,0,TOTALS,FINLAND,200,25,56,44.6,17,34,50.0,8,22,36.4,29,34,85.3,8,19,27,11,23,17,18,2,87,1
11966,277339,325_11_43,SERBIA,0,TOTALS,SERBIA,200,30,54,55.6,18,33,54.5,12,21,57.1,12,22,54.5,10,32,42,13,21,17,7,3,84,1
11967,277352,325_11_43,CROATIA,0,TOTALS,CROATIA,200,20,59,33.9,11,41,26.8,9,18,50.0,10,11,90.9,8,17,25,9,23,14,6,1,59,0
11968,277365,325_11_44,CZECH REPUBLIC,0,TOTALS,CZECH REPUBLIC,200,30,70,42.9,25,55,45.5,5,15,33.3,7,8,87.5,16,36,52,12,17,12,6,3,72,0
11969,277378,325_11_44,UKRAINE,0,TOTALS,UKRAINE,200,28,73,38.4,20,49,40.8,8,24,33.3,12,19,63.2,13,24,37,15,12,7,10,2,76,1
11970,277391,325_11_45,POLAND,0,TOTALS,POLAND,200,28,57,49.1,16,31,51.6,12,26,46.2,14,22,63.6,13,27,40,19,14,20,10,3,82,1
11971,277404,325_11_45,GERMANY,0,TOTALS,GERMANY,200,27,61,44.3,23,44,52.3,4,17,23.5,7,11,63.6,9,19,28,11,20,15,15,3,65,0
11972,277417,325_11_46,TURKEY,0,TOTALS,TURKEY,200,26,63,41.3,23,47,48.9,3,16,18.8,9,16,56.2,12,27,39,14,19,11,10,2,64,1
11973,277430,325_11_46,SLOVENIA,0,TOTALS,SLOVENIA,200,20,59,33.9,10,30,33.3,10,29,34.5,11,14,78.6,13,26,39,10,20,14,4,2,61,0
11974,277443,325_11_47,LITHUANIA,0,TOTALS,LITHUANIA,200,27,65,41.5,23,44,52.3,4,21,19.0,17,20,85.0,11,24,35,13,23,9,2,4,75,0
11975,277456,325_11_47,SPAIN,0,TOTALS,SPAIN,200,27,65,41.5,19,47,40.4,8,18,44.4,22,27,81.5,19,28,47,12,22,13,5,2,84,1
11976,277469,325_11_48,ITALY,0,TOTALS,ITALY,225,29,72,40.3,21,46,45.7,8,26,30.8,19,32,59.4,13,25,38,8,19,16,14,1,85,1
11977,277482,325_11_48,LATVIA,0,TOTALS,LATVIA,225,30,72,41.7,24,47,51.1,6,25,24.0,17,20,85.0,16,31,47,14,30,20,14,6,83,0
11978,277495,325_11_49,UKRAINE,0,TOTALS,UKRAINE,200,26,68,38.2,19,47,40.4,7,21,33.3,9,11,81.8,17,26,43,13,13,11,14,3,68,1
11979,277508,325_11_49,GREECE,0,TOTALS,GREECE,200,26,60,43.3,22,46,47.8,4,14,28.6,4,8,50.0,10,24,34,12,18,15,11,4,60,0
11980,277521,325_11_50,SPAIN,0,TOTALS,SPAIN,200,23,59,39.0,16,33,48.5,7,26,26.9,11,16,68.8,14,37,51,16,20,15,5,3,64,1
11981,277534,325_11_50,CROATIA,0,TOTALS,CROATIA,200,14,55,25.5,9,32,28.1,5,23,21.7,17,24,70.8,8,25,33,6,19,13,5,0,50,0
11982,277547,325_11_51,CZECH REPUBLIC,0,TOTALS,CZECH REPUBLIC,200,27,63,42.9,16,33,48.5,11,30,36.7,2,8,25.0,13,26,39,13,19,15,13,2,67,1
11983,277560,325_11_51,FINLAND,0,TOTALS,FINLAND,200,25,64,39.1,22,44,50.0,3,20,15.0,8,19,42.1,11,27,38,12,15,14,13,2,61,0
11984,277573,325_11_52,TURKEY,0,TOTALS,TURKEY,200,32,63,50.8,27,51,52.9,5,12,41.7,11,18,61.1,13,27,40,15,25,17,11,4,80,1
11985,277586,325_11_52,LITHUANIA,0,TOTALS,LITHUANIA,200,26,59,44.1,24,42,57.1,2,17,11.8,16,27,59.3,10,20,30,12,21,16,9,7,70,0
11986,277599,325_11_53,POLAND,0,TOTALS,POLAND,200,19,61,31.1,17,43,39.5,2,18,11.1,12,19,63.2,14,35,49,6,15,23,7,1,52,0
11987,277612,325_11_53,ITALY,0,TOTALS,ITALY,200,26,71,36.6,19,42,45.2,7,29,24.1,11,15,73.3,10,30,40,15,20,11,13,5,70,1
11988,277624,325_11_54,SLOVENIA,0,TOTALS,SLOVENIA,200,25,66,37.9,19,46,41.3,6,20,30.0,13,13,100.0,15,20,35,10,16,19,20,2,69,0
11989,277637,325_11_54,LATVIA,0,TOTALS,LATVIA,200,29,54,53.7,20,35,57.1,9,19,47.4,11,17,64.7,8,27,35,16,17,23,15,8,78,1
11990,277650,325_11_55,FRANCE,0,TOTALS,FRANCE,200,25,60,41.7,23,43,53.5,2,17,11.8,9,14,64.3,11,25,36,11,21,12,6,0,61,0
11991,277663,325_11_55,SERBIA,0,TOTALS,SERBIA,200,23,53,43.4,16,34,47.1,7,19,36.8,18,30,60.0,13,25,38,15,18,12,6,2,71,1
11992,277676,325_11_56,RUSSIA,0,TOTALS,RUSSIA,200,21,64,32.8,12,40,30.0,9,24,37.5,18,29,62.1,20,23,43,13,17,10,9,1,69,1
11993,277689,325_11_56,GERMANY,0,TOTALS,GERMANY,200,25,52,48.1,18,34,52.9,7,18,38.9,9,23,39.1,10,26,36,12,28,16,8,4,66,0
11994,277702,325_11_57,CROATIA,0,TOTALS,CROATIA,200,21,67,31.3,14,47,29.8,7,20,35.0,11,20,55.0,13,21,34,13,25,18,12,0,60,0
11995,277715,325_11_57,LITHUANIA,0,TOTALS,LITHUANIA,200,30,54,55.6,23,39,59.0,7,15,46.7,20,26,76.9,5,35,40,21,20,20,6,6,87,1
11996,277728,325_11_58,FINLAND,0,TOTALS,FINLAND,200,22,65,33.8,17,46,37.0,5,19,26.3,3,8,37.5,10,24,34,11,15,16,8,1,52,0
11997,277741,325_11_58,UKRAINE,0,TOTALS,UKRAINE,200,30,71,42.3,22,46,47.8,8,25,32.0,7,7,100.0,15,33,48,19,18,14,16,7,75,1
11998,277754,325_11_59,POLAND,0,TOTALS,POLAND,200,27,63,42.9,22,43,51.2,5,20,25.0,11,17,64.7,14,31,45,12,11,17,10,5,70,1
11999,277767,325_11_59,FRANCE,0,TOTALS,FRANCE,200,27,74,36.5,21,50,42.0,6,24,25.0,6,8,75.0,16,23,39,16,20,14,9,5,66,0
12000,277780,325_11_60,GREECE,0,TOTALS,GREECE,200,31,67,46.3,21,38,55.3,10,29,34.5,6,6,100.0,14,32,46,15,23,21,14,4,78,1
12001,277793,325_11_60,CZECH REPUBLIC,0,TOTALS,CZECH REPUBLIC,200,20,56,35.7,15,36,41.7,5,20,25.0,14,30,46.7,8,21,29,10,18,18,20,2,59,0
12002,277806,325_11_61,ITALY,0,TOTALS,ITALY,200,20,68,29.4,16,44,36.4,4,24,16.7,17,27,63.0,16,29,45,9,28,13,4,4,61,0
12003,277819,325_11_61,SERBIA,0,TOTALS,SERBIA,200,21,62,33.9,18,44,40.9,3,18,16.7,22,36,61.1,18,34,52,11,27,13,8,3,67,1
12004,277832,325_11_62,SPAIN,0,TOTALS,SPAIN,200,24,63,38.1,15,38,39.5,9,25,36.0,20,32,62.5,22,26,48,14,14,11,8,4,77,1
12005,277845,325_11_62,TURKEY,0,TOTALS,TURKEY,200,21,53,39.6,17,39,43.6,4,14,28.6,8,13,61.5,7,24,31,11,24,14,7,5,54,0
12006,277858,325_11_63,SLOVENIA,0,TOTALS,SLOVENIA,200,28,63,44.4,17,39,43.6,11,24,45.8,6,14,42.9,3,19,22,16,26,13,15,0,73,0
12007,277871,325_11_63,GERMANY,0,TOTALS,GERMANY,200,30,54,55.6,25,40,62.5,5,14,35.7,21,27,77.8,7,35,42,17,19,18,11,1,86,1
12008,277884,325_11_64,FRANCE,0,TOTALS,FRANCE,200,33,70,47.1,26,45,57.8,7,25,28.0,7,14,50.0,12,27,39,22,12,10,13,0,80,1
12009,277897,325_11_64,CROATIA,0,TOTALS,CROATIA,200,23,57,40.4,13,34,38.2,10,23,43.5,5,10,50.0,8,27,35,16,18,22,4,6,61,0
12010,277910,325_11_65,LATVIA,0,TOTALS,LATVIA,200,23,68,33.8,22,42,52.4,1,26,3.8,11,18,61.1,15,26,41,6,19,17,16,2,58,0
12011,277923,325_11_65,RUSSIA,0,TOTALS,RUSSIA,200,24,71,33.8,21,51,41.2,3,20,15.0,13,19,68.4,21,31,52,11,17,17,13,7,64,1
12012,277936,325_11_66,POLAND,0,TOTALS,POLAND,200,24,68,35.3,18,46,39.1,6,22,27.3,12,17,70.6,12,27,39,12,18,20,11,5,66,0
12013,277949,325_11_66,LITHUANIA,0,TOTALS,LITHUANIA,200,29,67,43.3,24,52,46.2,5,15,33.3,15,25,60.0,16,31,47,22,19,21,11,3,78,1
12014,277962,325_11_67,FINLAND,0,TOTALS,FINLAND,200,18,63,28.6,11,35,31.4,7,28,25.0,12,25,48.0,14,26,40,6,14,15,16,0,55,0
12015,277975,325_11_67,GREECE,0,TOTALS,GREECE,200,26,61,42.6,19,30,63.3,7,31,22.6,9,12,75.0,10,37,47,14,17,20,13,9,68,1
12016,277988,325_11_68,ITALY,0,TOTALS,ITALY,200,26,62,41.9,17,34,50.0,9,28,32.1,4,14,28.6,10,30,40,15,17,16,5,0,65,0
12017,278001,325_11_68,TURKEY,0,TOTALS,TURKEY,200,26,61,42.6,19,39,48.7,7,22,31.8,10,19,52.6,8,31,39,17,19,12,8,5,69,1
12018,278014,325_11_69,UKRAINE,0,TOTALS,UKRAINE,200,30,62,48.4,20,39,51.3,10,23,43.5,17,26,65.4,13,26,39,16,13,13,13,6,87,1
12019,278027,325_11_69,CZECH REPUBLIC,0,TOTALS,CZECH REPUBLIC,200,29,68,42.6,23,50,46.0,6,18,33.3,9,10,90.0,13,22,35,13,20,15,11,1,73,0
12020,278040,325_11_70,SERBIA,0,TOTALS,SERBIA,200,25,67,37.3,22,48,45.8,3,19,15.8,12,21,57.1,11,30,41,10,28,10,10,1,65,0
12021,278053,325_11_70,SPAIN,0,TOTALS,SPAIN,200,22,57,38.6,19,40,47.5,3,17,17.6,24,30,80.0,9,33,42,7,25,11,6,10,71,1
12022,278066,326_11_01,HUNGARY,0,TOTALS,HUNGARY,200,27,58,46.6,23,41,56.1,4,17,23.5,11,20,55.0,16,26,42,17,16,24,16,2,69,1
12023,278079,326_11_01,GEORGIA,0,TOTALS,GEORGIA,200,17,52,32.7,15,41,36.6,2,11,18.2,5,10,50.0,10,20,30,7,20,31,12,0,41,0
12024,278092,326_11_02,MONTENEGRO,0,TOTALS,MONTENEGRO,200,36,65,55.4,31,50,62.0,5,15,33.3,20,28,71.4,20,34,54,17,13,12,12,5,97,1
12025,278105,326_11_02,AUSTRIA,0,TOTALS,AUSTRIA,200,15,63,23.8,12,50,24.0,3,13,23.1,5,10,50.0,15,14,29,7,21,20,4,3,38,0
12026,278118,326_11_03,ENGLAND,0,TOTALS,ENGLAND,200,22,65,33.8,19,49,38.8,3,16,18.8,18,30,60.0,17,30,47,10,21,24,18,2,65,1
12027,278131,326_11_03,ESTONIA,0,TOTALS,ESTONIA,200,24,65,36.9,19,41,46.3,5,24,20.8,10,20,50.0,13,33,46,9,25,26,14,5,63,0
12028,278144,326_11_04,SWEDEN,0,TOTALS,SWEDEN,200,37,89,41.6,34,72,47.2,3,17,17.6,13,19,68.4,26,33,59,22,15,14,14,5,90,1
12029,278157,326_11_04,NORWAY,0,TOTALS,NORWAY,200,19,65,29.2,16,51,31.4,3,14,21.4,9,16,56.2,16,25,41,8,15,25,9,3,50,0
12030,278170,326_11_05,BULGARIA,0,TOTALS,BULGARIA,200,41,73,56.2,29,38,76.3,12,35,34.3,12,21,57.1,18,44,62,32,22,24,8,7,106,0
12031,278183,326_11_05,LUXEMBOURG,0,TOTALS,LUXEMBOURG,200,21,73,28.8,14,49,28.6,7,24,29.2,10,23,43.5,12,18,30,7,22,18,17,1,59,1
12032,278196,326_11_06,ROMANIA,0,TOTALS,ROMANIA,200,28,76,36.8,25,65,38.5,3,11,27.3,7,16,43.8,21,31,52,17,20,26,14,7,66,1
12033,278209,326_11_06,NETHERLANDS,0,TOTALS,NETHERLANDS,200,20,66,30.3,10,39,25.6,10,27,37.0,15,20,75.0,16,34,50,16,18,26,11,8,65,0
12034,278222,326_11_07,PORTUGAL,0,TOTALS,PORTUGAL,200,22,63,34.9,15,41,36.6,7,22,31.8,6,16,37.5,19,22,41,5,23,15,8,4,57,0
12035,278235,326_11_07,BELGIUM,0,TOTALS,BELGIUM,200,20,48,41.7,19,39,48.7,1,9,11.1,18,28,64.3,9,29,38,11,22,17,10,2,59,1
12036,278248,326_11_08,SWITZERLAND,0,TOTALS,SWITZERLAND,200,27,70,38.6,19,46,41.3,8,24,33.3,21,29,72.4,16,27,43,12,31,24,14,2,83,0
12037,278261,326_11_08,SLOVAK REPUBLIC,0,TOTALS,SLOVAK REPUBLIC,200,31,68,45.6,26,46,56.5,5,22,22.7,20,32,62.5,14,31,45,23,27,21,16,9,87,1
12038,278273,326_11_09,DENMARK,0,TOTALS,DENMARK,200,28,70,40.0,25,55,45.5,3,15,20.0,3,10,30.0,21,32,53,13,8,16,6,1,62,1
12039,278286,326_11_09,PORTUGAL,0,TOTALS,PORTUGAL,200,21,60,35.0,18,30,60.0,3,30,10.0,5,5,100.0,7,26,33,13,11,17,8,4,50,0
12040,278299,326_11_10,ISRAEL,0,TOTALS,ISRAEL,200,44,89,49.4,36,65,55.4,8,24,33.3,5,13,38.5,20,26,46,31,17,16,27,3,101,0
12041,278312,326_11_10,SWITZERLAND,0,TOTALS,SWITZERLAND,200,21,64,32.8,17,45,37.8,4,19,21.1,3,6,50.0,19,28,47,7,17,41,8,5,49,1
12042,278325,326_11_11,BELGIUM,0,TOTALS,BELGIUM,200,24,66,36.4,15,34,44.1,9,32,28.1,11,20,55.0,17,30,47,10,20,19,11,0,68,1
12043,278338,326_11_11,ENGLAND,0,TOTALS,ENGLAND,200,21,59,35.6,20,37,54.1,1,22,4.5,13,24,54.2,14,29,43,10,22,22,10,0,56,0
12044,278351,326_11_12,SLOVAK REPUBLIC,0,TOTALS,SLOVAK REPUBLIC,200,21,58,36.2,12,37,32.4,9,21,42.9,6,16,37.5,9,40,49,15,18,26,12,9,57,1
12045,278364,326_11_12,SWEDEN,0,TOTALS,SWEDEN,200,23,79,29.1,21,63,33.3,2,16,12.5,8,17,47.1,18,32,50,13,16,16,11,7,56,0
12046,278377,326_11_13,LUXEMBOURG,0,TOTALS,LUXEMBOURG,200,21,60,35.0,19,42,45.2,2,18,11.1,14,23,60.9,10,30,40,9,22,25,14,5,58,0
12047,278390,326_11_13,HUNGARY,0,TOTALS,HUNGARY,200,25,69,36.2,19,42,45.2,6,27,22.2,23,30,76.7,14,33,47,21,21,16,13,3,79,1
12048,278403,326_11_14,NETHERLANDS,0,TOTALS,NETHERLANDS,200,21,60,35.0,14,32,43.8,7,28,25.0,13,18,72.2,13,24,37,16,16,17,9,6,62,1
12049,278416,326_11_14,MONTENEGRO,0,TOTALS,MONTENEGRO,200,21,54,38.9,17,35,48.6,4,19,21.1,11,16,68.8,12,26,38,14,18,22,7,1,57,0
12050,278429,326_11_15,ESTONIA,0,TOTALS,ESTONIA,200,19,62,30.6,14,40,35.0,5,22,22.7,11,16,68.8,15,28,43,10,20,21,15,2,54,1
12051,278442,326_11_15,BELGIUM,0,TOTALS,BELGIUM,200,18,55,32.7,14,41,34.1,4,14,28.6,7,16,43.8,13,29,42,9,20,27,9,4,47,0
12052,278455,326_11_16,NORWAY,0,TOTALS,NORWAY,200,20,60,33.3,16,39,41.0,4,21,19.0,22,32,68.8,8,22,30,14,16,26,14,2,66,0
12053,278468,326_11_16,SLOVAK REPUBLIC,0,TOTALS,SLOVAK REPUBLIC,200,41,79,51.9,32,51,62.7,9,28,32.1,8,13,61.5,15,38,53,28,29,23,13,3,99,1
12054,278481,326_11_17,GEORGIA,0,TOTALS,GEORGIA,200,20,57,35.1,11,38,28.9,9,19,47.4,6,10,60.0,12,24,36,7,22,21,11,1,55,0
12055,278494,326_11_17,BULGARIA,0,TOTALS,BULGARIA,200,19,60,31.7,8,24,33.3,11,36,30.6,18,25,72.0,17,27,44,12,20,19,11,5,67,1
12056,278507,326_11_18,AUSTRIA,0,TOTALS,AUSTRIA,200,16,60,26.7,11,45,24.4,5,15,33.3,15,26,57.7,15,20,35,9,22,23,16,4,52,0
12057,278520,326_11_18,ROMANIA,0,TOTALS,ROMANIA,200,23,65,35.4,23,51,45.1,0,14,0.0,18,29,62.1,29,35,64,10,21,31,12,8,64,1
12058,278533,326_11_19,ENGLAND,0,TOTALS,ENGLAND,200,19,70,27.1,17,52,32.7,2,18,11.1,2,13,15.4,16,33,49,10,20,14,4,1,42,0
12059,278546,326_11_19,DENMARK,0,TOTALS,DENMARK,200,20,59,33.9,14,36,38.9,6,23,26.1,14,19,73.7,8,39,47,14,12,13,6,5,60,1
12060,278559,326_11_20,SWEDEN,0,TOTALS,SWEDEN,225,35,78,44.9,33,65,50.8,2,13,15.4,13,21,61.9,14,44,58,15,20,21,5,2,85,1
12061,278572,326_11_20,ISRAEL,0,TOTALS,ISRAEL,225,29,84,34.5,21,55,38.2,8,29,27.6,14,21,66.7,14,31,45,15,27,16,15,1,80,0
12062,278585,326_11_21,PORTUGAL,0,TOTALS,PORTUGAL,200,26,62,41.9,18,43,41.9,8,19,42.1,14,20,70.0,10,19,29,13,22,18,16,3,74,1
12063,278598,326_11_21,ENGLAND,0,TOTALS,ENGLAND,200,24,55,43.6,19,41,46.3,5,14,35.7,13,24,54.2,13,30,43,9,21,28,9,4,66,0
12064,278611,326_11_22,SWITZERLAND,0,TOTALS,SWITZERLAND,200,23,69,33.3,17,53,32.1,6,16,37.5,6,14,42.9,19,36,55,18,18,30,11,9,58,0
12065,278624,326_11_22,SWEDEN,0,TOTALS,SWEDEN,200,29,77,37.7,27,58,46.6,2,19,10.5,8,10,80.0,13,30,43,13,16,17,18,7,68,1
12066,278637,326_11_23,DENMARK,0,TOTALS,DENMARK,200,22,60,36.7,19,53,35.8,3,7,42.9,16,26,61.5,19,37,56,12,8,21,4,1,63,1
12067,278650,326_11_23,ESTONIA,0,TOTALS,ESTONIA,200,21,66,31.8,15,33,45.5,6,33,18.2,1,2,50.0,8,23,31,10,22,14,7,4,49,0
12068,278663,326_11_24,ISRAEL,0,TOTALS,ISRAEL,200,37,76,48.7,29,56,51.8,8,20,40.0,23,35,65.7,19,41,60,28,24,14,14,3,105,0
12069,278676,326_11_24,NORWAY,0,TOTALS,NORWAY,200,12,59,20.3,5,26,19.2,7,33,21.2,12,24,50.0,8,24,32,11,25,25,7,3,43,1
12070,278689,326_11_25,MONTENEGRO,0,TOTALS,MONTENEGRO,200,35,66,53.0,26,40,65.0,9,26,34.6,17,21,81.0,13,32,45,20,18,16,10,7,96,1
12071,278702,326_11_25,ROMANIA,0,TOTALS,ROMANIA,200,21,63,33.3,16,45,35.6,5,18,27.8,10,19,52.6,13,21,34,10,19,18,6,3,57,0
12072,278715,326_11_26,GEORGIA,0,TOTALS,GEORGIA,225,33,86,38.4,18,36,50.0,15,50,30.0,24,29,82.8,19,33,52,22,29,21,18,2,105,0
12073,278728,326_11_26,LUXEMBOURG,0,TOTALS,LUXEMBOURG,225,36,65,55.4,24,44,54.5,12,21,57.1,14,31,45.2,9,35,44,18,23,31,13,1,98,1
12074,278741,326_11_27,BELGIUM,0,TOTALS,BELGIUM,200,23,72,31.9,15,46,32.6,8,26,30.8,2,2,100.0,15,23,38,15,24,11,3,2,56,0
12075,278754,326_11_27,DENMARK,0,TOTALS,DENMARK,200,21,50,42.0,13,32,40.6,8,18,44.4,15,26,57.7,10,34,44,8,12,15,4,7,65,1
12076,278767,326_11_28,SLOVAK REPUBLIC,0,TOTALS,SLOVAK REPUBLIC,200,25,65,38.5,19,42,45.2,6,23,26.1,5,10,50.0,11,21,32,11,23,27,12,5,61,0
12077,278780,326_11_28,ISRAEL,0,TOTALS,ISRAEL,200,33,64,51.6,25,50,50.0,8,14,57.1,13,21,61.9,14,30,44,20,18,26,20,5,87,1
12078,278793,326_11_29,BULGARIA,0,TOTALS,BULGARIA,200,34,64,53.1,29,44,65.9,5,20,25.0,3,12,25.0,16,22,38,17,22,18,16,1,76,1
12079,278806,326_11_29,HUNGARY,0,TOTALS,HUNGARY,200,20,50,40.0,18,36,50.0,2,14,14.3,12,19,63.2,9,20,29,13,11,24,12,1,54,0
12080,278819,326_11_30,NETHERLANDS,0,TOTALS,NETHERLANDS,200,26,61,42.6,14,33,42.4,12,28,42.9,7,18,38.9,18,26,44,17,18,19,10,8,71,1
12081,278832,326_11_30,AUSTRIA,0,TOTALS,AUSTRIA,200,18,62,29.0,15,47,31.9,3,15,20.0,7,11,63.6,16,25,41,12,21,23,7,2,46,0
12082,278845,326_11_31,ESTONIA,0,TOTALS,ESTONIA,200,33,63,52.4,23,38,60.5,10,25,40.0,5,8,62.5,9,22,31,18,25,14,10,2,81,1
12083,278858,326_11_31,PORTUGAL,0,TOTALS,PORTUGAL,200,22,51,43.1,14,36,38.9,8,15,53.3,13,23,56.5,12,19,31,13,12,19,7,2,65,0
12084,278871,326_11_32,NORWAY,0,TOTALS,NORWAY,200,24,77,31.2,21,49,42.9,3,28,10.7,23,31,74.2,19,28,47,17,31,14,13,2,74,0
12085,278884,326_11_32,SWITZERLAND,0,TOTALS,SWITZERLAND,200,25,65,38.5,22,50,44.0,3,15,20.0,26,47,55.3,22,38,60,16,24,25,11,4,79,1
12086,278897,326_11_33,MONTENEGRO,0,TOTALS,MONTENEGRO,200,22,61,36.1,21,48,43.8,1,13,7.7,7,10,70.0,13,24,37,4,17,27,11,2,52,0
12087,278910,326_11_33,SWEDEN,0,TOTALS,SWEDEN,200,26,61,42.6,20,41,48.8,6,20,30.0,8,12,66.7,11,23,34,16,15,19,10,3,66,1
12088,278923,326_11_34,ROMANIA,0,TOTALS,ROMANIA,200,30,68,44.1,26,56,46.4,4,12,33.3,15,24,62.5,18,39,57,21,19,27,10,9,79,1
12089,278936,326_11_34,NORWAY,0,TOTALS,NORWAY,200,20,70,28.6,16,51,31.4,4,19,21.1,5,8,62.5,12,25,37,8,18,24,9,3,49,0
12090,278949,326_11_35,NETHERLANDS,0,TOTALS,NETHERLANDS,200,20,56,35.7,15,33,45.5,5,23,21.7,17,23,73.9,10,31,41,13,16,24,2,3,62,0
12091,278962,326_11_35,ISRAEL,0,TOTALS,ISRAEL,200,31,67,46.3,29,53,54.7,2,14,14.3,14,21,66.7,6,26,32,15,16,13,10,3,78,1
12092,278975,326_11_36,AUSTRIA,0,TOTALS,AUSTRIA,200,21,75,28.0,19,60,31.7,2,15,13.3,4,12,33.3,15,26,41,9,16,26,16,4,48,0
12093,278988,326_11_36,SWITZERLAND,0,TOTALS,SWITZERLAND,200,26,76,34.2,24,64,37.5,2,12,16.7,16,25,64.0,27,43,70,15,11,28,17,5,70,1
12094,279001,326_11_37,BULGARIA,0,TOTALS,BULGARIA,200,28,58,48.3,21,40,52.5,7,18,38.9,18,36,50.0,15,20,35,14,16,19,6,4,81,1
12095,279014,326_11_37,ESTONIA,0,TOTALS,ESTONIA,200,28,59,47.5,17,33,51.5,11,26,42.3,3,6,50.0,13,25,38,18,29,26,8,5,70,0
12096,279027,326_11_38,GEORGIA,0,TOTALS,GEORGIA,225,20,73,27.4,11,41,26.8,9,32,28.1,10,15,66.7,15,30,45,16,23,20,13,1,59,0
12097,279040,326_11_38,ENGLAND,0,TOTALS,ENGLAND,225,21,60,35.0,15,37,40.5,6,23,26.1,13,20,65.0,10,39,49,7,16,30,11,5,61,1
12098,279053,326_11_39,HUNGARY,0,TOTALS,HUNGARY,200,20,59,33.9,17,39,43.6,3,20,15.0,3,6,50.0,8,27,35,10,17,16,10,2,46,0
12099,279066,326_11_39,DENMARK,0,TOTALS,DENMARK,200,17,54,31.5,10,38,26.3,7,16,43.8,9,14,64.3,12,32,44,13,8,21,9,3,50,1
12100,279079,326_11_40,LUXEMBOURG,0,TOTALS,LUXEMBOURG,200,25,63,39.7,23,47,48.9,2,16,12.5,13,20,65.0,14,29,43,6,17,22,3,2,65,0
12101,279092,326_11_40,PORTUGAL,0,TOTALS,PORTUGAL,200,27,74,36.5,18,39,46.2,9,35,25.7,9,19,47.4,23,28,51,16,18,23,8,3,72,1
12102,279105,326_11_41,ISRAEL,0,TOTALS,ISRAEL,200,23,75,30.7,21,59,35.6,2,16,12.5,10,15,66.7,12,24,36,12,30,16,13,2,58,0
12103,279118,326_11_41,MONTENEGRO,0,TOTALS,MONTENEGRO,200,23,54,42.6,14,35,40.0,9,19,47.4,23,31,74.2,10,40,50,14,20,23,10,3,78,1
12104,279131,326_11_42,SWITZERLAND,0,TOTALS,SWITZERLAND,200,24,81,29.6,21,62,33.9,3,19,15.8,12,17,70.6,28,28,56,9,14,11,7,3,63,0
12105,279144,326_11_42,ROMANIA,0,TOTALS,ROMANIA,200,33,72,45.8,24,48,50.0,9,24,37.5,4,11,36.4,15,29,44,21,14,12,6,2,79,1
12106,279157,326_11_43,SWEDEN,0,TOTALS,SWEDEN,200,26,64,40.6,18,45,40.0,8,19,42.1,8,16,50.0,17,38,55,15,14,25,13,6,68,1
12107,279170,326_11_43,NETHERLANDS,0,TOTALS,NETHERLANDS,200,17,66,25.8,13,44,29.5,4,22,18.2,5,10,50.0,13,26,39,9,17,23,14,3,43,0
12108,279183,326_11_44,SLOVAK REPUBLIC,0,TOTALS,SLOVAK REPUBLIC,200,35,63,55.6,28,48,58.3,7,15,46.7,4,7,57.1,7,33,40,20,24,26,18,8,81,1
12109,279196,326_11_44,AUSTRIA,0,TOTALS,AUSTRIA,200,15,62,24.2,13,53,24.5,2,9,22.2,14,23,60.9,17,23,40,5,16,28,14,1,46,0
12110,279209,326_11_45,DENMARK,0,TOTALS,DENMARK,200,25,53,47.2,19,35,54.3,6,18,33.3,16,24,66.7,10,23,33,11,9,21,7,4,72,0
12111,279222,326_11_45,BULGARIA,0,TOTALS,BULGARIA,200,31,72,43.1,20,39,51.3,11,33,33.3,8,9,88.9,19,21,40,12,22,17,13,3,81,1
12112,279235,326_11_46,PORTUGAL,0,TOTALS,PORTUGAL,200,23,60,38.3,15,35,42.9,8,25,32.0,7,16,43.8,18,29,47,12,18,24,6,3,61,1
12113,279248,326_11_46,GEORGIA,0,TOTALS,GEORGIA,200,23,66,34.8,19,43,44.2,4,23,17.4,7,14,50.0,18,24,42,14,21,17,6,3,57,0
12114,279261,326_11_47,ESTONIA,0,TOTALS,ESTONIA,200,20,58,34.5,13,38,34.2,7,20,35.0,6,10,60.0,15,17,32,13,26,20,4,1,53,0
12115,279274,326_11_47,HUNGARY,0,TOTALS,HUNGARY,200,25,61,41.0,23,51,45.1,2,10,20.0,23,28,82.1,22,25,47,19,16,16,9,7,75,1
12116,279287,326_11_48,BELGIUM,0,TOTALS,BELGIUM,200,27,69,39.1,21,47,44.7,6,22,27.3,3,14,21.4,18,33,51,16,15,17,8,8,63,1
12117,279300,326_11_48,LUXEMBOURG,0,TOTALS,LUXEMBOURG,200,19,71,26.8,14,43,32.6,5,28,17.9,6,10,60.0,21,29,50,11,18,20,5,3,49,0
12118,279313,326_11_49,ROMANIA,0,TOTALS,ROMANIA,200,19,57,33.3,13,37,35.1,6,20,30.0,6,16,37.5,16,26,42,12,13,26,7,4,50,0
12119,279326,326_11_49,SLOVAK REPUBLIC,0,TOTALS,SLOVAK REPUBLIC,200,35,71,49.3,25,49,51.0,10,22,45.5,6,9,66.7,9,29,38,22,18,13,12,6,86,1
12120,279339,326_11_50,AUSTRIA,0,TOTALS,AUSTRIA,200,19,65,29.2,15,48,31.2,4,17,23.5,7,15,46.7,16,35,51,9,17,23,11,5,49,0
12121,279352,326_11_50,NORWAY,0,TOTALS,NORWAY,200,20,71,28.2,16,51,31.4,4,20,20.0,11,12,91.7,16,30,46,7,16,17,11,1,55,1
12122,279365,326_11_51,GEORGIA,0,TOTALS,GEORGIA,200,23,55,41.8,16,37,43.2,7,18,38.9,17,27,63.0,10,23,33,13,18,20,15,2,70,1
12123,279378,326_11_51,BELGIUM,0,TOTALS,BELGIUM,200,21,54,38.9,19,40,47.5,2,14,14.3,14,19,73.7,12,24,36,15,21,26,11,5,58,0
12124,279391,326_11_52,LUXEMBOURG,0,TOTALS,LUXEMBOURG,200,21,68,30.9,8,33,24.2,13,35,37.1,3,6,50.0,13,19,32,12,8,20,5,2,58,1
12125,279404,326_11_52,ENGLAND,0,TOTALS,ENGLAND,200,44,81,54.3,36,57,63.2,8,24,33.3,4,11,36.4,19,34,53,24,9,14,11,2,100,0
12126,279417,326_11_53,HUNGARY,0,TOTALS,HUNGARY,200,18,54,33.3,13,38,34.2,5,16,31.2,6,13,46.2,8,20,28,10,18,24,14,3,47,0
12127,279430,326_11_53,NETHERLANDS,0,TOTALS,NETHERLANDS,200,20,59,33.9,19,43,44.2,1,16,6.2,11,17,64.7,18,29,47,15,18,28,13,5,52,1
12128,279443,326_11_54,ISRAEL,0,TOTALS,ISRAEL,200,23,62,37.1,20,42,47.6,3,20,15.0,11,21,52.4,8,23,31,11,24,18,14,4,60,0
12129,279456,326_11_54,ESTONIA,0,TOTALS,ESTONIA,200,24,56,42.9,19,40,47.5,5,16,31.2,23,28,82.1,12,35,47,18,22,24,13,3,76,1
12130,279469,326_11_55,LUXEMBOURG,0,TOTALS,LUXEMBOURG,200,34,71,47.9,26,46,56.5,8,25,32.0,11,18,61.1,12,36,48,18,13,19,16,3,87,1
12131,279482,326_11_55,AUSTRIA,0,TOTALS,AUSTRIA,200,30,74,40.5,20,48,41.7,10,26,38.5,6,10,60.0,12,29,41,20,17,21,14,2,76,0
12132,279495,326_11_56,BULGARIA,0,TOTALS,BULGARIA,200,25,57,43.9,17,35,48.6,8,22,36.4,9,14,64.3,7,29,36,10,21,22,14,1,67,1
12133,279508,326_11_56,MONTENEGRO,0,TOTALS,MONTENEGRO,200,19,55,34.5,14,31,45.2,5,24,20.8,11,14,78.6,9,25,34,8,18,27,10,5,54,0
12134,279521,326_11_57,GEORGIA,0,TOTALS,GEORGIA,200,25,65,38.5,18,40,45.0,7,25,28.0,13,17,76.5,13,32,45,21,16,21,13,4,70,1
12135,279534,326_11_57,NORWAY,0,TOTALS,NORWAY,200,19,58,32.8,17,44,38.6,2,14,14.3,7,15,46.7,8,26,34,11,12,26,9,0,47,0
12136,279547,326_11_58,SWEDEN,0,TOTALS,SWEDEN,200,22,76,28.9,19,63,30.2,3,13,23.1,7,13,53.8,15,21,36,7,17,15,11,9,54,0
12137,279560,326_11_58,DENMARK,0,TOTALS,DENMARK,200,32,64,50.0,25,48,52.1,7,16,43.8,7,14,50.0,15,41,56,13,15,24,8,5,78,1
12138,279573,326_11_59,ENGLAND,0,TOTALS,ENGLAND,200,24,58,41.4,18,40,45.0,6,18,33.3,7,14,50.0,13,23,36,7,14,19,14,5,61,0
12139,279586,326_11_59,SWITZERLAND,0,TOTALS,SWITZERLAND,200,28,66,42.4,20,45,44.4,8,21,38.1,7,10,70.0,16,23,39,13,15,18,9,8,71,1
12140,279599,326_11_60,HUNGARY,0,TOTALS,HUNGARY,200,26,69,37.7,23,49,46.9,3,20,15.0,13,22,59.1,14,14,28,10,13,20,12,2,68,0
12141,279612,326_11_60,ISRAEL,0,TOTALS,ISRAEL,200,40,67,59.7,34,55,61.8,6,12,50.0,10,16,62.5,16,32,48,31,18,24,10,2,96,1
12142,279625,326_11_61,PORTUGAL,0,TOTALS,PORTUGAL,200,20,72,27.8,17,52,32.7,3,20,15.0,3,5,60.0,14,26,40,10,16,11,5,2,46,0
12143,279638,326_11_61,ROMANIA,0,TOTALS,ROMANIA,200,28,71,39.4,23,56,41.1,5,15,33.3,11,19,57.9,19,39,58,16,16,12,7,5,72,1
12144,279651,326_11_62,NETHERLANDS,0,TOTALS,NETHERLANDS,200,21,58,36.2,14,35,40.0,7,23,30.4,13,20,65.0,13,27,40,13,14,25,12,3,62,0
12145,279664,326_11_62,ESTONIA,0,TOTALS,ESTONIA,200,24,63,38.1,16,43,37.2,8,20,40.0,7,8,87.5,10,26,36,17,23,26,14,2,63,1
12146,279677,326_11_63,BELGIUM,0,TOTALS,BELGIUM,200,23,61,37.7,21,49,42.9,2,12,16.7,21,33,63.6,19,30,49,15,22,24,16,5,69,1
12147,279690,326_11_63,SLOVAK REPUBLIC,0,TOTALS,SLOVAK REPUBLIC,200,18,61,29.5,16,44,36.4,2,17,11.8,16,21,76.2,14,27,41,10,29,23,16,3,54,0
12148,279703,326_11_64,MONTENEGRO,0,TOTALS,MONTENEGRO,200,22,59,37.3,18,42,42.9,4,17,23.5,17,26,65.4,16,27,43,11,20,23,8,2,65,0
12149,279716,326_11_64,SWEDEN,0,TOTALS,SWEDEN,200,29,62,46.8,27,53,50.9,2,9,22.2,11,19,57.9,8,25,33,13,21,15,11,4,71,1
12150,279729,326_11_65,BULGARIA,0,TOTALS,BULGARIA,200,27,70,38.6,20,35,57.1,7,35,20.0,9,16,56.2,13,29,42,10,22,10,9,3,70,1
12151,279742,326_11_65,DENMARK,0,TOTALS,DENMARK,200,21,62,33.9,15,40,37.5,6,22,27.3,20,27,74.1,16,34,50,9,16,17,6,3,68,0
12152,279754,327_11_01,GIBRALTAR,0,TOTALS,GIBRALTAR,200,9,52,17.3,7,41,17.1,2,11,18.2,9,29,31.0,8,22,30,2,18,31,10,2,29,0
12153,279767,327_11_01,WALES,0,TOTALS,WALES,200,42,76,55.3,42,74,56.8,0,2,0.0,11,26,42.3,15,43,58,18,29,27,20,6,95,1
12154,279780,327_11_02,SAN MARINO,0,TOTALS,SAN MARINO,200,25,83,30.1,20,56,35.7,5,27,18.5,14,26,53.8,23,22,45,5,19,15,18,1,69,1
12155,279793,327_11_02,MOLDOVA,0,TOTALS,MOLDOVA,200,24,55,43.6,24,51,47.1,0,4,0.0,14,23,60.9,12,41,53,10,21,27,8,6,62,0
12156,279806,327_11_03,ANDORRA,0,TOTALS,ANDORRA,200,22,68,32.4,18,51,35.3,4,17,23.5,17,43,39.5,28,32,60,8,24,25,4,3,65,0
12157,279819,327_11_03,SAN MARINO,0,TOTALS,SAN MARINO,200,24,58,41.4,17,39,43.6,7,19,36.8,20,30,66.7,4,30,34,9,31,13,17,3,75,1
12158,279832,327_11_04,MOLDOVA,0,TOTALS,MOLDOVA,200,34,71,47.9,34,65,52.3,0,6,0.0,5,9,55.6,20,26,46,10,7,26,20,5,73,1
12159,279844,327_11_04,GIBRALTAR,0,TOTALS,GIBRALTAR,200,12,44,27.3,7,26,26.9,5,18,27.8,2,4,50.0,7,18,25,1,6,38,11,1,31,0
12160,279857,327_11_05,WALES,0,TOTALS,WALES,200,29,83,34.9,27,74,36.5,2,9,22.2,14,40,35.0,28,35,63,5,25,27,11,1,74,1
12161,279870,327_11_05,MOLDOVA,0,TOTALS,MOLDOVA,200,29,74,39.2,28,65,43.1,1,9,11.1,13,33,39.4,17,39,56,7,25,26,16,13,72,0
12162,279882,327_11_06,GIBRALTAR,0,TOTALS,GIBRALTAR,200,17,57,29.8,11,40,27.5,6,17,35.3,3,9,33.3,12,16,28,2,10,26,6,0,43,0
12163,279895,327_11_06,ANDORRA,0,TOTALS,ANDORRA,200,41,76,53.9,39,64,60.9,2,12,16.7,13,19,68.4,24,31,55,14,10,12,17,2,97,1
12164,279908,327_11_07,SAN MARINO,0,TOTALS,SAN MARINO,200,29,78,37.2,23,55,41.8,6,23,26.1,8,14,57.1,19,27,46,8,16,20,23,3,72,1
12165,279920,327_11_07,GIBRALTAR,0,TOTALS,GIBRALTAR,200,14,43,32.6,11,28,39.3,3,15,20.0,5,11,45.5,7,28,35,3,10,41,7,1,36,0
12166,279933,327_11_08,ANDORRA,0,TOTALS,ANDORRA,200,24,74,32.4,23,65,35.4,1,9,11.1,13,25,52.0,19,21,40,7,32,25,21,3,62,0
12167,279946,327_11_08,WALES,0,TOTALS,WALES,200,20,53,37.7,20,49,40.8,0,4,0.0,24,36,66.7,16,36,52,4,25,40,14,4,64,1
12168,279959,327_11_09,MOLDOVA,0,TOTALS,MOLDOVA,200,23,61,37.7,21,49,42.9,2,12,16.7,26,37,70.3,17,41,58,7,17,23,10,5,74,1
12169,279972,327_11_09,ANDORRA,0,TOTALS,ANDORRA,200,25,79,31.6,21,60,35.0,4,19,21.1,9,17,52.9,14,25,39,9,26,15,11,4,63,0
12170,279985,327_11_10,WALES,0,TOTALS,WALES,200,23,69,33.3,20,59,33.9,3,10,30.0,16,30,53.3,21,36,57,6,19,24,6,6,65,1
12171,279998,327_11_10,SAN MARINO,0,TOTALS,SAN MARINO,200,23,74,31.1,20,56,35.7,3,18,16.7,11,16,68.8,13,29,42,8,22,17,10,5,60,0
12172,283633,330_11_01,MONTENEGRO,0,TOTALS,MONTENEGRO,200,27,63,42.9,23,45,51.1,4,18,22.2,4,9,44.4,9,13,22,14,24,19,7,1,62,1
12173,283646,330_11_01,SERBIA,0,TOTALS,SERBIA,200,40,63,63.5,32,47,68.1,8,16,50.0,12,20,60.0,14,31,45,19,15,18,11,4,100,0
12174,283659,330_11_02,TURKEY,0,TOTALS,TURKEY,200,35,71,49.3,32,59,54.2,3,12,25.0,12,20,60.0,21,19,40,25,22,21,14,4,85,1
12175,283672,330_11_02,BULGARIA,0,TOTALS,BULGARIA,200,26,64,40.6,24,54,44.4,2,10,20.0,21,23,91.3,16,18,34,13,21,27,8,3,75,0
12176,283685,330_11_03,RUSSIA,0,TOTALS,RUSSIA,200,19,64,29.7,13,44,29.5,6,20,30.0,23,40,57.5,19,26,45,4,25,15,11,2,67,0
12177,283698,330_11_03,GERMANY,0,TOTALS,GERMANY,200,22,61,36.1,16,42,38.1,6,19,31.6,21,29,72.4,15,33,48,13,29,18,12,0,71,1
12178,283711,330_11_04,ITALY,0,TOTALS,ITALY,200,31,68,45.6,24,41,58.5,7,27,25.9,11,18,61.1,9,20,29,13,30,18,16,1,80,0
12179,283724,330_11_04,CROATIA,0,TOTALS,CROATIA,200,23,52,44.2,16,29,55.2,7,23,30.4,33,42,78.6,10,30,40,19,22,28,10,1,86,1
12180,283737,330_11_05,CZECH REPUBLIC,0,TOTALS,CZECH REPUBLIC,200,26,63,41.3,21,51,41.2,5,12,41.7,13,17,76.5,8,25,33,13,23,19,10,1,70,1
12181,283750,330_11_05,SPAIN,0,TOTALS,SPAIN,200,25,67,37.3,18,43,41.9,7,24,29.2,10,24,41.7,21,25,46,12,21,20,12,5,67,0
12182,283763,330_11_06,FRANCE,0,TOTALS,FRANCE,200,26,67,38.8,16,38,42.1,10,29,34.5,9,13,69.2,17,27,44,13,25,23,16,2,71,1
12183,283776,330_11_06,UKRAINE,0,TOTALS,UKRAINE,200,22,56,39.3,20,42,47.6,2,14,14.3,10,23,43.5,14,25,39,8,14,20,11,3,56,0
12184,283789,330_11_07,POLAND,0,TOTALS,POLAND,200,24,65,36.9,24,54,44.4,0,11,0.0,11,16,68.8,13,26,39,7,13,19,4,1,59,0
12185,283802,330_11_07,GREECE,0,TOTALS,GREECE,200,29,68,42.6,23,46,50.0,6,22,27.3,9,12,75.0,12,29,41,13,22,14,10,4,73,1
12186,283815,330_11_08,LATVIA,0,TOTALS,LATVIA,200,32,64,50.0,29,46,63.0,3,18,16.7,16,30,53.3,9,26,35,7,17,12,10,1,83,1
12187,283828,330_11_08,LITHUANIA,0,TOTALS,LITHUANIA,200,30,68,44.1,24,43,55.8,6,25,24.0,14,18,77.8,12,27,39,11,23,25,7,0,80,0
12188,283841,330_11_09,SERBIA,0,TOTALS,SERBIA,200,26,57,45.6,17,31,54.8,9,26,34.6,22,27,81.5,13,26,39,14,22,21,4,0,83,0
12189,283854,330_11_09,RUSSIA,0,TOTALS,RUSSIA,200,34,71,47.9,25,51,49.0,9,20,45.0,14,25,56.0,17,19,36,12,23,10,13,1,91,1
12190,283867,330_11_10,CROATIA,0,TOTALS,CROATIA,200,29,68,42.6,21,43,48.8,8,25,32.0,25,31,80.6,16,32,48,14,29,22,3,0,91,1
12191,283880,330_11_10,TURKEY,0,TOTALS,TURKEY,200,29,74,39.2,25,53,47.2,4,21,19.0,23,31,74.2,15,24,39,11,27,12,14,2,85,0
12192,283893,330_11_11,SPAIN,0,TOTALS,SPAIN,200,31,78,39.7,22,50,44.0,9,28,32.1,5,16,31.2,21,24,45,18,24,17,11,8,76,1
12193,283906,330_11_11,POLAND,0,TOTALS,POLAND,200,13,45,28.9,12,36,33.3,1,9,11.1,20,29,69.0,11,29,40,10,15,24,7,0,47,0
12194,283919,330_11_12,BULGARIA,0,TOTALS,BULGARIA,200,26,66,39.4,23,53,43.4,3,13,23.1,17,24,70.8,18,23,41,13,20,20,9,3,72,0
12195,283932,330_11_12,ITALY,0,TOTALS,ITALY,200,32,76,42.1,25,56,44.6,7,20,35.0,13,23,56.5,23,28,51,14,21,16,14,6,84,1
12196,283945,330_11_13,GREECE,0,TOTALS,GREECE,200,22,64,34.4,18,44,40.9,4,20,20.0,8,10,80.0,17,22,39,10,15,18,5,3,56,0
12197,283958,330_11_13,CZECH REPUBLIC,0,TOTALS,CZECH REPUBLIC,200,33,66,50.0,23,42,54.8,10,24,41.7,9,10,90.0,8,27,35,15,17,8,13,4,85,1
12198,283971,330_11_14,LITHUANIA,0,TOTALS,LITHUANIA,200,22,50,44.0,17,34,50.0,5,16,31.2,12,20,60.0,8,28,36,9,28,21,8,4,61,1
12199,283984,330_11_14,FRANCE,0,TOTALS,FRANCE,200,17,61,27.9,11,35,31.4,6,26,23.1,15,22,68.2,19,25,44,8,18,20,10,2,55,0
12200,283997,330_11_15,GERMANY,0,TOTALS,GERMANY,200,27,66,40.9,22,45,48.9,5,21,23.8,12,20,60.0,17,27,44,12,16,14,7,5,71,1
12201,284010,330_11_15,MONTENEGRO,0,TOTALS,MONTENEGRO,200,19,63,30.2,13,43,30.2,6,20,30.0,10,11,90.9,13,26,39,11,22,18,8,3,54,0
12202,284023,330_11_16,UKRAINE,0,TOTALS,UKRAINE,200,24,57,42.1,20,41,48.8,4,16,25.0,9,21,42.9,19,32,51,11,25,29,9,3,61,0
12203,284036,330_11_16,LATVIA,0,TOTALS,LATVIA,200,26,67,38.8,22,50,44.0,4,17,23.5,15,26,57.7,15,22,37,15,21,14,15,1,71,1
12204,284049,330_11_17,SPAIN,0,TOTALS,SPAIN,200,22,57,38.6,18,40,45.0,4,17,23.5,16,27,59.3,15,28,43,14,20,15,10,4,64,1
12205,284062,330_11_17,GREECE,0,TOTALS,GREECE,200,18,53,34.0,16,39,41.0,2,14,14.3,8,11,72.7,9,25,34,9,28,21,9,4,46,0
12206,284075,330_11_18,CROATIA,0,TOTALS,CROATIA,200,38,79,48.1,32,61,52.5,6,18,33.3,16,18,88.9,22,28,50,24,16,24,7,7,98,1
12207,284088,330_11_18,BULGARIA,0,TOTALS,BULGARIA,200,32,71,45.1,28,58,48.3,4,13,30.8,14,16,87.5,11,19,30,20,17,18,11,7,82,0
12208,284101,330_11_19,RUSSIA,0,TOTALS,RUSSIA,200,30,77,39.0,27,62,43.5,3,15,20.0,28,38,73.7,23,22,45,10,28,13,10,2,91,1
12209,284114,330_11_19,MONTENEGRO,0,TOTALS,MONTENEGRO,200,30,56,53.6,27,43,62.8,3,13,23.1,22,30,73.3,5,29,34,13,34,17,6,4,85,0
12210,284127,330_11_20,FRANCE,0,TOTALS,FRANCE,200,22,54,40.7,13,30,43.3,9,24,37.5,12,16,75.0,14,35,49,17,12,20,5,1,65,1
12211,284140,330_11_20,LATVIA,0,TOTALS,LATVIA,200,19,58,32.8,12,34,35.3,7,24,29.2,8,10,80.0,6,20,26,10,18,13,12,0,53,0
12212,284153,330_11_21,POLAND,0,TOTALS,POLAND,200,28,70,40.0,23,53,43.4,5,17,29.4,13,22,59.1,11,23,34,17,21,16,15,0,74,0
12213,284166,330_11_21,CZECH REPUBLIC,0,TOTALS,CZECH REPUBLIC,200,31,73,42.5,27,56,48.2,4,17,23.5,12,18,66.7,21,37,58,13,23,23,12,2,78,1
12214,284179,330_11_22,LITHUANIA,0,TOTALS,LITHUANIA,200,32,78,41.0,26,55,47.3,6,23,26.1,5,7,71.4,16,19,35,17,23,16,12,1,75,0
12215,284192,330_11_22,UKRAINE,0,TOTALS,UKRAINE,200,29,50,58.0,21,32,65.6,8,18,44.4,14,25,56.0,6,28,34,18,13,26,4,3,80,1
12216,284205,330_11_23,SERBIA,0,TOTALS,SERBIA,200,22,64,34.4,15,41,36.6,7,23,30.4,17,24,70.8,12,26,38,13,24,20,13,2,68,0
12217,284218,330_11_23,GERMANY,0,TOTALS,GERMANY,200,28,69,40.6,24,55,43.6,4,14,28.6,14,20,70.0,16,26,42,9,24,21,13,3,74,1
12218,284231,330_11_24,TURKEY,0,TOTALS,TURKEY,200,27,66,40.9,21,47,44.7,6,19,31.6,4,7,57.1,21,28,49,20,17,29,10,3,64,1
12219,284244,330_11_24,ITALY,0,TOTALS,ITALY,200,18,60,30.0,17,42,40.5,1,18,5.6,15,18,83.3,11,18,29,7,14,19,13,3,52,0
12220,284257,330_11_25,POLAND,0,TOTALS,POLAND,200,33,85,38.8,29,68,42.6,4,17,23.5,11,15,73.3,22,26,48,14,23,14,12,0,81,1
12221,284270,330_11_25,BULGARIA,0,TOTALS,BULGARIA,200,23,57,40.4,18,42,42.9,5,15,33.3,15,22,68.2,11,30,41,12,18,26,8,4,66,0
12222,284283,330_11_26,MONTENEGRO,0,TOTALS,MONTENEGRO,200,18,54,33.3,15,44,34.1,3,10,30.0,16,30,53.3,15,20,35,11,16,23,13,4,55,0
12223,284296,330_11_26,LITHUANIA,0,TOTALS,LITHUANIA,200,31,65,47.7,27,49,55.1,4,16,25.0,7,14,50.0,17,28,45,19,22,30,11,7,73,1
12224,284309,330_11_27,RUSSIA,0,TOTALS,RUSSIA,200,15,55,27.3,15,42,35.7,0,13,0.0,17,26,65.4,14,27,41,7,25,27,5,1,47,0
12225,284322,330_11_27,SPAIN,0,TOTALS,SPAIN,200,26,66,39.4,22,45,48.9,4,21,19.0,19,27,70.4,14,29,43,14,24,19,14,3,75,1
12226,284335,330_11_28,TURKEY,0,TOTALS,TURKEY,200,30,64,46.9,26,44,59.1,4,20,20.0,11,18,61.1,14,24,38,20,23,19,15,1,75,1
12227,284348,330_11_28,LATVIA,0,TOTALS,LATVIA,200,25,58,43.1,19,40,47.5,6,18,33.3,16,24,66.7,14,22,36,14,20,21,8,1,72,0
12228,284361,330_11_29,SERBIA,0,TOTALS,SERBIA,200,35,70,50.0,26,43,60.5,9,27,33.3,9,15,60.0,10,34,44,13,27,12,4,2,88,1
12229,284374,330_11_29,CZECH REPUBLIC,0,TOTALS,CZECH REPUBLIC,200,25,70,35.7,22,51,43.1,3,19,15.8,22,32,68.8,16,26,42,12,21,11,5,1,75,0
12230,284387,330_11_30,ITALY,0,TOTALS,ITALY,200,21,58,36.2,17,39,43.6,4,19,21.1,10,17,58.8,12,26,38,9,22,17,7,4,56,0
12231,284400,330_11_30,FRANCE,0,TOTALS,FRANCE,200,24,57,42.1,15,32,46.9,9,25,36.0,19,22,86.4,8,28,36,11,14,12,9,4,76,1
12232,284413,330_11_31,GERMANY,0,TOTALS,GERMANY,200,15,52,28.8,14,39,35.9,1,13,7.7,24,30,80.0,13,33,46,6,24,20,4,0,55,1
12233,284426,330_11_31,GREECE,0,TOTALS,GREECE,200,15,54,27.8,13,41,31.7,2,13,15.4,17,25,68.0,10,23,33,7,27,17,10,4,49,0
12234,284439,330_11_32,CROATIA,0,TOTALS,CROATIA,200,28,68,41.2,22,50,44.0,6,18,33.3,24,29,82.8,10,28,38,11,17,18,21,3,86,1
12235,284452,330_11_32,UKRAINE,0,TOTALS,UKRAINE,200,32,70,45.7,23,45,51.1,9,25,36.0,10,13,76.9,11,30,41,13,22,27,11,2,83,0
12236,284465,330_11_33,LITHUANIA,0,TOTALS,LITHUANIA,200,38,74,51.4,34,55,61.8,4,19,21.1,5,8,62.5,17,27,44,25,27,21,7,3,85,1
12237,284478,330_11_33,POLAND,0,TOTALS,POLAND,200,28,68,41.2,26,57,45.6,2,11,18.2,20,31,64.5,17,23,40,19,17,14,8,3,78,0
12238,284491,330_11_34,BULGARIA,0,TOTALS,BULGARIA,200,28,63,44.4,24,50,48.0,4,13,30.8,8,16,50.0,6,25,31,13,13,12,7,3,68,0
12239,284504,330_11_34,MONTENEGRO,0,TOTALS,MONTENEGRO,200,34,75,45.3,31,61,50.8,3,14,21.4,10,12,83.3,18,32,50,18,14,14,5,2,81,1
12240,284517,330_11_35,GREECE,0,TOTALS,GREECE,200,27,66,40.9,17,41,41.5,10,25,40.0,10,15,66.7,13,21,34,22,26,16,9,2,74,0
12241,284530,330_11_35,SERBIA,0,TOTALS,SERBIA,200,25,53,47.2,20,33,60.6,5,20,25.0,27,36,75.0,10,28,38,14,18,16,12,3,82,1
12242,284543,330_11_36,UKRAINE,0,TOTALS,UKRAINE,200,18,50,36.0,14,37,37.8,4,13,30.8,5,21,23.8,5,28,33,7,14,27,12,0,45,0
12243,284556,330_11_36,ITALY,0,TOTALS,ITALY,200,26,65,40.0,17,47,36.2,9,18,50.0,7,10,70.0,11,35,46,9,22,24,13,2,68,1
12244,284569,330_11_37,CZECH REPUBLIC,0,TOTALS,CZECH REPUBLIC,200,31,67,46.3,27,54,50.0,4,13,30.8,14,19,73.7,13,31,44,16,24,18,7,1,80,1
12245,284582,330_11_37,RUSSIA,0,TOTALS,RUSSIA,200,27,71,38.0,21,49,42.9,6,22,27.3,15,25,60.0,15,24,39,8,20,14,8,2,75,0
12246,284595,330_11_38,FRANCE,0,TOTALS,FRANCE,200,19,49,38.8,14,35,40.0,5,14,35.7,8,14,57.1,7,36,43,9,18,26,7,4,51,1
12247,284608,330_11_38,TURKEY,0,TOTALS,TURKEY,200,17,63,27.0,15,42,35.7,2,21,9.5,8,16,50.0,12,26,38,9,20,19,11,1,44,0
12248,284621,330_11_39,SPAIN,0,TOTALS,SPAIN,200,17,61,27.9,12,39,30.8,5,22,22.7,15,23,65.2,12,23,35,10,23,14,15,2,54,1
12249,284634,330_11_39,GERMANY,0,TOTALS,GERMANY,200,14,36,38.9,10,25,40.0,4,11,36.4,10,19,52.6,4,33,37,4,22,30,9,2,42,0
12250,284647,330_11_40,LATVIA,0,TOTALS,LATVIA,200,25,66,37.9,20,42,47.6,5,24,20.8,1,4,25.0,10,26,36,14,22,15,9,0,56,0
12251,284660,330_11_40,CROATIA,0,TOTALS,CROATIA,200,26,71,36.6,24,56,42.9,2,15,13.3,15,19,78.9,21,32,53,9,13,16,6,1,69,1
12252,284673,330_11_41,POLAND,0,TOTALS,POLAND,200,29,67,43.3,27,52,51.9,2,15,13.3,7,13,53.8,13,37,50,18,15,22,9,3,67,1
12253,284686,330_11_41,MONTENEGRO,0,TOTALS,MONTENEGRO,200,22,63,34.9,18,46,39.1,4,17,23.5,7,14,50.0,7,27,34,16,15,20,12,2,55,0
12254,284699,330_11_42,LITHUANIA,0,TOTALS,LITHUANIA,200,41,72,56.9,36,58,62.1,5,14,35.7,5,9,55.6,9,26,35,21,19,24,15,3,92,1
12255,284712,330_11_42,BULGARIA,0,TOTALS,BULGARIA,200,30,65,46.2,29,56,51.8,1,9,11.1,16,24,66.7,12,19,31,17,16,23,12,4,77,0
12256,284725,330_11_43,RUSSIA,0,TOTALS,RUSSIA,200,30,56,53.6,25,44,56.8,5,12,41.7,16,35,45.7,13,27,40,8,22,25,11,1,81,1
12257,284738,330_11_43,GREECE,0,TOTALS,GREECE,200,25,63,39.7,19,50,38.0,6,13,46.2,14,18,77.8,9,21,30,11,31,20,12,2,70,0
12258,284751,330_11_44,TURKEY,0,TOTALS,TURKEY,200,30,73,41.1,26,57,45.6,4,16,25.0,7,11,63.6,19,37,56,19,19,24,6,1,71,1
12259,284764,330_11_44,UKRAINE,0,TOTALS,UKRAINE,200,18,62,29.0,16,47,34.0,2,15,13.3,13,26,50.0,12,25,37,9,15,19,12,2,51,0
12260,284777,330_11_45,GERMANY,0,TOTALS,GERMANY,200,25,63,39.7,16,43,37.2,9,20,45.0,13,17,76.5,14,27,41,10,21,15,4,3,72,0
12261,284790,330_11_45,CZECH REPUBLIC,0,TOTALS,CZECH REPUBLIC,200,30,67,44.8,22,43,51.2,8,24,33.3,10,17,58.8,13,27,40,16,19,10,10,3,78,1
12262,284803,330_11_46,ITALY,0,TOTALS,ITALY,200,25,62,40.3,16,40,40.0,9,22,40.9,7,9,77.8,7,29,36,12,19,11,6,3,66,0
12263,284816,330_11_46,LATVIA,0,TOTALS,LATVIA,200,29,66,43.9,19,38,50.0,10,28,35.7,8,16,50.0,13,30,43,18,13,8,7,1,76,1
12264,284829,330_11_47,SERBIA,0,TOTALS,SERBIA,200,29,67,43.3,25,51,49.0,4,16,25.0,10,22,45.5,14,23,37,11,26,13,8,3,72,0
12265,284842,330_11_47,SPAIN,0,TOTALS,SPAIN,200,24,61,39.3,16,39,41.0,8,22,36.4,18,29,62.1,16,30,46,12,25,18,6,7,74,1
12266,284855,330_11_48,CROATIA,0,TOTALS,CROATIA,200,22,54,40.7,18,38,47.4,4,16,25.0,20,28,71.4,12,33,45,14,15,25,6,0,68,1
12267,284868,330_11_48,FRANCE,0,TOTALS,FRANCE,200,25,72,34.7,23,52,44.2,2,20,10.0,8,12,66.7,14,23,37,8,24,15,13,2,60,0
12268,284881,330_11_49,BULGARIA,0,TOTALS,BULGARIA,200,33,63,52.4,27,45,60.0,6,18,33.3,13,20,65.0,8,27,35,19,19,24,9,10,85,1
12269,284894,330_11_49,POLAND,0,TOTALS,POLAND,200,41,91,45.1,34,70,48.6,7,21,33.3,15,19,78.9,25,26,51,27,18,18,13,3,104,0
12270,284907,330_11_50,SPAIN,0,TOTALS,SPAIN,200,24,60,40.0,18,42,42.9,6,18,33.3,11,11,100.0,11,33,44,12,24,21,5,5,65,1
12271,284920,330_11_50,TURKEY,0,TOTALS,TURKEY,200,20,62,32.3,19,43,44.2,1,19,5.3,13,21,61.9,13,25,38,6,19,18,9,6,54,0
12272,284933,330_11_51,LITHUANIA,0,TOTALS,LITHUANIA,200,31,65,47.7,25,43,58.1,6,22,27.3,8,14,57.1,12,22,34,24,18,20,11,4,76,1
12273,284946,330_11_51,MONTENEGRO,0,TOTALS,MONTENEGRO,200,28,57,49.1,25,44,56.8,3,13,23.1,13,19,68.4,9,23,32,19,18,19,8,0,72,0
12274,284959,330_11_52,CROATIA,0,TOTALS,CROATIA,200,31,76,40.8,24,49,49.0,7,27,25.9,19,26,73.1,23,33,56,13,22,15,12,3,88,1
12275,284972,330_11_52,RUSSIA,0,TOTALS,RUSSIA,200,21,62,33.9,17,43,39.5,4,19,21.1,16,24,66.7,11,25,36,5,19,17,5,3,62,0
12276,284985,330_11_53,CZECH REPUBLIC,0,TOTALS,CZECH REPUBLIC,200,28,62,45.2,24,52,46.2,4,10,40.0,8,10,80.0,11,26,37,15,18,14,6,3,68,1
12277,284998,330_11_53,LATVIA,0,TOTALS,LATVIA,200,27,72,37.5,23,55,41.8,4,17,23.5,8,14,57.1,19,23,42,13,13,11,7,1,66,0
12278,285011,330_11_54,SERBIA,0,TOTALS,SERBIA,200,35,65,53.8,30,49,61.2,5,16,31.2,24,34,70.6,13,36,49,19,24,21,9,2,99,1
12279,285024,330_11_54,UKRAINE,0,TOTALS,UKRAINE,200,28,73,38.4,25,52,48.1,3,21,14.3,10,25,40.0,14,17,31,14,29,19,12,4,69,0
12280,285037,330_11_55,FRANCE,0,TOTALS,FRANCE,200,22,64,34.4,18,41,43.9,4,23,17.4,12,23,52.2,16,29,45,9,18,10,6,5,60,1
12281,285050,330_11_55,GERMANY,0,TOTALS,GERMANY,200,22,62,35.5,17,39,43.6,5,23,21.7,7,17,41.2,14,32,46,5,19,13,1,5,56,0
12282,285063,330_11_56,ITALY,0,TOTALS,ITALY,200,26,55,47.3,20,38,52.6,6,17,35.3,11,19,57.9,7,27,34,16,23,17,6,2,69,1
12283,285076,330_11_56,GREECE,0,TOTALS,GREECE,200,19,55,34.5,16,40,40.0,3,15,20.0,23,29,79.3,9,22,31,9,20,16,7,5,64,0
12284,285089,330_11_57,MONTENEGRO,0,TOTALS,MONTENEGRO,200,27,66,40.9,26,57,45.6,1,9,11.1,9,15,60.0,14,19,33,23,15,19,6,4,64,0
12285,285102,330_11_57,BULGARIA,0,TOTALS,BULGARIA,200,39,66,59.1,30,46,65.2,9,20,45.0,11,17,64.7,13,28,41,29,17,17,10,4,98,1
12286,285115,330_11_58,LATVIA,0,TOTALS,LATVIA,200,24,61,39.3,12,37,32.4,12,24,50.0,8,15,53.3,12,25,37,14,23,10,10,2,68,1
12287,285126,330_11_58,GERMANY,0,TOTALS,GERMANY,200,20,49,40.8,15,33,45.5,5,16,31.2,8,22,36.4,11,25,36,9,17,18,4,3,53,0
12288,285139,330_11_59,POLAND,0,TOTALS,POLAND,200,20,54,37.0,16,40,40.0,4,14,28.6,13,16,81.2,9,20,29,14,22,28,5,2,57,0
12289,285152,330_11_59,LITHUANIA,0,TOTALS,LITHUANIA,200,37,75,49.3,28,49,57.1,9,26,34.6,15,24,62.5,19,27,46,26,18,16,15,1,98,1
12290,285165,330_11_60,RUSSIA,0,TOTALS,RUSSIA,200,29,61,47.5,24,48,50.0,5,13,38.5,10,19,52.6,6,22,28,13,18,11,8,2,73,1
12291,285178,330_11_60,TURKEY,0,TOTALS,TURKEY,200,27,65,41.5,22,44,50.0,5,21,23.8,12,16,75.0,16,30,46,10,23,17,4,0,71,0
12292,285191,330_11_61,CROATIA,0,TOTALS,CROATIA,200,26,58,44.8,19,34,55.9,7,24,29.2,5,11,45.5,12,28,40,16,19,21,9,4,64,1
12293,285204,330_11_61,SPAIN,0,TOTALS,SPAIN,200,24,73,32.9,21,47,44.7,3,26,11.5,9,15,60.0,21,24,45,9,16,14,15,1,60,0
12294,285217,330_11_62,UKRAINE,0,TOTALS,UKRAINE,200,27,70,38.6,23,55,41.8,4,15,26.7,7,13,53.8,13,28,41,17,21,19,12,6,65,0
12295,285230,330_11_62,GREECE,0,TOTALS,GREECE,200,26,64,40.6,20,46,43.5,6,18,33.3,9,13,69.2,8,29,37,15,19,22,13,4,67,1
12296,285243,330_11_63,CZECH REPUBLIC,0,TOTALS,CZECH REPUBLIC,200,28,66,42.4,20,48,41.7,8,18,44.4,9,12,75.0,15,20,35,15,23,16,9,1,73,1
12297,285256,330_11_63,FRANCE,0,TOTALS,FRANCE,200,21,55,38.2,13,31,41.9,8,24,33.3,15,20,75.0,15,23,38,12,18,22,10,7,65,0
12298,285269,330_11_64,SERBIA,0,TOTALS,SERBIA,200,29,53,54.7,24,38,63.2,5,15,33.3,20,27,74.1,9,29,38,16,21,27,10,0,83,1
12299,285282,330_11_64,ITALY,0,TOTALS,ITALY,200,27,64,42.2,22,46,47.8,5,18,27.8,16,23,69.6,11,17,28,8,25,18,16,1,75,0
12300,285295,330_11_65,MONTENEGRO,0,TOTALS,MONTENEGRO,200,28,58,48.3,23,40,57.5,5,18,27.8,14,20,70.0,13,23,36,16,15,24,12,2,75,0
12301,285308,330_11_65,POLAND,0,TOTALS,POLAND,200,32,61,52.5,28,43,65.1,4,18,22.2,9,12,75.0,7,20,27,24,20,21,14,2,77,1
12302,285319,330_11_66,GERMANY,0,TOTALS,GERMANY,200,14,56,25.0,9,37,24.3,5,19,26.3,8,14,57.1,20,28,48,5,13,22,3,4,41,0
12303,285332,330_11_66,TURKEY,0,TOTALS,TURKEY,200,25,63,39.7,17,43,39.5,8,20,40.0,8,15,53.3,13,25,38,15,16,11,14,3,66,1
12304,285345,330_11_67,BULGARIA,0,TOTALS,BULGARIA,200,34,67,50.7,32,58,55.2,2,9,22.2,12,20,60.0,9,25,34,28,17,20,10,5,82,1
12305,285358,330_11_67,LITHUANIA,0,TOTALS,LITHUANIA,200,44,85,51.8,39,66,59.1,5,19,26.3,10,14,71.4,18,27,45,33,21,13,12,1,103,0
12306,285371,330_11_68,LATVIA,0,TOTALS,LATVIA,200,26,60,43.3,22,50,44.0,4,10,40.0,14,23,60.9,10,20,30,12,16,11,7,0,70,0
12307,285384,330_11_68,RUSSIA,0,TOTALS,RUSSIA,200,33,61,54.1,27,48,56.2,6,13,46.2,12,16,75.0,10,26,36,12,24,12,4,0,84,1
12308,285397,330_11_69,FRANCE,0,TOTALS,FRANCE,225,19,62,30.6,16,37,43.2,3,25,12.0,12,19,63.2,8,28,36,10,35,17,12,4,53,0
12309,285410,330_11_69,SPAIN,0,TOTALS,SPAIN,225,17,50,34.0,12,33,36.4,5,17,29.4,22,38,57.9,14,36,50,10,23,27,8,4,61,1
12310,285422,330_11_70,CZECH REPUBLIC,0,TOTALS,CZECH REPUBLIC,200,23,66,34.8,20,50,40.0,3,16,18.8,8,13,61.5,12,32,44,9,14,15,6,2,57,0
12311,285435,330_11_70,CROATIA,0,TOTALS,CROATIA,200,28,75,37.3,22,48,45.8,6,27,22.2,5,9,55.6,17,28,45,11,19,12,13,1,67,1
12312,285448,331_11_01,SWITZERLAND,0,TOTALS,SWITZERLAND,200,31,66,47.0,26,49,53.1,5,17,29.4,7,17,41.2,18,35,53,19,10,20,15,5,74,1
12313,285461,331_11_01,SLOVAK REPUBLIC,0,TOTALS,SLOVAK REPUBLIC,200,18,75,24.0,13,53,24.5,5,22,22.7,2,10,20.0,24,22,46,4,14,24,9,2,43,0
12314,285474,331_11_02,LUXEMBOURG,0,TOTALS,LUXEMBOURG,250,27,87,31.0,21,55,38.2,6,32,18.8,18,37,48.6,19,36,55,13,26,18,16,6,78,1
12315,285487,331_11_02,ROMANIA,0,TOTALS,ROMANIA,250,30,79,38.0,27,70,38.6,3,9,33.3,10,30,33.3,20,50,70,7,34,29,10,3,73,0
12316,285500,331_11_03,NETHERLANDS,0,TOTALS,NETHERLANDS,200,26,64,40.6,22,44,50.0,4,20,20.0,12,22,54.5,18,32,50,16,19,19,6,1,68,1
12317,285513,331_11_03,PORTUGAL,0,TOTALS,PORTUGAL,200,17,58,29.3,14,34,41.2,3,24,12.5,11,20,55.0,12,24,36,11,19,17,9,2,48,0
12318,285526,331_11_04,AUSTRIA,0,TOTALS,AUSTRIA,200,16,58,27.6,13,42,31.0,3,16,18.8,5,8,62.5,10,32,42,8,17,19,9,0,40,0
12319,285539,331_11_04,FINLAND,0,TOTALS,FINLAND,200,22,75,29.3,13,45,28.9,9,30,30.0,8,20,40.0,27,33,60,10,13,15,10,6,61,1
12320,285552,331_11_05,IRELAND,0,TOTALS,IRELAND,200,20,59,33.9,18,45,40.0,2,14,14.3,9,16,56.2,9,29,38,7,15,26,7,1,51,0
12321,285565,331_11_05,SWEDEN,0,TOTALS,SWEDEN,200,35,75,46.7,31,62,50.0,4,13,30.8,10,17,58.8,16,31,47,9,18,16,15,4,84,1
12322,285578,331_11_06,ARMENIA,0,TOTALS,ARMENIA,200,18,62,29.0,13,38,34.2,5,24,20.8,17,30,56.7,22,16,38,4,29,15,8,1,58,0
12323,285591,331_11_06,HUNGARY,0,TOTALS,HUNGARY,200,30,59,50.8,29,49,59.2,1,10,10.0,17,25,68.0,12,28,40,14,25,20,9,6,78,1
12324,285604,331_11_07,ENGLAND,0,TOTALS,ENGLAND,200,25,66,37.9,22,53,41.5,3,13,23.1,20,25,80.0,11,36,47,7,20,20,15,11,73,1
12325,285617,331_11_07,MKD,0,TOTALS,MKD,200,24,75,32.0,23,58,39.7,1,17,5.9,11,18,61.1,16,31,47,8,23,23,5,3,60,0
12326,285630,331_11_08,ESTONIA,0,TOTALS,ESTONIA,200,22,46,47.8,17,35,48.6,5,11,45.5,9,29,31.0,12,26,38,12,19,16,7,1,58,0
12327,285643,331_11_08,BELGIUM,0,TOTALS,BELGIUM,200,25,61,41.0,23,48,47.9,2,13,15.4,7,16,43.8,14,21,35,8,26,17,10,1,59,1
12328,285656,331_11_09,CYPRUS,0,TOTALS,CYPRUS,200,22,54,40.7,20,42,47.6,2,12,16.7,17,28,60.7,5,21,26,4,19,22,14,2,63,0
12329,285669,331_11_09,SLOVENIA,0,TOTALS,SLOVENIA,200,29,62,46.8,25,41,61.0,4,21,19.0,22,30,73.3,16,32,48,15,25,21,11,5,84,1
12330,285682,331_11_10,DENMARK,0,TOTALS,DENMARK,200,18,49,36.7,16,43,37.2,2,6,33.3,4,13,30.8,14,23,37,8,19,25,8,2,42,0
12331,285695,331_11_10,BOSNIA AND HERZEGOVINA,0,TOTALS,BOSNIA AND HERZEGOVINA,200,29,66,43.9,24,50,48.0,5,16,31.2,10,21,47.6,20,21,41,12,20,14,17,3,73,1
12332,285708,331_11_11,FINLAND,0,TOTALS,FINLAND,200,26,70,37.1,20,46,43.5,6,24,25.0,7,14,50.0,15,24,39,10,18,13,7,5,65,0
12333,285721,331_11_11,NETHERLANDS,0,TOTALS,NETHERLANDS,200,33,67,49.3,27,49,55.1,6,18,33.3,4,7,57.1,11,31,42,17,17,14,2,2,76,1
12334,285734,331_11_12,GEORGIA,0,TOTALS,GEORGIA,200,24,65,36.9,19,47,40.4,5,18,27.8,17,24,70.8,14,33,47,9,11,18,8,2,70,1
12335,285747,331_11_12,LUXEMBOURG,0,TOTALS,LUXEMBOURG,200,30,84,35.7,25,54,46.3,5,30,16.7,2,5,40.0,19,28,47,10,18,16,10,4,67,0
12336,285760,331_11_13,SLOVAK REPUBLIC,0,TOTALS,SLOVAK REPUBLIC,200,23,64,35.9,22,48,45.8,1,16,6.2,5,14,35.7,11,30,41,13,31,26,10,6,52,0
12337,285773,331_11_13,ARMENIA,0,TOTALS,ARMENIA,200,27,68,39.7,25,52,48.1,2,16,12.5,20,49,40.8,24,31,55,15,15,18,15,4,76,1
12338,285786,331_11_14,SLOVENIA,0,TOTALS,SLOVENIA,200,38,78,48.7,36,60,60.0,2,18,11.1,17,22,77.3,12,32,44,18,26,17,19,3,95,1
12339,285799,331_11_14,AUSTRIA,0,TOTALS,AUSTRIA,200,22,65,33.8,18,52,34.6,4,13,30.8,13,29,44.8,14,25,39,8,18,30,7,4,61,0
12340,285812,331_11_15,HUNGARY,0,TOTALS,HUNGARY,200,27,63,42.9,23,52,44.2,4,11,36.4,11,14,78.6,16,35,51,16,13,18,5,6,69,1
12341,285825,331_11_15,IRELAND,0,TOTALS,IRELAND,200,15,58,25.9,13,46,28.3,2,12,16.7,4,8,50.0,8,20,28,5,20,17,10,0,36,0
12342,285838,331_11_16,PORTUGAL,0,TOTALS,PORTUGAL,200,27,65,41.5,19,44,43.2,8,21,38.1,13,25,52.0,21,28,49,19,14,19,13,4,75,1
12343,285851,331_11_16,CYPRUS,0,TOTALS,CYPRUS,200,17,49,34.7,15,36,41.7,2,13,15.4,7,11,63.6,7,21,28,11,21,26,8,2,43,0
12344,285864,331_11_17,ROMANIA,0,TOTALS,ROMANIA,200,17,61,27.9,16,45,35.6,1,16,6.2,8,18,44.4,11,23,34,2,18,19,12,5,43,0
12345,285877,331_11_17,ENGLAND,0,TOTALS,ENGLAND,200,27,66,40.9,23,49,46.9,4,17,23.5,5,8,62.5,14,36,50,12,17,21,9,7,63,1
12346,285890,331_11_18,SWEDEN,0,TOTALS,SWEDEN,200,28,69,40.6,23,54,42.6,5,15,33.3,12,21,57.1,13,23,36,13,20,18,10,2,73,0
12347,285903,331_11_18,SWITZERLAND,0,TOTALS,SWITZERLAND,200,32,68,47.1,27,58,46.6,5,10,50.0,18,26,69.2,20,29,49,7,19,25,9,7,87,1
12348,285916,331_11_19,ISRAEL,0,TOTALS,ISRAEL,200,38,78,48.7,27,50,54.0,11,28,39.3,16,27,59.3,12,28,40,14,27,13,11,2,103,0
12349,285929,331_11_19,ESTONIA,0,TOTALS,ESTONIA,200,22,61,36.1,19,41,46.3,3,20,15.0,21,34,61.8,10,31,41,5,26,20,8,2,68,1
12350,285942,331_11_20,BELGIUM,0,TOTALS,BELGIUM,200,26,62,41.9,23,44,52.3,3,18,16.7,3,4,75.0,12,22,34,10,26,16,12,1,58,1
12351,285955,331_11_20,DENMARK,0,TOTALS,DENMARK,200,18,53,34.0,15,36,41.7,3,17,17.6,14,26,53.8,17,23,40,10,12,19,7,2,53,0
12352,285968,331_11_21,ENGLAND,0,TOTALS,ENGLAND,200,26,70,37.1,23,53,43.4,3,17,17.6,14,21,66.7,19,27,46,19,19,21,17,3,69,1
12353,285981,331_11_21,GEORGIA,0,TOTALS,GEORGIA,200,23,50,46.0,21,39,53.8,2,11,18.2,10,22,45.5,6,28,34,13,16,25,13,2,58,0
12354,285994,331_11_22,CYPRUS,0,TOTALS,CYPRUS,200,22,63,34.9,15,41,36.6,7,22,31.8,6,6,100.0,6,17,23,13,16,17,13,0,57,0
12355,286007,331_11_22,FINLAND,0,TOTALS,FINLAND,200,24,55,43.6,17,42,40.5,7,13,53.8,14,21,66.7,18,34,52,12,14,28,7,4,69,1
12356,286020,331_11_23,SWITZERLAND,0,TOTALS,SWITZERLAND,200,27,68,39.7,20,41,48.8,7,27,25.9,4,8,50.0,13,36,49,15,22,25,11,6,65,1
12357,286033,331_11_23,IRELAND,0,TOTALS,IRELAND,200,16,64,25.0,12,50,24.0,4,14,28.6,11,20,55.0,16,30,46,9,13,18,15,0,47,0
12358,286046,331_11_24,PORTUGAL,0,TOTALS,PORTUGAL,200,15,55,27.3,13,38,34.2,2,17,11.8,19,25,76.0,13,38,51,5,23,20,5,2,51,0
12359,286059,331_11_24,SLOVENIA,0,TOTALS,SLOVENIA,200,21,63,33.3,16,36,44.4,5,27,18.5,12,22,54.5,9,28,37,15,24,10,8,2,59,1
12360,286072,331_11_25,ARMENIA,0,TOTALS,ARMENIA,200,33,86,38.4,28,65,43.1,5,21,23.8,8,18,44.4,25,27,52,17,18,12,10,4,79,0
12361,286085,331_11_25,SWEDEN,0,TOTALS,SWEDEN,200,32,76,42.1,25,57,43.9,7,19,36.8,14,18,77.8,19,31,50,12,17,17,11,4,85,1
12362,286098,331_11_26,DENMARK,0,TOTALS,DENMARK,200,22,57,38.6,19,47,40.4,3,10,30.0,12,23,52.2,11,31,42,7,15,27,8,1,59,0
12363,286111,331_11_26,ISRAEL,0,TOTALS,ISRAEL,200,33,68,48.5,25,47,53.2,8,21,38.1,6,15,40.0,6,25,31,16,27,16,13,2,80,1
12364,286124,331_11_27,MKD,0,TOTALS,MKD,200,24,59,40.7,18,37,48.6,6,22,27.3,8,20,40.0,11,33,44,7,20,21,8,5,62,0
12365,286137,331_11_27,ROMANIA,0,TOTALS,ROMANIA,200,24,71,33.8,22,60,36.7,2,11,18.2,18,26,69.2,15,28,43,6,18,12,10,4,68,1
12366,286150,331_11_28,BOSNIA AND HERZEGOVINA,0,TOTALS,BOSNIA AND HERZEGOVINA,200,29,54,53.7,23,40,57.5,6,14,42.9,16,27,59.3,13,23,36,14,23,22,13,3,80,1
12367,286163,331_11_28,BELGIUM,0,TOTALS,BELGIUM,200,28,56,50.0,23,38,60.5,5,18,27.8,10,19,52.6,12,16,28,17,21,24,10,1,71,0
12368,286176,331_11_29,NETHERLANDS,0,TOTALS,NETHERLANDS,200,33,71,46.5,30,51,58.8,3,20,15.0,21,34,61.8,22,26,48,15,8,16,15,6,90,1
12369,286189,331_11_29,AUSTRIA,0,TOTALS,AUSTRIA,200,21,58,36.2,19,49,38.8,2,9,22.2,4,6,66.7,13,21,34,8,22,31,10,3,48,0
12370,286202,331_11_30,SLOVAK REPUBLIC,0,TOTALS,SLOVAK REPUBLIC,200,19,60,31.7,12,35,34.3,7,25,28.0,3,8,37.5,6,21,27,9,26,14,8,1,48,0
12371,286215,331_11_30,HUNGARY,0,TOTALS,HUNGARY,200,27,55,49.1,26,49,53.1,1,6,16.7,14,31,45.2,11,35,46,9,13,17,6,4,69,1
12372,286228,331_11_31,ESTONIA,0,TOTALS,ESTONIA,200,31,64,48.4,27,53,50.9,4,11,36.4,16,26,61.5,12,23,35,9,19,13,17,1,82,1
12373,286241,331_11_31,DENMARK,0,TOTALS,DENMARK,200,27,61,44.3,27,58,46.6,0,3,0.0,9,19,47.4,18,26,44,6,22,23,6,2,63,0
12374,286254,331_11_32,FINLAND,0,TOTALS,FINLAND,200,22,61,36.1,16,40,40.0,6,21,28.6,12,15,80.0,15,32,47,9,19,21,4,4,62,0
12375,286267,331_11_32,PORTUGAL,0,TOTALS,PORTUGAL,200,26,68,38.2,22,54,40.7,4,14,28.6,8,16,50.0,13,25,38,11,16,12,10,0,64,1
12376,286280,331_11_33,IRELAND,0,TOTALS,IRELAND,200,21,62,33.9,19,55,34.5,2,7,28.6,15,18,83.3,10,18,28,11,21,13,11,0,59,0
12377,286293,331_11_33,ARMENIA,0,TOTALS,ARMENIA,200,24,53,45.3,16,27,59.3,8,26,30.8,15,27,55.6,16,29,45,16,19,21,8,3,71,1
12378,286306,331_11_34,LUXEMBOURG,0,TOTALS,LUXEMBOURG,200,25,73,34.2,21,51,41.2,4,22,18.2,10,13,76.9,14,26,40,11,8,18,9,2,64,0
12379,286319,331_11_34,ENGLAND,0,TOTALS,ENGLAND,200,35,75,46.7,31,63,49.2,4,12,33.3,7,8,87.5,13,29,42,16,16,19,10,11,81,1
12380,286332,331_11_35,AUSTRIA,0,TOTALS,AUSTRIA,200,22,65,33.8,17,40,42.5,5,25,20.0,7,12,58.3,14,33,47,7,17,25,8,5,56,0
12381,286345,331_11_35,CYPRUS,0,TOTALS,CYPRUS,200,28,67,41.8,23,51,45.1,5,16,31.2,8,20,40.0,12,32,44,16,14,19,20,1,69,1
12382,286358,331_11_36,ISRAEL,0,TOTALS,ISRAEL,200,34,71,47.9,28,50,56.0,6,21,28.6,10,15,66.7,12,26,38,16,33,16,5,3,84,0
12383,286371,331_11_36,BOSNIA AND HERZEGOVINA,0,TOTALS,BOSNIA AND HERZEGOVINA,200,29,62,46.8,25,48,52.1,4,14,28.6,23,46,50.0,14,27,41,12,21,16,8,7,85,1
12384,286384,331_11_37,GEORGIA,0,TOTALS,GEORGIA,225,26,81,32.1,21,60,35.0,5,21,23.8,13,21,61.9,21,35,56,14,24,24,11,10,70,1
12385,286397,331_11_37,MKD,0,TOTALS,MKD,225,25,69,36.2,19,47,40.4,6,22,27.3,13,25,52.0,9,29,38,14,20,21,12,5,69,0
12386,286410,331_11_38,SLOVENIA,0,TOTALS,SLOVENIA,200,20,61,32.8,12,26,46.2,8,35,22.9,11,19,57.9,10,31,41,11,17,8,8,2,59,1
12387,286423,331_11_38,NETHERLANDS,0,TOTALS,NETHERLANDS,200,22,64,34.4,15,40,37.5,7,24,29.2,7,15,46.7,12,35,47,9,22,14,6,1,58,0
12388,286436,331_11_39,HUNGARY,0,TOTALS,HUNGARY,200,30,63,47.6,25,49,51.0,5,14,35.7,8,16,50.0,14,36,50,11,13,16,10,3,73,1
12389,286449,331_11_39,SWITZERLAND,0,TOTALS,SWITZERLAND,200,24,68,35.3,19,38,50.0,5,30,16.7,8,14,57.1,11,21,32,16,18,13,10,4,61,0
12390,286462,331_11_40,SWEDEN,0,TOTALS,SWEDEN,225,31,67,46.3,30,60,50.0,1,7,14.3,38,48,79.2,13,34,47,12,22,17,8,1,101,1
12391,286475,331_11_40,SLOVAK REPUBLIC,0,TOTALS,SLOVAK REPUBLIC,225,38,82,46.3,30,58,51.7,8,24,33.3,16,30,53.3,14,23,37,17,32,15,9,4,100,0
12392,286488,331_11_41,BOSNIA AND HERZEGOVINA,0,TOTALS,BOSNIA AND HERZEGOVINA,200,36,61,59.0,31,49,63.3,5,12,41.7,15,26,57.7,14,25,39,12,22,18,12,2,92,1
12393,286501,331_11_41,ESTONIA,0,TOTALS,ESTONIA,200,24,59,40.7,24,51,47.1,0,8,0.0,17,24,70.8,13,17,30,9,22,20,9,4,65,0
12394,286514,331_11_42,FINLAND,0,TOTALS,FINLAND,200,30,72,41.7,24,54,44.4,6,18,33.3,10,15,66.7,18,25,43,8,19,19,11,5,76,0
12395,286527,331_11_42,SLOVENIA,0,TOTALS,SLOVENIA,200,29,56,51.8,19,35,54.3,10,21,47.6,15,18,83.3,3,25,28,17,19,19,14,4,83,1
12396,286540,331_11_43,BELGIUM,0,TOTALS,BELGIUM,200,25,56,44.6,22,37,59.5,3,19,15.8,17,26,65.4,11,21,32,13,13,19,7,4,70,0
12397,286553,331_11_43,ISRAEL,0,TOTALS,ISRAEL,200,31,62,50.0,20,36,55.6,11,26,42.3,7,12,58.3,9,21,30,16,21,18,2,3,80,1
12398,286566,331_11_44,CYPRUS,0,TOTALS,CYPRUS,200,22,62,35.5,17,42,40.5,5,20,25.0,1,4,25.0,5,25,30,9,20,18,9,1,50,0
12399,286579,331_11_44,NETHERLANDS,0,TOTALS,NETHERLANDS,200,32,85,37.6,28,57,49.1,4,28,14.3,11,24,45.8,36,36,72,10,10,17,11,2,79,1
12400,286592,331_11_45,SWEDEN,0,TOTALS,SWEDEN,200,25,68,36.8,21,53,39.6,4,15,26.7,12,15,80.0,9,25,34,13,18,10,9,0,66,0
12401,286605,331_11_45,HUNGARY,0,TOTALS,HUNGARY,200,31,65,47.7,28,54,51.9,3,11,27.3,7,15,46.7,12,33,45,6,15,18,5,3,72,1
12402,286618,331_11_46,SLOVAK REPUBLIC,0,TOTALS,SLOVAK REPUBLIC,200,18,62,29.0,11,33,33.3,7,29,24.1,7,11,63.6,16,23,39,7,19,22,5,3,50,0
12403,286631,331_11_46,IRELAND,0,TOTALS,IRELAND,200,28,59,47.5,23,48,47.9,5,11,45.5,12,21,57.1,10,29,39,5,9,14,13,2,73,1
12404,286644,331_11_47,MKD,0,TOTALS,MKD,200,27,72,37.5,27,55,49.1,0,17,0.0,14,26,53.8,17,24,41,3,16,7,5,4,68,0
12405,286657,331_11_47,LUXEMBOURG,0,TOTALS,LUXEMBOURG,200,30,68,44.1,26,53,49.1,4,15,26.7,6,12,50.0,14,31,45,10,21,12,4,5,70,1
12406,286670,331_11_48,ROMANIA,0,TOTALS,ROMANIA,200,28,75,37.3,27,69,39.1,1,6,16.7,7,16,43.8,19,40,59,13,12,20,6,1,64,1
12407,286683,331_11_48,GEORGIA,0,TOTALS,GEORGIA,200,19,80,23.8,15,50,30.0,4,30,13.3,5,13,38.5,23,32,55,11,15,19,14,10,47,0
12408,286696,331_11_49,PORTUGAL,0,TOTALS,PORTUGAL,200,31,65,47.7,27,48,56.2,4,17,23.5,10,16,62.5,11,32,43,13,14,16,21,3,76,1
12409,286709,331_11_49,AUSTRIA,0,TOTALS,AUSTRIA,200,16,57,28.1,15,44,34.1,1,13,7.7,7,13,53.8,13,24,37,3,17,28,5,1,40,0
12410,286722,331_11_50,ARMENIA,0,TOTALS,ARMENIA,200,29,67,43.3,24,49,49.0,5,18,27.8,18,36,50.0,16,30,46,17,14,12,10,2,81,1
12411,286735,331_11_50,SWITZERLAND,0,TOTALS,SWITZERLAND,200,24,62,38.7,19,47,40.4,5,15,33.3,10,17,58.8,10,30,40,11,26,20,4,5,63,0
12412,286748,331_11_51,GEORGIA,0,TOTALS,GEORGIA,200,18,53,34.0,15,44,34.1,3,9,33.3,13,26,50.0,8,25,33,7,18,15,9,7,52,0
12413,286761,331_11_51,PORTUGAL,0,TOTALS,PORTUGAL,200,24,63,38.1,17,47,36.2,7,16,43.8,12,21,57.1,19,35,54,12,21,21,9,2,67,1
12414,286774,331_11_52,ENGLAND,0,TOTALS,ENGLAND,200,36,75,48.0,29,56,51.8,7,19,36.8,0,0,0.0,13,30,43,21,10,10,10,4,79,1
12415,286787,331_11_52,NETHERLANDS,0,TOTALS,NETHERLANDS,200,22,63,34.9,18,48,37.5,4,15,26.7,10,11,90.9,10,26,36,8,5,17,5,1,58,0
12416,286800,331_11_53,LUXEMBOURG,0,TOTALS,LUXEMBOURG,200,23,68,33.8,18,48,37.5,5,20,25.0,12,22,54.5,10,30,40,12,18,13,8,2,63,0
12417,286813,331_11_53,FINLAND,0,TOTALS,FINLAND,200,25,70,35.7,19,47,40.4,6,23,26.1,11,18,61.1,18,39,57,10,19,18,6,4,67,1
12418,286826,331_11_54,AUSTRIA,0,TOTALS,AUSTRIA,200,21,60,35.0,14,45,31.1,7,15,46.7,5,12,41.7,8,30,38,7,15,20,11,5,54,0
12419,286839,331_11_54,MKD,0,TOTALS,MKD,200,22,60,36.7,20,52,38.5,2,8,25.0,9,20,45.0,11,34,45,9,17,18,15,4,55,1
12420,286852,331_11_55,ROMANIA,0,TOTALS,ROMANIA,200,18,56,32.1,17,44,38.6,1,12,8.3,12,17,70.6,4,24,28,6,17,19,8,3,49,0
12421,286865,331_11_55,SLOVENIA,0,TOTALS,SLOVENIA,200,28,68,41.2,21,42,50.0,7,26,26.9,12,15,80.0,15,35,50,16,19,18,11,2,75,1
12422,286878,331_11_56,SLOVAK REPUBLIC,0,TOTALS,SLOVAK REPUBLIC,200,27,55,49.1,20,39,51.3,7,16,43.8,11,20,55.0,7,21,28,17,18,17,11,2,72,1
12423,286891,331_11_56,DENMARK,0,TOTALS,DENMARK,200,24,53,45.3,20,40,50.0,4,13,30.8,18,25,72.0,10,24,34,14,14,19,12,3,70,0
12424,286904,331_11_57,HUNGARY,0,TOTALS,HUNGARY,200,18,49,36.7,15,40,37.5,3,9,33.3,29,46,63.0,8,35,43,5,25,18,3,2,68,0
12425,286917,331_11_57,ISRAEL,0,TOTALS,ISRAEL,200,26,62,41.9,16,33,48.5,10,29,34.5,20,30,66.7,5,30,35,16,32,7,7,3,82,1
12426,286930,331_11_58,SWITZERLAND,0,TOTALS,SWITZERLAND,200,24,59,40.7,17,41,41.5,7,18,38.9,19,26,73.1,9,26,35,17,22,20,9,1,74,0
12427,286943,331_11_58,ESTONIA,0,TOTALS,ESTONIA,200,37,70,52.9,33,57,57.9,4,13,30.8,12,22,54.5,11,29,40,17,17,15,14,2,90,1
12428,286956,331_11_59,ARMENIA,0,TOTALS,ARMENIA,200,26,64,40.6,22,51,43.1,4,13,30.8,17,33,51.5,16,20,36,10,21,17,10,0,73,0
12429,286969,331_11_59,BOSNIA AND HERZEGOVINA,0,TOTALS,BOSNIA AND HERZEGOVINA,200,30,58,51.7,28,47,59.6,2,11,18.2,21,27,77.8,9,29,38,10,29,23,11,4,83,1
12430,286982,331_11_60,SWEDEN,0,TOTALS,SWEDEN,200,22,60,36.7,18,47,38.3,4,13,30.8,4,6,66.7,18,24,42,3,20,23,6,1,52,0
12431,286995,331_11_60,BELGIUM,0,TOTALS,BELGIUM,200,27,62,43.5,23,50,46.0,4,12,33.3,14,21,66.7,11,21,32,10,16,13,16,2,72,1
12432,287008,331_11_61,DENMARK,0,TOTALS,DENMARK,200,25,57,43.9,22,44,50.0,3,13,23.1,7,11,63.6,11,33,44,12,24,20,12,0,60,1
12433,287021,331_11_61,IRELAND,0,TOTALS,IRELAND,200,12,49,24.5,9,39,23.1,3,10,30.0,14,20,70.0,5,21,26,6,16,20,8,0,41,0
12434,287034,331_11_62,SLOVENIA,0,TOTALS,SLOVENIA,200,22,63,34.9,16,36,44.4,6,27,22.2,8,13,61.5,12,22,34,8,18,17,12,4,58,0
12435,287047,331_11_62,ENGLAND,0,TOTALS,ENGLAND,200,25,60,41.7,18,39,46.2,7,21,33.3,6,9,66.7,13,31,44,17,12,22,10,6,63,1
12436,287060,331_11_63,PORTUGAL,0,TOTALS,PORTUGAL,200,23,62,37.1,20,46,43.5,3,16,18.8,14,24,58.3,13,31,44,10,11,9,19,1,63,1
12437,287073,331_11_63,LUXEMBOURG,0,TOTALS,LUXEMBOURG,200,15,50,30.0,12,39,30.8,3,11,27.3,8,11,72.7,6,31,37,2,20,25,1,4,41,0
12438,287086,331_11_64,NETHERLANDS,0,TOTALS,NETHERLANDS,200,34,71,47.9,31,64,48.4,3,7,42.9,22,33,66.7,21,36,57,17,14,19,8,4,93,1
12439,287099,331_11_64,ROMANIA,0,TOTALS,ROMANIA,200,24,74,32.4,22,60,36.7,2,14,14.3,9,14,64.3,15,20,35,6,24,16,10,6,59,0
12440,287112,331_11_65,FINLAND,0,TOTALS,FINLAND,200,29,64,45.3,24,45,53.3,5,19,26.3,22,36,61.1,12,34,46,13,11,19,12,4,85,1
12441,287125,331_11_65,GEORGIA,0,TOTALS,GEORGIA,200,27,70,38.6,21,48,43.8,6,22,27.3,9,14,64.3,12,29,41,14,26,21,12,4,69,0
12442,287138,331_11_66,BELGIUM,0,TOTALS,BELGIUM,200,32,72,44.4,27,55,49.1,5,17,29.4,10,14,71.4,13,27,40,14,15,8,15,1,79,1
12443,287151,331_11_66,SWITZERLAND,0,TOTALS,SWITZERLAND,200,17,56,30.4,16,40,40.0,1,16,6.2,13,20,65.0,14,27,41,8,11,19,2,4,48,0
12444,287164,331_11_67,MKD,0,TOTALS,MKD,200,29,74,39.2,24,50,48.0,5,24,20.8,18,27,66.7,22,23,45,12,22,15,8,2,81,0
12445,287177,331_11_67,CYPRUS,0,TOTALS,CYPRUS,200,28,59,47.5,26,45,57.8,2,14,14.3,27,34,79.4,10,26,36,10,18,15,9,4,85,1
12446,287190,331_11_68,BOSNIA AND HERZEGOVINA,0,TOTALS,BOSNIA AND HERZEGOVINA,200,30,76,39.5,24,55,43.6,6,21,28.6,15,18,83.3,18,24,42,9,14,14,19,3,81,1
12447,287203,331_11_68,HUNGARY,0,TOTALS,HUNGARY,200,27,56,48.2,23,44,52.3,4,12,33.3,3,4,75.0,4,29,33,16,21,27,5,8,61,0
12448,287216,331_11_69,ISRAEL,0,TOTALS,ISRAEL,200,30,67,44.8,24,47,51.1,6,20,30.0,6,13,46.2,11,24,35,10,23,16,9,3,72,0
12449,287229,331_11_69,ARMENIA,0,TOTALS,ARMENIA,200,29,67,43.3,23,50,46.0,6,17,35.3,12,23,52.2,18,25,43,12,17,14,6,2,76,1
12450,287242,331_11_70,ESTONIA,0,TOTALS,ESTONIA,200,31,65,47.7,30,56,53.6,1,9,11.1,17,30,56.7,13,24,37,13,18,15,10,1,80,0
12451,287255,331_11_70,SWEDEN,0,TOTALS,SWEDEN,200,36,70,51.4,31,55,56.4,5,15,33.3,14,19,73.7,12,25,37,16,23,16,12,3,91,1
12452,287268,331_11_71,AUSTRIA,0,TOTALS,AUSTRIA,200,18,55,32.7,14,41,34.1,4,14,28.6,10,12,83.3,10,26,36,9,8,9,7,3,50,1
12453,287281,331_11_71,SLOVAK REPUBLIC,0,TOTALS,SLOVAK REPUBLIC,200,20,57,35.1,16,40,40.0,4,17,23.5,3,7,42.9,13,27,40,7,16,15,4,2,47,0
12454,287294,331_11_72,GEORGIA,0,TOTALS,GEORGIA,200,21,69,30.4,20,63,31.7,1,6,16.7,10,22,45.5,12,28,40,10,12,23,14,3,53,0
12455,287307,331_11_72,SWEDEN,0,TOTALS,SWEDEN,200,37,73,50.7,33,55,60.0,4,18,22.2,6,11,54.5,10,41,51,17,20,23,18,7,84,1
12456,287320,331_11_73,NETHERLANDS,0,TOTALS,NETHERLANDS,200,28,65,43.1,25,52,48.1,3,13,23.1,12,16,75.0,11,25,36,7,18,19,10,1,71,0
12457,287333,331_11_73,ARMENIA,0,TOTALS,ARMENIA,200,29,61,47.5,20,37,54.1,9,24,37.5,18,23,78.3,8,26,34,11,15,16,11,4,85,1
12458,287346,331_11_74,SWITZERLAND,0,TOTALS,SWITZERLAND,200,35,69,50.7,25,48,52.1,10,21,47.6,11,13,84.6,17,36,53,15,26,30,8,8,91,1
12459,287359,331_11_74,LUXEMBOURG,0,TOTALS,LUXEMBOURG,200,31,71,43.7,27,53,50.9,4,18,22.2,15,34,44.1,13,16,29,11,19,15,16,3,81,0
12460,287372,331_11_75,HUNGARY,0,TOTALS,HUNGARY,200,27,67,40.3,23,51,45.1,4,16,25.0,11,14,78.6,12,23,35,12,19,16,10,1,69,1
12461,287385,331_11_75,ROMANIA,0,TOTALS,ROMANIA,200,22,56,39.3,21,37,56.8,1,19,5.3,17,26,65.4,15,28,43,6,20,22,10,3,62,0
12462,287398,331_11_76,BELGIUM,0,TOTALS,BELGIUM,200,22,55,40.0,21,47,44.7,1,8,12.5,8,11,72.7,7,17,24,10,20,11,13,4,53,1
12463,287411,331_11_76,FINLAND,0,TOTALS,FINLAND,200,19,47,40.4,17,36,47.2,2,11,18.2,9,21,42.9,14,27,41,9,16,21,3,1,49,0
12464,287424,331_11_77,PORTUGAL,0,TOTALS,PORTUGAL,200,27,55,49.1,18,37,48.6,9,18,50.0,10,17,58.8,11,25,36,10,23,21,10,1,73,1
12465,287437,331_11_77,ESTONIA,0,TOTALS,ESTONIA,200,16,49,32.7,14,36,38.9,2,13,15.4,15,20,75.0,7,21,28,8,18,20,12,0,49,0
12466,287450,331_11_78,ENGLAND,0,TOTALS,ENGLAND,225,38,79,48.1,31,59,52.5,7,20,35.0,11,16,68.8,16,34,50,17,14,13,9,10,94,1
12467,287463,331_11_78,ISRAEL,0,TOTALS,ISRAEL,225,31,74,41.9,23,48,47.9,8,26,30.8,14,17,82.4,11,26,37,13,18,11,10,4,84,0
12468,287476,331_11_79,BOSNIA AND HERZEGOVINA,0,TOTALS,BOSNIA AND HERZEGOVINA,200,20,59,33.9,16,39,41.0,4,20,20.0,9,21,42.9,12,24,36,6,22,14,8,7,53,0
12469,287489,331_11_79,SLOVENIA,0,TOTALS,SLOVENIA,200,26,63,41.3,13,33,39.4,13,30,43.3,9,12,75.0,10,30,40,13,24,13,6,2,74,1
12470,287502,331_11_80,MKD,0,TOTALS,MKD,200,26,70,37.1,21,48,43.8,5,22,22.7,8,17,47.1,23,25,48,12,22,22,10,4,65,1
12471,287515,331_11_80,IRELAND,0,TOTALS,IRELAND,200,24,59,40.7,22,49,44.9,2,10,20.0,13,23,56.5,11,26,37,16,17,20,10,3,63,0
12472,287528,331_11_81,GEORGIA,0,TOTALS,GEORGIA,200,24,69,34.8,23,55,41.8,1,14,7.1,11,17,64.7,12,24,36,6,11,12,12,4,60,0
12473,287541,331_11_81,LUXEMBOURG,0,TOTALS,LUXEMBOURG,200,27,64,42.2,21,43,48.8,6,21,28.6,5,7,71.4,13,32,45,10,14,19,6,2,65,1
12474,287554,331_11_82,NETHERLANDS,0,TOTALS,NETHERLANDS,200,24,59,40.7,21,48,43.8,3,11,27.3,22,35,62.9,21,30,51,12,19,22,9,1,73,1
12475,287567,331_11_82,ROMANIA,0,TOTALS,ROMANIA,200,18,58,31.0,15,44,34.1,3,14,21.4,18,27,66.7,13,20,33,5,26,14,9,3,57,0
12476,287580,331_11_83,SWEDEN,0,TOTALS,SWEDEN,200,30,71,42.3,26,52,50.0,4,19,21.1,4,8,50.0,14,26,40,6,11,14,10,1,68,0
12477,287593,331_11_83,SWITZERLAND,0,TOTALS,SWITZERLAND,200,30,72,41.7,28,57,49.1,2,15,13.3,8,12,66.7,17,27,44,12,12,14,9,5,70,1
12478,287606,331_11_84,CYPRUS,0,TOTALS,CYPRUS,200,26,59,44.1,21,43,48.8,5,16,31.2,8,11,72.7,8,15,23,12,17,14,8,2,65,1
12479,287619,331_11_84,DENMARK,0,TOTALS,DENMARK,200,41,77,53.2,34,57,59.6,7,20,35.0,14,19,73.7,22,28,50,25,15,11,10,1,103,0
12480,287632,331_11_85,ARMENIA,0,TOTALS,ARMENIA,200,19,64,29.7,14,37,37.8,5,27,18.5,9,14,64.3,17,21,38,6,20,10,9,1,52,0
12481,287645,331_11_85,HUNGARY,0,TOTALS,HUNGARY,200,24,52,46.2,20,43,46.5,4,9,44.4,13,22,59.1,10,27,37,10,15,15,6,0,65,1
12482,287658,331_11_86,ESTONIA,0,TOTALS,ESTONIA,200,30,69,43.5,24,53,45.3,6,16,37.5,3,3,100.0,13,22,35,12,33,22,10,0,69,0
12483,287671,331_11_86,FINLAND,0,TOTALS,FINLAND,200,27,54,50.0,23,41,56.1,4,13,30.8,22,45,48.9,17,24,41,11,11,20,13,3,80,1
12484,287684,331_11_87,ISRAEL,0,TOTALS,ISRAEL,200,27,58,46.6,19,41,46.3,8,17,47.1,9,17,52.9,9,24,33,13,20,21,11,0,71,0
12485,287697,331_11_87,BOSNIA AND HERZEGOVINA,0,TOTALS,BOSNIA AND HERZEGOVINA,200,27,53,50.9,23,40,57.5,4,13,30.8,14,24,58.3,8,24,32,9,19,20,15,4,72,1
12486,287710,331_11_88,PORTUGAL,0,TOTALS,PORTUGAL,200,20,61,32.8,18,39,46.2,2,22,9.1,11,16,68.8,14,17,31,7,14,16,9,3,53,1
12487,287723,331_11_88,BELGIUM,0,TOTALS,BELGIUM,200,22,45,48.9,16,31,51.6,6,14,42.9,2,5,40.0,6,27,33,11,19,22,10,5,52,0
12488,287736,331_11_89,ENGLAND,0,TOTALS,ENGLAND,200,27,58,46.6,19,39,48.7,8,19,42.1,11,19,57.9,10,20,30,9,11,12,8,1,73,0
12489,287749,331_11_89,SLOVENIA,0,TOTALS,SLOVENIA,200,34,67,50.7,24,40,60.0,10,27,37.0,4,5,80.0,12,25,37,20,23,13,7,0,82,1
12490,287762,332_11_01,ANDORRA,0,TOTALS,ANDORRA,200,27,76,35.5,25,67,37.3,2,9,22.2,8,16,50.0,23,39,62,8,26,27,11,7,64,1
12491,287775,332_11_01,WALES,0,TOTALS,WALES,200,13,67,19.4,10,48,20.8,3,19,15.8,20,30,66.7,18,27,45,3,18,30,14,1,49,0
12492,287788,332_11_02,SAN MARINO,0,TOTALS,SAN MARINO,200,25,74,33.8,19,51,37.3,6,23,26.1,19,23,82.6,15,35,50,4,18,21,17,1,75,1
12493,287799,332_11_02,MALTA,0,TOTALS,MALTA,200,27,73,37.0,23,61,37.7,4,12,33.3,16,29,55.2,18,35,53,5,17,24,12,6,74,0
12494,287812,332_11_03,WALES,0,TOTALS,WALES,200,25,75,33.3,19,53,35.8,6,22,27.3,11,23,47.8,19,31,50,6,18,13,12,4,67,1
12495,287825,332_11_03,PRINCIPALITY OF MONACO,0,TOTALS,PRINCIPALITY OF MONACO,200,14,47,29.8,10,38,26.3,4,9,44.4,8,18,44.4,3,36,39,1,20,28,3,6,40,0
12496,287836,332_11_04,MALTA,0,TOTALS,MALTA,200,35,76,46.1,35,68,51.5,0,8,0.0,13,17,76.5,18,40,58,13,23,18,16,4,83,1
12497,287847,332_11_04,GIBRALTAR,0,TOTALS,GIBRALTAR,200,17,60,28.3,16,45,35.6,1,15,6.7,14,35,40.0,12,27,39,4,12,23,7,1,49,0
12498,287860,332_11_05,PRINCIPALITY OF MONACO,0,TOTALS,PRINCIPALITY OF MONACO,200,7,54,13.0,7,51,13.7,0,3,0.0,7,22,31.8,13,27,40,1,17,33,9,7,21,1
12499,287873,332_11_05,ANDORRA,0,TOTALS,ANDORRA,200,44,91,48.4,43,82,52.4,1,9,11.1,11,23,47.8,27,40,67,15,18,15,21,9,100,0
12500,287884,332_11_06,GIBRALTAR,0,TOTALS,GIBRALTAR,200,13,60,21.7,12,54,22.2,1,6,16.7,9,27,33.3,12,34,46,3,17,35,9,8,36,0
12501,287897,332_11_06,SAN MARINO,0,TOTALS,SAN MARINO,200,35,91,38.5,33,80,41.2,2,11,18.2,18,30,60.0,26,43,69,16,21,17,20,5,90,1
12502,287910,332_11_07,WALES,0,TOTALS,WALES,200,29,90,32.2,22,64,34.4,7,26,26.9,5,16,31.2,26,40,66,8,17,12,15,2,70,1
12503,287921,332_11_07,GIBRALTAR,0,TOTALS,GIBRALTAR,200,5,48,10.4,5,42,11.9,0,6,0.0,10,24,41.7,10,37,47,0,19,33,8,2,20,0
12504,287932,332_11_08,MALTA,0,TOTALS,MALTA,200,32,75,42.7,29,62,46.8,3,13,23.1,7,12,58.3,22,39,61,10,16,21,18,1,74,1
12505,287945,332_11_08,PRINCIPALITY OF MONACO,0,TOTALS,PRINCIPALITY OF MONACO,200,19,66,28.8,17,50,34.0,2,16,12.5,5,20,25.0,17,23,40,5,10,22,9,6,45,0
12506,287958,332_11_09,ANDORRA,0,TOTALS,ANDORRA,200,31,73,42.5,28,59,47.5,3,14,21.4,11,18,61.1,18,35,53,9,19,23,14,5,76,1
12507,287969,332_11_09,MALTA,0,TOTALS,MALTA,200,17,66,25.8,16,58,27.6,1,8,12.5,14,29,48.3,22,27,49,4,18,25,14,2,49,0
12508,287982,332_11_10,SAN MARINO,0,TOTALS,SAN MARINO,200,27,74,36.5,24,57,42.1,3,17,17.6,23,48,47.9,21,47,68,4,21,24,9,4,80,1
12509,287995,332_11_10,WALES,0,TOTALS,WALES,200,31,97,32.0,30,88,34.1,1,9,11.1,10,18,55.6,21,37,58,5,33,16,12,1,73,0
12510,288006,332_11_11,GIBRALTAR,0,TOTALS,GIBRALTAR,200,16,65,24.6,16,54,29.6,0,11,0.0,17,38,44.7,21,27,48,2,26,23,15,4,49,0
12511,288019,332_11_11,PRINCIPALITY OF MONACO,0,TOTALS,PRINCIPALITY OF MONACO,200,31,72,43.1,31,69,44.9,0,3,0.0,11,34,32.4,24,37,61,8,28,28,8,3,73,1
12512,288030,332_11_12,MALTA,0,TOTALS,MALTA,200,27,75,36.0,26,62,41.9,1,13,7.7,12,15,80.0,19,32,51,4,17,29,14,6,67,0
12513,288043,332_11_12,WALES,0,TOTALS,WALES,200,30,78,38.5,27,70,38.6,3,8,37.5,14,24,58.3,20,27,47,9,14,17,20,1,77,1
12514,288056,332_11_13,ANDORRA,0,TOTALS,ANDORRA,200,35,82,42.7,34,75,45.3,1,7,14.3,13,21,61.9,28,36,64,13,25,24,11,5,84,1
12515,288068,332_11_13,SAN MARINO,0,TOTALS,SAN MARINO,200,19,63,30.2,16,45,35.6,3,18,16.7,29,42,69.0,14,21,35,5,20,22,14,5,70,0
12516,291795,336_11_01,AUSTRALIA,0,TOTALS,AUSTRALIA,200,34,75,45.3,26,50,52.0,8,25,32.0,15,22,68.2,18,27,45,19,22,11,5,4,91,1
12517,291808,336_11_01,NEW ZEALAND,0,TOTALS,NEW ZEALAND,200,29,71,40.8,20,44,45.5,9,27,33.3,11,17,64.7,10,23,33,13,23,16,4,3,78,0
12518,291821,336_11_02,NEW ZEALAND,0,TOTALS,NEW ZEALAND,200,19,52,36.5,11,28,39.3,8,24,33.3,18,28,64.3,7,19,26,12,26,20,3,8,64,0
12519,291834,336_11_02,AUSTRALIA,0,TOTALS,AUSTRALIA,200,29,68,42.6,26,53,49.1,3,15,20.0,20,25,80.0,16,25,41,13,26,17,4,2,81,1
12520,291845,336_11_03,AUSTRALIA,0,TOTALS,AUSTRALIA,200,35,65,53.8,28,48,58.3,7,17,41.2,15,20,75.0,10,27,37,23,18,14,5,5,92,1
12521,291857,336_11_03,NEW ZEALAND,0,TOTALS,NEW ZEALAND,200,25,72,34.7,18,48,37.5,7,24,29.2,11,17,64.7,17,21,38,11,21,18,1,2,68,0
12522,291940,338_11_01,AUSTRALIA,0,TOTALS,AUSTRALIA,200,32,72,44.4,24,51,47.1,8,21,38.1,15,24,62.5,14,28,42,23,28,17,10,8,87,1
12523,291953,338_11_01,NEW ZEALAND,0,TOTALS,NEW ZEALAND,200,17,52,32.7,15,42,35.7,2,10,20.0,15,32,46.9,7,26,33,6,22,25,7,4,51,0
12524,291966,338_11_02,NEW ZEALAND,0,TOTALS,NEW ZEALAND,200,16,65,24.6,14,49,28.6,2,16,12.5,14,22,63.6,17,24,41,10,21,19,3,4,48,0
12525,291979,338_11_02,AUSTRALIA,0,TOTALS,AUSTRALIA,200,32,66,48.5,21,46,45.7,11,20,55.0,11,24,45.8,13,28,41,18,20,14,9,9,86,1
12526,291990,338_11_03,AUSTRALIA,0,TOTALS,AUSTRALIA,200,27,69,39.1,22,56,39.3,5,13,38.5,12,23,52.2,14,27,41,14,26,18,13,4,71,1
12527,292002,338_11_03,NEW ZEALAND,0,TOTALS,NEW ZEALAND,200,19,61,31.1,17,46,37.0,2,15,13.3,8,17,47.1,13,26,39,7,19,30,3,8,48,0
12528,292090,340_12_01,NIGERIA,0,TOTALS,NIGERIA,200,20,60,33.3,18,47,38.3,2,13,15.4,18,31,58.1,20,22,42,9,17,13,11,3,60,1
12529,292103,340_12_01,TUNISIA,0,TOTALS,TUNISIA,200,23,57,40.4,15,34,44.1,8,23,34.8,2,5,40.0,12,27,39,15,25,21,2,4,56,0
12530,292116,340_12_02,BRAZIL,0,TOTALS,BRAZIL,200,28,68,41.2,26,53,49.1,2,15,13.3,17,21,81.0,12,26,38,13,24,15,6,2,75,1
12531,292129,340_12_02,AUSTRALIA,0,TOTALS,AUSTRALIA,200,28,66,42.4,24,44,54.5,4,22,18.2,11,14,78.6,11,30,41,14,26,19,4,1,71,0
12532,292142,340_12_03,USA,0,TOTALS,USA,200,31,72,43.1,23,47,48.9,8,25,32.0,28,38,73.7,18,38,56,27,26,14,10,5,98,1
12533,292155,340_12_03,FRANCE,0,TOTALS,FRANCE,200,26,66,39.4,24,44,54.5,2,22,9.1,17,27,63.0,9,31,40,10,26,18,4,3,71,0
12534,292168,340_12_04,SPAIN,0,TOTALS,SPAIN,200,36,63,57.1,25,44,56.8,11,19,57.9,14,22,63.6,12,27,39,27,20,13,3,3,97,1
12535,292181,340_12_04,CHINA,0,TOTALS,CHINA,200,33,64,51.6,26,48,54.2,7,16,43.8,8,17,47.1,7,18,25,15,20,9,6,1,81,0
12536,292194,340_12_05,RUSSIA,0,TOTALS,RUSSIA,200,37,59,62.7,32,44,72.7,5,15,33.3,16,25,64.0,5,27,32,24,27,16,11,9,95,1
12537,292207,340_12_05,GREAT BRITAIN,0,TOTALS,GREAT BRITAIN,200,25,76,32.9,21,50,42.0,4,26,15.4,21,29,72.4,25,22,47,10,24,18,5,0,75,0
12538,292220,340_12_06,ARGENTINA,0,TOTALS,ARGENTINA,200,36,71,50.7,25,44,56.8,11,27,40.7,19,26,73.1,9,25,34,21,20,7,12,3,102,0
12539,292233,340_12_06,LITHUANIA,0,TOTALS,LITHUANIA,200,28,60,46.7,25,50,50.0,3,10,30.0,20,22,90.9,8,28,36,16,22,16,2,2,79,1
12540,292246,340_12_07,CHINA,0,TOTALS,CHINA,200,21,56,37.5,16,43,37.2,5,13,38.5,7,10,70.0,3,26,29,7,15,16,4,7,54,0
12541,292259,340_12_07,RUSSIA,0,TOTALS,RUSSIA,200,30,68,44.1,26,51,51.0,4,17,23.5,9,13,69.2,13,33,46,19,14,12,9,7,73,1
12542,292272,340_12_08,AUSTRALIA,0,TOTALS,AUSTRALIA,200,30,81,37.0,26,57,45.6,4,24,16.7,6,12,50.0,15,24,39,14,24,5,11,2,70,0
12543,292285,340_12_08,SPAIN,0,TOTALS,SPAIN,200,28,65,43.1,21,44,47.7,7,21,33.3,19,26,73.1,16,40,56,21,20,16,2,5,82,1
12544,292298,340_12_09,LITHUANIA,0,TOTALS,LITHUANIA,200,25,54,46.3,22,41,53.7,3,13,23.1,19,21,90.5,10,32,42,19,26,18,7,2,72,1
12545,292311,340_12_09,NIGERIA,0,TOTALS,NIGERIA,200,16,66,24.2,15,50,30.0,1,16,6.2,20,29,69.0,21,20,41,3,23,16,4,3,53,0
12546,292324,340_12_10,GREAT BRITAIN,0,TOTALS,GREAT BRITAIN,200,23,59,39.0,16,40,40.0,7,19,36.8,9,15,60.0,12,29,41,9,21,19,4,1,62,0
12547,292337,340_12_10,BRAZIL,0,TOTALS,BRAZIL,200,28,66,42.4,25,44,56.8,3,22,13.6,8,14,57.1,11,25,36,14,20,12,10,3,67,1
12548,292350,340_12_11,FRANCE,0,TOTALS,FRANCE,200,25,64,39.1,16,39,41.0,9,25,36.0,12,14,85.7,11,33,44,17,24,15,4,5,71,1
12549,292363,340_12_11,ARGENTINA,0,TOTALS,ARGENTINA,200,23,62,37.1,19,39,48.7,4,23,17.4,14,18,77.8,9,27,36,12,20,12,8,1,64,0
12550,292376,340_12_12,TUNISIA,0,TOTALS,TUNISIA,200,23,65,35.4,14,39,35.9,9,26,34.6,8,21,38.1,12,19,31,12,11,19,4,2,63,1
12551,292389,340_12_12,USA,0,TOTALS,USA,200,43,70,61.4,33,45,73.3,10,25,40.0,14,18,77.8,9,35,44,28,19,9,8,3,110,0
12552,292402,340_12_13,FRANCE,0,TOTALS,FRANCE,200,31,58,53.4,25,46,54.3,6,12,50.0,14,24,58.3,9,29,38,13,16,13,5,5,82,1
12553,292415,340_12_13,LITHUANIA,0,TOTALS,LITHUANIA,200,28,64,43.8,22,43,51.2,6,21,28.6,12,15,80.0,8,21,29,14,26,11,1,2,74,0
12554,292428,340_12_14,AUSTRALIA,0,TOTALS,AUSTRALIA,200,31,79,39.2,23,55,41.8,8,24,33.3,11,17,64.7,21,30,51,23,22,10,9,4,81,1
12555,292441,340_12_14,CHINA,0,TOTALS,CHINA,200,19,52,36.5,10,35,28.6,9,17,52.9,14,24,58.3,6,30,36,10,18,19,5,5,61,0
12556,292454,340_12_15,ARGENTINA,0,TOTALS,ARGENTINA,200,36,71,50.7,27,46,58.7,9,25,36.0,11,17,64.7,9,31,40,23,14,8,6,4,92,1
12557,292467,340_12_15,TUNISIA,0,TOTALS,TUNISIA,200,26,65,40.0,17,42,40.5,9,23,39.1,8,14,57.1,8,25,33,15,14,15,3,8,69,0
12558,292480,340_12_16,BRAZIL,0,TOTALS,BRAZIL,200,29,64,45.3,23,47,48.9,6,17,35.3,10,18,55.6,9,26,35,13,22,13,7,0,74,0
12559,292493,340_12_16,RUSSIA,0,TOTALS,RUSSIA,200,28,58,48.3,22,40,55.0,6,18,33.3,13,24,54.2,9,27,36,18,19,16,2,2,75,1
12560,292506,340_12_17,SPAIN,0,TOTALS,SPAIN,200,27,64,42.2,23,47,48.9,4,17,23.5,21,32,65.6,15,28,43,22,17,13,3,6,79,1
12561,292519,340_12_17,GREAT BRITAIN,0,TOTALS,GREAT BRITAIN,200,29,65,44.6,20,41,48.8,9,24,37.5,11,16,68.8,10,26,36,12,28,13,4,1,78,0
12562,292532,340_12_18,USA,0,TOTALS,USA,200,59,83,71.1,30,37,81.1,29,46,63.0,9,14,64.3,10,28,38,41,12,7,12,1,156,0
12563,292545,340_12_18,NIGERIA,0,TOTALS,NIGERIA,200,28,68,41.2,22,41,53.7,6,27,22.2,11,14,78.6,13,19,32,15,13,25,2,1,73,1
12564,292558,340_12_19,TUNISIA,0,TOTALS,TUNISIA,200,27,63,42.9,22,44,50.0,5,19,26.3,10,13,76.9,16,18,34,12,14,19,12,2,69,0
12565,292571,340_12_19,FRANCE,0,TOTALS,FRANCE,200,29,55,52.7,24,36,66.7,5,19,26.3,10,10,100.0,7,21,28,19,18,20,10,8,73,1
12566,292584,340_12_20,RUSSIA,0,TOTALS,RUSSIA,200,29,62,46.8,20,39,51.3,9,23,39.1,10,11,90.9,10,24,34,19,20,10,4,4,77,1
12567,292597,340_12_20,SPAIN,0,TOTALS,SPAIN,200,27,63,42.9,24,48,50.0,3,15,20.0,17,19,89.5,10,23,33,12,18,9,5,4,74,0
12568,292610,340_12_21,LITHUANIA,0,TOTALS,LITHUANIA,200,38,65,58.5,31,49,63.3,7,16,43.8,11,15,73.3,6,36,42,21,28,23,3,1,94,0
12569,292623,340_12_21,USA,0,TOTALS,USA,200,35,79,44.3,25,46,54.3,10,33,30.3,19,31,61.3,13,24,37,13,22,9,17,2,99,1
12570,292636,340_12_22,CHINA,0,TOTALS,CHINA,200,19,55,34.5,17,47,36.2,2,8,25.0,19,30,63.3,7,25,32,6,16,11,0,2,59,0
12571,292649,340_12_22,BRAZIL,0,TOTALS,BRAZIL,200,37,78,47.4,25,53,47.2,12,25,48.0,12,16,75.0,18,31,49,27,25,6,5,3,98,1
12572,292662,340_12_23,GREAT BRITAIN,0,TOTALS,GREAT BRITAIN,200,30,71,42.3,23,50,46.0,7,21,33.3,8,9,88.9,14,18,32,15,20,16,6,1,75,1
12573,292675,340_12_23,AUSTRALIA,0,TOTALS,AUSTRALIA,200,40,70,57.1,27,46,58.7,13,24,54.2,13,14,92.9,12,25,37,16,17,12,5,3,106,0
12574,292688,340_12_24,NIGERIA,0,TOTALS,NIGERIA,200,28,72,38.9,20,49,40.8,8,23,34.8,15,18,83.3,20,23,43,16,21,16,3,2,79,0
12575,292701,340_12_24,ARGENTINA,0,TOTALS,ARGENTINA,200,32,59,54.2,21,41,51.2,11,18,61.1,18,22,81.8,5,24,29,27,19,10,6,3,93,1
12576,292714,340_12_25,AUSTRALIA,0,TOTALS,AUSTRALIA,200,31,74,41.9,20,44,45.5,11,30,36.7,9,9,100.0,14,24,38,20,18,15,8,2,82,1
12577,292727,340_12_25,RUSSIA,0,TOTALS,RUSSIA,200,29,56,51.8,22,40,55.0,7,16,43.8,15,20,75.0,4,27,31,25,15,18,8,8,80,0
12578,292740,340_12_26,TUNISIA,0,TOTALS,TUNISIA,200,26,60,43.3,20,45,44.4,6,15,40.0,5,9,55.6,12,20,32,10,19,19,8,4,63,0
12579,292753,340_12_26,LITHUANIA,0,TOTALS,LITHUANIA,200,27,58,46.6,16,34,47.1,11,24,45.8,11,17,64.7,13,24,37,24,18,16,9,4,76,1
12580,292766,340_12_27,FRANCE,0,TOTALS,FRANCE,200,30,62,48.4,22,34,64.7,8,28,28.6,11,17,64.7,9,28,37,24,18,13,11,6,79,1
12581,292779,340_12_27,NIGERIA,0,TOTALS,NIGERIA,200,25,61,41.0,15,41,36.6,10,20,50.0,13,19,68.4,9,27,36,10,16,16,6,0,73,0
12582,292792,340_12_28,GREAT BRITAIN,0,TOTALS,GREAT BRITAIN,200,31,77,40.3,18,41,43.9,13,36,36.1,15,20,75.0,18,31,49,19,24,5,5,5,90,1
12583,292805,340_12_28,CHINA,0,TOTALS,CHINA,200,19,52,36.5,15,37,40.5,4,15,26.7,16,26,61.5,7,30,37,8,20,15,2,6,58,0
12584,292818,340_12_29,SPAIN,0,TOTALS,SPAIN,200,29,56,51.8,25,43,58.1,4,13,30.8,20,27,74.1,9,27,36,23,20,14,3,5,82,0
12585,292831,340_12_29,BRAZIL,0,TOTALS,BRAZIL,200,35,68,51.5,27,51,52.9,8,17,47.1,10,17,58.8,11,21,32,21,26,9,8,2,88,1
12586,292844,340_12_30,ARGENTINA,0,TOTALS,ARGENTINA,200,33,65,50.8,23,39,59.0,10,26,38.5,21,28,75.0,8,25,33,22,18,16,2,2,97,1
12587,292857,340_12_30,USA,0,TOTALS,USA,200,45,88,51.1,25,49,51.0,20,39,51.3,16,20,80.0,20,27,47,29,26,8,11,2,126,0
12588,292870,340_12_31,RUSSIA,0,TOTALS,RUSSIA,200,28,62,45.2,23,45,51.1,5,17,29.4,22,36,61.1,9,29,38,24,23,11,4,4,83,1
12589,292883,340_12_31,LITHUANIA,0,TOTALS,LITHUANIA,200,22,59,37.3,14,40,35.0,8,19,42.1,22,30,73.3,9,34,43,15,28,14,4,1,74,0
12590,292896,340_12_32,FRANCE,0,TOTALS,FRANCE,200,22,65,33.8,15,43,34.9,7,22,31.8,8,12,66.7,10,28,38,10,29,11,3,3,59,0
12591,292909,340_12_32,SPAIN,0,TOTALS,SPAIN,200,21,56,37.5,17,36,47.2,4,20,20.0,20,29,69.0,10,35,45,12,17,13,4,3,66,1
12592,292922,340_12_33,BRAZIL,0,TOTALS,BRAZIL,200,29,67,43.3,22,44,50.0,7,23,30.4,12,24,50.0,11,24,35,12,26,8,3,1,77,0
12593,292935,340_12_33,ARGENTINA,0,TOTALS,ARGENTINA,200,28,59,47.5,21,35,60.0,7,24,29.2,19,28,67.9,8,30,38,14,24,10,4,2,82,1
12594,292948,340_12_34,USA,0,TOTALS,USA,200,39,86,45.3,20,40,50.0,19,46,41.3,22,32,68.8,20,32,52,24,21,10,13,0,119,0
12595,292961,340_12_34,AUSTRALIA,0,TOTALS,AUSTRALIA,200,32,71,45.1,23,49,46.9,9,22,40.9,13,21,61.9,9,33,42,19,30,18,4,3,86,1
12596,292974,340_12_35,SPAIN,0,TOTALS,SPAIN,200,21,56,37.5,12,33,36.4,9,23,39.1,16,22,72.7,8,29,37,15,19,11,5,4,67,1
12597,292987,340_12_35,RUSSIA,0,TOTALS,RUSSIA,200,23,61,37.7,16,34,47.1,7,27,25.9,6,12,50.0,10,26,36,15,22,13,5,3,59,0
12598,293000,340_12_36,ARGENTINA,0,TOTALS,ARGENTINA,200,31,70,44.3,20,44,45.5,11,26,42.3,10,11,90.9,8,21,29,21,17,11,2,1,83,1
12599,293013,340_12_36,USA,0,TOTALS,USA,200,43,81,53.1,25,39,64.1,18,42,42.9,5,7,71.4,15,31,46,25,18,10,5,5,109,0
12600,293026,340_12_37,ARGENTINA,0,TOTALS,ARGENTINA,200,27,61,44.3,14,28,50.0,13,33,39.4,10,13,76.9,7,20,27,17,19,12,10,1,77,0
12601,293039,340_12_37,RUSSIA,0,TOTALS,RUSSIA,200,28,55,50.9,19,32,59.4,9,23,39.1,16,20,80.0,7,26,33,14,13,15,6,3,81,1
12602,293052,340_12_38,USA,0,TOTALS,USA,200,34,70,48.6,19,33,57.6,15,37,40.5,24,31,77.4,13,24,37,13,27,11,7,1,107,1
12603,293065,340_12_38,SPAIN,0,TOTALS,SPAIN,200,33,67,49.3,26,48,54.2,7,19,36.8,27,32,84.4,10,25,35,22,27,11,4,1,100,0
12604,294061,342_12_01,RUSSIA,0,TOTALS,RUSSIA,200,32,59,54.2,24,40,60.0,8,19,42.1,19,27,70.4,16,32,48,22,22,23,15,4,91,1
12605,294074,342_12_01,KOREA,0,TOTALS,KOREA,200,13,61,21.3,9,38,23.7,4,23,17.4,26,35,74.3,17,13,30,10,20,19,11,5,56,0
12606,294087,342_12_02,GREECE,0,TOTALS,GREECE,200,39,62,62.9,29,38,76.3,10,24,41.7,19,27,70.4,12,39,51,31,18,16,5,3,107,0
12607,294100,342_12_02,JORDAN,0,TOTALS,JORDAN,200,22,67,32.8,13,40,32.5,9,27,33.3,10,17,58.8,8,13,21,15,23,11,6,1,63,1
12608,294113,342_12_03,ANGOLA,0,TOTALS,ANGOLA,200,32,60,53.3,23,40,57.5,9,20,45.0,15,18,83.3,14,23,37,14,19,14,3,1,88,1
12609,294126,342_12_03,MKD,0,TOTALS,MKD,200,29,63,46.0,19,28,67.9,10,35,28.6,16,23,69.6,13,12,25,17,19,9,8,0,84,0
12610,294139,342_12_04,NIGERIA,0,TOTALS,NIGERIA,200,27,70,38.6,18,46,39.1,9,24,37.5,6,8,75.0,15,31,46,16,23,15,5,8,69,0
12611,294152,342_12_04,VENEZUELA,0,TOTALS,VENEZUELA,200,27,68,39.7,20,47,42.6,7,21,33.3,10,17,58.8,14,28,42,18,18,12,7,7,71,1
12612,294165,342_12_05,KOREA,0,TOTALS,KOREA,200,31,70,44.3,23,49,46.9,8,21,38.1,15,20,75.0,7,21,28,16,28,6,4,2,85,0
12613,294178,342_12_05,DOMINICAN REPUBLIC,0,TOTALS,DOMINICAN REPUBLIC,200,35,76,46.1,29,50,58.0,6,26,23.1,19,32,59.4,24,34,58,19,19,13,3,0,95,1
12614,294191,342_12_06,MKD,0,TOTALS,MKD,200,33,69,47.8,26,42,61.9,7,27,25.9,11,19,57.9,10,25,35,19,25,7,9,0,84,1
12615,294204,342_12_06,NEW ZEALAND,0,TOTALS,NEW ZEALAND,200,21,59,35.6,15,37,40.5,6,22,27.3,14,22,63.6,17,30,47,12,24,22,0,0,62,0
12616,294217,342_12_07,JORDAN,0,TOTALS,JORDAN,200,19,65,29.2,15,39,38.5,4,26,15.4,10,19,52.6,8,23,31,11,19,13,4,0,52,0
12617,294230,342_12_07,PUERTO RICO,0,TOTALS,PUERTO RICO,200,34,66,51.5,28,45,62.2,6,21,28.6,19,23,82.6,10,41,51,25,24,11,8,2,93,1
12618,294243,342_12_08,VENEZUELA,0,TOTALS,VENEZUELA,200,28,64,43.8,17,39,43.6,11,25,44.0,15,21,71.4,12,22,34,19,23,16,7,2,82,1
12619,294256,342_12_08,LITHUANIA,0,TOTALS,LITHUANIA,200,36,63,57.1,27,45,60.0,9,18,50.0,19,24,79.2,7,27,34,25,19,13,9,4,100,0
12620,294269,342_12_09,NEW ZEALAND,0,TOTALS,NEW ZEALAND,200,24,69,34.8,12,34,35.3,12,35,34.3,8,11,72.7,20,27,47,19,26,16,9,0,68,1
12621,294282,342_12_09,ANGOLA,0,TOTALS,ANGOLA,200,21,66,31.8,17,41,41.5,4,25,16.0,18,25,72.0,21,25,46,12,20,12,7,2,64,0
12622,294295,342_12_10,DOMINICAN REPUBLIC,0,TOTALS,DOMINICAN REPUBLIC,200,25,63,39.7,20,44,45.5,5,19,26.3,14,18,77.8,9,27,36,13,19,13,4,2,69,0
12623,294308,342_12_10,RUSSIA,0,TOTALS,RUSSIA,200,32,68,47.1,26,48,54.2,6,20,30.0,14,21,66.7,14,31,45,28,21,13,9,2,84,1
12624,294321,342_12_11,LITHUANIA,0,TOTALS,LITHUANIA,200,27,53,50.9,20,33,60.6,7,20,35.0,19,26,73.1,3,30,33,20,21,11,4,2,80,0
12625,294334,342_12_11,NIGERIA,0,TOTALS,NIGERIA,200,29,66,43.9,18,42,42.9,11,24,45.8,17,26,65.4,11,24,35,13,25,7,7,1,86,1
12626,294347,342_12_12,PUERTO RICO,0,TOTALS,PUERTO RICO,200,31,66,47.0,26,46,56.5,5,20,25.0,17,21,81.0,15,19,34,15,25,9,4,1,84,0
12627,294360,342_12_12,GREECE,0,TOTALS,GREECE,200,29,55,52.7,15,31,48.4,14,24,58.3,26,31,83.9,9,21,30,19,22,9,4,0,98,1
12628,294373,342_12_13,RUSSIA,0,TOTALS,RUSSIA,200,26,53,49.1,21,33,63.6,5,20,25.0,23,32,71.9,11,27,38,24,22,9,8,3,80,1
12629,294386,342_12_13,ANGOLA,0,TOTALS,ANGOLA,200,21,57,36.8,15,37,40.5,6,20,30.0,17,27,63.0,12,20,32,10,29,11,4,2,65,0
12630,294399,342_12_14,GREECE,0,TOTALS,GREECE,200,28,49,57.1,22,31,71.0,6,18,33.3,17,28,60.7,6,22,28,18,19,9,4,1,79,0
12631,294412,342_12_14,NIGERIA,0,TOTALS,NIGERIA,200,29,68,42.6,25,46,54.3,4,22,18.2,18,20,90.0,17,21,38,6,24,9,4,3,80,1
12632,294425,342_12_15,MKD,0,TOTALS,MKD,200,29,64,45.3,18,35,51.4,11,29,37.9,7,9,77.8,8,24,32,12,27,13,3,2,76,0
12633,294438,342_12_15,DOMINICAN REPUBLIC,0,TOTALS,DOMINICAN REPUBLIC,200,27,70,38.6,20,50,40.0,7,20,35.0,25,31,80.6,22,28,50,20,15,11,6,0,86,1
12634,294451,342_12_16,LITHUANIA,0,TOTALS,LITHUANIA,200,25,58,43.1,19,43,44.2,6,15,40.0,20,31,64.5,4,33,37,11,24,10,8,4,76,1
12635,294464,342_12_16,PUERTO RICO,0,TOTALS,PUERTO RICO,200,25,65,38.5,17,46,37.0,8,19,42.1,14,22,63.6,10,34,44,13,26,15,4,3,72,0
12636,294477,342_12_17,NIGERIA,0,TOTALS,NIGERIA,200,25,59,42.4,17,36,47.2,8,23,34.8,19,24,79.2,15,18,33,12,18,17,10,2,77,0
12637,294490,342_12_17,RUSSIA,0,TOTALS,RUSSIA,200,29,52,55.8,15,25,60.0,14,27,51.9,13,20,65.0,7,22,29,26,23,21,11,1,85,1
12638,294503,342_12_18,LITHUANIA,0,TOTALS,LITHUANIA,200,39,61,63.9,29,43,67.4,10,18,55.6,21,24,87.5,7,28,35,26,27,15,6,1,109,0
12639,294516,342_12_18,DOMINICAN REPUBLIC,0,TOTALS,DOMINICAN REPUBLIC,200,27,70,38.6,21,48,43.8,6,22,27.3,23,30,76.7,17,14,31,18,21,11,8,0,83,1
12640,294529,342_12_19,NIGERIA,0,TOTALS,NIGERIA,200,33,64,51.6,26,47,55.3,7,17,41.2,15,25,60.0,15,27,42,18,23,12,5,8,88,1
12641,294542,342_12_19,DOMINICAN REPUBLIC,0,TOTALS,DOMINICAN REPUBLIC,200,26,74,35.1,18,46,39.1,8,28,28.6,13,21,61.9,22,19,41,9,19,12,4,3,73,0
12642,295047,344_12_01,EGYPT,0,TOTALS,EGYPT,200,28,72,38.9,26,64,40.6,2,8,25.0,10,17,58.8,14,22,36,8,19,16,12,7,68,0
12643,295059,344_12_01,CHINA,0,TOTALS,CHINA,200,29,66,43.9,21,49,42.9,8,17,47.1,14,21,66.7,17,31,48,12,14,22,8,8,80,1
12644,295072,344_12_02,KOREA,0,TOTALS,KOREA,200,22,73,30.1,9,28,32.1,13,45,28.9,5,6,83.3,13,21,34,13,17,18,13,6,62,0
12645,295085,344_12_02,SPAIN,0,TOTALS,SPAIN,200,36,84,42.9,31,62,50.0,5,22,22.7,3,6,50.0,28,39,67,21,14,24,9,3,80,1
12646,295098,344_12_03,CZECH REPUBLIC,0,TOTALS,CZECH REPUBLIC,200,24,62,38.7,16,45,35.6,8,17,47.1,14,21,66.7,11,32,43,16,13,17,11,3,70,1
12647,295111,344_12_03,FRANCE,0,TOTALS,FRANCE,200,27,66,40.9,19,44,43.2,8,22,36.4,2,5,40.0,9,31,40,14,18,17,11,4,64,0
12648,295124,344_12_04,AUSTRALIA,0,TOTALS,AUSTRALIA,200,23,61,37.7,17,37,45.9,6,24,25.0,15,28,53.6,15,22,37,15,15,12,5,3,67,0
12649,295137,344_12_04,USA,0,TOTALS,USA,200,36,70,51.4,27,53,50.9,9,17,52.9,8,16,50.0,16,31,47,15,23,8,9,1,89,1
12650,295150,344_12_05,CANADA,0,TOTALS,CANADA,225,24,73,32.9,19,47,40.4,5,26,19.2,16,28,57.1,20,33,53,8,17,23,17,5,69,1
12651,295163,344_12_05,LITHUANIA,0,TOTALS,LITHUANIA,225,23,71,32.4,17,42,40.5,6,29,20.7,11,18,61.1,18,34,52,10,25,27,13,2,63,0
12652,295176,344_12_06,ARGENTINA,0,TOTALS,ARGENTINA,200,25,71,35.2,20,44,45.5,5,27,18.5,13,18,72.2,7,29,36,2,26,18,13,1,68,0
12653,295189,344_12_06,CROATIA,0,TOTALS,CROATIA,200,27,64,42.2,21,42,50.0,6,22,27.3,18,27,66.7,10,42,52,10,23,23,10,5,78,1
12654,295201,344_12_07,CHINA,0,TOTALS,CHINA,200,17,46,37.0,15,37,40.5,2,9,22.2,19,25,76.0,5,22,27,13,21,23,4,4,55,0
12655,295214,344_12_07,AUSTRALIA,0,TOTALS,AUSTRALIA,200,35,75,46.7,28,52,53.8,7,23,30.4,15,18,83.3,18,26,44,15,24,12,12,4,92,1
12656,295227,344_12_08,FRANCE,0,TOTALS,FRANCE,200,33,75,44.0,26,52,50.0,7,23,30.4,5,7,71.4,17,30,47,23,23,18,14,8,78,1
12657,295240,344_12_08,EGYPT,0,TOTALS,EGYPT,200,21,60,35.0,20,53,37.7,1,7,14.3,11,28,39.3,15,24,39,5,8,22,8,5,54,0
12658,295253,344_12_09,USA,0,TOTALS,USA,200,35,76,46.1,33,67,49.3,2,9,22.2,23,26,88.5,19,45,64,13,17,22,12,4,95,1
12659,295266,344_12_09,CZECH REPUBLIC,0,TOTALS,CZECH REPUBLIC,200,21,77,27.3,18,59,30.5,3,18,16.7,12,17,70.6,12,23,35,5,23,19,8,2,57,0
12660,295279,344_12_10,CROATIA,0,TOTALS,CROATIA,200,24,75,32.0,20,51,39.2,4,24,16.7,14,14,100.0,16,37,53,14,24,14,7,3,66,1
12661,295292,344_12_10,CANADA,0,TOTALS,CANADA,200,19,61,31.1,14,37,37.8,5,24,20.8,10,21,47.6,10,33,43,8,16,14,8,4,53,0
12662,295305,344_12_11,LITHUANIA,0,TOTALS,LITHUANIA,225,47,87,54.0,41,70,58.6,6,17,35.3,19,24,79.2,31,42,73,18,19,24,4,7,119,1
12663,295318,344_12_11,KOREA,0,TOTALS,KOREA,225,40,97,41.2,23,57,40.4,17,40,42.5,11,14,78.6,16,12,28,18,23,8,18,7,108,0
12664,295331,344_12_12,SPAIN,0,TOTALS,SPAIN,200,22,70,31.4,19,41,46.3,3,29,10.3,11,21,52.4,18,25,43,7,21,18,9,6,58,0
12665,295344,344_12_12,ARGENTINA,0,TOTALS,ARGENTINA,200,23,59,39.0,21,45,46.7,2,14,14.3,20,25,80.0,11,33,44,15,24,22,7,4,68,1
12666,295357,344_12_13,FRANCE,0,TOTALS,FRANCE,200,20,62,32.3,16,49,32.7,4,13,30.8,9,10,90.0,9,34,43,14,18,15,8,4,53,0
12667,295369,344_12_13,CHINA,0,TOTALS,CHINA,200,21,55,38.2,15,39,38.5,6,16,37.5,11,16,68.8,3,31,34,14,15,12,9,4,59,1
12668,295382,344_12_14,CZECH REPUBLIC,0,TOTALS,CZECH REPUBLIC,200,25,64,39.1,21,44,47.7,4,20,20.0,4,6,66.7,11,31,42,16,19,20,8,1,58,0
12669,295395,344_12_14,AUSTRALIA,0,TOTALS,AUSTRALIA,200,23,64,35.9,22,44,50.0,1,20,5.0,16,24,66.7,12,29,41,17,9,15,13,2,63,1
12670,295408,344_12_15,EGYPT,0,TOTALS,EGYPT,200,30,69,43.5,29,62,46.8,1,7,14.3,12,15,80.0,14,24,38,12,16,28,7,8,73,1
12671,295421,344_12_15,USA,0,TOTALS,USA,200,50,85,58.8,45,73,61.6,5,12,41.7,6,19,31.6,18,26,44,14,19,16,17,2,111,0
12672,295434,344_12_16,KOREA,0,TOTALS,KOREA,200,25,71,35.2,14,36,38.9,11,35,31.4,7,9,77.8,12,15,27,12,27,15,5,1,68,1
12673,295447,344_12_16,CROATIA,0,TOTALS,CROATIA,200,43,80,53.8,33,57,57.9,10,23,43.5,28,36,77.8,27,36,63,34,15,8,8,3,124,0
12674,295460,344_12_17,LITHUANIA,0,TOTALS,LITHUANIA,225,27,72,37.5,18,44,40.9,9,28,32.1,20,28,71.4,15,30,45,14,30,18,6,4,83,0
12675,295473,344_12_17,SPAIN,0,TOTALS,SPAIN,225,30,67,44.8,19,39,48.7,11,28,39.3,20,34,58.8,11,30,41,18,23,17,10,5,91,1
12676,295486,344_12_18,CANADA,0,TOTALS,CANADA,200,26,63,41.3,20,50,40.0,6,13,46.2,22,38,57.9,16,27,43,8,19,11,3,2,80,1
12677,295499,344_12_18,ARGENTINA,0,TOTALS,ARGENTINA,200,25,62,40.3,19,39,48.7,6,23,26.1,20,26,76.9,9,32,41,14,27,10,6,3,76,0
12678,295512,344_12_19,SPAIN,0,TOTALS,SPAIN,200,32,61,52.5,26,40,65.0,6,21,28.6,13,17,76.5,11,22,33,24,16,18,18,5,83,1
12679,295525,344_12_19,CANADA,0,TOTALS,CANADA,200,22,63,34.9,16,43,37.2,6,20,30.0,12,18,66.7,22,19,41,9,17,25,8,2,62,0
12680,295537,344_12_20,CHINA,0,TOTALS,CHINA,200,23,58,39.7,17,36,47.2,6,22,27.3,19,21,90.5,10,31,41,8,18,15,6,5,71,1
12681,295550,344_12_20,CZECH REPUBLIC,0,TOTALS,CZECH REPUBLIC,200,29,80,36.2,26,65,40.0,3,15,20.0,7,13,53.8,23,25,48,9,21,12,11,2,68,0
12682,295563,344_12_21,ARGENTINA,0,TOTALS,ARGENTINA,200,42,78,53.8,38,62,61.3,4,16,25.0,18,20,90.0,13,35,48,29,20,17,17,2,106,0
12683,295576,344_12_21,KOREA,0,TOTALS,KOREA,200,23,67,34.3,18,43,41.9,5,24,20.8,8,13,61.5,10,21,31,10,20,25,8,2,59,1
12684,295589,344_12_22,AUSTRALIA,0,TOTALS,AUSTRALIA,250,35,88,39.8,22,52,42.3,13,36,36.1,5,11,45.5,23,36,59,26,12,19,13,4,88,1
12685,295602,344_12_22,EGYPT,0,TOTALS,EGYPT,250,30,71,42.3,24,54,44.4,6,17,35.3,7,16,43.8,9,28,37,17,15,18,12,7,73,0
12686,295615,344_12_23,CROATIA,0,TOTALS,CROATIA,200,27,77,35.1,22,55,40.0,5,22,22.7,23,33,69.7,22,33,55,17,20,13,11,7,82,1
12687,295628,344_12_23,LITHUANIA,0,TOTALS,LITHUANIA,200,27,81,33.3,14,47,29.8,13,34,38.2,11,17,64.7,21,32,53,15,25,17,11,7,78,0
12688,295641,344_12_24,USA,0,TOTALS,USA,200,33,84,39.3,31,72,43.1,2,12,16.7,18,34,52.9,28,33,61,14,19,16,19,6,86,1
12689,295654,344_12_24,FRANCE,0,TOTALS,FRANCE,200,20,64,31.2,16,44,36.4,4,20,20.0,6,12,50.0,15,29,44,9,24,30,8,4,50,0
12690,295667,344_12_25,KOREA,0,TOTALS,KOREA,200,22,71,31.0,14,36,38.9,8,35,22.9,9,11,81.8,12,24,36,11,19,22,9,6,61,0
12691,295680,344_12_25,CANADA,0,TOTALS,CANADA,200,31,74,41.9,26,59,44.1,5,15,33.3,15,23,65.2,25,36,61,18,16,24,11,3,82,1
12692,295693,344_12_26,CROATIA,0,TOTALS,CROATIA,200,25,66,37.9,16,37,43.2,9,29,31.0,14,15,93.3,13,27,40,14,21,18,12,1,73,1
12693,295706,344_12_26,SPAIN,0,TOTALS,SPAIN,200,26,73,35.6,24,52,46.2,2,21,9.5,14,20,70.0,20,29,49,8,16,18,11,4,68,0
12694,295719,344_12_27,EGYPT,0,TOTALS,EGYPT,200,26,60,43.3,24,48,50.0,2,12,16.7,16,24,66.7,9,22,31,8,17,18,8,2,70,0
12695,295732,344_12_27,CZECH REPUBLIC,0,TOTALS,CZECH REPUBLIC,200,30,68,44.1,29,52,55.8,1,16,6.2,17,21,81.0,16,28,44,17,22,17,13,3,78,1
12696,295745,344_12_28,FRANCE,0,TOTALS,FRANCE,200,16,45,35.6,11,29,37.9,5,16,31.2,5,9,55.6,12,23,35,9,16,25,6,2,42,0
12697,295758,344_12_28,AUSTRALIA,0,TOTALS,AUSTRALIA,200,24,56,42.9,15,35,42.9,9,21,42.9,7,11,63.6,11,17,28,15,13,12,14,2,64,1
12698,295771,344_12_29,LITHUANIA,0,TOTALS,LITHUANIA,200,31,64,48.4,24,39,61.5,7,25,28.0,13,19,68.4,11,27,38,18,23,22,7,2,82,0
12699,295784,344_12_29,ARGENTINA,0,TOTALS,ARGENTINA,200,35,72,48.6,29,54,53.7,6,18,33.3,16,20,80.0,12,24,36,22,20,18,15,4,92,1
12700,295797,344_12_30,USA,0,TOTALS,USA,200,50,92,54.3,43,76,56.6,7,16,43.8,9,17,52.9,21,42,63,25,14,16,15,11,116,0
12701,295809,344_12_30,CHINA,0,TOTALS,CHINA,200,18,68,26.5,11,45,24.4,7,23,30.4,4,10,40.0,11,26,37,13,17,30,5,5,47,1
12702,295822,344_12_31,FRANCE,0,TOTALS,FRANCE,200,44,75,58.7,34,54,63.0,10,21,47.6,12,17,70.6,17,38,55,27,15,13,11,5,110,0
12703,295835,344_12_31,KOREA,0,TOTALS,KOREA,200,21,71,29.6,14,46,30.4,7,25,28.0,1,6,16.7,15,17,32,12,20,18,9,3,50,1
12704,295848,344_12_32,LITHUANIA,0,TOTALS,LITHUANIA,200,29,74,39.2,25,58,43.1,4,16,25.0,11,18,61.1,18,23,41,19,17,18,14,2,73,1
12705,295861,344_12_32,EGYPT,0,TOTALS,EGYPT,200,28,58,48.3,23,42,54.8,5,16,31.2,11,16,68.8,9,29,38,9,17,26,10,17,72,0
12706,295874,344_12_33,SPAIN,0,TOTALS,SPAIN,200,24,60,40.0,20,48,41.7,4,12,33.3,12,18,66.7,9,32,41,5,17,16,7,3,64,1
12707,295886,344_12_33,CHINA,0,TOTALS,CHINA,200,19,58,32.8,12,34,35.3,7,24,29.2,12,13,92.3,6,28,34,10,17,19,7,3,57,0
12708,295899,344_12_34,USA,0,TOTALS,USA,200,48,86,55.8,44,71,62.0,4,15,26.7,13,24,54.2,27,32,59,17,15,16,16,9,113,0
12709,295912,344_12_34,CANADA,0,TOTALS,CANADA,200,25,74,33.8,23,56,41.1,2,18,11.1,7,12,58.3,20,16,36,9,18,23,13,0,59,1
12710,295925,344_12_35,AUSTRALIA,0,TOTALS,AUSTRALIA,200,28,66,42.4,21,42,50.0,7,24,29.2,15,18,83.3,17,23,40,19,19,16,13,4,78,1
12711,295938,344_12_35,ARGENTINA,0,TOTALS,ARGENTINA,200,23,50,46.0,18,32,56.2,5,18,27.8,8,15,53.3,5,21,26,5,23,21,8,1,59,0
12712,295951,344_12_36,CROATIA,0,TOTALS,CROATIA,200,35,76,46.1,26,49,53.1,9,27,33.3,15,16,93.8,16,28,44,24,20,9,11,3,94,1
12713,295964,344_12_36,CZECH REPUBLIC,0,TOTALS,CZECH REPUBLIC,200,27,72,37.5,19,49,38.8,8,23,34.8,9,13,69.2,19,25,44,13,16,20,5,2,71,0
12714,295977,344_12_37,KOREA,0,TOTALS,KOREA,200,29,67,43.3,21,43,48.8,8,24,33.3,23,25,92.0,11,16,27,14,20,17,16,3,89,1
12715,295990,344_12_37,EGYPT,0,TOTALS,EGYPT,200,34,67,50.7,33,60,55.0,1,7,14.3,14,22,63.6,22,26,48,14,21,28,8,6,83,0
12716,296003,344_12_38,FRANCE,0,TOTALS,FRANCE,200,24,67,35.8,16,45,35.6,8,22,36.4,8,21,38.1,22,27,49,11,16,19,7,1,64,0
12717,296016,344_12_38,LITHUANIA,0,TOTALS,LITHUANIA,200,31,61,50.8,26,45,57.8,5,16,31.2,8,12,66.7,5,27,32,12,21,12,11,2,75,1
12718,296028,344_12_39,CHINA,0,TOTALS,CHINA,200,23,66,34.8,18,43,41.9,5,23,21.7,13,18,72.2,11,29,40,5,19,18,9,12,64,0
12719,296041,344_12_39,CANADA,0,TOTALS,CANADA,200,24,78,30.8,23,64,35.9,1,14,7.1,19,26,73.1,29,34,63,8,22,20,13,4,68,1
12720,296054,344_12_40,ARGENTINA,0,TOTALS,ARGENTINA,200,27,68,39.7,21,44,47.7,6,24,25.0,18,23,78.3,14,32,46,19,20,11,9,6,78,1
12721,296067,344_12_40,CZECH REPUBLIC,0,TOTALS,CZECH REPUBLIC,200,28,70,40.0,23,48,47.9,5,22,22.7,9,19,47.4,14,27,41,15,20,14,5,3,70,0
12722,296080,344_12_41,SPAIN,0,TOTALS,SPAIN,200,23,58,39.7,17,36,47.2,6,22,27.3,14,19,73.7,7,23,30,14,24,24,4,2,66,0
12723,296093,344_12_41,USA,0,TOTALS,USA,200,35,81,43.2,32,68,47.1,3,13,23.1,22,33,66.7,26,31,57,12,20,18,10,4,95,1
12724,296106,344_12_42,AUSTRALIA,0,TOTALS,AUSTRALIA,200,29,62,46.8,14,26,53.8,15,36,41.7,10,14,71.4,9,24,33,18,18,11,10,1,83,1
12725,296119,344_12_42,CROATIA,0,TOTALS,CROATIA,200,24,58,41.4,16,28,57.1,8,30,26.7,15,21,71.4,13,24,37,14,17,19,5,2,71,0
12726,296131,344_12_43,CHINA,0,TOTALS,CHINA,200,27,57,47.4,18,35,51.4,9,22,40.9,14,16,87.5,10,24,34,17,14,17,10,6,77,1
12727,296144,344_12_43,CZECH REPUBLIC,0,TOTALS,CZECH REPUBLIC,200,28,68,41.2,21,46,45.7,7,22,31.8,7,9,77.8,16,18,34,17,16,13,4,1,70,0
12728,296157,344_12_44,CANADA,0,TOTALS,CANADA,200,30,67,44.8,24,54,44.4,6,13,46.2,18,23,78.3,17,27,44,8,22,17,7,4,84,1
12729,296170,344_12_44,ARGENTINA,0,TOTALS,ARGENTINA,200,28,63,44.4,22,43,51.2,6,20,30.0,17,22,77.3,10,21,31,22,21,17,8,3,79,0
12730,296183,344_12_45,SPAIN,0,TOTALS,SPAIN,200,21,67,31.3,15,39,38.5,6,28,21.4,13,20,65.0,11,22,33,4,31,15,8,5,61,0
12731,296196,344_12_45,CROATIA,0,TOTALS,CROATIA,200,29,57,50.9,20,38,52.6,9,19,47.4,26,35,74.3,9,39,48,21,25,17,9,1,93,1
12732,296209,344_12_46,USA,0,TOTALS,USA,200,35,58,60.3,27,40,67.5,8,18,44.4,17,21,81.0,12,31,43,16,13,16,11,1,95,1
12733,296222,344_12_46,AUSTRALIA,0,TOTALS,AUSTRALIA,200,21,65,32.3,12,23,52.2,9,42,21.4,11,16,68.8,14,13,27,18,18,13,6,3,62,0
12734,297431,346_12_01,VENEZUELA,0,TOTALS,VENEZUELA,200,34,56,60.7,29,40,72.5,5,16,31.2,13,20,65.0,12,25,37,21,18,17,4,2,86,1
12735,297444,346_12_01,CHILE,0,TOTALS,CHILE,200,21,52,40.4,15,27,55.6,6,25,24.0,13,19,68.4,5,15,20,8,17,10,1,1,61,0
12736,297457,346_12_02,URUGUAY,0,TOTALS,URUGUAY,200,50,70,71.4,37,49,75.5,13,21,61.9,9,13,69.2,9,35,44,29,9,12,18,2,122,0
12737,297470,346_12_02,BOLIVIA,0,TOTALS,BOLIVIA,200,14,55,25.5,8,29,27.6,6,26,23.1,2,6,33.3,8,11,19,10,12,25,8,1,36,1
12738,297483,346_12_03,PARAGUAY,0,TOTALS,PARAGUAY,200,22,50,44.0,14,28,50.0,8,22,36.4,11,16,68.8,7,22,29,11,22,13,7,4,63,0
12739,297496,346_12_03,BRAZIL,0,TOTALS,BRAZIL,200,22,56,39.3,18,37,48.6,4,19,21.1,19,23,82.6,11,22,33,9,19,11,10,0,67,1
12740,297508,346_12_04,COLOMBIA,0,TOTALS,COLOMBIA,200,27,59,45.8,23,47,48.9,4,12,33.3,10,21,47.6,14,26,40,9,14,20,15,0,68,0
12741,297521,346_12_04,ARGENTINA,0,TOTALS,ARGENTINA,200,34,68,50.0,18,37,48.6,16,31,51.6,3,5,60.0,9,29,38,22,19,22,10,6,87,1
12742,297534,346_12_05,CHILE,0,TOTALS,CHILE,200,26,58,44.8,19,36,52.8,7,22,31.8,17,24,70.8,4,32,36,15,24,13,4,2,76,1
12743,297546,346_12_05,COLOMBIA,0,TOTALS,COLOMBIA,200,22,75,29.3,19,55,34.5,3,20,15.0,19,29,65.5,24,32,56,6,24,14,7,3,66,0
12744,297559,346_12_06,BOLIVIA,0,TOTALS,BOLIVIA,200,25,58,43.1,18,32,56.2,7,26,26.9,5,8,62.5,4,33,37,10,18,29,6,0,62,0
12745,297572,346_12_06,PARAGUAY,0,TOTALS,PARAGUAY,200,27,69,39.1,20,35,57.1,7,34,20.6,20,32,62.5,15,29,44,13,14,13,18,2,81,1
12746,297585,346_12_07,BRAZIL,0,TOTALS,BRAZIL,200,26,52,50.0,18,31,58.1,8,21,38.1,17,25,68.0,10,18,28,10,23,19,9,0,77,1
12747,297598,346_12_07,URUGUAY,0,TOTALS,URUGUAY,200,23,48,47.9,15,33,45.5,8,15,53.3,19,21,90.5,8,22,30,8,24,24,8,2,73,0
12748,297611,346_12_08,ARGENTINA,0,TOTALS,ARGENTINA,200,32,57,56.1,22,34,64.7,10,23,43.5,16,26,61.5,10,18,28,20,23,17,5,1,90,1
12749,297624,346_12_08,VENEZUELA,0,TOTALS,VENEZUELA,200,28,55,50.9,16,33,48.5,12,22,54.5,19,24,79.2,7,20,27,8,27,14,11,2,87,0
12750,297636,346_12_09,COLOMBIA,0,TOTALS,COLOMBIA,200,27,70,38.6,24,53,45.3,3,17,17.6,9,14,64.3,19,18,37,12,13,12,5,0,66,1
12751,297649,346_12_09,VENEZUELA,0,TOTALS,VENEZUELA,200,43,73,58.9,35,50,70.0,8,23,34.8,7,11,63.6,13,27,40,19,13,8,8,2,101,0
12752,297662,346_12_10,BRAZIL,0,TOTALS,BRAZIL,200,37,72,51.4,30,46,65.2,7,26,26.9,14,22,63.6,19,31,50,26,7,13,14,2,95,1
12753,297675,346_12_10,BOLIVIA,0,TOTALS,BOLIVIA,200,18,58,31.0,8,30,26.7,10,28,35.7,0,0,0.0,7,17,24,11,14,22,5,2,46,0
12754,297688,346_12_11,ARGENTINA,0,TOTALS,ARGENTINA,200,31,66,47.0,16,28,57.1,15,38,39.5,11,15,73.3,13,34,47,24,12,15,9,6,88,1
12755,297701,346_12_11,CHILE,0,TOTALS,CHILE,200,25,73,34.2,17,48,35.4,8,25,32.0,6,8,75.0,15,23,38,10,14,16,8,2,64,0
12756,297714,346_12_12,PARAGUAY,0,TOTALS,PARAGUAY,200,24,68,35.3,17,41,41.5,7,27,25.9,15,17,88.2,11,12,23,9,21,12,7,1,70,0
12757,297727,346_12_12,URUGUAY,0,TOTALS,URUGUAY,200,30,49,61.2,25,36,69.4,5,13,38.5,17,22,77.3,7,34,41,16,21,19,7,3,82,1
12758,297740,346_12_13,CHILE,0,TOTALS,CHILE,200,28,64,43.8,14,36,38.9,14,28,50.0,18,25,72.0,7,24,31,12,25,13,5,2,88,0
12759,297753,346_12_13,PARAGUAY,0,TOTALS,PARAGUAY,200,28,63,44.4,22,43,51.2,6,20,30.0,31,34,91.2,12,32,44,17,24,13,6,4,93,1
12760,297766,346_12_14,BRAZIL,0,TOTALS,BRAZIL,200,29,60,48.3,23,42,54.8,6,18,33.3,6,10,60.0,9,24,33,14,20,14,4,3,70,0
12761,297779,346_12_14,VENEZUELA,0,TOTALS,VENEZUELA,200,31,62,50.0,23,41,56.1,8,21,38.1,16,24,66.7,9,21,30,16,12,6,6,1,86,1
12762,297792,346_12_15,ARGENTINA,0,TOTALS,ARGENTINA,200,31,60,51.7,17,29,58.6,14,31,45.2,12,16,75.0,7,28,35,14,24,17,9,2,88,1
12763,297805,346_12_15,URUGUAY,0,TOTALS,URUGUAY,200,28,63,44.4,19,46,41.3,9,17,52.9,16,21,76.2,6,23,29,11,24,13,11,3,81,0
12764,297818,346_12_16,URUGUAY,0,TOTALS,URUGUAY,200,30,50,60.0,25,36,69.4,5,14,35.7,15,18,83.3,7,21,28,12,19,18,9,2,80,1
12765,297831,346_12_16,BRAZIL,0,TOTALS,BRAZIL,200,26,61,42.6,21,38,55.3,5,23,21.7,11,17,64.7,15,11,26,13,20,18,11,2,68,0
12766,297844,346_12_17,VENEZUELA,0,TOTALS,VENEZUELA,200,20,55,36.4,17,36,47.2,3,19,15.8,13,21,61.9,9,24,33,7,19,17,4,0,56,0
12767,297857,346_12_17,ARGENTINA,0,TOTALS,ARGENTINA,200,30,57,52.6,21,33,63.6,9,24,37.5,10,16,62.5,5,26,31,14,24,14,5,3,79,1
12768,297870,347_12_01,JAMAICA,0,TOTALS,JAMAICA,200,34,68,50.0,26,48,54.2,8,20,40.0,15,29,51.7,19,29,48,22,24,22,12,3,91,1
12769,297883,347_12_01,COSTA RICA,0,TOTALS,COSTA RICA,200,20,57,35.1,19,51,37.3,1,6,16.7,20,32,62.5,16,21,37,10,29,25,12,4,61,0
12770,297896,347_12_02,CUBA,0,TOTALS,CUBA,200,25,65,38.5,19,51,37.3,6,14,42.9,12,20,60.0,12,33,45,12,20,23,14,7,68,0
12771,297909,347_12_02,BAHAMAS,0,TOTALS,BAHAMAS,200,33,68,48.5,30,59,50.8,3,9,33.3,12,24,50.0,12,31,43,15,14,20,11,6,81,1
12772,297922,347_12_03,MEXICO,0,TOTALS,MEXICO,200,24,69,34.8,20,48,41.7,4,21,19.0,23,42,54.8,20,31,51,12,23,15,12,5,75,1
12773,297934,347_12_03,VIRGIN ISLANDS,0,TOTALS,VIRGIN ISLANDS,200,25,75,33.3,20,50,40.0,5,25,20.0,12,18,66.7,20,35,55,12,29,19,6,5,67,0
12774,297947,347_12_04,PUERTO RICO,0,TOTALS,PUERTO RICO,200,37,70,52.9,26,42,61.9,11,28,39.3,7,12,58.3,12,29,41,28,19,12,8,7,92,1
12775,297959,347_12_04,PANAMA,0,TOTALS,PANAMA,200,22,63,34.9,18,49,36.7,4,14,28.6,12,16,75.0,12,24,36,10,15,17,6,5,60,0
12776,297972,347_12_05,VIRGIN ISLANDS,0,TOTALS,VIRGIN ISLANDS,200,25,83,30.1,20,63,31.7,5,20,25.0,9,13,69.2,22,24,46,10,21,10,7,4,64,0
12777,297985,347_12_05,JAMAICA,0,TOTALS,JAMAICA,200,26,60,43.3,21,47,44.7,5,13,38.5,23,28,82.1,13,37,50,9,14,15,5,4,80,1
12778,297998,347_12_06,NICARAGUA,0,TOTALS,NICARAGUA,200,17,63,27.0,12,41,29.3,5,22,22.7,8,12,66.7,9,29,38,12,21,17,6,2,47,0
12779,298011,347_12_06,CUBA,0,TOTALS,CUBA,200,27,60,45.0,18,40,45.0,9,20,45.0,17,25,68.0,9,39,48,19,10,13,9,1,80,1
12780,298024,347_12_07,DOMINICAN REPUBLIC,0,TOTALS,DOMINICAN REPUBLIC,200,30,60,50.0,24,42,57.1,6,18,33.3,19,29,65.5,12,36,48,18,15,13,5,4,85,1
12781,298037,347_12_07,MEXICO,0,TOTALS,MEXICO,200,26,68,38.2,16,38,42.1,10,30,33.3,5,7,71.4,7,20,27,14,25,14,7,1,67,0
12782,298050,347_12_08,BAHAMAS,0,TOTALS,BAHAMAS,200,26,72,36.1,25,55,45.5,1,17,5.9,18,35,51.4,19,24,43,10,24,18,8,3,71,0
12783,298063,347_12_08,PUERTO RICO,0,TOTALS,PUERTO RICO,200,29,63,46.0,22,38,57.9,7,25,28.0,23,33,69.7,13,33,46,24,26,17,9,3,88,1
12784,298076,347_12_09,COSTA RICA,0,TOTALS,COSTA RICA,200,22,60,36.7,17,44,38.6,5,16,31.2,15,28,53.6,6,23,29,10,19,11,11,0,64,0
12785,298089,347_12_09,VIRGIN ISLANDS,0,TOTALS,VIRGIN ISLANDS,200,35,67,52.2,31,52,59.6,4,15,26.7,18,23,78.3,12,37,49,21,21,17,7,1,92,1
12786,298101,347_12_10,PANAMA,0,TOTALS,PANAMA,200,26,57,45.6,21,40,52.5,5,17,29.4,21,30,70.0,13,38,51,11,16,15,3,1,78,1
12787,298114,347_12_10,BAHAMAS,0,TOTALS,BAHAMAS,200,26,78,33.3,18,49,36.7,8,29,27.6,10,18,55.6,18,24,42,15,25,6,9,1,70,0
12788,298127,347_12_11,JAMAICA,0,TOTALS,JAMAICA,200,26,63,41.3,23,49,46.9,3,14,21.4,9,14,64.3,8,22,30,7,16,10,5,4,64,0
12789,298140,347_12_11,DOMINICAN REPUBLIC,0,TOTALS,DOMINICAN REPUBLIC,200,29,61,47.5,19,40,47.5,10,21,47.6,12,17,70.6,14,29,43,17,17,13,4,5,80,1
12790,298153,347_12_12,PUERTO RICO,0,TOTALS,PUERTO RICO,200,38,71,53.5,26,40,65.0,12,31,38.7,19,25,76.0,13,31,44,26,11,16,12,1,107,0
12791,298166,347_12_12,NICARAGUA,0,TOTALS,NICARAGUA,200,27,63,42.9,21,40,52.5,6,23,26.1,7,14,50.0,8,24,32,9,19,16,8,0,67,1
12792,298179,347_12_13,NICARAGUA,0,TOTALS,NICARAGUA,200,22,71,31.0,18,52,34.6,4,19,21.1,12,16,75.0,18,21,39,10,27,17,7,7,60,0
12793,298191,347_12_13,PANAMA,0,TOTALS,PANAMA,200,32,65,49.2,25,47,53.2,7,18,38.9,22,33,66.7,14,32,46,12,14,13,8,5,93,1
12794,298204,347_12_14,MEXICO,0,TOTALS,MEXICO,200,30,68,44.1,22,41,53.7,8,27,29.6,6,17,35.3,16,24,40,19,26,14,10,4,74,0
12795,298217,347_12_14,JAMAICA,0,TOTALS,JAMAICA,200,25,61,41.0,20,41,48.8,5,20,25.0,21,28,75.0,12,27,39,15,18,19,5,5,76,1
12796,298230,347_12_15,DOMINICAN REPUBLIC,0,TOTALS,DOMINICAN REPUBLIC,200,26,57,45.6,24,46,52.2,2,11,18.2,15,17,88.2,9,37,46,18,15,18,8,7,69,1
12797,298243,347_12_15,COSTA RICA,0,TOTALS,COSTA RICA,200,21,67,31.3,18,62,29.0,3,5,60.0,6,8,75.0,10,22,32,13,16,14,11,5,51,0
12798,298256,347_12_16,CUBA,0,TOTALS,CUBA,200,26,69,37.7,22,47,46.8,4,22,18.2,5,12,41.7,12,27,39,18,17,14,5,3,61,0
12799,298269,347_12_16,PUERTO RICO,0,TOTALS,PUERTO RICO,200,39,74,52.7,33,54,61.1,6,20,30.0,11,19,57.9,14,34,48,26,11,8,10,6,95,1
12800,298282,347_12_17,BAHAMAS,0,TOTALS,BAHAMAS,200,46,99,46.5,40,76,52.6,6,23,26.1,18,25,72.0,17,31,48,15,18,10,20,3,116,0
12801,298295,347_12_17,NICARAGUA,0,TOTALS,NICARAGUA,200,23,58,39.7,18,42,42.9,5,16,31.2,11,25,44.0,9,38,47,13,21,29,9,4,62,1
12802,298307,347_12_18,PANAMA,0,TOTALS,PANAMA,200,36,60,60.0,31,52,59.6,5,8,62.5,17,21,81.0,11,28,39,5,21,17,7,1,94,1
12803,298320,347_12_18,CUBA,0,TOTALS,CUBA,200,23,54,42.6,18,43,41.9,5,11,45.5,15,22,68.2,6,14,20,9,20,13,9,1,66,0
12804,298333,347_12_19,COSTA RICA,0,TOTALS,COSTA RICA,200,22,52,42.3,20,44,45.5,2,8,25.0,16,25,64.0,12,27,39,14,27,33,11,1,62,0
12805,298346,347_12_19,MEXICO,0,TOTALS,MEXICO,200,33,64,51.6,27,40,67.5,6,24,25.0,17,21,81.0,6,22,28,15,22,21,16,3,89,1
12806,298359,347_12_20,VIRGIN ISLANDS,0,TOTALS,VIRGIN ISLANDS,200,27,63,42.9,24,50,48.0,3,13,23.1,16,19,84.2,10,31,41,10,19,15,2,3,73,0
12807,298372,347_12_20,DOMINICAN REPUBLIC,0,TOTALS,DOMINICAN REPUBLIC,200,29,74,39.2,23,53,43.4,6,21,28.6,14,18,77.8,18,26,44,17,20,9,7,4,78,1
12808,298385,347_12_21,DOMINICAN REPUBLIC,0,TOTALS,DOMINICAN REPUBLIC,200,28,62,45.2,19,43,44.2,9,19,47.4,14,21,66.7,14,28,42,14,14,9,2,2,79,1
12809,298397,347_12_21,PANAMA,0,TOTALS,PANAMA,200,23,58,39.7,20,44,45.5,3,14,21.4,13,16,81.2,10,25,35,4,17,9,4,2,62,0
12810,298410,347_12_22,PUERTO RICO,0,TOTALS,PUERTO RICO,200,40,80,50.0,30,57,52.6,10,23,43.5,13,22,59.1,21,22,43,26,23,6,4,0,103,0
12811,298423,347_12_22,JAMAICA,0,TOTALS,JAMAICA,200,30,62,48.4,24,48,50.0,6,14,42.9,23,29,79.3,10,25,35,7,22,9,4,1,89,1
12812,298435,347_12_23,PANAMA,0,TOTALS,PANAMA,200,22,70,31.4,17,52,32.7,5,18,27.8,5,7,71.4,12,23,35,9,17,12,3,2,54,0
12813,298448,347_12_23,JAMAICA,0,TOTALS,JAMAICA,200,29,62,46.8,25,45,55.6,4,17,23.5,16,20,80.0,12,38,50,18,12,10,7,5,78,1
12814,298461,347_12_24,DOMINICAN REPUBLIC,0,TOTALS,DOMINICAN REPUBLIC,200,23,57,40.4,16,36,44.4,7,21,33.3,27,35,77.1,8,33,41,7,15,12,5,5,80,1
12815,298474,347_12_24,PUERTO RICO,0,TOTALS,PUERTO RICO,200,28,73,38.4,24,55,43.6,4,18,22.2,12,16,75.0,13,27,40,13,26,9,3,3,72,0
12816,298955,349_12_01,USA,0,TOTALS,USA,200,35,59,59.3,32,48,66.7,3,11,27.3,32,56,57.1,17,47,64,26,20,21,5,5,105,0
12817,298968,349_12_01,VIRGIN ISLANDS,0,TOTALS,VIRGIN ISLANDS,200,11,71,15.5,7,39,17.9,4,32,12.5,16,24,66.7,14,16,30,7,38,16,10,3,42,1
12818,298981,349_12_02,CANADA,0,TOTALS,CANADA,200,31,76,40.8,28,57,49.1,3,19,15.8,12,23,52.2,19,44,63,18,24,20,7,3,77,1
12819,298994,349_12_02,PUERTO RICO,0,TOTALS,PUERTO RICO,200,16,69,23.2,11,42,26.2,5,27,18.5,14,22,63.6,9,26,35,10,21,14,10,1,51,0
12820,299007,349_12_03,BRAZIL,0,TOTALS,BRAZIL,200,26,73,35.6,21,50,42.0,5,23,21.7,22,28,78.6,26,34,60,8,17,17,4,2,79,1
12821,299020,349_12_03,MEXICO,0,TOTALS,MEXICO,200,23,61,37.7,18,38,47.4,5,23,21.7,18,25,72.0,6,22,28,6,22,10,9,0,69,0
12822,299033,349_12_04,ARGENTINA,0,TOTALS,ARGENTINA,200,31,73,42.5,28,58,48.3,3,15,20.0,15,21,71.4,18,30,48,19,16,18,19,2,80,1
12823,299046,349_12_04,COLOMBIA,0,TOTALS,COLOMBIA,200,19,56,33.9,18,47,38.3,1,9,11.1,6,18,33.3,15,24,39,5,20,31,8,8,45,0
12824,299059,349_12_05,MEXICO,0,TOTALS,MEXICO,200,21,63,33.3,19,46,41.3,2,17,11.8,15,32,46.9,13,25,38,10,24,25,5,2,59,1
12825,299072,349_12_05,USA,0,TOTALS,USA,200,43,80,53.8,39,57,68.4,4,23,17.4,20,37,54.1,14,36,50,20,23,17,12,3,110,0
12826,299085,349_12_06,PUERTO RICO,0,TOTALS,PUERTO RICO,200,24,65,36.9,18,41,43.9,6,24,25.0,11,25,44.0,13,23,36,11,23,16,11,2,65,0
12827,299098,349_12_06,ARGENTINA,0,TOTALS,ARGENTINA,200,28,57,49.1,25,41,61.0,3,16,18.8,17,29,58.6,9,30,39,19,24,20,8,6,76,1
12828,299111,349_12_07,VIRGIN ISLANDS,0,TOTALS,VIRGIN ISLANDS,200,24,66,36.4,18,43,41.9,6,23,26.1,11,19,57.9,19,14,33,7,17,13,10,3,65,0
12829,299124,349_12_07,BRAZIL,0,TOTALS,BRAZIL,200,29,60,48.3,18,39,46.2,11,21,52.4,15,21,71.4,17,24,41,20,16,19,4,5,84,1
12830,299137,349_12_08,COLOMBIA,0,TOTALS,COLOMBIA,200,27,70,38.6,24,53,45.3,3,17,17.6,10,22,45.5,13,27,40,12,23,21,7,8,67,0
12831,299150,349_12_08,CANADA,0,TOTALS,CANADA,200,35,80,43.8,31,64,48.4,4,16,25.0,24,34,70.6,21,38,59,17,20,12,12,4,98,1
12832,299163,349_12_09,VIRGIN ISLANDS,0,TOTALS,VIRGIN ISLANDS,200,22,70,31.4,19,52,36.5,3,18,16.7,34,49,69.4,17,34,51,8,24,14,9,2,81,1
12833,299176,349_12_09,MEXICO,0,TOTALS,MEXICO,200,28,67,41.8,24,53,45.3,4,14,28.6,19,36,52.8,13,33,46,9,31,19,8,5,79,0
12834,299189,349_12_10,CANADA,0,TOTALS,CANADA,200,27,64,42.2,20,41,48.8,7,23,30.4,14,22,63.6,11,26,37,8,20,6,2,3,75,1
12835,299202,349_12_10,ARGENTINA,0,TOTALS,ARGENTINA,200,25,61,41.0,19,42,45.2,6,19,31.6,12,14,85.7,8,26,34,14,20,11,3,0,68,0
12836,299215,349_12_11,BRAZIL,0,TOTALS,BRAZIL,200,25,72,34.7,21,53,39.6,4,19,21.1,10,17,58.8,20,19,39,15,21,16,5,3,64,0
12837,299228,349_12_11,USA,0,TOTALS,USA,200,33,66,50.0,28,48,58.3,5,18,27.8,12,21,57.1,13,30,43,15,19,13,9,5,83,1
12838,299241,349_12_12,COLOMBIA,0,TOTALS,COLOMBIA,200,27,74,36.5,25,57,43.9,2,17,11.8,16,29,55.2,28,30,58,11,16,13,5,6,72,1
12839,299254,349_12_12,PUERTO RICO,0,TOTALS,PUERTO RICO,200,24,65,36.9,19,43,44.2,5,22,22.7,12,19,63.2,14,23,37,12,21,10,8,2,65,0
12840,299267,349_12_13,VIRGIN ISLANDS,0,TOTALS,VIRGIN ISLANDS,200,26,71,36.6,21,57,36.8,5,14,35.7,11,19,57.9,17,21,38,15,18,10,13,6,68,0
12841,299280,349_12_13,PUERTO RICO,0,TOTALS,PUERTO RICO,200,24,64,37.5,17,42,40.5,7,22,31.8,16,21,76.2,16,30,46,18,16,18,4,7,71,1
12842,299293,349_12_14,COLOMBIA,0,TOTALS,COLOMBIA,200,29,74,39.2,23,51,45.1,6,23,26.1,18,31,58.1,20,29,49,17,17,12,6,4,82,0
12843,299306,349_12_14,MEXICO,0,TOTALS,MEXICO,200,32,69,46.4,28,56,50.0,4,13,30.8,17,24,70.8,14,30,44,5,18,16,6,1,85,1
12844,299319,349_12_15,USA,0,TOTALS,USA,200,40,73,54.8,35,55,63.6,5,18,27.8,22,33,66.7,17,27,44,17,17,12,12,3,107,0
12845,299332,349_12_15,ARGENTINA,0,TOTALS,ARGENTINA,200,28,60,46.7,25,45,55.6,3,15,20.0,13,20,65.0,7,20,27,17,28,20,4,0,72,1
12846,299345,349_12_16,CANADA,0,TOTALS,CANADA,200,20,63,31.7,10,34,29.4,10,29,34.5,12,15,80.0,12,32,44,6,19,14,7,6,62,0
12847,299358,349_12_16,BRAZIL,0,TOTALS,BRAZIL,200,23,63,36.5,16,42,38.1,7,21,33.3,13,17,76.5,10,31,41,10,14,11,7,2,66,1
12848,299371,349_12_17,VIRGIN ISLANDS,0,TOTALS,VIRGIN ISLANDS,200,26,69,37.7,21,52,40.4,5,17,29.4,20,29,69.0,16,30,46,18,23,19,13,10,77,1
12849,299384,349_12_17,COLOMBIA,0,TOTALS,COLOMBIA,200,18,59,30.5,17,42,40.5,1,17,5.9,15,29,51.7,20,26,46,6,25,26,6,6,52,0
12850,299397,349_12_18,PUERTO RICO,0,TOTALS,PUERTO RICO,200,30,77,39.0,26,45,57.8,4,32,12.5,9,20,45.0,12,28,40,18,31,11,8,3,73,0
12851,299410,349_12_18,MEXICO,0,TOTALS,MEXICO,200,22,61,36.1,20,49,40.8,2,12,16.7,29,40,72.5,16,34,50,5,16,19,4,0,75,1
12852,299423,349_12_19,ARGENTINA,0,TOTALS,ARGENTINA,200,25,60,41.7,22,45,48.9,3,15,20.0,13,24,54.2,11,26,37,12,25,17,8,1,66,0
12853,299436,349_12_19,CANADA,0,TOTALS,CANADA,200,25,62,40.3,19,46,41.3,6,16,37.5,12,24,50.0,16,29,45,12,22,17,7,4,68,1
12854,299449,349_12_20,USA,0,TOTALS,USA,200,30,69,43.5,26,57,45.6,4,12,33.3,17,27,63.0,21,23,44,9,20,18,18,3,81,1
12855,299462,349_12_20,BRAZIL,0,TOTALS,BRAZIL,200,19,51,37.3,13,36,36.1,6,15,40.0,12,27,44.4,14,24,38,9,27,26,4,7,56,0
12856,299954,351_12_01,VENEZUELA,0,TOTALS,VENEZUELA,200,32,71,45.1,28,62,45.2,4,9,44.4,23,39,59.0,19,32,51,11,17,22,20,3,91,1
12857,299967,351_12_01,PARAGUAY,0,TOTALS,PARAGUAY,200,22,72,30.6,19,43,44.2,3,29,10.3,9,14,64.3,12,25,37,6,26,30,14,2,56,0
12858,299979,351_12_02,CHILE,0,TOTALS,CHILE,200,9,51,17.6,7,25,28.0,2,26,7.7,5,15,33.3,4,17,21,5,16,14,12,3,25,0
12859,299992,351_12_02,ARGENTINA,0,TOTALS,ARGENTINA,200,29,67,43.3,29,60,48.3,0,7,0.0,13,26,50.0,25,44,69,18,17,23,9,7,71,1
12860,300005,351_12_03,BRAZIL,0,TOTALS,BRAZIL,225,35,87,40.2,29,68,42.6,6,19,31.6,13,28,46.4,31,31,62,11,22,34,15,4,89,1
12861,300015,351_12_03,COLOMBIA,0,TOTALS,COLOMBIA,225,30,73,41.1,27,62,43.5,3,11,27.3,22,30,73.3,13,24,37,11,22,29,23,1,85,0
12862,300028,351_12_04,URUGUAY,0,TOTALS,URUGUAY,200,22,84,26.2,18,63,28.6,4,21,19.0,13,22,59.1,31,28,59,12,12,14,10,3,61,1
12863,300041,351_12_04,PERU,0,TOTALS,PERU,200,12,52,23.1,11,43,25.6,1,9,11.1,8,16,50.0,9,27,36,10,17,22,7,4,33,0
12864,300053,351_12_05,VENEZUELA,0,TOTALS,VENEZUELA,200,23,71,32.4,22,59,37.3,1,12,8.3,15,28,53.6,16,29,45,9,26,14,11,2,62,0
12865,300063,351_12_05,CHILE,0,TOTALS,CHILE,200,25,56,44.6,17,28,60.7,8,28,28.6,7,24,29.2,12,38,50,14,27,23,8,5,65,1
12866,300074,351_12_06,ARGENTINA,0,TOTALS,ARGENTINA,200,39,62,62.9,36,52,69.2,3,10,30.0,15,33,45.5,17,37,54,27,14,26,17,2,96,1
12867,300087,351_12_06,PARAGUAY,0,TOTALS,PARAGUAY,200,11,53,20.8,10,32,31.2,1,21,4.8,6,15,40.0,7,14,21,2,25,32,18,3,29,0
12868,300100,351_12_07,BRAZIL,0,TOTALS,BRAZIL,200,28,83,33.7,24,65,36.9,4,18,22.2,4,11,36.4,30,35,65,14,10,18,14,1,64,1
12869,300113,351_12_07,PERU,0,TOTALS,PERU,200,9,53,17.0,7,32,21.9,2,21,9.5,2,7,28.6,5,24,29,2,7,19,9,3,22,0
12870,300126,351_12_08,URUGUAY,0,TOTALS,URUGUAY,200,27,69,39.1,20,44,45.5,7,25,28.0,17,26,65.4,21,30,51,20,14,12,8,5,78,1
12871,300136,351_12_08,COLOMBIA,0,TOTALS,COLOMBIA,200,22,64,34.4,18,45,40.0,4,19,21.1,5,14,35.7,15,22,37,11,17,15,7,3,53,0
12872,300146,351_12_09,CHILE,0,TOTALS,CHILE,200,26,52,50.0,23,38,60.5,3,14,21.4,7,16,43.8,9,26,35,19,12,20,0,0,62,1
12873,300156,351_12_09,PARAGUAY,0,TOTALS,PARAGUAY,200,20,57,35.1,15,29,51.7,5,28,17.9,8,11,72.7,9,18,27,12,20,18,0,4,53,0
12874,300168,351_12_10,ARGENTINA,0,TOTALS,ARGENTINA,200,27,66,40.9,24,53,45.3,3,13,23.1,17,28,60.7,19,37,56,10,25,19,3,2,74,1
12875,300181,351_12_10,VENEZUELA,0,TOTALS,VENEZUELA,200,17,53,32.1,15,40,37.5,2,13,15.4,9,32,28.1,7,22,29,8,22,17,6,5,45,0
12876,300193,351_12_11,PERU,0,TOTALS,PERU,200,14,79,17.7,8,42,19.0,6,37,16.2,5,8,62.5,14,23,37,10,15,14,11,6,39,0
12877,300205,351_12_11,COLOMBIA,0,TOTALS,COLOMBIA,200,26,66,39.4,20,52,38.5,6,14,42.9,4,14,28.6,17,41,58,21,10,27,5,9,62,1
12878,300215,351_12_12,URUGUAY,0,TOTALS,URUGUAY,200,18,57,31.6,14,35,40.0,4,22,18.2,27,40,67.5,14,30,44,12,16,13,13,6,67,1
12879,300226,351_12_12,BRAZIL,0,TOTALS,BRAZIL,200,20,64,31.2,19,56,33.9,1,8,12.5,5,14,35.7,12,27,39,5,28,20,7,5,46,0
12880,300238,351_12_13,COLOMBIA,0,TOTALS,COLOMBIA,200,30,59,50.8,28,49,57.1,2,10,20.0,16,29,55.2,15,30,45,11,17,23,11,2,78,1
12881,300251,351_12_13,PARAGUAY,0,TOTALS,PARAGUAY,200,20,64,31.2,7,28,25.0,13,36,36.1,7,14,50.0,13,13,26,9,22,20,13,5,60,0
12882,300264,351_12_14,VENEZUELA,0,TOTALS,VENEZUELA,200,31,77,40.3,21,50,42.0,10,27,37.0,8,16,50.0,18,28,46,22,15,18,21,6,80,1
12883,300277,351_12_14,PERU,0,TOTALS,PERU,200,18,60,30.0,16,47,34.0,2,13,15.4,7,12,58.3,15,27,42,12,16,35,11,2,45,0
12884,300289,351_12_15,PARAGUAY,0,TOTALS,PARAGUAY,200,22,70,31.4,19,45,42.2,3,25,12.0,10,20,50.0,15,23,38,17,24,17,23,5,57,1
12885,300301,351_12_15,PERU,0,TOTALS,PERU,200,17,60,28.3,16,45,35.6,1,15,6.7,14,30,46.7,22,37,59,15,17,30,5,0,49,0
12886,300310,351_12_16,COLOMBIA,0,TOTALS,COLOMBIA,200,25,63,39.7,23,53,43.4,2,10,20.0,9,15,60.0,12,35,47,4,21,21,5,11,61,0
12887,300321,351_12_16,VENEZUELA,0,TOTALS,VENEZUELA,200,24,78,30.8,21,61,34.4,3,17,17.6,15,29,51.7,21,22,43,8,11,11,9,7,66,1
12888,300333,351_12_17,ARGENTINA,0,TOTALS,ARGENTINA,200,32,78,41.0,27,60,45.0,5,18,27.8,4,13,30.8,22,26,48,20,12,17,24,4,73,1
12889,300346,351_12_17,BRAZIL,0,TOTALS,BRAZIL,200,13,52,25.0,12,44,27.3,1,8,12.5,3,4,75.0,10,24,34,7,20,32,8,3,30,0
12890,300359,351_12_18,URUGUAY,0,TOTALS,URUGUAY,200,23,67,34.3,20,51,39.2,3,16,18.8,12,16,75.0,16,24,40,10,18,8,14,2,61,1
12891,300372,351_12_18,CHILE,0,TOTALS,CHILE,200,11,38,28.9,8,25,32.0,3,13,23.1,10,22,45.5,6,28,34,7,11,20,5,6,35,0
12892,300382,351_12_19,CHILE,0,TOTALS,CHILE,200,20,49,40.8,10,22,45.5,10,27,37.0,14,29,48.3,12,26,38,10,16,15,6,4,64,1
12893,300392,351_12_19,BRAZIL,0,TOTALS,BRAZIL,200,24,70,34.3,22,63,34.9,2,7,28.6,11,19,57.9,22,22,44,14,27,13,9,2,61,0
12894,300403,351_12_20,URUGUAY,0,TOTALS,URUGUAY,200,13,49,26.5,10,36,27.8,3,13,23.1,15,26,57.7,8,27,35,11,14,15,5,6,44,0
12895,300415,351_12_20,ARGENTINA,0,TOTALS,ARGENTINA,200,26,67,38.8,21,48,43.8,5,19,26.3,6,12,50.0,13,29,42,17,19,7,7,6,63,1
12896,300799,353_12_01,COSTA RICA,0,TOTALS,COSTA RICA,200,14,62,22.6,13,55,23.6,1,7,14.3,6,20,30.0,22,21,43,6,23,35,26,6,35,0
12897,300811,353_12_01,GUATEMALA,0,TOTALS,GUATEMALA,200,23,63,36.5,21,53,39.6,2,10,20.0,10,28,35.7,14,28,42,15,20,34,17,3,58,1
12898,300824,353_12_02,PUERTO RICO,0,TOTALS,PUERTO RICO,200,45,91,49.5,42,77,54.5,3,14,21.4,10,20,50.0,29,33,62,20,10,24,17,10,103,0
12899,300834,353_12_02,BARBADOS,0,TOTALS,BARBADOS,200,11,61,18.0,10,42,23.8,1,19,5.3,10,18,55.6,6,13,19,3,18,25,11,3,33,1
12900,300847,353_12_03,CAYMAN ISLANDS,0,TOTALS,CAYMAN ISLANDS,200,9,34,26.5,6,23,26.1,3,11,27.3,6,12,50.0,8,22,30,2,22,63,7,2,27,1
12901,300860,353_12_03,MEXICO,0,TOTALS,MEXICO,200,54,97,55.7,50,86,58.1,4,11,36.4,15,36,41.7,23,17,40,21,14,16,50,2,127,0
12902,300867,353_12_04,EL SALVADOR,0,TOTALS,EL SALVADOR,200,17,62,27.4,14,54,25.9,3,8,37.5,26,48,54.2,9,22,31,3,13,24,11,6,63,0
12903,300880,353_12_04,BAHAMAS,0,TOTALS,BAHAMAS,200,32,93,34.4,27,72,37.5,5,21,23.8,4,15,26.7,33,26,59,7,34,27,18,9,73,1
12904,300891,353_12_05,BARBADOS,0,TOTALS,BARBADOS,200,18,74,24.3,13,53,24.5,5,21,23.8,10,22,45.5,14,28,42,7,25,42,4,6,51,0
12905,300904,353_12_05,COSTA RICA,0,TOTALS,COSTA RICA,200,30,81,37.0,28,71,39.4,2,10,20.0,17,32,53.1,20,36,56,16,19,30,18,2,79,1
12906,300916,353_12_06,GUATEMALA,0,TOTALS,GUATEMALA,200,9,53,17.0,8,45,17.8,1,8,12.5,7,19,36.8,6,30,36,3,19,32,12,1,26,0
12907,300928,353_12_06,PUERTO RICO,0,TOTALS,PUERTO RICO,200,31,85,36.5,28,73,38.4,3,12,25.0,7,19,36.8,21,32,53,17,18,27,16,9,72,1
12908,300941,353_12_07,CAYMAN ISLANDS,0,TOTALS,CAYMAN ISLANDS,200,7,51,13.7,7,45,15.6,0,6,0.0,4,11,36.4,7,23,30,3,23,49,7,4,18,1
12909,300954,353_12_07,EL SALVADOR,0,TOTALS,EL SALVADOR,200,46,115,40.0,46,110,41.8,0,5,0.0,16,31,51.6,41,33,74,16,16,21,35,4,108,0
12910,300965,353_12_08,MEXICO,0,TOTALS,MEXICO,200,28,67,41.8,25,55,45.5,3,12,25.0,15,28,53.6,12,23,35,8,10,25,19,5,74,1
12911,300977,353_12_08,BAHAMAS,0,TOTALS,BAHAMAS,200,29,73,39.7,26,55,47.3,3,18,16.7,5,12,41.7,18,23,41,9,25,36,7,4,66,0
12912,300988,353_12_09,COSTA RICA,0,TOTALS,COSTA RICA,200,14,63,22.2,14,57,24.6,0,6,0.0,8,19,42.1,5,24,29,10,18,31,10,5,36,0
12913,301001,353_12_09,PUERTO RICO,0,TOTALS,PUERTO RICO,200,36,78,46.2,35,69,50.7,1,9,11.1,13,22,59.1,18,37,55,25,12,24,9,8,86,1
12914,301012,353_12_10,BARBADOS,0,TOTALS,BARBADOS,200,21,73,28.8,19,60,31.7,2,13,15.4,11,25,44.0,19,28,47,8,15,21,3,0,55,0
12915,301024,353_12_10,GUATEMALA,0,TOTALS,GUATEMALA,200,39,82,47.6,35,69,50.7,4,13,30.8,6,16,37.5,21,32,53,22,22,13,12,1,88,1
12916,301037,353_12_11,BAHAMAS,0,TOTALS,BAHAMAS,200,49,104,47.1,48,91,52.7,1,13,7.7,6,18,33.3,39,29,68,30,18,18,22,1,105,0
12917,301050,353_12_11,CAYMAN ISLANDS,0,TOTALS,CAYMAN ISLANDS,200,10,44,22.7,6,31,19.4,4,13,30.8,12,19,63.2,3,12,15,8,16,33,3,2,36,1
12918,301061,353_12_12,EL SALVADOR,0,TOTALS,EL SALVADOR,200,23,67,34.3,23,60,38.3,0,7,0.0,8,22,36.4,18,23,41,13,17,33,8,2,54,0
12919,301074,353_12_12,MEXICO,0,TOTALS,MEXICO,200,31,92,33.7,27,78,34.6,4,14,28.6,10,18,55.6,27,25,52,14,22,24,15,4,76,1
12920,301087,353_12_13,COSTA RICA,0,TOTALS,COSTA RICA,200,30,88,34.1,29,80,36.2,1,8,12.5,12,22,54.5,25,23,48,19,17,16,26,8,73,1
12921,301100,353_12_13,CAYMAN ISLANDS,0,TOTALS,CAYMAN ISLANDS,200,8,52,15.4,6,42,14.3,2,10,20.0,3,16,18.8,16,31,47,3,17,42,9,3,21,0
12922,301113,353_12_14,EL SALVADOR,0,TOTALS,EL SALVADOR,200,38,94,40.4,36,88,40.9,2,6,33.3,8,23,34.8,23,42,65,23,24,23,16,9,86,1
12923,301123,353_12_14,BARBADOS,0,TOTALS,BARBADOS,200,18,87,20.7,15,70,21.4,3,17,17.6,13,30,43.3,23,33,56,6,19,24,14,5,52,0
12924,301136,353_12_15,MEXICO,0,TOTALS,MEXICO,200,30,74,40.5,27,65,41.5,3,9,33.3,12,30,40.0,18,23,41,16,17,25,26,7,75,1
12925,301149,353_12_15,GUATEMALA,0,TOTALS,GUATEMALA,200,18,55,32.7,16,44,36.4,2,11,18.2,10,16,62.5,8,23,31,13,22,44,13,3,48,0
12926,301162,353_12_16,PUERTO RICO,0,TOTALS,PUERTO RICO,200,30,67,44.8,21,43,48.8,9,24,37.5,9,18,50.0,10,20,30,21,7,10,8,7,78,1
12927,301175,353_12_16,BAHAMAS,0,TOTALS,BAHAMAS,200,24,65,36.9,20,48,41.7,4,17,23.5,3,8,37.5,12,26,38,11,19,21,7,2,55,0
12928,301186,353_12_17,CAYMAN ISLANDS,0,TOTALS,CAYMAN ISLANDS,200,21,88,23.9,20,79,25.3,1,9,11.1,6,16,37.5,25,34,59,7,21,25,9,6,49,0
12929,301196,353_12_17,BARBADOS,0,TOTALS,BARBADOS,200,24,93,25.8,23,86,26.7,1,7,14.3,15,25,60.0,26,35,61,10,11,19,11,5,64,1
12930,301207,353_12_18,COSTA RICA,0,TOTALS,COSTA RICA,200,28,75,37.3,26,63,41.3,2,12,16.7,9,18,50.0,16,14,30,12,24,23,12,12,67,0
12931,301220,353_12_18,EL SALVADOR,0,TOTALS,EL SALVADOR,200,32,72,44.4,31,69,44.9,1,3,33.3,19,30,63.3,13,28,41,18,18,24,13,7,84,1
12932,301233,353_12_19,GUATEMALA,0,TOTALS,GUATEMALA,200,17,53,32.1,16,44,36.4,1,9,11.1,12,21,57.1,6,32,38,11,23,27,11,2,47,0
12933,301246,353_12_19,BAHAMAS,0,TOTALS,BAHAMAS,200,24,85,28.2,23,70,32.9,1,15,6.7,14,31,45.2,31,21,52,9,15,24,10,7,63,1
12934,301259,353_12_20,MEXICO,0,TOTALS,MEXICO,200,19,65,29.2,17,52,32.7,2,13,15.4,21,33,63.6,16,17,33,8,16,17,7,6,61,0
12935,301272,353_12_20,PUERTO RICO,0,TOTALS,PUERTO RICO,200,32,66,48.5,24,50,48.0,8,16,50.0,8,15,53.3,14,23,37,16,24,18,6,9,80,1
12936,301644,355_12_01,EL SALVADOR,0,TOTALS,EL SALVADOR,200,33,69,47.8,30,61,49.2,3,8,37.5,18,33,54.5,17,26,43,17,19,24,16,7,87,1
12937,301654,355_12_01,GUATEMALA,0,TOTALS,GUATEMALA,200,20,73,27.4,19,68,27.9,1,5,20.0,7,13,53.8,12,19,31,8,24,30,13,3,48,0
12938,301667,355_12_02,COSTA RICA,0,TOTALS,COSTA RICA,200,27,76,35.5,24,60,40.0,3,16,18.8,13,18,72.2,13,22,35,11,22,12,18,7,70,1
12939,301676,355_12_02,PANAMA,0,TOTALS,PANAMA,200,16,68,23.5,16,66,24.2,0,2,0.0,11,25,44.0,21,27,48,2,13,28,9,5,43,0
12940,301689,355_12_03,BELIZE,0,TOTALS,BELIZE,200,31,97,32.0,30,87,34.5,1,10,10.0,8,17,47.1,29,33,62,10,22,18,21,5,71,1
12941,301701,355_12_03,HONDURAS,0,TOTALS,HONDURAS,200,12,54,22.2,11,49,22.4,1,5,20.0,7,18,38.9,7,27,34,5,16,37,10,3,32,0
12942,301714,355_12_04,PANAMA,0,TOTALS,PANAMA,200,33,84,39.3,31,74,41.9,2,10,20.0,19,31,61.3,26,30,56,11,18,25,14,6,87,1
12943,301724,355_12_04,GUATEMALA,0,TOTALS,GUATEMALA,200,18,63,28.6,15,51,29.4,3,12,25.0,12,22,54.5,7,24,31,8,22,24,8,3,51,0
12944,301737,355_12_05,BELIZE,0,TOTALS,BELIZE,200,18,67,26.9,18,50,36.0,0,17,0.0,19,27,70.4,19,21,40,5,17,30,7,8,55,0
12945,301750,355_12_05,EL SALVADOR,0,TOTALS,EL SALVADOR,200,29,74,39.2,28,63,44.4,1,11,9.1,10,19,52.6,14,19,33,12,22,21,15,4,69,1
12946,301763,355_12_06,HONDURAS,0,TOTALS,HONDURAS,200,14,58,24.1,13,47,27.7,1,11,9.1,2,12,16.7,10,21,31,9,18,36,18,3,31,0
12947,301776,355_12_06,COSTA RICA,0,TOTALS,COSTA RICA,200,36,79,45.6,32,62,51.6,4,17,23.5,15,23,65.2,22,29,51,17,20,23,20,5,91,1
12948,301787,355_12_07,COSTA RICA,0,TOTALS,COSTA RICA,200,34,77,44.2,27,55,49.1,7,22,31.8,5,14,35.7,13,20,33,20,21,14,14,3,80,1
12949,301797,355_12_07,EL SALVADOR,0,TOTALS,EL SALVADOR,200,23,61,37.7,20,46,43.5,3,15,20.0,9,20,45.0,21,25,46,9,13,31,8,2,58,0
12950,301805,355_12_08,GUATEMALA,0,TOTALS,GUATEMALA,200,19,77,24.7,18,65,27.7,1,12,8.3,11,31,35.5,15,30,45,6,26,24,16,3,50,0
12951,301818,355_12_08,BELIZE,0,TOTALS,BELIZE,200,19,92,20.7,17,76,22.4,2,16,12.5,17,34,50.0,33,36,69,4,25,35,11,11,57,1
12952,301831,355_12_09,HONDURAS,0,TOTALS,HONDURAS,200,13,66,19.7,9,48,18.8,4,18,22.2,4,12,33.3,13,19,32,7,15,26,8,6,34,0
12953,301842,355_12_09,PANAMA,0,TOTALS,PANAMA,200,30,67,44.8,27,56,48.2,3,11,27.3,11,21,52.4,14,35,49,10,7,24,16,6,74,1
12954,301854,355_12_10,BELIZE,0,TOTALS,BELIZE,200,19,61,31.1,18,51,35.3,1,10,10.0,13,32,40.6,19,27,46,5,13,28,19,4,52,0
12955,301865,355_12_10,COSTA RICA,0,TOTALS,COSTA RICA,200,24,65,36.9,16,37,43.2,8,28,28.6,11,20,55.0,12,22,34,18,25,25,17,6,67,1
12956,301873,355_12_11,PANAMA,0,TOTALS,PANAMA,225,24,70,34.3,22,59,37.3,2,11,18.2,2,6,33.3,13,32,45,8,22,31,7,7,52,0
12957,301882,355_12_11,EL SALVADOR,0,TOTALS,EL SALVADOR,225,21,80,26.2,20,73,27.4,1,7,14.3,16,30,53.3,17,26,43,9,11,21,16,3,59,1
12958,301892,355_12_12,GUATEMALA,0,TOTALS,GUATEMALA,200,16,73,21.9,11,49,22.4,5,24,20.8,5,13,38.5,15,22,37,6,23,27,13,3,42,0
12959,301905,355_12_12,HONDURAS,0,TOTALS,HONDURAS,200,28,73,38.4,25,63,39.7,3,10,30.0,11,31,35.5,18,29,47,13,14,24,16,7,70,1
12960,301916,355_12_13,COSTA RICA,0,TOTALS,COSTA RICA,200,43,84,51.2,39,71,54.9,4,13,30.8,9,25,36.0,20,29,49,28,16,21,28,8,99,1
12961,301926,355_12_13,GUATEMALA,0,TOTALS,GUATEMALA,200,9,56,16.1,8,45,17.8,1,11,9.1,5,20,25.0,13,22,35,6,18,37,13,2,24,0
12962,301935,355_12_14,PANAMA,0,TOTALS,PANAMA,200,15,67,22.4,11,50,22.0,4,17,23.5,15,27,55.6,21,27,48,6,7,16,11,3,49,0
12963,301947,355_12_14,BELIZE,0,TOTALS,BELIZE,200,23,68,33.8,18,46,39.1,5,22,22.7,2,4,50.0,13,31,44,13,19,15,10,6,53,1
12964,301960,355_12_15,EL SALVADOR,0,TOTALS,EL SALVADOR,200,34,75,45.3,33,63,52.4,1,12,8.3,16,22,72.7,17,28,45,21,14,26,13,4,85,1
12965,301973,355_12_15,HONDURAS,0,TOTALS,HONDURAS,200,21,65,32.3,16,52,30.8,5,13,38.5,5,14,35.7,8,17,25,11,21,27,9,3,52,0
12966,302124,357_12_01,MOLDOVA,0,TOTALS,MOLDOVA,200,35,74,47.3,29,57,50.9,6,17,35.3,5,10,50.0,13,31,44,13,24,20,6,7,81,1
12967,302136,357_12_01,GIBRALTAR,0,TOTALS,GIBRALTAR,200,20,62,32.3,15,46,32.6,5,16,31.2,17,26,65.4,15,29,44,5,16,17,8,0,62,0
12968,302148,357_12_02,MALTA,0,TOTALS,MALTA,200,23,57,40.4,18,39,46.2,5,18,27.8,24,29,82.8,11,35,46,8,25,20,6,1,75,1
12969,302160,357_12_02,SCOTLAND,0,TOTALS,SCOTLAND,200,22,66,33.3,19,54,35.2,3,12,25.0,17,28,60.7,13,27,40,7,22,13,9,1,64,0
12970,302173,357_12_03,SAN MARINO,0,TOTALS,SAN MARINO,200,22,60,36.7,14,33,42.4,8,27,29.6,6,14,42.9,15,32,47,5,25,19,6,2,58,1
12971,302186,357_12_03,WALES,0,TOTALS,WALES,200,21,63,33.3,20,53,37.7,1,10,10.0,10,18,55.6,14,27,41,6,20,14,9,0,53,0
12972,302198,357_12_04,GIBRALTAR,0,TOTALS,GIBRALTAR,200,17,62,27.4,14,50,28.0,3,12,25.0,10,19,52.6,14,20,34,3,18,24,6,0,47,0
12973,302211,357_12_04,ANDORRA,0,TOTALS,ANDORRA,200,41,76,53.9,31,47,66.0,10,29,34.5,4,11,36.4,20,32,52,19,18,19,15,4,96,1
12974,302224,357_12_05,WALES,0,TOTALS,WALES,200,23,65,35.4,20,41,48.8,3,24,12.5,2,10,20.0,11,21,32,8,32,20,4,1,51,0
12975,302236,357_12_05,MALTA,0,TOTALS,MALTA,200,27,55,49.1,23,42,54.8,4,13,30.8,23,43,53.5,16,33,49,10,21,20,14,1,81,1
12976,302248,357_12_06,SCOTLAND,0,TOTALS,SCOTLAND,200,27,51,52.9,27,46,58.7,0,5,0.0,17,31,54.8,9,28,37,4,22,16,12,7,71,1
12977,302261,357_12_06,SAN MARINO,0,TOTALS,SAN MARINO,200,21,62,33.9,11,31,35.5,10,31,32.3,16,22,72.7,13,23,36,10,27,18,5,1,68,0
12978,302274,357_12_07,ANDORRA,0,TOTALS,ANDORRA,200,33,60,55.0,25,42,59.5,8,18,44.4,26,33,78.8,9,30,39,19,28,17,4,0,100,0
12979,302285,357_12_07,MOLDOVA,0,TOTALS,MOLDOVA,200,26,62,41.9,20,44,45.5,6,18,33.3,26,38,68.4,12,21,33,11,25,14,9,3,84,1
12980,302297,357_12_08,SCOTLAND,0,TOTALS,SCOTLAND,200,27,58,46.6,22,42,52.4,5,16,31.2,16,26,61.5,8,26,34,10,19,23,6,2,75,0
12981,302310,357_12_08,WALES,0,TOTALS,WALES,200,29,68,42.6,25,57,43.9,4,11,36.4,14,20,70.0,15,29,44,8,21,22,11,0,76,1
12982,302323,357_12_09,SAN MARINO,0,TOTALS,SAN MARINO,200,23,59,39.0,15,32,46.9,8,27,29.6,17,18,94.4,9,23,32,5,24,11,4,0,71,1
12983,302335,357_12_09,MALTA,0,TOTALS,MALTA,200,22,56,39.3,16,36,44.4,6,20,30.0,19,23,82.6,11,26,37,10,23,14,4,2,69,0
12984,302347,357_12_10,GIBRALTAR,0,TOTALS,GIBRALTAR,200,26,78,33.3,23,52,44.2,3,26,11.5,17,28,60.7,23,25,48,8,16,12,5,1,72,0
12985,302360,357_12_10,WALES,0,TOTALS,WALES,200,36,71,50.7,30,50,60.0,6,21,28.6,17,22,77.3,12,33,45,16,24,10,3,1,95,1
12986,302373,357_12_11,ANDORRA,0,TOTALS,ANDORRA,200,25,71,35.2,19,38,50.0,6,33,18.2,19,29,65.5,17,22,39,15,16,20,21,0,75,1
12987,302385,357_12_11,MALTA,0,TOTALS,MALTA,200,28,62,45.2,23,46,50.0,5,16,31.2,4,5,80.0,12,37,49,14,28,32,10,5,65,0
12988,302397,357_12_12,SCOTLAND,0,TOTALS,SCOTLAND,200,33,63,52.4,26,39,66.7,7,24,29.2,11,21,52.4,12,29,41,21,21,20,12,4,84,1
12989,302409,357_12_12,GIBRALTAR,0,TOTALS,GIBRALTAR,200,21,62,33.9,17,45,37.8,4,17,23.5,14,20,70.0,14,23,37,12,17,24,12,0,60,0
12990,302421,357_12_13,MALTA,0,TOTALS,MALTA,200,40,62,64.5,32,49,65.3,8,13,61.5,8,19,42.1,10,31,41,26,18,12,10,2,96,1
12991,302434,357_12_13,SAN MARINO,0,TOTALS,SAN MARINO,200,17,59,28.8,8,25,32.0,9,34,26.5,14,20,70.0,14,16,30,13,20,17,8,1,57,0
12992,302447,357_12_14,ANDORRA,0,TOTALS,ANDORRA,200,29,69,42.0,24,50,48.0,5,19,26.3,11,21,52.4,18,32,50,16,15,21,11,0,74,1
12993,302458,357_12_14,MOLDOVA,0,TOTALS,MOLDOVA,200,29,64,45.3,25,50,50.0,4,14,28.6,10,18,55.6,9,26,35,9,18,18,11,6,72,0
12994,302966,359_12_01,FRANCE,0,TOTALS,FRANCE,200,20,48,41.7,16,30,53.3,4,18,22.2,8,11,72.7,9,24,33,13,23,16,6,3,52,0
12995,302979,359_12_01,GERMANY,0,TOTALS,GERMANY,200,17,45,37.8,13,30,43.3,4,15,26.7,16,25,64.0,9,19,28,10,17,14,10,1,54,1
12996,302992,359_12_02,LITHUANIA,0,TOTALS,LITHUANIA,200,29,65,44.6,25,47,53.2,4,18,22.2,18,27,66.7,16,27,43,11,22,13,16,3,80,1
12997,303005,359_12_02,SWEDEN,0,TOTALS,SWEDEN,200,25,65,38.5,15,40,37.5,10,25,40.0,11,20,55.0,15,23,38,10,24,20,6,2,71,0
12998,303018,359_12_03,RUSSIA,0,TOTALS,RUSSIA,200,27,56,48.2,21,36,58.3,6,20,30.0,26,39,66.7,10,20,30,11,17,12,11,1,86,1
12999,303031,359_12_03,ESTONIA,0,TOTALS,ESTONIA,200,23,52,44.2,20,35,57.1,3,17,17.6,9,16,56.2,10,23,33,8,30,29,6,0,58,0
13000,303044,359_12_04,LATVIA,0,TOTALS,LATVIA,200,34,63,54.0,29,41,70.7,5,22,22.7,15,21,71.4,8,29,37,20,22,11,16,4,88,1
13001,303057,359_12_04,GEORGIA,0,TOTALS,GEORGIA,200,16,57,28.1,12,36,33.3,4,21,19.0,14,21,66.7,13,26,39,6,19,21,7,0,50,0
13002,303070,359_12_05,GREECE,0,TOTALS,GREECE,225,33,77,42.9,26,58,44.8,7,19,36.8,16,23,69.6,15,23,38,13,29,11,9,3,89,1
13003,303083,359_12_05,UKRAINE,0,TOTALS,UKRAINE,225,29,65,44.6,20,41,48.8,9,24,37.5,19,27,70.4,11,34,45,14,26,19,4,5,86,0
13004,303096,359_12_06,TURKEY,0,TOTALS,TURKEY,200,20,45,44.4,16,34,47.1,4,11,36.4,16,25,64.0,10,24,34,8,25,19,5,1,60,0
13005,303109,359_12_06,SPAIN,0,TOTALS,SPAIN,200,24,61,39.3,16,33,48.5,8,28,28.6,23,31,74.2,16,18,34,13,22,9,9,1,79,1
13006,303122,359_12_07,SERBIA,0,TOTALS,SERBIA,200,28,56,50.0,19,36,52.8,9,20,45.0,26,33,78.8,7,30,37,15,24,10,3,2,91,1
13007,303135,359_12_07,MONTENEGRO,0,TOTALS,MONTENEGRO,200,26,70,37.1,19,43,44.2,7,27,25.9,14,19,73.7,17,24,41,12,28,10,7,2,73,0
13008,303148,359_12_08,SLOVENIA,0,TOTALS,SLOVENIA,200,26,58,44.8,17,35,48.6,9,23,39.1,20,27,74.1,11,27,38,13,21,12,4,2,81,1
13009,303161,359_12_08,ITALY,0,TOTALS,ITALY,200,27,56,48.2,22,37,59.5,5,19,26.3,9,19,47.4,5,23,28,9,24,11,10,0,68,0
13010,303174,359_12_09,UKRAINE,0,TOTALS,UKRAINE,200,25,57,43.9,17,34,50.0,8,23,34.8,17,22,77.3,9,17,26,14,26,13,5,2,75,0
13011,303187,359_12_09,RUSSIA,0,TOTALS,RUSSIA,200,29,65,44.6,22,45,48.9,7,20,35.0,16,24,66.7,21,23,44,17,20,14,5,1,81,1
13012,303200,359_12_10,GEORGIA,0,TOTALS,GEORGIA,200,23,48,47.9,15,24,62.5,8,24,33.3,13,15,86.7,4,19,23,10,29,22,1,0,67,1
13013,303213,359_12_10,TURKEY,0,TOTALS,TURKEY,200,36,78,46.2,32,57,56.1,4,21,19.0,27,32,84.4,24,22,46,24,21,7,8,2,103,0
13014,303226,359_12_11,ESTONIA,0,TOTALS,ESTONIA,200,28,67,41.8,24,45,53.3,4,22,18.2,9,15,60.0,6,15,21,16,27,18,13,3,69,0
13015,303239,359_12_11,GREECE,0,TOTALS,GREECE,200,32,57,56.1,25,36,69.4,7,21,33.3,20,27,74.1,11,32,43,22,22,26,13,2,91,1
13016,303252,359_12_12,ITALY,0,TOTALS,ITALY,200,29,67,43.3,22,42,52.4,7,25,28.0,24,33,72.7,14,23,37,13,37,16,10,0,89,1
13017,303265,359_12_12,LITHUANIA,0,TOTALS,LITHUANIA,200,21,50,42.0,18,36,50.0,3,14,21.4,37,48,77.1,12,28,40,14,29,23,5,2,82,0
13018,303278,359_12_13,GERMANY,0,TOTALS,GERMANY,200,14,49,28.6,11,35,31.4,3,14,21.4,14,25,56.0,14,27,41,8,24,19,2,2,45,0
13019,303291,359_12_13,SERBIA,0,TOTALS,SERBIA,200,23,58,39.7,15,43,34.9,8,15,53.3,15,17,88.2,11,25,36,10,26,13,3,6,69,1
13020,303304,359_12_14,SPAIN,0,TOTALS,SPAIN,200,18,48,37.5,14,35,40.0,4,13,30.8,24,27,88.9,6,22,28,8,27,18,12,0,64,1
13021,303317,359_12_14,LATVIA,0,TOTALS,LATVIA,200,16,50,32.0,15,28,53.6,1,22,4.5,18,23,78.3,13,21,34,5,28,23,9,2,51,0
13022,303330,359_12_15,MONTENEGRO,0,TOTALS,MONTENEGRO,200,14,46,30.4,9,35,25.7,5,11,45.5,35,41,85.4,9,10,19,10,28,17,4,1,68,1
13023,303343,359_12_15,FRANCE,0,TOTALS,FRANCE,200,34,54,63.0,25,37,67.6,9,17,52.9,25,32,78.1,13,25,38,24,30,17,4,7,102,0
13024,303356,359_12_16,SWEDEN,0,TOTALS,SWEDEN,200,27,61,44.3,21,41,51.2,6,20,30.0,9,13,69.2,7,28,35,5,28,13,2,3,69,0
13025,303369,359_12_16,SLOVENIA,0,TOTALS,SLOVENIA,200,25,60,41.7,21,44,47.7,4,16,25.0,16,24,66.7,11,27,38,16,23,11,6,2,70,1
13026,303382,359_12_17,ESTONIA,0,TOTALS,ESTONIA,200,23,67,34.3,17,49,34.7,6,18,33.3,17,30,56.7,17,24,41,5,23,13,12,0,69,0
13027,303395,359_12_17,UKRAINE,0,TOTALS,UKRAINE,200,25,58,43.1,19,37,51.4,6,21,28.6,16,22,72.7,12,35,47,17,23,22,6,7,72,1
13028,303408,359_12_18,TURKEY,0,TOTALS,TURKEY,225,28,62,45.2,25,53,47.2,3,9,33.3,5,12,41.7,14,28,42,12,21,19,8,2,64,1
13029,303421,359_12_18,LATVIA,0,TOTALS,LATVIA,225,21,57,36.8,10,23,43.5,11,34,32.4,8,12,66.7,7,22,29,12,21,17,1,3,61,0
13030,303434,359_12_19,MONTENEGRO,0,TOTALS,MONTENEGRO,200,19,53,35.8,15,33,45.5,4,20,20.0,13,17,76.5,10,17,27,9,23,16,8,0,55,0
13031,303447,359_12_19,GERMANY,0,TOTALS,GERMANY,200,24,56,42.9,16,34,47.1,8,22,36.4,15,17,88.2,15,25,40,12,20,16,8,1,71,1
13032,303460,359_12_20,GEORGIA,0,TOTALS,GEORGIA,200,15,53,28.3,11,29,37.9,4,24,16.7,15,26,57.7,7,15,22,4,22,20,3,2,49,1
13033,303473,359_12_20,SPAIN,0,TOTALS,SPAIN,200,42,76,55.3,35,55,63.6,7,21,33.3,20,26,76.9,19,37,56,17,22,8,6,1,111,0
13034,303486,359_12_21,FRANCE,0,TOTALS,FRANCE,200,24,54,44.4,16,35,45.7,8,19,42.1,11,13,84.6,10,18,28,9,22,19,5,6,67,0
13035,303499,359_12_21,SERBIA,0,TOTALS,SERBIA,200,23,49,46.9,20,40,50.0,3,9,33.3,21,26,80.8,8,18,26,9,20,18,6,1,70,1
13036,303512,359_12_22,SWEDEN,0,TOTALS,SWEDEN,200,21,58,36.2,17,38,44.7,4,20,20.0,16,23,69.6,10,29,39,7,17,13,4,1,62,0
13037,303525,359_12_22,ITALY,0,TOTALS,ITALY,200,34,71,47.9,26,49,53.1,8,22,36.4,11,18,61.1,14,29,43,18,22,5,9,4,87,1
13038,303538,359_12_23,GREECE,0,TOTALS,GREECE,200,25,59,42.4,18,34,52.9,7,25,28.0,7,11,63.6,8,24,32,13,24,18,2,2,64,0
13039,303551,359_12_23,RUSSIA,0,TOTALS,RUSSIA,200,22,60,36.7,11,33,33.3,11,27,40.7,11,20,55.0,18,25,43,14,15,21,7,3,66,1
13040,303564,359_12_24,SLOVENIA,0,TOTALS,SLOVENIA,200,29,58,50.0,22,38,57.9,7,20,35.0,22,30,73.3,9,25,34,21,27,14,7,1,87,1
13041,303577,359_12_24,LITHUANIA,0,TOTALS,LITHUANIA,200,31,71,43.7,28,58,48.3,3,13,23.1,16,23,69.6,14,22,36,16,28,14,9,4,81,0
13042,303590,359_12_25,LITHUANIA,0,TOTALS,LITHUANIA,200,30,58,51.7,23,43,53.5,7,15,46.7,15,23,65.2,12,27,39,17,29,22,7,3,82,1
13043,303603,359_12_25,SPAIN,0,TOTALS,SPAIN,200,20,57,35.1,17,41,41.5,3,16,18.8,17,28,60.7,15,17,32,7,26,18,4,4,60,0
13044,303616,359_12_26,FRANCE,0,TOTALS,FRANCE,200,30,55,54.5,18,29,62.1,12,26,46.2,9,15,60.0,10,26,36,19,15,16,6,4,81,1
13045,303629,359_12_26,RUSSIA,0,TOTALS,RUSSIA,200,25,61,41.0,20,40,50.0,5,21,23.8,7,11,63.6,11,17,28,7,19,18,5,3,62,0
13046,303642,359_12_27,MONTENEGRO,0,TOTALS,MONTENEGRO,200,25,66,37.9,23,53,43.4,2,13,15.4,12,18,66.7,22,26,48,13,23,16,4,5,64,0
13047,303655,359_12_27,SWEDEN,0,TOTALS,SWEDEN,200,23,60,38.3,16,40,40.0,7,20,35.0,19,22,86.4,12,22,34,11,19,11,2,5,72,1
13048,303668,359_12_28,ITALY,0,TOTALS,ITALY,200,22,52,42.3,16,27,59.3,6,25,24.0,18,30,60.0,8,17,25,8,27,20,8,1,68,0
13049,303681,359_12_28,TURKEY,0,TOTALS,TURKEY,200,35,62,56.5,27,47,57.4,8,15,53.3,17,29,58.6,14,24,38,19,26,16,11,0,95,1
13050,303694,359_12_29,GREECE,0,TOTALS,GREECE,200,26,63,41.3,18,31,58.1,8,32,25.0,8,14,57.1,9,20,29,11,26,17,5,2,68,0
13051,303707,359_12_29,GERMANY,0,TOTALS,GERMANY,200,35,60,58.3,29,39,74.4,6,21,28.6,14,24,58.3,10,32,42,17,21,15,5,4,90,1
13052,303720,359_12_30,ESTONIA,0,TOTALS,ESTONIA,200,33,73,45.2,27,44,61.4,6,29,20.7,15,20,75.0,14,33,47,13,25,16,5,3,87,1
13053,303733,359_12_30,GEORGIA,0,TOTALS,GEORGIA,200,24,73,32.9,16,46,34.8,8,27,29.6,17,27,63.0,19,26,45,18,21,10,5,0,73,0
13054,303746,359_12_31,LATVIA,0,TOTALS,LATVIA,200,24,59,40.7,18,37,48.6,6,22,27.3,8,16,50.0,6,20,26,12,28,12,5,1,62,0
13055,303759,359_12_31,SLOVENIA,0,TOTALS,SLOVENIA,200,21,46,45.7,17,31,54.8,4,15,26.7,23,30,76.7,6,30,36,10,22,20,8,3,69,1
13056,303772,359_12_32,UKRAINE,0,TOTALS,UKRAINE,200,17,56,30.4,12,35,34.3,5,21,23.8,14,20,70.0,10,17,27,11,25,17,6,2,53,0
13057,303785,359_12_32,SERBIA,0,TOTALS,SERBIA,200,30,55,54.5,27,44,61.4,3,11,27.3,19,31,61.3,12,30,42,9,21,12,8,2,82,1
13058,303798,359_12_33,SPAIN,0,TOTALS,SPAIN,200,24,57,42.1,15,33,45.5,9,24,37.5,19,28,67.9,13,25,38,14,26,14,3,2,76,0
13059,303811,359_12_33,ITALY,0,TOTALS,ITALY,200,27,63,42.9,19,40,47.5,8,23,34.8,16,21,76.2,12,27,39,8,26,13,3,1,78,1
13060,303824,359_12_34,GERMANY,0,TOTALS,GERMANY,200,25,57,43.9,20,40,50.0,5,17,29.4,19,21,90.5,12,25,37,14,17,11,6,1,74,1
13061,303837,359_12_34,RUSSIA,0,TOTALS,RUSSIA,200,24,62,38.7,17,42,40.5,7,20,35.0,4,11,36.4,15,20,35,10,22,15,5,4,59,0
13062,303850,359_12_35,SWEDEN,0,TOTALS,SWEDEN,200,22,67,32.8,11,38,28.9,11,29,37.9,14,18,77.8,12,28,40,15,17,6,1,2,69,1
13063,303863,359_12_35,ESTONIA,0,TOTALS,ESTONIA,200,26,68,38.2,22,52,42.3,4,16,25.0,10,12,83.3,13,36,49,10,20,11,2,2,66,0
13064,303876,359_12_36,LITHUANIA,0,TOTALS,LITHUANIA,200,27,67,40.3,23,55,41.8,4,12,33.3,17,22,77.3,17,24,41,16,23,7,4,1,75,0
13065,303889,359_12_36,LATVIA,0,TOTALS,LATVIA,200,26,60,43.3,22,41,53.7,4,19,21.1,22,23,95.7,10,25,35,12,22,10,3,5,78,1
13066,303902,359_12_37,UKRAINE,0,TOTALS,UKRAINE,200,20,48,41.7,16,35,45.7,4,13,30.8,18,21,85.7,5,22,27,9,18,18,7,2,62,0
13067,303915,359_12_37,FRANCE,0,TOTALS,FRANCE,200,27,63,42.9,20,41,48.8,7,22,31.8,14,19,73.7,16,23,39,10,20,15,11,5,75,1
13068,303928,359_12_38,GEORGIA,0,TOTALS,GEORGIA,200,25,71,35.2,18,50,36.0,7,21,33.3,8,14,57.1,19,15,34,16,20,17,3,2,65,0
13069,303941,359_12_38,MONTENEGRO,0,TOTALS,MONTENEGRO,200,30,73,41.1,27,50,54.0,3,23,13.0,18,21,85.7,28,30,58,19,14,19,7,3,81,1
13070,303954,359_12_39,TURKEY,0,TOTALS,TURKEY,200,28,54,51.9,24,48,50.0,4,6,66.7,11,17,64.7,4,29,33,13,25,17,8,1,71,0
13071,303967,359_12_39,SLOVENIA,0,TOTALS,SLOVENIA,200,25,55,45.5,15,30,50.0,10,25,40.0,12,22,54.5,7,25,32,14,21,13,5,0,72,1
13072,303980,359_12_40,SERBIA,0,TOTALS,SERBIA,200,36,65,55.4,34,58,58.6,2,7,28.6,12,16,75.0,16,27,43,16,17,21,8,3,86,1
13073,303993,359_12_40,GREECE,0,TOTALS,GREECE,200,29,60,48.3,23,44,52.3,6,16,37.5,5,6,83.3,5,14,19,16,17,15,8,1,69,0
13074,304006,359_12_41,ITALY,0,TOTALS,ITALY,200,25,55,45.5,20,37,54.1,5,18,27.8,23,32,71.9,7,16,23,10,26,12,7,3,78,0
13075,304019,359_12_41,LATVIA,0,TOTALS,LATVIA,200,32,56,57.1,21,32,65.6,11,24,45.8,19,25,76.0,11,26,37,15,26,17,5,4,94,1
13076,304032,359_12_42,GERMANY,0,TOTALS,GERMANY,200,28,61,45.9,25,47,53.2,3,14,21.4,15,28,53.6,7,26,33,9,25,13,5,2,74,0
13077,304045,359_12_42,UKRAINE,0,TOTALS,UKRAINE,200,26,57,45.6,23,46,50.0,3,11,27.3,26,33,78.8,9,31,40,14,26,13,4,1,81,1
13078,304058,359_12_43,MONTENEGRO,0,TOTALS,MONTENEGRO,200,27,69,39.1,23,49,46.9,4,20,20.0,14,21,66.7,18,21,39,14,18,16,6,3,72,0
13079,304071,359_12_43,ESTONIA,0,TOTALS,ESTONIA,200,30,61,49.2,23,40,57.5,7,21,33.3,9,15,60.0,10,26,36,15,22,16,3,1,76,1
13080,304084,359_12_44,TURKEY,0,TOTALS,TURKEY,200,18,66,27.3,16,48,33.3,2,18,11.1,7,14,50.0,11,18,29,10,18,15,9,1,45,0
13081,304097,359_12_44,LITHUANIA,0,TOTALS,LITHUANIA,200,29,54,53.7,18,33,54.5,11,21,52.4,7,14,50.0,9,31,40,18,19,22,8,5,76,1
13082,304110,359_12_45,RUSSIA,0,TOTALS,RUSSIA,200,23,60,38.3,16,37,43.2,7,23,30.4,8,12,66.7,10,18,28,12,23,8,9,1,61,0
13083,304123,359_12_45,SERBIA,0,TOTALS,SERBIA,200,29,58,50.0,21,41,51.2,8,17,47.1,18,23,78.3,14,29,43,18,17,10,2,3,84,1
13084,304136,359_12_46,GEORGIA,0,TOTALS,GEORGIA,200,23,61,37.7,18,35,51.4,5,26,19.2,13,23,56.5,9,23,32,9,30,10,2,3,64,0
13085,304149,359_12_46,SWEDEN,0,TOTALS,SWEDEN,200,28,56,50.0,23,34,67.6,5,22,22.7,26,39,66.7,11,34,45,14,22,14,6,2,87,1
13086,304162,359_12_47,SLOVENIA,0,TOTALS,SLOVENIA,200,23,49,46.9,13,29,44.8,10,20,50.0,14,17,82.4,11,23,34,13,22,17,4,2,70,1
13087,304175,359_12_47,SPAIN,0,TOTALS,SPAIN,200,25,58,43.1,20,41,48.8,5,17,29.4,8,16,50.0,15,12,27,8,22,13,4,2,63,0
13088,304188,359_12_48,GREECE,0,TOTALS,GREECE,200,26,59,44.1,16,45,35.6,10,14,71.4,10,13,76.9,12,24,36,13,22,13,4,1,72,1
13089,304201,359_12_48,FRANCE,0,TOTALS,FRANCE,200,18,55,32.7,13,38,34.2,5,17,29.4,14,20,70.0,17,21,38,6,18,19,2,6,55,0
13090,304214,359_12_49,GEORGIA,0,TOTALS,GEORGIA,200,25,69,36.2,19,41,46.3,6,28,21.4,19,24,79.2,21,31,52,10,21,21,4,0,75,1
13091,304227,359_12_49,ESTONIA,0,TOTALS,ESTONIA,200,28,71,39.4,23,45,51.1,5,26,19.2,11,18,61.1,13,25,38,11,24,15,3,4,72,0
13092,304240,359_12_50,LITHUANIA,0,TOTALS,LITHUANIA,200,28,66,42.4,20,43,46.5,8,23,34.8,15,22,68.2,15,39,54,11,23,13,7,7,79,1
13093,304253,359_12_50,GREECE,0,TOTALS,GREECE,200,16,69,23.2,14,51,27.5,2,18,11.1,9,19,47.4,16,26,42,6,21,13,5,2,43,0
13094,304266,359_12_51,SWEDEN,0,TOTALS,SWEDEN,200,17,54,31.5,12,36,33.3,5,18,27.8,9,11,81.8,6,17,23,6,18,16,5,2,48,0
13095,304279,359_12_51,MONTENEGRO,0,TOTALS,MONTENEGRO,200,35,62,56.5,27,42,64.3,8,20,40.0,8,10,80.0,10,32,42,22,15,14,4,5,86,1
13096,304292,359_12_52,SERBIA,0,TOTALS,SERBIA,200,27,55,49.1,24,45,53.3,3,10,30.0,17,19,89.5,10,24,34,9,22,18,7,2,74,1
13097,304305,359_12_52,LATVIA,0,TOTALS,LATVIA,200,22,52,42.3,15,32,46.9,7,20,35.0,14,17,82.4,7,17,24,7,20,20,4,3,65,0
13098,304318,359_12_53,GERMANY,0,TOTALS,GERMANY,200,16,55,29.1,12,31,38.7,4,24,16.7,11,22,50.0,15,18,33,5,20,10,4,2,47,0
13099,304331,359_12_53,SPAIN,0,TOTALS,SPAIN,200,26,57,45.6,19,37,51.4,7,20,35.0,14,18,77.8,14,28,42,15,22,12,2,0,73,1
13100,304344,359_12_54,RUSSIA,0,TOTALS,RUSSIA,200,24,52,46.2,21,39,53.8,3,13,23.1,17,22,77.3,8,35,43,11,25,20,8,4,68,0
13101,304357,359_12_54,ITALY,0,TOTALS,ITALY,200,20,61,32.8,12,38,31.6,8,23,34.8,21,28,75.0,10,22,32,11,21,15,7,1,69,1
13102,304370,359_12_55,SLOVENIA,0,TOTALS,SLOVENIA,200,19,56,33.9,15,35,42.9,4,21,19.0,12,16,75.0,13,20,33,8,22,14,3,2,54,0
13103,304383,359_12_55,FRANCE,0,TOTALS,FRANCE,200,29,64,45.3,24,55,43.6,5,9,55.6,14,18,77.8,17,26,43,13,19,10,2,5,77,1
13104,304396,359_12_56,TURKEY,0,TOTALS,TURKEY,200,27,63,42.9,24,52,46.2,3,11,27.3,17,20,85.0,10,29,39,9,18,16,9,1,74,1
13105,304409,359_12_56,UKRAINE,0,TOTALS,UKRAINE,200,19,55,34.5,17,34,50.0,2,21,9.5,7,16,43.8,10,27,37,12,22,24,4,5,47,0
13106,304422,359_12_57,LATVIA,0,TOTALS,LATVIA,200,25,54,46.3,13,30,43.3,12,24,50.0,14,20,70.0,13,20,33,8,17,14,2,0,76,1
13107,304435,359_12_57,GREECE,0,TOTALS,GREECE,200,28,58,48.3,24,41,58.5,4,17,23.5,14,24,58.3,9,19,28,11,23,13,1,1,74,0
13108,304448,359_12_58,MONTENEGRO,0,TOTALS,MONTENEGRO,200,31,71,43.7,26,48,54.2,5,23,21.7,16,22,72.7,21,20,41,13,24,15,4,2,83,1
13109,304461,359_12_58,GEORGIA,0,TOTALS,GEORGIA,200,25,59,42.4,15,32,46.9,10,27,37.0,22,27,81.5,15,23,38,14,22,14,3,3,82,0
13110,304474,359_12_59,GERMANY,0,TOTALS,GERMANY,200,22,53,41.5,19,37,51.4,3,16,18.8,18,25,72.0,11,30,41,4,24,18,2,2,65,1
13111,304487,359_12_59,SLOVENIA,0,TOTALS,SLOVENIA,200,19,61,31.1,13,36,36.1,6,25,24.0,9,15,60.0,15,23,38,13,25,17,4,1,53,0
13112,304500,359_12_60,ESTONIA,0,TOTALS,ESTONIA,200,21,59,35.6,18,44,40.9,3,15,20.0,9,23,39.1,10,26,36,11,21,13,2,4,54,0
13113,304513,359_12_60,SWEDEN,0,TOTALS,SWEDEN,200,33,71,46.5,19,41,46.3,14,30,46.7,11,15,73.3,12,32,44,19,23,7,2,2,91,1
13114,304526,359_12_61,SERBIA,0,TOTALS,SERBIA,200,23,57,40.4,20,43,46.5,3,14,21.4,19,30,63.3,14,28,42,10,24,18,7,1,68,0
13115,304539,359_12_61,LITHUANIA,0,TOTALS,LITHUANIA,200,28,63,44.4,24,45,53.3,4,18,22.2,13,23,56.5,9,24,33,20,26,14,8,1,73,1
13116,304552,359_12_62,RUSSIA,0,TOTALS,RUSSIA,200,37,78,47.4,28,61,45.9,9,17,52.9,0,1,0.0,20,23,43,19,19,10,10,4,83,1
13117,304565,359_12_62,UKRAINE,0,TOTALS,UKRAINE,200,22,55,40.0,16,38,42.1,6,17,35.3,13,18,72.2,9,21,30,12,9,18,4,3,63,0
13118,304578,359_12_63,SPAIN,0,TOTALS,SPAIN,200,20,57,35.1,16,36,44.4,4,21,19.0,15,21,71.4,11,23,34,6,24,11,6,1,59,0
13119,304591,359_12_63,FRANCE,0,TOTALS,FRANCE,200,21,52,40.4,15,30,50.0,6,22,27.3,18,24,75.0,9,31,40,9,27,14,5,5,66,1
13120,304604,359_12_64,ITALY,0,TOTALS,ITALY,200,24,61,39.3,16,31,51.6,8,30,26.7,5,7,71.4,7,23,30,13,24,15,6,4,61,0
13121,304617,359_12_64,TURKEY,0,TOTALS,TURKEY,200,23,57,40.4,18,48,37.5,5,9,55.6,14,23,60.9,11,29,40,10,18,18,6,2,65,1
13122,304630,359_12_65,GREECE,0,TOTALS,GREECE,200,23,57,40.4,18,42,42.9,5,15,33.3,10,13,76.9,9,13,22,10,21,13,11,2,61,0
13123,304643,359_12_65,SLOVENIA,0,TOTALS,SLOVENIA,200,29,56,51.8,20,37,54.1,9,19,47.4,13,15,86.7,15,26,41,18,19,20,2,2,80,1
13124,304656,359_12_66,SWEDEN,0,TOTALS,SWEDEN,200,28,69,40.6,19,40,47.5,9,29,31.0,16,21,76.2,15,26,41,17,18,12,6,2,81,1
13125,304669,359_12_66,GEORGIA,0,TOTALS,GEORGIA,200,26,61,42.6,23,45,51.1,3,16,18.8,12,19,63.2,13,29,42,7,22,17,4,3,67,0
13126,304682,359_12_67,LATVIA,0,TOTALS,LATVIA,200,21,56,37.5,11,32,34.4,10,24,41.7,11,12,91.7,12,21,33,9,18,16,3,0,63,0
13127,304695,359_12_67,GERMANY,0,TOTALS,GERMANY,200,35,64,54.7,32,53,60.4,3,11,27.3,7,13,53.8,10,24,34,7,21,8,7,2,80,1
13128,304708,359_12_68,ESTONIA,0,TOTALS,ESTONIA,200,29,62,46.8,24,45,53.3,5,17,29.4,8,11,72.7,11,25,36,17,14,20,4,3,71,0
13129,304721,359_12_68,MONTENEGRO,0,TOTALS,MONTENEGRO,200,33,74,44.6,27,57,47.4,6,17,35.3,15,19,78.9,16,21,37,15,16,8,6,3,87,1
13130,304734,359_12_69,SERBIA,0,TOTALS,SERBIA,200,20,55,36.4,18,44,40.9,2,11,18.2,24,35,68.6,18,17,35,7,28,17,8,3,66,0
13131,304747,359_12_69,SPAIN,0,TOTALS,SPAIN,200,21,49,42.9,18,30,60.0,3,19,15.8,22,31,71.0,13,21,34,9,28,20,5,1,67,1
13132,304760,359_12_70,LITHUANIA,0,TOTALS,LITHUANIA,200,21,53,39.6,17,37,45.9,4,16,25.0,4,10,40.0,12,30,42,13,24,19,3,2,50,1
13133,304773,359_12_70,FRANCE,0,TOTALS,FRANCE,200,15,58,25.9,11,36,30.6,4,22,18.2,15,24,62.5,15,22,37,9,16,9,5,7,49,0
13134,304786,360_12_01,SLOVAK REPUBLIC,0,TOTALS,SLOVAK REPUBLIC,200,25,73,34.2,20,39,51.3,5,34,14.7,4,12,33.3,19,28,47,10,19,12,7,3,59,0
13135,304799,360_12_01,AUSTRIA,0,TOTALS,AUSTRIA,200,23,54,42.6,17,40,42.5,6,14,42.9,12,24,50.0,10,33,43,13,16,15,6,1,64,1
13136,304812,360_12_02,GREAT BRITAIN,0,TOTALS,GREAT BRITAIN,200,28,58,48.3,21,43,48.8,7,15,46.7,13,19,68.4,11,39,50,16,19,21,8,4,76,1
13137,304825,360_12_02,PORTUGAL,0,TOTALS,PORTUGAL,200,23,71,32.4,18,50,36.0,5,21,23.8,13,21,61.9,14,21,35,11,18,10,17,1,64,0
13138,304838,360_12_03,BELGIUM,0,TOTALS,BELGIUM,200,23,65,35.4,17,43,39.5,6,22,27.3,27,36,75.0,13,32,45,15,13,8,15,3,79,1
13139,304851,360_12_03,MKD,0,TOTALS,MKD,200,18,61,29.5,13,39,33.3,5,22,22.7,8,9,88.9,9,30,39,6,26,20,4,1,49,0
13140,304864,360_12_04,HUNGARY,0,TOTALS,HUNGARY,200,18,54,33.3,8,26,30.8,10,28,35.7,7,17,41.2,11,27,38,10,18,18,7,0,53,0
13141,304877,360_12_04,SWITZERLAND,0,TOTALS,SWITZERLAND,200,22,60,36.7,16,42,38.1,6,18,33.3,10,13,76.9,12,29,41,9,14,10,6,8,60,1
13142,304890,360_12_05,ISRAEL,0,TOTALS,ISRAEL,200,26,65,40.0,17,37,45.9,9,28,32.1,8,17,47.1,10,25,35,11,20,13,13,2,69,0
13143,304903,360_12_05,BULGARIA,0,TOTALS,BULGARIA,200,26,66,39.4,15,37,40.5,11,29,37.9,15,18,83.3,15,36,51,13,20,17,5,2,78,1
13144,304916,360_12_06,BELARUS,0,TOTALS,BELARUS,200,27,62,43.5,21,45,46.7,6,17,35.3,13,22,59.1,12,30,42,16,22,29,14,7,73,0
13145,304929,360_12_06,CROATIA,0,TOTALS,CROATIA,200,27,81,33.3,22,59,37.3,5,22,22.7,18,26,69.2,24,28,52,19,26,20,17,1,77,1
13146,304942,360_12_07,NETHERLANDS,0,TOTALS,NETHERLANDS,200,13,45,28.9,9,35,25.7,4,10,40.0,9,14,64.3,5,22,27,10,32,34,5,1,39,0
13147,304955,360_12_07,POLAND,0,TOTALS,POLAND,200,34,61,55.7,32,50,64.0,2,11,18.2,27,39,69.2,11,27,38,18,14,17,17,1,97,1
13148,304968,360_12_08,FINLAND,0,TOTALS,FINLAND,200,22,73,30.1,17,45,37.8,5,28,17.9,10,20,50.0,12,22,34,7,27,7,5,2,59,0
13149,304981,360_12_08,CZECH REPUBLIC,0,TOTALS,CZECH REPUBLIC,200,28,57,49.1,26,40,65.0,2,17,11.8,16,36,44.4,17,42,59,18,22,18,5,2,74,1
13150,304994,360_12_09,LUXEMBOURG,0,TOTALS,LUXEMBOURG,225,23,69,33.3,21,44,47.7,2,25,8.0,8,17,47.1,7,25,32,4,28,20,22,3,56,0
13151,305007,360_12_09,NETHERLANDS,0,TOTALS,NETHERLANDS,225,21,56,37.5,18,36,50.0,3,20,15.0,19,40,47.5,19,42,61,11,18,31,13,4,64,1
13152,305020,360_12_10,DENMARK,0,TOTALS,DENMARK,200,29,76,38.2,24,55,43.6,5,21,23.8,16,28,57.1,20,31,51,12,25,16,11,0,79,1
13153,305033,360_12_10,BELARUS,0,TOTALS,BELARUS,200,27,60,45.0,18,36,50.0,9,24,37.5,14,24,58.3,8,29,37,17,22,18,10,7,77,0
13154,305046,360_12_11,POLAND,0,TOTALS,POLAND,200,29,72,40.3,28,56,50.0,1,16,6.2,12,16,75.0,18,32,50,16,19,17,11,0,71,1
13155,305059,360_12_11,BELGIUM,0,TOTALS,BELGIUM,200,22,60,36.7,18,35,51.4,4,25,16.0,11,18,61.1,8,23,31,7,18,17,10,4,59,0
13156,305072,360_12_12,CROATIA,0,TOTALS,CROATIA,200,30,76,39.5,21,46,45.7,9,30,30.0,9,11,81.8,19,28,47,15,31,19,8,2,78,0
13157,305085,360_12_12,GREAT BRITAIN,0,TOTALS,GREAT BRITAIN,200,28,66,42.4,18,41,43.9,10,25,40.0,24,34,70.6,12,27,39,14,15,13,5,5,90,1
13158,305098,360_12_13,AUSTRIA,0,TOTALS,AUSTRIA,200,14,59,23.7,12,42,28.6,2,17,11.8,9,16,56.2,13,28,41,6,21,20,1,2,39,0
13159,305111,360_12_13,ISRAEL,0,TOTALS,ISRAEL,200,28,58,48.3,22,38,57.9,6,20,30.0,13,26,50.0,8,35,43,16,22,12,7,8,75,1
13160,305124,360_12_14,MKD,0,TOTALS,MKD,200,18,63,28.6,12,40,30.0,6,23,26.1,7,10,70.0,9,19,28,8,23,18,8,0,49,0
13161,305137,360_12_14,POLAND,0,TOTALS,POLAND,200,31,59,52.5,28,43,65.1,3,16,18.8,18,23,78.3,12,37,49,23,17,20,12,2,83,1
13162,305150,360_12_15,CZECH REPUBLIC,0,TOTALS,CZECH REPUBLIC,200,35,73,47.9,30,51,58.8,5,22,22.7,7,10,70.0,20,28,48,15,25,14,12,1,82,1
13163,305163,360_12_15,HUNGARY,0,TOTALS,HUNGARY,200,16,58,27.6,14,46,30.4,2,12,16.7,17,27,63.0,18,20,38,5,17,19,7,1,51,0
13164,305176,360_12_16,PORTUGAL,0,TOTALS,PORTUGAL,200,27,66,40.9,24,48,50.0,3,18,16.7,8,11,72.7,6,27,33,15,21,13,8,5,65,0
13165,305189,360_12_16,CROATIA,0,TOTALS,CROATIA,200,30,67,44.8,27,48,56.2,3,19,15.8,16,23,69.6,14,33,47,15,19,15,7,1,79,1
13166,305202,360_12_17,BULGARIA,0,TOTALS,BULGARIA,200,26,67,38.8,21,40,52.5,5,27,18.5,12,20,60.0,15,30,45,17,20,11,10,5,69,1
13167,305215,360_12_17,SLOVAK REPUBLIC,0,TOTALS,SLOVAK REPUBLIC,200,20,60,33.3,13,30,43.3,7,30,23.3,14,17,82.4,9,29,38,13,21,15,6,6,61,0
13168,305228,360_12_18,BELGIUM,0,TOTALS,BELGIUM,200,36,76,47.4,23,38,60.5,13,38,34.2,18,25,72.0,20,33,53,23,12,9,11,4,103,0
13169,305241,360_12_18,LUXEMBOURG,0,TOTALS,LUXEMBOURG,200,20,62,32.3,15,43,34.9,5,19,26.3,11,14,78.6,7,25,32,8,22,15,4,1,56,1
13170,305254,360_12_19,SWITZERLAND,0,TOTALS,SWITZERLAND,200,22,61,36.1,18,45,40.0,4,16,25.0,16,25,64.0,15,29,44,11,22,16,3,3,64,0
13171,305267,360_12_19,FINLAND,0,TOTALS,FINLAND,200,33,69,47.8,22,34,64.7,11,35,31.4,13,20,65.0,8,28,36,25,25,7,9,2,90,1
13172,305280,360_12_20,GREAT BRITAIN,0,TOTALS,GREAT BRITAIN,200,21,62,33.9,16,44,36.4,5,18,27.8,24,28,85.7,9,37,46,13,19,18,9,3,71,1
13173,305293,360_12_20,DENMARK,0,TOTALS,DENMARK,200,23,68,33.8,19,48,39.6,4,20,20.0,10,23,43.5,11,33,44,14,26,19,8,1,60,0
13174,305306,360_12_21,NETHERLANDS,0,TOTALS,NETHERLANDS,200,13,53,24.5,11,38,28.9,2,15,13.3,5,13,38.5,18,22,40,5,17,28,5,0,33,0
13175,305318,360_12_21,BELGIUM,0,TOTALS,BELGIUM,200,30,53,56.6,19,30,63.3,11,23,47.8,6,12,50.0,5,26,31,20,15,16,16,4,77,1
13176,305331,360_12_22,BELARUS,0,TOTALS,BELARUS,200,26,66,39.4,20,42,47.6,6,24,25.0,11,15,73.3,9,28,37,14,17,15,16,5,69,1
13177,305341,360_12_22,GREAT BRITAIN,0,TOTALS,GREAT BRITAIN,200,24,62,38.7,22,52,42.3,2,10,20.0,11,17,64.7,14,34,48,16,16,24,9,1,61,0
13178,305354,360_12_23,LUXEMBOURG,0,TOTALS,LUXEMBOURG,200,24,79,30.4,18,56,32.1,6,23,26.1,14,23,60.9,14,33,47,15,27,20,7,2,68,0
13179,305367,360_12_23,MKD,0,TOTALS,MKD,200,31,73,42.5,23,44,52.3,8,29,27.6,17,30,56.7,13,45,58,19,23,22,10,2,87,1
13180,305380,360_12_24,DENMARK,0,TOTALS,DENMARK,200,27,62,43.5,21,43,48.8,6,19,31.6,13,20,65.0,18,21,39,13,18,17,6,3,73,0
13181,305393,360_12_24,PORTUGAL,0,TOTALS,PORTUGAL,200,27,60,45.0,20,35,57.1,7,25,28.0,13,17,76.5,12,17,29,14,19,16,14,5,74,1
13182,305406,360_12_25,SLOVAK REPUBLIC,0,TOTALS,SLOVAK REPUBLIC,200,22,66,33.3,16,48,33.3,6,18,33.3,10,16,62.5,14,24,38,11,22,18,7,3,60,0
13183,305419,360_12_25,ISRAEL,0,TOTALS,ISRAEL,200,27,62,43.5,21,47,44.7,6,15,40.0,19,27,70.4,15,29,44,17,18,18,9,4,79,1
13184,305432,360_12_26,HUNGARY,0,TOTALS,HUNGARY,200,35,74,47.3,27,52,51.9,8,22,36.4,7,11,63.6,17,27,44,16,27,13,5,1,85,1
13185,305445,360_12_26,FINLAND,0,TOTALS,FINLAND,200,23,54,42.6,14,23,60.9,9,31,29.0,15,27,55.6,7,20,27,15,19,12,6,4,70,0
13186,305458,360_12_27,POLAND,0,TOTALS,POLAND,200,46,76,60.5,40,52,76.9,6,24,25.0,21,31,67.7,22,32,54,32,6,8,14,2,119,0
13187,305471,360_12_27,LUXEMBOURG,0,TOTALS,LUXEMBOURG,200,24,67,35.8,12,39,30.8,12,28,42.9,4,4,100.0,11,12,23,15,21,18,5,0,64,1
13188,305484,360_12_28,PORTUGAL,0,TOTALS,PORTUGAL,200,23,55,41.8,21,42,50.0,2,13,15.4,16,29,55.2,12,30,42,6,23,22,9,4,64,1
13189,305497,360_12_28,BELARUS,0,TOTALS,BELARUS,200,23,61,37.7,21,50,42.0,2,11,18.2,15,19,78.9,8,28,36,9,25,17,12,2,63,0
13190,305510,360_12_29,BULGARIA,0,TOTALS,BULGARIA,200,29,64,45.3,22,39,56.4,7,25,28.0,10,15,66.7,16,25,41,16,16,20,14,1,75,1
13191,305523,360_12_29,AUSTRIA,0,TOTALS,AUSTRIA,200,25,58,43.1,20,38,52.6,5,20,25.0,7,11,63.6,10,20,30,15,19,20,9,3,62,0
13192,305536,360_12_30,CZECH REPUBLIC,0,TOTALS,CZECH REPUBLIC,200,21,61,34.4,17,36,47.2,4,25,16.0,19,32,59.4,18,29,47,13,22,13,7,3,65,1
13193,305549,360_12_30,SWITZERLAND,0,TOTALS,SWITZERLAND,200,19,52,36.5,15,41,36.6,4,11,36.4,16,23,69.6,8,27,35,7,30,15,8,3,58,0
13194,305562,360_12_31,MKD,0,TOTALS,MKD,200,22,59,37.3,13,32,40.6,9,27,33.3,3,3,100.0,8,23,31,14,20,20,5,1,56,0
13195,305575,360_12_31,NETHERLANDS,0,TOTALS,NETHERLANDS,200,25,56,44.6,23,45,51.1,2,11,18.2,9,17,52.9,11,25,36,9,10,18,10,4,61,1
13196,305588,360_12_32,CROATIA,0,TOTALS,CROATIA,200,25,48,52.1,16,29,55.2,9,19,47.4,16,23,69.6,7,35,42,19,20,28,7,2,75,1
13197,305601,360_12_32,DENMARK,0,TOTALS,DENMARK,200,23,68,33.8,21,48,43.8,2,20,10.0,6,17,35.3,14,19,33,9,23,16,13,0,54,0
13198,305614,360_12_33,GREAT BRITAIN,0,TOTALS,GREAT BRITAIN,200,24,56,42.9,19,43,44.2,5,13,38.5,11,18,61.1,12,30,42,11,15,20,6,6,64,0
13199,305627,360_12_33,FINLAND,0,TOTALS,FINLAND,200,26,69,37.7,16,37,43.2,10,32,31.2,5,13,38.5,16,21,37,15,19,14,5,4,67,1
13200,305640,360_12_34,DENMARK,0,TOTALS,DENMARK,200,28,62,45.2,17,38,44.7,11,24,45.8,11,18,61.1,12,28,40,22,18,17,9,2,78,1
13201,305653,360_12_34,SWITZERLAND,0,TOTALS,SWITZERLAND,200,18,54,33.3,14,38,36.8,4,16,25.0,7,14,50.0,12,24,36,10,18,22,9,8,47,0
13202,305666,360_12_35,CROATIA,0,TOTALS,CROATIA,200,22,57,38.6,18,47,38.3,4,10,40.0,19,26,73.1,11,18,29,15,21,16,10,2,67,0
13203,305679,360_12_35,CZECH REPUBLIC,0,TOTALS,CZECH REPUBLIC,200,34,65,52.3,18,35,51.4,16,30,53.3,8,18,44.4,16,28,44,21,20,19,10,6,92,1
13204,305692,360_12_36,HUNGARY,0,TOTALS,HUNGARY,200,21,66,31.8,14,41,34.1,7,25,28.0,11,20,55.0,18,26,44,13,24,22,13,0,60,0
13205,305705,360_12_36,BELARUS,0,TOTALS,BELARUS,200,24,54,44.4,17,33,51.5,7,21,33.3,15,19,78.9,6,29,35,11,21,22,9,4,70,1
13206,305718,360_12_37,BULGARIA,0,TOTALS,BULGARIA,200,25,74,33.8,19,54,35.2,6,20,30.0,6,9,66.7,17,23,40,13,22,12,7,1,62,0
13207,305730,360_12_37,BELGIUM,0,TOTALS,BELGIUM,200,28,63,44.4,13,26,50.0,15,37,40.5,11,16,68.8,14,33,47,19,15,14,4,5,82,1
13208,305743,360_12_38,MKD,0,TOTALS,MKD,200,27,74,36.5,23,50,46.0,4,24,16.7,2,8,25.0,12,24,36,13,18,15,18,2,60,0
13209,305756,360_12_38,SLOVAK REPUBLIC,0,TOTALS,SLOVAK REPUBLIC,200,28,55,50.9,18,28,64.3,10,27,37.0,14,24,58.3,8,38,46,16,13,25,11,2,80,1
13210,305769,360_12_39,ISRAEL,0,TOTALS,ISRAEL,200,27,57,47.4,20,37,54.1,7,20,35.0,15,24,62.5,7,29,36,13,18,16,8,1,76,1
13211,305782,360_12_39,POLAND,0,TOTALS,POLAND,200,26,63,41.3,17,36,47.2,9,27,33.3,12,16,75.0,11,28,39,17,22,15,4,3,73,0
13212,305795,360_12_40,AUSTRIA,0,TOTALS,AUSTRIA,200,40,77,51.9,35,58,60.3,5,19,26.3,23,35,65.7,23,41,64,21,20,16,11,3,108,0
13213,305808,360_12_40,LUXEMBOURG,0,TOTALS,LUXEMBOURG,200,24,70,34.3,17,47,36.2,7,23,30.4,9,14,64.3,9,18,27,12,28,15,10,0,64,1
13214,305821,360_12_41,CZECH REPUBLIC,0,TOTALS,CZECH REPUBLIC,200,36,61,59.0,27,36,75.0,9,25,36.0,10,14,71.4,9,29,38,18,21,19,8,4,91,1
13215,305834,360_12_41,GREAT BRITAIN,0,TOTALS,GREAT BRITAIN,200,28,60,46.7,22,44,50.0,6,16,37.5,13,15,86.7,3,19,22,20,12,12,7,0,75,0
13216,305847,360_12_42,PORTUGAL,0,TOTALS,PORTUGAL,200,19,55,34.5,17,43,39.5,2,12,16.7,21,27,77.8,9,27,36,11,17,17,9,5,61,1
13217,305860,360_12_42,HUNGARY,0,TOTALS,HUNGARY,200,21,58,36.2,17,46,37.0,4,12,33.3,9,21,42.9,16,30,46,16,25,21,10,2,55,0
13218,305873,360_12_43,FINLAND,0,TOTALS,FINLAND,200,26,73,35.6,23,48,47.9,3,25,12.0,14,20,70.0,16,15,31,5,19,18,6,2,69,0
13219,305886,360_12_43,CROATIA,0,TOTALS,CROATIA,200,31,57,54.4,25,36,69.4,6,21,28.6,26,32,81.2,12,33,45,19,21,20,13,2,94,1
13220,305899,360_12_44,SWITZERLAND,0,TOTALS,SWITZERLAND,200,30,77,39.0,26,57,45.6,4,20,20.0,14,17,82.4,22,16,38,10,25,18,12,3,78,0
13221,305912,360_12_44,BELARUS,0,TOTALS,BELARUS,200,33,61,54.1,25,41,61.0,8,20,40.0,15,25,60.0,15,25,40,19,17,23,11,7,89,1
13222,305925,360_12_45,POLAND,0,TOTALS,POLAND,200,30,73,41.1,21,48,43.8,9,25,36.0,1,2,50.0,17,30,47,17,21,16,7,4,70,0
13223,305938,360_12_45,BULGARIA,0,TOTALS,BULGARIA,200,26,62,41.9,12,31,38.7,14,31,45.2,12,16,75.0,8,27,35,14,15,13,11,5,78,1
13224,305951,360_12_46,NETHERLANDS,0,TOTALS,NETHERLANDS,200,24,57,42.1,22,41,53.7,2,16,12.5,11,14,78.6,13,29,42,10,20,23,8,4,61,0
13225,305964,360_12_46,AUSTRIA,0,TOTALS,AUSTRIA,200,25,62,40.3,18,46,39.1,7,16,43.8,7,16,43.8,11,19,30,17,15,14,13,5,64,1
13226,305976,360_12_47,BELGIUM,0,TOTALS,BELGIUM,200,23,60,38.3,13,42,31.0,10,18,55.6,10,14,71.4,9,35,44,14,18,19,6,2,66,0
13227,305989,360_12_47,ISRAEL,0,TOTALS,ISRAEL,200,26,78,33.3,21,57,36.8,5,21,23.8,12,18,66.7,20,29,49,9,16,13,9,3,69,1
13228,306000,360_12_48,SLOVAK REPUBLIC,0,TOTALS,SLOVAK REPUBLIC,200,29,70,41.4,23,34,67.6,6,36,16.7,12,17,70.6,14,35,49,11,11,19,12,4,76,1
13229,306013,360_12_48,LUXEMBOURG,0,TOTALS,LUXEMBOURG,200,24,67,35.8,20,47,42.6,4,20,20.0,0,3,0.0,10,26,36,13,15,22,12,2,52,0
13230,306026,360_12_49,HUNGARY,0,TOTALS,HUNGARY,200,21,62,33.9,17,35,48.6,4,27,14.8,9,18,50.0,13,30,43,12,22,19,9,3,55,0
13231,306039,360_12_49,DENMARK,0,TOTALS,DENMARK,200,27,64,42.2,19,42,45.2,8,22,36.4,15,23,65.2,11,28,39,15,16,15,11,5,77,1
13232,306052,360_12_50,PORTUGAL,0,TOTALS,PORTUGAL,200,11,66,16.7,7,38,18.4,4,28,14.3,16,24,66.7,18,30,48,8,20,14,7,6,42,0
13233,306063,360_12_50,SWITZERLAND,0,TOTALS,SWITZERLAND,200,14,52,26.9,8,33,24.2,6,19,31.6,18,30,60.0,12,37,49,9,19,18,6,6,52,1
13234,306076,360_12_51,AUSTRIA,0,TOTALS,AUSTRIA,225,27,71,38.0,21,48,43.8,6,23,26.1,17,31,54.8,18,39,57,16,16,22,9,2,77,0
13235,306089,360_12_51,MKD,0,TOTALS,MKD,225,30,78,38.5,19,37,51.4,11,41,26.8,14,22,63.6,13,33,46,15,23,17,8,1,85,1
13236,306102,360_12_52,NETHERLANDS,0,TOTALS,NETHERLANDS,200,18,62,29.0,11,38,28.9,7,24,29.2,4,6,66.7,18,18,36,15,18,16,8,2,47,0
13237,306113,360_12_52,SLOVAK REPUBLIC,0,TOTALS,SLOVAK REPUBLIC,200,18,51,35.3,15,28,53.6,3,23,13.0,16,27,59.3,16,25,41,9,14,15,8,3,55,1
13238,306126,360_12_53,POLAND,0,TOTALS,POLAND,200,33,64,51.6,28,50,56.0,5,14,35.7,12,14,85.7,11,42,53,20,18,20,9,6,83,1
13239,306139,360_12_53,FINLAND,0,TOTALS,FINLAND,200,26,71,36.6,16,40,40.0,10,31,32.3,8,18,44.4,8,21,29,9,18,12,10,2,70,0
13240,306152,360_12_54,GREAT BRITAIN,0,TOTALS,GREAT BRITAIN,225,40,79,50.6,30,55,54.5,10,24,41.7,11,12,91.7,9,35,44,23,20,15,4,0,101,1
13241,306164,360_12_54,BELGIUM,0,TOTALS,BELGIUM,225,37,79,46.8,24,42,57.1,13,37,35.1,13,25,52.0,11,30,41,16,18,13,7,3,100,0
13242,306177,360_12_55,LUXEMBOURG,0,TOTALS,LUXEMBOURG,200,33,61,54.1,23,46,50.0,10,15,66.7,18,25,72.0,5,28,33,15,25,19,10,0,94,1
13243,306190,360_12_55,HUNGARY,0,TOTALS,HUNGARY,200,29,62,46.8,25,38,65.8,4,24,16.7,24,39,61.5,13,24,37,14,22,24,12,1,86,0
13244,306203,360_12_56,BULGARIA,0,TOTALS,BULGARIA,200,33,73,45.2,25,45,55.6,8,28,28.6,5,8,62.5,9,28,37,19,24,9,6,6,79,0
13245,306216,360_12_56,CROATIA,0,TOTALS,CROATIA,200,27,68,39.7,18,39,46.2,9,29,31.0,22,29,75.9,16,29,45,13,18,12,5,1,85,1
13246,306227,360_12_57,MKD,0,TOTALS,MKD,200,24,63,38.1,13,32,40.6,11,31,35.5,12,21,57.1,13,21,34,15,22,14,6,0,71,0
13247,306240,360_12_57,SWITZERLAND,0,TOTALS,SWITZERLAND,200,29,58,50.0,24,44,54.5,5,14,35.7,17,24,70.8,12,27,39,18,17,14,7,1,80,1
13248,306253,360_12_58,CZECH REPUBLIC,0,TOTALS,CZECH REPUBLIC,200,26,60,43.3,22,41,53.7,4,19,21.1,16,27,59.3,10,39,49,14,22,16,4,8,72,1
13249,306266,360_12_58,ISRAEL,0,TOTALS,ISRAEL,200,20,66,30.3,15,48,31.2,5,18,27.8,16,21,76.2,8,29,37,11,24,12,9,3,61,0
13250,306279,360_12_59,NETHERLANDS,0,TOTALS,NETHERLANDS,200,21,52,40.4,19,43,44.2,2,9,22.2,8,14,57.1,7,33,40,9,15,24,7,2,52,0
13251,306292,360_12_59,BELARUS,0,TOTALS,BELARUS,200,25,67,37.3,20,48,41.7,5,19,26.3,9,14,64.3,13,25,38,16,11,12,10,2,64,1
13252,306305,360_12_60,FINLAND,0,TOTALS,FINLAND,200,29,78,37.2,24,52,46.2,5,26,19.2,7,14,50.0,17,22,39,11,13,15,9,2,70,0
13253,306316,360_12_60,BELGIUM,0,TOTALS,BELGIUM,200,33,65,50.8,24,45,53.3,9,20,45.0,9,13,69.2,11,35,46,16,15,18,10,5,84,1
13254,306327,360_12_61,SLOVAK REPUBLIC,0,TOTALS,SLOVAK REPUBLIC,200,23,63,36.5,16,30,53.3,7,33,21.2,9,13,69.2,7,25,32,15,15,14,11,5,62,0
13255,306340,360_12_61,DENMARK,0,TOTALS,DENMARK,200,34,65,52.3,25,47,53.2,9,18,50.0,4,11,36.4,9,34,43,16,11,12,9,1,81,1
13256,306353,360_12_62,POLAND,0,TOTALS,POLAND,200,31,72,43.1,18,45,40.0,13,27,48.1,8,9,88.9,9,37,46,17,17,8,5,3,83,1
13257,306366,360_12_62,GREAT BRITAIN,0,TOTALS,GREAT BRITAIN,200,21,68,30.9,18,51,35.3,3,17,17.6,8,15,53.3,14,32,46,10,15,13,2,3,53,0
13258,306379,360_12_63,AUSTRIA,0,TOTALS,AUSTRIA,200,25,71,35.2,24,53,45.3,1,18,5.6,6,11,54.5,20,21,41,16,21,17,10,3,57,0
13259,306392,360_12_63,PORTUGAL,0,TOTALS,PORTUGAL,200,25,54,46.3,18,31,58.1,7,23,30.4,9,19,47.4,12,27,39,17,14,20,7,3,66,1
13260,306405,360_12_64,BULGARIA,0,TOTALS,BULGARIA,200,25,58,43.1,16,37,43.2,9,21,42.9,8,14,57.1,9,26,35,15,17,22,5,1,67,1
13261,306418,360_12_64,ISRAEL,0,TOTALS,ISRAEL,200,39,67,58.2,29,44,65.9,10,23,43.5,13,18,72.2,6,26,32,22,18,7,13,2,101,0
13262,306431,360_12_65,CROATIA,0,TOTALS,CROATIA,200,27,65,41.5,16,40,40.0,11,25,44.0,23,30,76.7,6,27,33,18,23,10,12,1,88,1
13263,306444,360_12_65,CZECH REPUBLIC,0,TOTALS,CZECH REPUBLIC,200,29,69,42.0,24,42,57.1,5,27,18.5,17,21,81.0,12,35,47,13,23,16,5,3,80,0
13264,309213,363_12_01,UKRAINE,0,TOTALS,UKRAINE,200,23,59,39.0,19,47,40.4,4,12,33.3,4,6,66.7,7,23,30,14,26,18,4,6,54,0
13265,309226,363_12_01,SERBIA,0,TOTALS,SERBIA,200,25,64,39.1,21,51,41.2,4,13,30.8,21,31,67.7,20,28,48,7,16,14,11,1,75,1
13266,309239,363_12_02,POLAND,0,TOTALS,POLAND,200,25,52,48.1,19,37,51.4,6,15,40.0,18,23,78.3,6,25,31,15,17,21,6,1,74,0
13267,309252,363_12_02,CROATIA,0,TOTALS,CROATIA,200,34,76,44.7,29,51,56.9,5,25,20.0,13,18,72.2,16,21,37,18,22,11,13,2,86,1
13268,309265,363_12_03,DENMARK,0,TOTALS,DENMARK,200,21,53,39.6,17,38,44.7,4,15,26.7,17,23,73.9,8,20,28,18,23,21,9,2,63,0
13269,309278,363_12_03,ITALY,0,TOTALS,ITALY,200,32,63,50.8,25,48,52.1,7,15,46.7,15,23,65.2,11,26,37,12,19,14,12,0,86,1
13270,309291,363_12_04,BULGARIA,0,TOTALS,BULGARIA,225,29,70,41.4,16,36,44.4,13,34,38.2,24,24,100.0,14,27,41,12,22,17,10,1,95,1
13271,309304,363_12_04,TURKEY,0,TOTALS,TURKEY,225,34,87,39.1,26,61,42.6,8,26,30.8,13,20,65.0,31,25,56,11,21,19,6,3,89,0
13272,309317,363_12_05,LATVIA,0,TOTALS,LATVIA,200,20,60,33.3,13,39,33.3,7,21,33.3,11,17,64.7,14,31,45,8,16,15,2,3,58,1
13273,309330,363_12_05,FRANCE,0,TOTALS,FRANCE,200,20,62,32.3,13,37,35.1,7,25,28.0,7,9,77.8,12,29,41,8,18,12,12,3,54,0
13274,309343,363_12_06,GREECE,0,TOTALS,GREECE,200,25,70,35.7,15,46,32.6,10,24,41.7,6,8,75.0,16,23,39,13,25,14,6,2,66,0
13275,309356,363_12_06,LITHUANIA,0,TOTALS,LITHUANIA,200,23,59,39.0,19,40,47.5,4,19,21.1,21,25,84.0,14,30,44,13,16,17,11,2,71,1
13276,309369,363_12_07,SLOVENIA,0,TOTALS,SLOVENIA,200,18,55,32.7,13,37,35.1,5,18,27.8,18,27,66.7,9,15,24,9,24,14,7,4,59,0
13277,309382,363_12_07,RUSSIA,0,TOTALS,RUSSIA,200,27,55,49.1,25,44,56.8,2,11,18.2,14,22,63.6,12,28,40,13,23,17,7,3,70,1
13278,309395,363_12_08,GERMANY,0,TOTALS,GERMANY,200,30,70,42.9,23,49,46.9,7,21,33.3,8,14,57.1,15,23,38,13,28,13,6,2,75,0
13279,309408,363_12_08,SPAIN,0,TOTALS,SPAIN,200,28,64,43.8,23,47,48.9,5,17,29.4,25,39,64.1,19,28,47,14,16,15,9,4,86,1
13280,309421,363_12_09,FRANCE,0,TOTALS,FRANCE,200,31,66,47.0,18,28,64.3,13,38,34.2,3,5,60.0,16,25,41,14,14,20,7,1,78,1
13281,309434,363_12_09,BULGARIA,0,TOTALS,BULGARIA,200,24,54,44.4,12,27,44.4,12,27,44.4,9,9,100.0,4,20,24,17,9,17,9,0,69,0
13282,309447,363_12_10,ITALY,0,TOTALS,ITALY,200,24,59,40.7,21,43,48.8,3,16,18.8,20,36,55.6,11,32,43,16,27,16,8,1,71,1
13283,309460,363_12_10,GREECE,0,TOTALS,GREECE,200,18,56,32.1,13,29,44.8,5,27,18.5,25,34,73.5,7,35,42,11,27,15,10,3,66,0
13284,309473,363_12_11,RUSSIA,0,TOTALS,RUSSIA,200,24,63,38.1,18,39,46.2,6,24,25.0,15,26,57.7,20,16,36,12,18,12,7,0,69,1
13285,309486,363_12_11,POLAND,0,TOTALS,POLAND,200,23,48,47.9,17,33,51.5,6,15,40.0,12,13,92.3,7,25,32,15,24,17,5,2,64,0
13286,309499,363_12_12,SPAIN,0,TOTALS,SPAIN,200,30,70,42.9,27,58,46.6,3,12,25.0,21,37,56.8,26,33,59,14,12,22,14,4,84,1
13287,309512,363_12_12,UKRAINE,0,TOTALS,UKRAINE,200,26,73,35.6,21,46,45.7,5,27,18.5,2,5,40.0,13,23,36,13,29,19,10,3,59,0
13288,309525,363_12_13,TURKEY,0,TOTALS,TURKEY,200,22,69,31.9,18,51,35.3,4,18,22.2,17,21,81.0,14,28,42,9,32,10,10,1,65,0
13289,309538,363_12_13,LATVIA,0,TOTALS,LATVIA,200,19,49,38.8,10,27,37.0,9,22,40.9,26,40,65.0,8,32,40,5,26,15,4,8,73,1
13290,309551,363_12_14,LITHUANIA,0,TOTALS,LITHUANIA,200,37,79,46.8,31,56,55.4,6,23,26.1,12,19,63.2,24,34,58,18,15,11,3,0,92,1
13291,309564,363_12_14,DENMARK,0,TOTALS,DENMARK,200,26,66,39.4,22,52,42.3,4,14,28.6,7,11,63.6,8,19,27,13,17,13,5,4,63,0
13292,309577,363_12_15,CROATIA,0,TOTALS,CROATIA,200,41,73,56.2,31,48,64.6,10,25,40.0,13,20,65.0,16,18,34,20,22,11,13,2,105,0
13293,309590,363_12_15,SLOVENIA,0,TOTALS,SLOVENIA,200,30,55,54.5,24,40,60.0,6,15,40.0,14,21,66.7,8,18,26,17,20,21,6,3,80,1
13294,309603,363_12_16,SERBIA,0,TOTALS,SERBIA,200,31,63,49.2,26,46,56.5,5,17,29.4,16,23,69.6,15,30,45,17,21,10,7,4,83,1
13295,309616,363_12_16,GERMANY,0,TOTALS,GERMANY,200,21,61,34.4,17,44,38.6,4,17,23.5,8,22,36.4,18,20,38,11,21,12,5,1,54,0
13296,309629,363_12_17,TURKEY,0,TOTALS,TURKEY,200,24,55,43.6,18,40,45.0,6,15,40.0,12,16,75.0,9,22,31,9,20,15,12,3,66,1
13297,309642,363_12_17,FRANCE,0,TOTALS,FRANCE,200,20,59,33.9,17,40,42.5,3,19,15.8,13,15,86.7,18,22,40,5,18,22,7,3,56,0
13298,309655,363_12_18,DENMARK,0,TOTALS,DENMARK,200,20,59,33.9,17,45,37.8,3,14,21.4,12,16,75.0,12,32,44,13,28,15,5,2,55,0
13299,309668,363_12_18,GREECE,0,TOTALS,GREECE,200,20,55,36.4,15,35,42.9,5,20,25.0,19,30,63.3,12,28,40,7,17,13,8,5,64,1
13300,309681,363_12_19,SLOVENIA,0,TOTALS,SLOVENIA,200,25,64,39.1,19,43,44.2,6,21,28.6,13,16,81.2,17,22,39,12,25,23,10,1,69,1
13301,309694,363_12_19,POLAND,0,TOTALS,POLAND,200,25,51,49.0,23,37,62.2,2,14,14.3,11,20,55.0,6,24,30,10,21,23,9,2,63,0
13302,309707,363_12_20,UKRAINE,0,TOTALS,UKRAINE,200,22,60,36.7,16,38,42.1,6,22,27.3,10,27,37.0,14,30,44,15,16,16,8,4,60,1
13303,309720,363_12_20,GERMANY,0,TOTALS,GERMANY,200,21,61,34.4,17,50,34.0,4,11,36.4,11,19,57.9,14,30,44,5,23,18,11,2,57,0
13304,309733,363_12_21,LATVIA,0,TOTALS,LATVIA,200,23,55,41.8,17,35,48.6,6,20,30.0,6,12,50.0,6,25,31,10,16,13,4,3,58,0
13305,309746,363_12_21,BULGARIA,0,TOTALS,BULGARIA,200,28,70,40.0,21,48,43.8,7,22,31.8,6,9,66.7,16,28,44,18,18,10,7,0,69,1
13306,309759,363_12_22,LITHUANIA,0,TOTALS,LITHUANIA,200,28,68,41.2,20,42,47.6,8,26,30.8,17,25,68.0,17,24,41,13,24,10,7,4,81,1
13307,309772,363_12_22,ITALY,0,TOTALS,ITALY,200,27,62,43.5,21,47,44.7,6,15,40.0,11,19,57.9,14,26,40,10,20,17,6,6,71,0
13308,309785,363_12_23,CROATIA,0,TOTALS,CROATIA,200,28,64,43.8,23,45,51.1,5,19,26.3,13,17,76.5,15,26,41,12,17,17,11,3,74,1
13309,309798,363_12_23,RUSSIA,0,TOTALS,RUSSIA,200,25,59,42.4,17,35,48.6,8,24,33.3,5,11,45.5,10,22,32,15,18,20,11,10,63,0
13310,309811,363_12_24,SPAIN,0,TOTALS,SPAIN,200,28,66,42.4,21,44,47.7,7,22,31.8,20,25,80.0,15,33,48,10,17,16,3,3,83,1
13311,309824,363_12_24,SERBIA,0,TOTALS,SERBIA,200,26,70,37.1,18,50,36.0,8,20,40.0,8,15,53.3,14,22,36,11,22,12,9,2,68,0
13312,309837,363_12_25,GERMANY,0,TOTALS,GERMANY,200,26,74,35.1,23,51,45.1,3,23,13.0,9,12,75.0,22,25,47,10,18,16,12,0,64,1
13313,309850,363_12_25,POLAND,0,TOTALS,POLAND,200,21,49,42.9,18,37,48.6,3,12,25.0,9,18,50.0,9,26,35,13,18,25,6,1,54,0
13314,309863,363_12_26,GREECE,0,TOTALS,GREECE,200,16,60,26.7,9,32,28.1,7,28,25.0,13,17,76.5,12,24,36,7,21,15,10,7,52,0
13315,309876,363_12_26,SPAIN,0,TOTALS,SPAIN,200,23,59,39.0,20,45,44.4,3,14,21.4,16,28,57.1,17,30,47,12,16,15,5,6,65,1
13316,309889,363_12_27,SLOVENIA,0,TOTALS,SLOVENIA,200,33,65,50.8,24,39,61.5,9,26,34.6,9,12,75.0,10,20,30,16,14,10,8,3,84,1
13317,309902,363_12_27,BULGARIA,0,TOTALS,BULGARIA,200,33,60,55.0,22,34,64.7,11,26,42.3,4,4,100.0,6,20,26,23,21,15,5,2,81,0
13318,309915,363_12_28,DENMARK,0,TOTALS,DENMARK,200,19,53,35.8,13,34,38.2,6,19,31.6,17,21,81.0,7,21,28,12,19,12,7,3,61,0
13319,309928,363_12_28,FRANCE,0,TOTALS,FRANCE,200,27,67,40.3,24,46,52.2,3,21,14.3,10,14,71.4,19,30,49,5,15,13,6,4,67,1
13320,309941,363_12_29,LITHUANIA,0,TOTALS,LITHUANIA,200,29,62,46.8,24,40,60.0,5,22,22.7,11,19,57.9,9,35,44,20,19,15,10,4,74,1
13321,309954,363_12_29,UKRAINE,0,TOTALS,UKRAINE,200,20,73,27.4,19,54,35.2,1,19,5.3,9,13,69.2,20,30,50,6,19,17,8,1,50,0
13322,309967,363_12_30,RUSSIA,0,TOTALS,RUSSIA,200,24,57,42.1,19,40,47.5,5,17,29.4,11,19,57.9,13,22,35,12,24,16,5,3,64,0
13323,309980,363_12_30,LATVIA,0,TOTALS,LATVIA,200,22,47,46.8,17,33,51.5,5,14,35.7,21,28,75.0,5,19,24,8,25,15,10,5,70,1
13324,309993,363_12_31,ITALY,0,TOTALS,ITALY,200,30,73,41.1,24,55,43.6,6,18,33.3,8,13,61.5,14,27,41,12,30,10,6,4,74,0
13325,310006,363_12_31,SERBIA,0,TOTALS,SERBIA,200,27,62,43.5,23,50,46.0,4,12,33.3,20,35,57.1,14,29,43,8,18,13,4,5,78,1
13326,310019,363_12_32,CROATIA,0,TOTALS,CROATIA,200,25,59,42.4,20,37,54.1,5,22,22.7,23,32,71.9,13,32,45,14,23,21,10,3,78,1
13327,310032,363_12_32,TURKEY,0,TOTALS,TURKEY,200,25,71,35.2,21,48,43.8,4,23,17.4,8,15,53.3,13,21,34,14,28,18,11,1,62,0
13328,310045,363_12_33,FRANCE,0,TOTALS,FRANCE,200,22,61,36.1,18,44,40.9,4,17,23.5,9,14,64.3,15,27,42,4,15,14,9,3,57,1
13329,310058,363_12_33,GERMANY,0,TOTALS,GERMANY,200,21,53,39.6,18,44,40.9,3,9,33.3,6,11,54.5,8,24,32,11,18,17,6,5,51,0
13330,310071,363_12_34,UKRAINE,0,TOTALS,UKRAINE,200,26,60,43.3,23,46,50.0,3,14,21.4,6,9,66.7,11,31,42,9,18,19,5,0,61,0
13331,310084,363_12_34,GREECE,0,TOTALS,GREECE,200,24,67,35.8,17,49,34.7,7,18,38.9,11,21,52.4,16,25,41,12,17,14,12,5,66,1
13332,310097,363_12_35,BULGARIA,0,TOTALS,BULGARIA,200,18,56,32.1,14,42,33.3,4,14,28.6,13,17,76.5,12,26,38,5,25,17,10,1,53,0
13333,310110,363_12_35,RUSSIA,0,TOTALS,RUSSIA,200,19,56,33.9,14,39,35.9,5,17,29.4,13,22,59.1,14,28,42,9,19,18,7,2,56,1
13334,310123,363_12_36,POLAND,0,TOTALS,POLAND,200,23,71,32.4,19,43,44.2,4,28,14.3,2,4,50.0,18,29,47,10,20,13,6,0,52,0
13335,310136,363_12_36,DENMARK,0,TOTALS,DENMARK,200,19,70,27.1,12,42,28.6,7,28,25.0,14,17,82.4,24,30,54,10,16,12,5,3,59,1
13336,310149,363_12_37,SERBIA,0,TOTALS,SERBIA,200,30,60,50.0,30,46,65.2,0,14,0.0,8,12,66.7,13,21,34,11,18,12,2,2,68,0
13337,310162,363_12_37,LITHUANIA,0,TOTALS,LITHUANIA,200,30,66,45.5,23,48,47.9,7,18,38.9,10,14,71.4,16,18,34,16,12,7,8,3,77,1
13338,310175,363_12_38,LATVIA,0,TOTALS,LATVIA,200,23,59,39.0,19,41,46.3,4,18,22.2,12,18,66.7,4,22,26,9,19,15,8,1,62,0
13339,310188,363_12_38,CROATIA,0,TOTALS,CROATIA,200,30,62,48.4,21,41,51.2,9,21,42.9,13,14,92.9,11,33,44,16,23,18,8,3,82,1
13340,310201,363_12_39,SPAIN,0,TOTALS,SPAIN,200,30,66,45.5,24,50,48.0,6,16,37.5,12,20,60.0,18,28,46,13,17,13,9,6,78,1
13341,310214,363_12_39,ITALY,0,TOTALS,ITALY,200,25,67,37.3,17,42,40.5,8,25,32.0,5,8,62.5,15,20,35,14,19,19,6,5,63,0
13342,310227,363_12_40,TURKEY,0,TOTALS,TURKEY,200,34,58,58.6,32,48,66.7,2,10,20.0,18,25,72.0,13,27,40,12,24,17,6,2,88,1
13343,310240,363_12_40,SLOVENIA,0,TOTALS,SLOVENIA,200,26,60,43.3,21,41,51.2,5,19,26.3,28,31,90.3,9,12,21,13,23,10,5,0,85,0
13344,310253,363_12_41,GERMANY,0,TOTALS,GERMANY,200,27,63,42.9,21,45,46.7,6,18,33.3,15,24,62.5,10,30,40,17,16,13,5,2,75,1
13345,310266,363_12_41,DENMARK,0,TOTALS,DENMARK,200,22,66,33.3,18,51,35.3,4,15,26.7,13,19,68.4,15,28,43,13,26,14,9,2,61,0
13346,310279,363_12_42,GREECE,0,TOTALS,GREECE,200,19,55,34.5,12,30,40.0,7,25,28.0,14,20,70.0,11,22,33,13,21,10,4,5,59,0
13347,310292,363_12_42,SERBIA,0,TOTALS,SERBIA,200,23,58,39.7,16,37,43.2,7,21,33.3,11,23,47.8,19,27,46,13,17,14,3,2,64,1
13348,310305,363_12_43,CROATIA,0,TOTALS,CROATIA,200,23,64,35.9,12,35,34.3,11,29,37.9,8,16,50.0,14,22,36,13,16,16,9,5,65,0
13349,310318,363_12_43,BULGARIA,0,TOTALS,BULGARIA,200,31,62,50.0,23,41,56.1,8,21,38.1,14,16,87.5,10,29,39,18,17,13,13,2,84,1
13350,310331,363_12_44,FRANCE,0,TOTALS,FRANCE,200,33,57,57.9,25,40,62.5,8,17,47.1,9,11,81.8,6,29,35,13,14,16,6,4,83,1
13351,310344,363_12_44,POLAND,0,TOTALS,POLAND,200,25,60,41.7,21,46,45.7,4,14,28.6,8,16,50.0,10,18,28,8,17,15,11,1,62,0
13352,310357,363_12_45,LITHUANIA,0,TOTALS,LITHUANIA,200,28,67,41.8,25,48,52.1,3,19,15.8,13,19,68.4,19,30,49,16,17,20,7,4,72,1
13353,310370,363_12_45,SPAIN,0,TOTALS,SPAIN,200,24,64,37.5,17,44,38.6,7,20,35.0,10,13,76.9,10,21,31,14,22,16,8,6,65,0
13354,310383,363_12_46,SLOVENIA,0,TOTALS,SLOVENIA,200,21,51,41.2,17,36,47.2,4,15,26.7,14,18,77.8,6,13,19,10,21,12,9,1,60,0
13355,310396,363_12_46,LATVIA,0,TOTALS,LATVIA,200,22,48,45.8,17,34,50.0,5,14,35.7,12,15,80.0,15,25,40,3,19,25,6,7,61,1
13356,310409,363_12_47,ITALY,0,TOTALS,ITALY,200,29,58,50.0,22,39,56.4,7,19,36.8,11,14,78.6,12,32,44,13,19,24,10,3,76,1
13357,310422,363_12_47,UKRAINE,0,TOTALS,UKRAINE,200,17,55,30.9,12,37,32.4,5,18,27.8,12,20,60.0,9,20,29,10,15,19,12,2,51,0
13358,310435,363_12_48,RUSSIA,0,TOTALS,RUSSIA,200,20,58,34.5,14,38,36.8,6,20,30.0,25,39,64.1,16,28,44,8,22,13,5,5,71,1
13359,310448,363_12_48,TURKEY,0,TOTALS,TURKEY,200,22,60,36.7,19,46,41.3,3,14,21.4,20,31,64.5,12,27,39,15,30,11,7,2,67,0
13360,310461,363_12_49,POLAND,0,TOTALS,POLAND,200,18,60,30.0,14,42,33.3,4,18,22.2,12,16,75.0,13,19,32,14,21,17,10,3,52,0
13361,310474,363_12_49,GERMANY,0,TOTALS,GERMANY,200,27,54,50.0,22,40,55.0,5,14,35.7,15,18,83.3,10,27,37,11,17,18,7,4,74,1
13362,310487,363_12_50,SPAIN,0,TOTALS,SPAIN,200,21,55,38.2,20,45,44.4,1,10,10.0,13,15,86.7,15,21,36,2,14,20,8,5,56,0
13363,310500,363_12_50,RUSSIA,0,TOTALS,RUSSIA,200,25,57,43.9,23,43,53.5,2,14,14.3,6,7,85.7,10,19,29,16,17,16,8,2,58,1
13364,310513,363_12_51,FRANCE,0,TOTALS,FRANCE,200,27,69,39.1,23,49,46.9,4,20,20.0,18,24,75.0,24,27,51,11,14,17,11,2,76,1
13365,310526,363_12_51,DENMARK,0,TOTALS,DENMARK,200,27,67,40.3,18,45,40.0,9,22,40.9,7,9,77.8,12,18,30,8,24,13,7,1,70,0
13366,310539,363_12_52,BULGARIA,0,TOTALS,BULGARIA,200,28,60,46.7,19,35,54.3,9,25,36.0,14,17,82.4,10,16,26,17,23,12,8,2,79,0
13367,310552,363_12_52,SERBIA,0,TOTALS,SERBIA,200,27,57,47.4,18,38,47.4,9,19,47.4,25,29,86.2,15,24,39,13,19,16,9,2,88,1
13368,310565,363_12_53,LITHUANIA,0,TOTALS,LITHUANIA,200,22,58,37.9,17,45,37.8,5,13,38.5,16,24,66.7,10,34,44,14,21,7,8,4,65,1
13369,310578,363_12_53,LATVIA,0,TOTALS,LATVIA,200,18,62,29.0,13,41,31.7,5,21,23.8,12,18,66.7,11,30,41,6,22,10,4,3,53,0
13370,310591,363_12_54,GREECE,0,TOTALS,GREECE,200,20,54,37.0,14,38,36.8,6,16,37.5,27,39,69.2,9,19,28,13,27,15,9,2,73,0
13371,310604,363_12_54,SLOVENIA,0,TOTALS,SLOVENIA,200,23,48,47.9,16,30,53.3,7,18,38.9,25,34,73.5,9,28,37,10,34,21,6,1,78,1
13372,310617,363_12_55,CROATIA,0,TOTALS,CROATIA,200,25,61,41.0,17,37,45.9,8,24,33.3,18,31,58.1,16,32,48,13,21,16,7,6,76,1
13373,310630,363_12_55,ITALY,0,TOTALS,ITALY,200,26,67,38.8,17,39,43.6,9,28,32.1,8,11,72.7,12,28,40,15,28,14,8,2,69,0
13374,310643,363_12_56,TURKEY,0,TOTALS,TURKEY,200,30,68,44.1,28,59,47.5,2,9,22.2,8,10,80.0,17,28,45,17,24,14,11,2,70,1
13375,310656,363_12_56,UKRAINE,0,TOTALS,UKRAINE,200,19,57,33.3,13,36,36.1,6,21,28.6,16,28,57.1,17,21,38,8,16,19,6,1,60,0
13376,310669,363_12_57,DENMARK,0,TOTALS,DENMARK,200,21,72,29.2,16,42,38.1,5,30,16.7,7,14,50.0,20,22,42,12,17,17,13,0,54,0
13377,310682,363_12_57,POLAND,0,TOTALS,POLAND,200,21,50,42.0,17,34,50.0,4,16,25.0,13,17,76.5,10,32,42,12,17,24,7,1,59,1
13378,310695,363_12_58,LATVIA,0,TOTALS,LATVIA,200,29,67,43.3,22,44,50.0,7,23,30.4,16,21,76.2,17,21,38,15,13,9,12,2,81,1
13379,310708,363_12_58,BULGARIA,0,TOTALS,BULGARIA,200,24,60,40.0,17,42,40.5,7,18,38.9,9,11,81.8,15,23,38,12,21,17,7,3,64,0
13380,310721,363_12_59,GERMANY,0,TOTALS,GERMANY,200,26,56,46.4,23,41,56.1,3,15,20.0,5,11,45.5,9,27,36,9,26,19,5,2,60,1
13381,310734,363_12_59,FRANCE,0,TOTALS,FRANCE,200,17,56,30.4,14,37,37.8,3,19,15.8,20,27,74.1,13,23,36,5,19,13,9,6,57,0
13382,310747,363_12_60,SPAIN,0,TOTALS,SPAIN,200,25,62,40.3,18,41,43.9,7,21,33.3,13,17,76.5,9,33,42,12,18,17,9,8,70,1
13383,310760,363_12_60,ITALY,0,TOTALS,ITALY,200,22,67,32.8,15,47,31.9,7,20,35.0,12,15,80.0,13,29,42,9,20,16,8,1,63,0
13384,310773,363_12_61,LITHUANIA,0,TOTALS,LITHUANIA,200,29,59,49.2,24,40,60.0,5,19,26.3,6,9,66.7,12,23,35,10,21,17,8,1,69,1
13385,310786,363_12_61,SERBIA,0,TOTALS,SERBIA,200,22,56,39.3,19,46,41.3,3,10,30.0,20,23,87.0,11,20,31,5,19,12,7,4,67,0
13386,310799,363_12_62,GREECE,0,TOTALS,GREECE,200,31,59,52.5,26,46,56.5,5,13,38.5,16,28,57.1,12,24,36,15,21,16,11,4,83,1
13387,310812,363_12_62,UKRAINE,0,TOTALS,UKRAINE,200,24,61,39.3,21,48,43.8,3,13,23.1,18,24,75.0,12,22,34,15,26,19,11,3,69,0
13388,310825,363_12_63,RUSSIA,0,TOTALS,RUSSIA,200,23,62,37.1,17,41,41.5,6,21,28.6,5,9,55.6,11,27,38,13,21,18,7,1,57,0
13389,310838,363_12_63,CROATIA,0,TOTALS,CROATIA,200,20,56,35.7,16,38,42.1,4,18,22.2,17,22,77.3,11,29,40,8,20,17,13,2,61,1
13390,310851,363_12_64,SLOVENIA,0,TOTALS,SLOVENIA,200,23,61,37.7,17,40,42.5,6,21,28.6,9,13,69.2,13,16,29,14,19,11,4,2,61,0
13391,310864,363_12_64,TURKEY,0,TOTALS,TURKEY,200,32,62,51.6,28,50,56.0,4,12,33.3,13,20,65.0,18,27,45,17,15,13,6,4,81,1
13392,310877,363_12_65,DENMARK,0,TOTALS,DENMARK,200,21,73,28.8,18,52,34.6,3,21,14.3,20,31,64.5,21,27,48,14,19,15,4,2,65,0
13393,310890,363_12_65,GERMANY,0,TOTALS,GERMANY,200,36,73,49.3,25,48,52.1,11,25,44.0,14,20,70.0,12,37,49,21,28,14,9,4,97,1
13394,310903,363_12_66,BULGARIA,0,TOTALS,BULGARIA,200,22,56,39.3,18,41,43.9,4,15,26.7,17,24,70.8,12,21,33,6,19,24,9,2,65,0
13395,310916,363_12_66,ITALY,0,TOTALS,ITALY,200,32,64,50.0,25,40,62.5,7,24,29.2,13,17,76.5,10,25,35,18,22,18,17,3,84,1
13396,310929,363_12_67,POLAND,0,TOTALS,POLAND,200,19,51,37.3,14,32,43.8,5,19,26.3,9,16,56.2,8,28,36,13,22,15,5,2,52,0
13397,310942,363_12_67,FRANCE,0,TOTALS,FRANCE,200,27,63,42.9,22,45,48.9,5,18,27.8,17,25,68.0,13,26,39,12,17,7,8,1,76,1
13398,310955,363_12_68,LATVIA,0,TOTALS,LATVIA,200,19,52,36.5,17,39,43.6,2,13,15.4,11,18,61.1,6,18,24,9,22,18,5,0,51,0
13399,310968,363_12_68,SPAIN,0,TOTALS,SPAIN,200,30,61,49.2,26,44,59.1,4,17,23.5,16,22,72.7,14,29,43,16,20,17,9,4,80,1
13400,310981,363_12_69,SERBIA,0,TOTALS,SERBIA,200,25,54,46.3,21,44,47.7,4,10,40.0,12,19,63.2,10,30,40,11,22,15,5,1,66,1
13401,310994,363_12_69,RUSSIA,0,TOTALS,RUSSIA,200,22,61,36.1,18,43,41.9,4,18,22.2,8,12,66.7,11,22,33,11,17,10,7,2,56,0
13402,311007,363_12_70,LITHUANIA,0,TOTALS,LITHUANIA,200,28,65,43.1,21,48,43.8,7,17,41.2,13,19,68.4,11,25,36,10,23,15,3,2,76,0
13403,311020,363_12_70,CROATIA,0,TOTALS,CROATIA,200,32,65,49.2,25,43,58.1,7,22,31.8,17,24,70.8,12,27,39,19,25,14,13,4,88,1
13404,311033,364_12_01,SCOTLAND,0,TOTALS,SCOTLAND,200,18,50,36.0,13,35,37.1,5,15,33.3,3,7,42.9,4,22,26,4,23,28,13,0,44,0
13405,311046,364_12_01,HUNGARY,0,TOTALS,HUNGARY,200,29,72,40.3,22,46,47.8,7,26,26.9,11,19,57.9,17,28,45,21,13,18,13,1,76,1
13406,311059,364_12_02,ENGLAND,0,TOTALS,ENGLAND,200,30,76,39.5,27,62,43.5,3,14,21.4,8,17,47.1,17,37,54,7,18,16,11,6,71,1
13407,311072,364_12_02,ISRAEL,0,TOTALS,ISRAEL,200,22,75,29.3,19,59,32.2,3,16,18.8,11,15,73.3,16,34,50,11,20,15,7,8,58,0
13408,311085,364_12_03,SWEDEN,0,TOTALS,SWEDEN,200,45,88,51.1,38,72,52.8,7,16,43.8,13,23,56.5,23,38,61,17,18,13,15,5,110,0
13409,311098,364_12_03,NORWAY,0,TOTALS,NORWAY,200,21,55,38.2,17,41,41.5,4,14,28.6,9,18,50.0,7,27,34,5,19,19,7,0,55,1
13410,311111,364_12_04,ROMANIA,0,TOTALS,ROMANIA,200,29,77,37.7,26,56,46.4,3,21,14.3,10,26,38.5,18,33,51,9,25,14,7,1,71,1
13411,311124,364_12_04,BELARUS,0,TOTALS,BELARUS,200,22,65,33.8,18,53,34.0,4,12,33.3,14,30,46.7,11,35,46,6,23,21,8,2,62,0
13412,311137,364_12_05,CZECH REPUBLIC,0,TOTALS,CZECH REPUBLIC,200,32,66,48.5,24,43,55.8,8,23,34.8,7,14,50.0,15,35,50,13,17,20,8,11,79,1
13413,311150,364_12_05,LUXEMBOURG,0,TOTALS,LUXEMBOURG,200,23,71,32.4,13,48,27.1,10,23,43.5,13,17,76.5,14,20,34,10,14,15,8,1,69,0
13414,311163,364_12_06,FINLAND,0,TOTALS,FINLAND,200,29,61,47.5,18,36,50.0,11,25,44.0,2,3,66.7,8,32,40,15,15,16,5,3,71,0
13415,311176,364_12_06,MONTENEGRO,0,TOTALS,MONTENEGRO,200,31,75,41.3,24,53,45.3,7,22,31.8,7,9,77.8,16,27,43,12,11,8,13,2,76,1
13416,311189,364_12_07,AUSTRIA,0,TOTALS,AUSTRIA,200,20,59,33.9,17,44,38.6,3,15,20.0,14,30,46.7,20,26,46,9,26,21,2,0,57,0
13417,311202,364_12_07,ESTONIA,0,TOTALS,ESTONIA,200,25,54,46.3,21,35,60.0,4,19,21.1,23,28,82.1,5,26,31,14,26,7,13,1,77,1
13418,311215,364_12_08,ICELAND,0,TOTALS,ICELAND,200,31,61,50.8,22,39,56.4,9,22,40.9,18,26,69.2,4,35,39,15,24,16,7,4,89,1
13419,311228,364_12_08,SWITZERLAND,0,TOTALS,SWITZERLAND,200,24,66,36.4,19,44,43.2,5,22,22.7,18,31,58.1,13,31,44,10,23,20,11,2,71,0
13420,311241,364_12_09,NETHERLANDS,0,TOTALS,NETHERLANDS,250,29,70,41.4,22,42,52.4,7,28,25.0,14,26,53.8,11,28,39,12,16,14,8,1,79,0
13421,311254,364_12_09,PORTUGAL,0,TOTALS,PORTUGAL,250,29,64,45.3,16,34,47.1,13,30,43.3,14,16,87.5,6,37,43,19,22,21,7,1,85,1
13422,311267,364_12_10,BOSNIA AND HERZEGOVINA,0,TOTALS,BOSNIA AND HERZEGOVINA,200,29,61,47.5,23,38,60.5,6,23,26.1,15,27,55.6,12,28,40,17,16,14,12,5,79,1
13423,311280,364_12_10,BELGIUM,0,TOTALS,BELGIUM,200,27,58,46.6,22,41,53.7,5,17,29.4,6,12,50.0,10,24,34,12,28,19,8,1,65,0
13424,311293,364_12_11,SLOVAK REPUBLIC,0,TOTALS,SLOVAK REPUBLIC,200,17,60,28.3,11,33,33.3,6,27,22.2,5,12,41.7,7,29,36,10,19,10,3,1,45,0
13425,311306,364_12_11,CZECH REPUBLIC,0,TOTALS,CZECH REPUBLIC,200,29,66,43.9,23,47,48.9,6,19,31.6,14,18,77.8,10,42,52,15,17,5,7,2,78,1
13426,311319,364_12_12,NORWAY,0,TOTALS,NORWAY,200,20,73,27.4,18,52,34.6,2,21,9.5,7,12,58.3,15,30,45,8,11,20,8,5,49,0
13427,311332,364_12_12,FINLAND,0,TOTALS,FINLAND,200,28,76,36.8,15,42,35.7,13,34,38.2,5,10,50.0,19,40,59,18,19,18,12,7,74,1
13428,311345,364_12_13,GEORGIA,0,TOTALS,GEORGIA,200,18,57,31.6,16,37,43.2,2,20,10.0,12,23,52.2,6,23,29,5,18,14,9,1,50,0
13429,311358,364_12_13,NETHERLANDS,0,TOTALS,NETHERLANDS,200,36,69,52.2,23,39,59.0,13,30,43.3,7,10,70.0,13,39,52,19,18,16,5,1,92,1
13430,311371,364_12_14,LUXEMBOURG,0,TOTALS,LUXEMBOURG,200,22,57,38.6,19,40,47.5,3,17,17.6,16,23,69.6,13,27,40,12,24,13,5,1,63,0
13431,311384,364_12_14,AUSTRIA,0,TOTALS,AUSTRIA,200,27,68,39.7,20,43,46.5,7,25,28.0,14,23,60.9,16,31,47,17,25,13,8,7,75,1
13432,311397,364_12_15,ISRAEL,0,TOTALS,ISRAEL,200,33,74,44.6,25,46,54.3,8,28,28.6,19,27,70.4,16,36,52,19,15,20,22,3,93,1
13433,311410,364_12_15,SCOTLAND,0,TOTALS,SCOTLAND,200,16,60,26.7,11,41,26.8,5,19,26.3,6,11,54.5,10,26,36,8,19,33,8,2,43,0
13434,311423,364_12_16,SWITZERLAND,0,TOTALS,SWITZERLAND,200,15,55,27.3,10,38,26.3,5,17,29.4,9,16,56.2,13,18,31,5,23,24,4,0,44,0
13435,311436,364_12_16,SWEDEN,0,TOTALS,SWEDEN,200,35,69,50.7,32,60,53.3,3,9,33.3,16,22,72.7,17,35,52,12,21,15,12,3,89,1
13436,311449,364_12_17,PORTUGAL,0,TOTALS,PORTUGAL,200,20,69,29.0,17,38,44.7,3,31,9.7,5,8,62.5,14,13,27,10,25,17,6,0,48,0
13437,311462,364_12_17,BOSNIA AND HERZEGOVINA,0,TOTALS,BOSNIA AND HERZEGOVINA,200,29,50,58.0,25,35,71.4,4,15,26.7,16,30,53.3,13,40,53,15,17,24,11,3,78,1
13438,311475,364_12_18,HUNGARY,0,TOTALS,HUNGARY,200,33,67,49.3,25,47,53.2,8,20,40.0,12,16,75.0,14,24,38,24,22,10,12,1,86,1
13439,311488,364_12_18,ROMANIA,0,TOTALS,ROMANIA,200,18,48,37.5,13,34,38.2,5,14,35.7,16,28,57.1,12,24,36,11,19,27,6,1,57,0
13440,311501,364_12_19,BELARUS,0,TOTALS,BELARUS,200,17,55,30.9,9,28,32.1,8,27,29.6,21,36,58.3,9,30,39,8,18,24,11,7,63,0
13441,311514,364_12_19,ENGLAND,0,TOTALS,ENGLAND,200,29,72,40.3,25,58,43.1,4,14,28.6,14,23,60.9,18,32,50,11,25,22,13,3,76,1
13442,311527,364_12_20,MONTENEGRO,0,TOTALS,MONTENEGRO,200,23,54,42.6,17,35,48.6,6,19,31.6,16,25,64.0,9,28,37,12,19,16,2,3,68,0
13443,311540,364_12_20,ICELAND,0,TOTALS,ICELAND,200,31,67,46.3,21,46,45.7,10,21,47.6,8,15,53.3,13,25,38,20,26,8,4,0,80,1
13444,311553,364_12_21,ESTONIA,0,TOTALS,ESTONIA,200,27,76,35.5,19,42,45.2,8,34,23.5,3,4,75.0,17,34,51,18,20,15,3,0,65,1
13445,311566,364_12_21,LUXEMBOURG,0,TOTALS,LUXEMBOURG,200,21,62,33.9,17,47,36.2,4,15,26.7,17,23,73.9,11,32,43,13,13,11,6,0,63,0
13446,311579,364_12_22,FINLAND,0,TOTALS,FINLAND,200,29,61,47.5,22,39,56.4,7,22,31.8,26,35,74.3,11,29,40,14,24,20,10,2,91,1
13447,311592,364_12_22,SWEDEN,0,TOTALS,SWEDEN,200,29,73,39.7,25,60,41.7,4,13,30.8,14,27,51.9,21,22,43,17,29,19,9,1,76,0
13448,311605,364_12_23,BELGIUM,0,TOTALS,BELGIUM,200,24,51,47.1,19,38,50.0,5,13,38.5,18,31,58.1,9,32,41,19,18,24,12,4,71,1
13449,311618,364_12_23,PORTUGAL,0,TOTALS,PORTUGAL,200,13,51,25.5,9,31,29.0,4,20,20.0,15,20,75.0,9,25,34,6,27,22,9,1,45,0
13450,311631,364_12_24,ENGLAND,0,TOTALS,ENGLAND,200,22,54,40.7,17,42,40.5,5,12,41.7,11,17,64.7,13,24,37,12,16,22,4,6,60,1
13451,311644,364_12_24,ROMANIA,0,TOTALS,ROMANIA,200,20,60,33.3,16,45,35.6,4,15,26.7,11,15,73.3,21,24,45,8,24,24,6,2,55,0
13452,311657,364_12_25,ISRAEL,0,TOTALS,ISRAEL,200,26,68,38.2,20,43,46.5,6,25,24.0,20,35,57.1,18,31,49,10,23,11,10,1,78,1
13453,311670,364_12_25,HUNGARY,0,TOTALS,HUNGARY,200,22,61,36.1,16,39,41.0,6,22,27.3,8,19,42.1,13,28,41,12,27,19,6,3,58,0
13454,311683,364_12_26,AUSTRIA,0,TOTALS,AUSTRIA,200,21,49,42.9,18,37,48.6,3,12,25.0,11,29,37.9,14,31,45,10,19,17,7,1,56,1
13455,311696,364_12_26,SLOVAK REPUBLIC,0,TOTALS,SLOVAK REPUBLIC,200,21,59,35.6,16,35,45.7,5,24,20.8,5,9,55.6,5,19,24,13,23,12,10,1,52,0
13456,311709,364_12_27,BOSNIA AND HERZEGOVINA,0,TOTALS,BOSNIA AND HERZEGOVINA,200,30,63,47.6,26,46,56.5,4,17,23.5,21,32,65.6,19,26,45,20,20,16,8,3,85,1
13457,311722,364_12_27,GEORGIA,0,TOTALS,GEORGIA,200,27,63,42.9,20,41,48.8,7,22,31.8,13,20,65.0,14,18,32,10,24,14,10,0,74,0
13458,311735,364_12_28,MONTENEGRO,0,TOTALS,MONTENEGRO,200,34,66,51.5,32,54,59.3,2,12,16.7,7,18,38.9,9,28,37,12,21,20,15,3,77,1
13459,311748,364_12_28,SWITZERLAND,0,TOTALS,SWITZERLAND,200,21,63,33.3,18,46,39.1,3,17,17.6,12,18,66.7,15,29,44,7,18,27,10,0,57,0
13460,311761,364_12_29,ICELAND,0,TOTALS,ICELAND,200,29,73,39.7,21,41,51.2,8,32,25.0,15,23,65.2,13,34,47,15,14,7,8,0,81,1
13461,311774,364_12_29,NORWAY,0,TOTALS,NORWAY,200,22,66,33.3,17,38,44.7,5,28,17.9,16,20,80.0,12,33,45,11,16,13,1,1,65,0
13462,311787,364_12_30,SCOTLAND,0,TOTALS,SCOTLAND,200,19,60,31.7,16,44,36.4,3,16,18.8,11,25,44.0,13,30,43,12,20,26,7,1,52,0
13463,311800,364_12_30,BELARUS,0,TOTALS,BELARUS,200,26,75,34.7,17,49,34.7,9,26,34.6,17,27,63.0,21,36,57,22,24,22,12,5,78,1
13464,311813,364_12_31,SWEDEN,0,TOTALS,SWEDEN,200,32,59,54.2,24,46,52.2,8,13,61.5,20,27,74.1,12,27,39,17,19,22,3,6,92,1
13465,311826,364_12_31,ICELAND,0,TOTALS,ICELAND,200,31,72,43.1,21,49,42.9,10,23,43.5,11,15,73.3,15,12,27,14,28,15,11,2,83,0
13466,311839,364_12_32,HUNGARY,0,TOTALS,HUNGARY,200,26,72,36.1,24,53,45.3,2,19,10.5,4,13,30.8,17,27,44,10,26,17,11,8,58,0
13467,311852,364_12_32,ENGLAND,0,TOTALS,ENGLAND,200,20,57,35.1,17,46,37.0,3,11,27.3,20,35,57.1,14,33,47,6,19,20,8,4,63,1
13468,311865,364_12_33,CZECH REPUBLIC,0,TOTALS,CZECH REPUBLIC,200,35,66,53.0,25,40,62.5,10,26,38.5,10,12,83.3,16,30,46,19,24,11,8,1,90,1
13469,311878,364_12_33,AUSTRIA,0,TOTALS,AUSTRIA,200,19,53,35.8,16,29,55.2,3,24,12.5,15,24,62.5,9,19,28,10,17,12,7,2,56,0
13470,311891,364_12_34,NETHERLANDS,0,TOTALS,NETHERLANDS,200,21,59,35.6,14,36,38.9,7,23,30.4,9,15,60.0,17,30,47,11,26,28,4,7,58,0
13471,311904,364_12_34,BOSNIA AND HERZEGOVINA,0,TOTALS,BOSNIA AND HERZEGOVINA,200,22,54,40.7,21,44,47.7,1,10,10.0,21,34,61.8,17,25,42,7,20,18,15,2,66,1
13472,311917,364_12_35,ROMANIA,0,TOTALS,ROMANIA,200,33,75,44.0,26,47,55.3,7,28,25.0,8,17,47.1,29,23,52,13,18,16,12,5,81,1
13473,311930,364_12_35,SCOTLAND,0,TOTALS,SCOTLAND,200,20,55,36.4,16,43,37.2,4,12,33.3,9,10,90.0,13,18,31,9,16,22,10,1,53,0
13474,311943,364_12_36,NORWAY,0,TOTALS,NORWAY,200,27,69,39.1,16,37,43.2,11,32,34.4,12,14,85.7,5,36,41,20,17,8,1,0,77,0
13475,311956,364_12_36,MONTENEGRO,0,TOTALS,MONTENEGRO,200,34,78,43.6,23,39,59.0,11,39,28.2,8,18,44.4,14,37,51,25,15,6,3,0,87,1
13476,311969,364_12_37,GEORGIA,0,TOTALS,GEORGIA,200,19,48,39.6,12,26,46.2,7,22,31.8,8,12,66.7,5,32,37,9,24,27,2,0,53,0
13477,311982,364_12_37,BELGIUM,0,TOTALS,BELGIUM,200,23,70,32.9,17,46,37.0,6,24,25.0,13,22,59.1,18,23,41,13,17,10,7,0,65,1
13478,311995,364_12_38,BELARUS,0,TOTALS,BELARUS,200,17,60,28.3,13,36,36.1,4,24,16.7,18,27,66.7,17,34,51,7,19,26,6,3,56,0
13479,312008,364_12_38,ISRAEL,0,TOTALS,ISRAEL,200,32,68,47.1,25,52,48.1,7,16,43.8,11,26,42.3,7,28,35,18,22,15,15,0,82,1
13480,312021,364_12_39,SLOVAK REPUBLIC,0,TOTALS,SLOVAK REPUBLIC,200,20,59,33.9,11,36,30.6,9,23,39.1,16,26,61.5,9,28,37,9,22,13,12,4,65,0
13481,312034,364_12_39,ESTONIA,0,TOTALS,ESTONIA,200,24,60,40.0,19,38,50.0,5,22,22.7,14,25,56.0,14,33,47,10,23,16,9,3,67,1
13482,312047,364_12_40,SWITZERLAND,0,TOTALS,SWITZERLAND,200,17,50,34.0,16,42,38.1,1,8,12.5,16,19,84.2,12,25,37,10,15,28,9,0,51,0
13483,312060,364_12_40,FINLAND,0,TOTALS,FINLAND,200,26,59,44.1,21,37,56.8,5,22,22.7,10,14,71.4,6,22,28,18,17,19,6,2,67,1
13484,312073,364_12_41,BELARUS,0,TOTALS,BELARUS,200,30,62,48.4,18,34,52.9,12,28,42.9,11,17,64.7,15,25,40,18,22,24,9,1,83,0
13485,312086,364_12_41,HUNGARY,0,TOTALS,HUNGARY,200,31,68,45.6,23,48,47.9,8,20,40.0,14,19,73.7,13,21,34,21,18,16,10,2,84,1
13486,312099,364_12_42,ISRAEL,0,TOTALS,ISRAEL,200,37,68,54.4,30,46,65.2,7,22,31.8,19,34,55.9,12,25,37,23,15,10,12,2,100,0
13487,312112,364_12_42,ROMANIA,0,TOTALS,ROMANIA,200,17,51,33.3,13,35,37.1,4,16,25.0,12,15,80.0,13,27,40,5,22,35,5,0,50,1
13488,312125,364_12_43,MONTENEGRO,0,TOTALS,MONTENEGRO,200,25,62,40.3,18,44,40.9,7,18,38.9,25,34,73.5,12,35,47,10,15,11,6,2,82,1
13489,312138,364_12_43,SWEDEN,0,TOTALS,SWEDEN,200,31,79,39.2,27,63,42.9,4,16,25.0,5,10,50.0,14,29,43,7,27,10,4,4,71,0
13490,312151,364_12_44,NORWAY,0,TOTALS,NORWAY,200,29,53,54.7,25,39,64.1,4,14,28.6,29,34,85.3,7,28,35,14,13,22,5,0,91,1
13491,312164,364_12_44,SWITZERLAND,0,TOTALS,SWITZERLAND,200,31,71,43.7,27,57,47.4,4,14,28.6,9,12,75.0,13,17,30,18,27,20,9,0,75,0
13492,312177,364_12_45,ESTONIA,0,TOTALS,ESTONIA,200,27,57,47.4,18,36,50.0,9,21,42.9,7,11,63.6,8,15,23,17,24,18,11,3,70,0
13493,312190,364_12_45,CZECH REPUBLIC,0,TOTALS,CZECH REPUBLIC,200,33,56,58.9,23,41,56.1,10,15,66.7,19,24,79.2,9,23,32,16,14,16,12,2,95,1
13494,312203,364_12_46,LUXEMBOURG,0,TOTALS,LUXEMBOURG,200,23,70,32.9,14,49,28.6,9,21,42.9,8,17,47.1,19,28,47,7,16,15,6,1,63,0
13495,312216,364_12_46,SLOVAK REPUBLIC,0,TOTALS,SLOVAK REPUBLIC,200,26,63,41.3,19,39,48.7,7,24,29.2,11,18,61.1,13,33,46,12,16,16,9,10,70,1
13496,312229,364_12_47,ICELAND,0,TOTALS,ICELAND,200,25,67,37.3,15,37,40.5,10,30,33.3,18,27,66.7,12,22,34,12,24,12,7,0,78,0
13497,312242,364_12_47,FINLAND,0,TOTALS,FINLAND,200,32,59,54.2,24,36,66.7,8,23,34.8,14,23,60.9,8,35,43,15,20,16,4,1,86,1
13498,312255,364_12_48,BELGIUM,0,TOTALS,BELGIUM,200,26,69,37.7,19,46,41.3,7,23,30.4,15,25,60.0,11,22,33,14,22,19,15,3,74,0
13499,312268,364_12_48,NETHERLANDS,0,TOTALS,NETHERLANDS,200,28,58,48.3,21,40,52.5,7,18,38.9,16,20,80.0,8,33,41,10,20,24,8,5,79,1
13500,312281,364_12_49,PORTUGAL,0,TOTALS,PORTUGAL,200,29,65,44.6,16,34,47.1,13,31,41.9,10,12,83.3,10,25,35,12,19,8,6,1,81,1
13501,312294,364_12_49,GEORGIA,0,TOTALS,GEORGIA,200,19,57,33.3,15,33,45.5,4,24,16.7,17,22,77.3,15,27,42,3,16,14,7,1,59,0
13502,312307,364_12_50,SCOTLAND,0,TOTALS,SCOTLAND,200,13,54,24.1,9,35,25.7,4,19,21.1,9,14,64.3,11,23,34,10,16,19,6,0,39,0
13503,312320,364_12_50,ENGLAND,0,TOTALS,ENGLAND,200,38,74,51.4,28,53,52.8,10,21,47.6,9,17,52.9,19,38,57,26,15,12,8,6,95,1
13504,312333,364_12_51,ISRAEL,0,TOTALS,ISRAEL,200,31,75,41.3,25,51,49.0,6,24,25.0,9,17,52.9,15,29,44,13,16,9,4,1,77,1
13505,312346,364_12_51,CZECH REPUBLIC,0,TOTALS,CZECH REPUBLIC,200,28,66,42.4,23,51,45.1,5,15,33.3,9,14,64.3,12,33,45,20,17,13,3,0,70,0
13506,312359,364_12_52,SWITZERLAND,0,TOTALS,SWITZERLAND,200,29,58,50.0,21,38,55.3,8,20,40.0,7,11,63.6,6,22,28,17,17,19,9,1,73,0
13507,312372,364_12_52,GEORGIA,0,TOTALS,GEORGIA,200,39,70,55.7,30,46,65.2,9,24,37.5,8,15,53.3,13,22,35,23,16,17,10,1,95,1
13508,312385,364_12_53,SWEDEN,0,TOTALS,SWEDEN,200,18,53,34.0,14,40,35.0,4,13,30.8,8,17,47.1,12,29,41,14,18,21,3,0,48,0
13509,312398,364_12_53,PORTUGAL,0,TOTALS,PORTUGAL,200,21,55,38.2,11,32,34.4,10,23,43.5,8,14,57.1,7,24,31,11,20,14,11,3,60,1
13510,312411,364_12_54,ENGLAND,0,TOTALS,ENGLAND,200,22,43,51.2,19,36,52.8,3,7,42.9,26,36,72.2,8,36,44,12,19,19,8,2,73,1
13511,312424,364_12_54,ESTONIA,0,TOTALS,ESTONIA,200,16,62,25.8,9,28,32.1,7,34,20.6,10,16,62.5,15,18,33,14,25,16,5,1,49,0
13512,312437,364_12_55,SCOTLAND,0,TOTALS,SCOTLAND,200,25,63,39.7,22,46,47.8,3,17,17.6,8,13,61.5,13,24,37,9,15,21,13,5,61,0
13513,312450,364_12_55,LUXEMBOURG,0,TOTALS,LUXEMBOURG,200,31,74,41.9,25,46,54.3,6,28,21.4,7,10,70.0,24,26,50,11,16,23,10,1,75,1
13514,312463,364_12_56,ROMANIA,0,TOTALS,ROMANIA,200,20,60,33.3,17,42,40.5,3,18,16.7,7,15,46.7,8,27,35,8,20,14,6,1,50,0
13515,312476,364_12_56,AUSTRIA,0,TOTALS,AUSTRIA,200,28,60,46.7,20,39,51.3,8,21,38.1,16,20,80.0,7,35,42,18,15,12,5,6,80,1
13516,312489,364_12_57,MONTENEGRO,0,TOTALS,MONTENEGRO,200,22,52,42.3,16,36,44.4,6,16,37.5,12,19,63.2,8,24,32,17,16,20,1,4,62,0
13517,312502,364_12_57,BELGIUM,0,TOTALS,BELGIUM,200,32,70,45.7,25,49,51.0,7,21,33.3,11,20,55.0,19,24,43,23,20,13,11,0,82,1
13518,312515,364_12_58,HUNGARY,0,TOTALS,HUNGARY,200,30,62,48.4,26,47,55.3,4,15,26.7,7,11,63.6,8,32,40,21,14,14,12,4,71,1
13519,312528,364_12_58,SLOVAK REPUBLIC,0,TOTALS,SLOVAK REPUBLIC,200,16,58,27.6,14,37,37.8,2,21,9.5,4,10,40.0,12,24,36,6,14,15,6,3,38,0
13520,312541,364_12_59,ICELAND,0,TOTALS,ICELAND,200,26,61,42.6,19,38,50.0,7,23,30.4,4,4,100.0,8,23,31,11,16,16,7,1,63,0
13521,312554,364_12_59,NETHERLANDS,0,TOTALS,NETHERLANDS,200,25,55,45.5,15,26,57.7,10,29,34.5,10,16,62.5,8,28,36,11,10,19,5,3,70,1
13522,312567,364_12_60,FINLAND,0,TOTALS,FINLAND,200,31,69,44.9,24,48,50.0,7,21,33.3,17,23,73.9,19,24,43,17,21,22,6,0,86,1
13523,312580,364_12_60,BOSNIA AND HERZEGOVINA,0,TOTALS,BOSNIA AND HERZEGOVINA,200,30,68,44.1,27,49,55.1,3,19,15.8,21,24,87.5,13,22,35,20,26,17,9,3,84,0
13524,312593,364_12_61,ESTONIA,0,TOTALS,ESTONIA,200,16,57,28.1,14,36,38.9,2,21,9.5,13,19,68.4,12,28,40,13,26,24,6,1,47,0
13525,312606,364_12_61,ISRAEL,0,TOTALS,ISRAEL,200,24,66,36.4,21,48,43.8,3,18,16.7,22,34,64.7,20,31,51,16,20,16,11,2,73,1
13526,312619,364_12_62,GEORGIA,0,TOTALS,GEORGIA,200,39,70,55.7,29,48,60.4,10,22,45.5,3,9,33.3,12,27,39,15,16,12,11,4,91,1
13527,312632,364_12_62,NORWAY,0,TOTALS,NORWAY,200,25,60,41.7,21,43,48.8,4,17,23.5,12,17,70.6,12,21,33,10,11,18,5,0,66,0
13528,312645,364_12_63,NETHERLANDS,0,TOTALS,NETHERLANDS,200,26,60,43.3,18,43,41.9,8,17,47.1,19,26,73.1,15,21,36,14,14,15,9,6,79,1
13529,312658,364_12_63,SWEDEN,0,TOTALS,SWEDEN,200,33,67,49.3,29,55,52.7,4,12,33.3,6,9,66.7,14,23,37,12,22,17,8,5,76,0
13530,312671,364_12_64,CZECH REPUBLIC,0,TOTALS,CZECH REPUBLIC,200,23,64,35.9,19,45,42.2,4,19,21.1,13,15,86.7,11,28,39,11,13,9,4,2,63,1
13531,312684,364_12_64,ENGLAND,0,TOTALS,ENGLAND,200,22,66,33.3,18,47,38.3,4,19,21.1,7,10,70.0,18,30,48,8,16,14,3,2,55,0
13532,312697,364_12_65,LUXEMBOURG,0,TOTALS,LUXEMBOURG,200,31,64,48.4,21,43,48.8,10,21,47.6,15,22,68.2,9,24,33,18,13,14,14,3,87,0
13533,312710,364_12_65,BELARUS,0,TOTALS,BELARUS,200,34,69,49.3,23,34,67.6,11,35,31.4,10,13,76.9,13,34,47,11,15,20,6,6,89,1
13534,312723,364_12_66,SLOVAK REPUBLIC,0,TOTALS,SLOVAK REPUBLIC,200,20,57,35.1,14,39,35.9,6,18,33.3,18,24,75.0,12,27,39,6,10,20,8,9,64,1
13535,312736,364_12_66,ROMANIA,0,TOTALS,ROMANIA,200,23,66,34.8,18,52,34.6,5,14,35.7,4,6,66.7,16,26,42,6,24,19,8,2,55,0
13536,312749,364_12_67,BOSNIA AND HERZEGOVINA,0,TOTALS,BOSNIA AND HERZEGOVINA,200,33,68,48.5,24,47,51.1,9,21,42.9,7,15,46.7,10,26,36,14,17,15,12,1,82,1
13537,312762,364_12_67,MONTENEGRO,0,TOTALS,MONTENEGRO,200,30,70,42.9,24,51,47.1,6,19,31.6,6,11,54.5,15,27,42,19,15,19,4,2,72,0
13538,312775,364_12_68,AUSTRIA,0,TOTALS,AUSTRIA,200,25,58,43.1,20,43,46.5,5,15,33.3,16,27,59.3,14,28,42,13,23,16,4,1,71,1
13539,312788,364_12_68,HUNGARY,0,TOTALS,HUNGARY,200,25,61,41.0,22,44,50.0,3,17,17.6,16,23,69.6,8,24,32,12,25,10,9,0,69,0
13540,312801,364_12_69,PORTUGAL,0,TOTALS,PORTUGAL,225,24,60,40.0,11,28,39.3,13,32,40.6,16,24,66.7,10,28,38,14,21,20,9,0,77,1
13541,312814,364_12_69,ICELAND,0,TOTALS,ICELAND,225,28,68,41.2,23,49,46.9,5,19,26.3,14,22,63.6,11,26,37,10,22,18,9,0,75,0
13542,312827,364_12_70,BELGIUM,0,TOTALS,BELGIUM,200,31,74,41.9,25,53,47.2,6,21,28.6,6,17,35.3,19,24,43,11,21,16,9,0,74,0
13543,312840,364_12_70,FINLAND,0,TOTALS,FINLAND,200,33,65,50.8,23,42,54.8,10,23,43.5,10,19,52.6,11,30,41,20,14,16,3,4,86,1
13544,312853,364_12_71,SLOVAK REPUBLIC,0,TOTALS,SLOVAK REPUBLIC,200,25,62,40.3,18,39,46.2,7,23,30.4,2,6,33.3,9,25,34,14,17,16,7,4,59,0
13545,312866,364_12_71,ICELAND,0,TOTALS,ICELAND,200,26,64,40.6,16,39,41.0,10,25,40.0,12,17,70.6,16,29,45,12,13,16,10,2,74,1
13546,312879,364_12_72,ISRAEL,0,TOTALS,ISRAEL,200,26,70,37.1,24,55,43.6,2,15,13.3,11,15,73.3,10,31,41,12,15,14,12,1,65,0
13547,312892,364_12_72,MONTENEGRO,0,TOTALS,MONTENEGRO,200,23,65,35.4,17,43,39.5,6,22,27.3,15,23,65.2,15,33,48,17,16,19,8,2,67,1
13548,312905,364_12_73,SWEDEN,0,TOTALS,SWEDEN,200,32,68,47.1,29,58,50.0,3,10,30.0,11,19,57.9,17,30,47,11,15,24,10,4,78,1
13549,312918,364_12_73,ROMANIA,0,TOTALS,ROMANIA,200,28,73,38.4,21,53,39.6,7,20,35.0,8,18,44.4,19,22,41,10,21,21,9,2,71,0
13550,312931,364_12_74,BELGIUM,0,TOTALS,BELGIUM,200,22,65,33.8,19,45,42.2,3,20,15.0,12,16,75.0,12,24,36,12,22,18,6,1,59,0
13551,312944,364_12_74,ESTONIA,0,TOTALS,ESTONIA,200,31,63,49.2,22,39,56.4,9,24,37.5,7,18,38.9,11,31,42,20,22,18,4,2,78,1
13552,312957,364_12_75,AUSTRIA,0,TOTALS,AUSTRIA,200,20,64,31.2,17,48,35.4,3,16,18.8,5,11,45.5,8,27,35,5,17,16,7,4,48,0
13553,312970,364_12_75,NETHERLANDS,0,TOTALS,NETHERLANDS,200,27,60,45.0,17,33,51.5,10,27,37.0,8,14,57.1,11,37,48,9,16,16,11,1,72,1
13554,312983,364_12_76,ENGLAND,0,TOTALS,ENGLAND,200,25,57,43.9,20,41,48.8,5,16,31.2,8,14,57.1,14,32,46,6,18,26,5,9,63,0
13555,312996,364_12_76,BOSNIA AND HERZEGOVINA,0,TOTALS,BOSNIA AND HERZEGOVINA,200,25,71,35.2,16,42,38.1,9,29,31.0,5,15,33.3,16,20,36,15,22,13,13,4,64,1
13556,313009,364_12_77,PORTUGAL,0,TOTALS,PORTUGAL,200,31,59,52.5,17,28,60.7,14,31,45.2,12,17,70.6,4,19,23,15,22,14,14,0,88,1
13557,313022,364_12_77,HUNGARY,0,TOTALS,HUNGARY,200,32,58,55.2,28,47,59.6,4,11,36.4,15,24,62.5,9,25,34,10,17,18,7,2,83,0
13558,313035,364_12_78,FINLAND,0,TOTALS,FINLAND,200,25,60,41.7,22,44,50.0,3,16,18.8,10,13,76.9,4,22,26,14,16,15,5,3,63,0
13559,313048,364_12_78,CZECH REPUBLIC,0,TOTALS,CZECH REPUBLIC,200,33,69,47.8,25,55,45.5,8,14,57.1,11,14,78.6,15,31,46,19,16,16,7,3,85,1
13560,313061,364_12_79,SCOTLAND,0,TOTALS,SCOTLAND,200,22,56,39.3,20,45,44.4,2,11,18.2,5,6,83.3,11,18,29,12,16,18,11,1,51,0
13561,313074,364_12_79,SWITZERLAND,0,TOTALS,SWITZERLAND,200,21,54,38.9,15,33,45.5,6,21,28.6,7,10,70.0,14,22,36,11,10,19,8,2,55,1
13562,313087,364_12_80,ISRAEL,0,TOTALS,ISRAEL,200,28,69,40.6,23,50,46.0,5,19,26.3,13,18,72.2,13,33,46,19,16,13,7,0,74,1
13563,313100,364_12_80,BELGIUM,0,TOTALS,BELGIUM,200,28,77,36.4,24,58,41.4,4,19,21.1,3,4,75.0,15,29,44,15,16,12,9,3,63,0
13564,313113,364_12_81,ICELAND,0,TOTALS,ICELAND,200,30,80,37.5,22,57,38.6,8,23,34.8,16,23,69.6,18,24,42,14,18,10,11,2,84,1
13565,313126,364_12_81,SWEDEN,0,TOTALS,SWEDEN,200,31,75,41.3,25,56,44.6,6,19,31.6,13,22,59.1,19,33,52,15,24,18,5,3,81,0
13566,313139,364_12_82,LUXEMBOURG,0,TOTALS,LUXEMBOURG,200,31,67,46.3,22,46,47.8,9,21,42.9,14,26,53.8,18,34,52,14,13,18,5,4,85,1
13567,313152,364_12_82,NORWAY,0,TOTALS,NORWAY,200,24,74,32.4,19,45,42.2,5,29,17.2,6,10,60.0,16,24,40,14,18,14,13,2,59,0
13568,313165,364_12_83,AUSTRIA,0,TOTALS,AUSTRIA,200,19,59,32.2,15,42,35.7,4,17,23.5,10,14,71.4,20,18,38,4,25,24,9,3,52,0
13569,313178,364_12_83,HUNGARY,0,TOTALS,HUNGARY,200,23,53,43.4,22,41,53.7,1,12,8.3,20,25,80.0,12,21,33,11,18,18,9,6,67,1
13570,313191,364_12_84,MONTENEGRO,0,TOTALS,MONTENEGRO,200,33,61,54.1,27,44,61.4,6,17,35.3,13,25,52.0,9,29,38,15,19,17,9,2,85,1
13571,313204,364_12_84,ESTONIA,0,TOTALS,ESTONIA,200,28,66,42.4,19,41,46.3,9,25,36.0,12,17,70.6,9,26,35,12,26,18,10,1,77,0
13572,313217,364_12_85,BELARUS,0,TOTALS,BELARUS,200,23,67,34.3,17,42,40.5,6,25,24.0,10,10,100.0,18,32,50,13,12,18,3,2,62,0
13573,313230,364_12_85,GEORGIA,0,TOTALS,GEORGIA,200,26,68,38.2,15,38,39.5,11,30,36.7,9,10,90.0,9,21,30,13,15,8,8,0,72,1
13574,313243,364_12_86,BOSNIA AND HERZEGOVINA,0,TOTALS,BOSNIA AND HERZEGOVINA,200,30,66,45.5,25,46,54.3,5,20,25.0,11,14,78.6,12,27,39,14,19,12,9,8,76,1
13575,313256,364_12_86,CZECH REPUBLIC,0,TOTALS,CZECH REPUBLIC,200,24,64,37.5,16,49,32.7,8,15,53.3,8,14,57.1,13,23,36,8,17,15,5,3,64,0
13576,313269,364_12_87,NETHERLANDS,0,TOTALS,NETHERLANDS,200,24,58,41.4,18,33,54.5,6,25,24.0,20,32,62.5,11,25,36,15,18,11,9,4,74,1
13577,313282,364_12_87,PORTUGAL,0,TOTALS,PORTUGAL,200,21,52,40.4,17,41,41.5,4,11,36.4,15,16,93.8,7,28,35,4,24,16,4,2,61,0
13578,313295,364_12_88,SLOVAK REPUBLIC,0,TOTALS,SLOVAK REPUBLIC,200,17,54,31.5,17,38,44.7,0,16,0.0,13,15,86.7,7,14,21,3,24,18,15,5,47,0
13579,313308,364_12_88,ROMANIA,0,TOTALS,ROMANIA,200,22,52,42.3,16,28,57.1,6,24,25.0,15,21,71.4,13,30,43,9,19,25,10,2,65,1
13580,313321,364_12_89,ENGLAND,0,TOTALS,ENGLAND,200,31,72,43.1,28,62,45.2,3,10,30.0,8,15,53.3,25,33,58,13,12,24,13,3,73,1
13581,313334,364_12_89,FINLAND,0,TOTALS,FINLAND,200,21,65,32.3,13,30,43.3,8,35,22.9,9,13,69.2,11,19,30,11,11,19,10,2,59,0
13582,316857,367_12_01,POLAND,0,TOTALS,POLAND,200,22,65,33.8,17,42,40.5,5,23,21.7,14,21,66.7,13,30,43,11,18,19,10,3,63,0
13583,316870,367_12_01,GREECE,0,TOTALS,GREECE,200,31,73,42.5,26,52,50.0,5,21,23.8,8,18,44.4,17,32,49,14,22,19,10,6,75,1
13584,316883,367_12_02,TURKEY,0,TOTALS,TURKEY,200,35,78,44.9,33,66,50.0,2,12,16.7,9,14,64.3,22,29,51,19,22,13,8,2,81,1
13585,316896,367_12_02,ENGLAND,0,TOTALS,ENGLAND,200,20,64,31.2,14,50,28.0,6,14,42.9,10,19,52.6,18,23,41,13,17,21,4,2,56,0
13586,316909,367_12_03,GERMANY,0,TOTALS,GERMANY,200,25,56,44.6,23,47,48.9,2,9,22.2,15,24,62.5,10,26,36,9,21,14,8,2,67,1
13587,316922,367_12_03,SERBIA,0,TOTALS,SERBIA,200,22,57,38.6,16,39,41.0,6,18,33.3,10,16,62.5,13,24,37,10,23,16,6,4,60,0
13588,316935,367_12_04,ITALY,0,TOTALS,ITALY,200,22,59,37.3,18,47,38.3,4,12,33.3,29,36,80.6,12,33,45,7,20,20,14,6,77,1
13589,316948,367_12_04,CROATIA,0,TOTALS,CROATIA,200,27,69,39.1,24,56,42.9,3,13,23.1,6,12,50.0,13,26,39,13,29,19,11,3,63,0
13590,316961,367_12_05,LITHUANIA,0,TOTALS,LITHUANIA,200,33,69,47.8,26,50,52.0,7,19,36.8,9,16,56.2,18,30,48,22,20,22,10,2,82,1
13591,316974,367_12_05,SLOVENIA,0,TOTALS,SLOVENIA,200,30,66,45.5,24,46,52.2,6,20,30.0,10,17,58.8,8,23,31,15,24,16,10,4,76,0
13592,316987,367_12_06,LATVIA,0,TOTALS,LATVIA,200,18,59,30.5,16,37,43.2,2,22,9.1,25,35,71.4,14,24,38,10,26,9,7,6,63,0
13593,317000,367_12_06,SPAIN,0,TOTALS,SPAIN,200,23,55,41.8,18,42,42.9,5,13,38.5,14,27,51.9,15,29,44,11,27,17,6,1,65,1
13594,317013,367_12_07,CZECH REPUBLIC,0,TOTALS,CZECH REPUBLIC,200,13,53,24.5,9,36,25.0,4,17,23.5,3,6,50.0,7,22,29,7,20,16,8,4,33,0
13595,317026,367_12_07,FRANCE,0,TOTALS,FRANCE,200,21,67,31.3,17,44,38.6,4,23,17.4,14,21,66.7,26,35,61,14,15,18,12,4,60,1
13596,317039,367_12_08,RUSSIA,0,TOTALS,RUSSIA,200,24,82,29.3,22,66,33.3,2,16,12.5,13,20,65.0,32,25,57,7,22,26,5,7,63,0
13597,317052,367_12_08,UKRAINE,0,TOTALS,UKRAINE,200,30,65,46.2,24,46,52.2,6,19,31.6,21,28,75.0,13,27,40,15,20,20,14,3,87,1
13598,317065,367_12_09,SLOVENIA,0,TOTALS,SLOVENIA,200,18,59,30.5,12,35,34.3,6,24,25.0,8,16,50.0,12,26,38,12,22,20,8,5,50,0
13599,317078,367_12_09,GERMANY,0,TOTALS,GERMANY,200,27,66,40.9,24,51,47.1,3,15,20.0,12,21,57.1,19,32,51,10,15,18,14,5,69,1
13600,317091,367_12_10,ENGLAND,0,TOTALS,ENGLAND,200,19,67,28.4,17,52,32.7,2,15,13.3,7,15,46.7,16,32,48,5,29,20,6,2,47,0
13601,317104,367_12_10,ITALY,0,TOTALS,ITALY,200,18,52,34.6,14,38,36.8,4,14,28.6,25,38,65.8,10,37,47,5,18,18,10,7,65,1
13602,317117,367_12_11,FRANCE,0,TOTALS,FRANCE,200,23,63,36.5,20,49,40.8,3,14,21.4,16,23,69.6,18,26,44,15,18,18,18,3,65,1
13603,317130,367_12_11,POLAND,0,TOTALS,POLAND,200,17,60,28.3,14,49,28.6,3,11,27.3,8,10,80.0,15,24,39,8,24,24,5,3,45,0
13604,317143,367_12_12,CROATIA,0,TOTALS,CROATIA,225,35,69,50.7,32,55,58.2,3,14,21.4,22,28,78.6,5,31,36,14,30,19,6,5,95,0
13605,317156,367_12_12,TURKEY,0,TOTALS,TURKEY,225,35,79,44.3,27,59,45.8,8,20,40.0,20,32,62.5,15,29,44,22,24,15,12,5,98,1
13606,317169,367_12_13,SERBIA,0,TOTALS,SERBIA,200,23,62,37.1,18,44,40.9,5,18,27.8,19,28,67.9,14,22,36,14,22,10,11,0,70,1
13607,317182,367_12_13,LITHUANIA,0,TOTALS,LITHUANIA,200,26,62,41.9,23,47,48.9,3,15,20.0,9,13,69.2,14,28,42,13,27,19,4,3,64,0
13608,317195,367_12_14,UKRAINE,0,TOTALS,UKRAINE,200,19,51,37.3,15,34,44.1,4,17,23.5,31,45,68.9,11,38,49,10,18,20,8,6,73,1
13609,317208,367_12_14,LATVIA,0,TOTALS,LATVIA,200,22,76,28.9,18,51,35.3,4,25,16.0,10,16,62.5,20,27,47,9,32,13,6,6,58,0
13610,317221,367_12_15,GREECE,0,TOTALS,GREECE,200,31,63,49.2,23,43,53.5,8,20,40.0,16,26,61.5,15,31,46,16,19,18,13,4,86,1
13611,317234,367_12_15,CZECH REPUBLIC,0,TOTALS,CZECH REPUBLIC,200,22,61,36.1,14,37,37.8,8,24,33.3,9,16,56.2,10,23,33,11,22,19,10,2,61,0
13612,317247,367_12_16,SPAIN,0,TOTALS,SPAIN,200,30,55,54.5,21,39,53.8,9,16,56.2,19,25,76.0,6,21,27,16,21,15,9,4,88,1
13613,317260,367_12_16,RUSSIA,0,TOTALS,RUSSIA,200,23,55,41.8,18,37,48.6,5,18,27.8,13,26,50.0,16,21,37,13,24,23,10,0,64,0
13614,317273,367_12_17,SERBIA,0,TOTALS,SERBIA,200,21,57,36.8,15,37,40.5,6,20,30.0,23,26,88.5,10,38,48,12,22,18,6,2,71,1
13615,317286,367_12_17,SLOVENIA,0,TOTALS,SLOVENIA,200,22,68,32.4,15,39,38.5,7,29,24.1,13,18,72.2,10,28,38,11,26,11,10,1,64,0
13616,317299,367_12_18,TURKEY,0,TOTALS,TURKEY,200,27,63,42.9,22,41,53.7,5,22,22.7,9,15,60.0,19,31,50,13,21,18,3,2,68,0
13617,317312,367_12_18,ITALY,0,TOTALS,ITALY,200,26,62,41.9,21,48,43.8,5,14,35.7,16,23,69.6,11,22,33,9,22,10,9,2,73,1
13618,317325,367_12_19,POLAND,0,TOTALS,POLAND,200,29,75,38.7,25,60,41.7,4,15,26.7,27,42,64.3,18,42,60,15,25,14,10,6,89,1
13619,317338,367_12_19,CZECH REPUBLIC,0,TOTALS,CZECH REPUBLIC,200,28,74,37.8,22,54,40.7,6,20,30.0,15,30,50.0,10,36,46,8,35,15,5,7,77,0
13620,317351,367_12_20,SPAIN,0,TOTALS,SPAIN,200,20,60,33.3,13,42,31.0,7,18,38.9,26,33,78.8,14,33,47,10,28,16,10,5,73,1
13621,317364,367_12_20,UKRAINE,0,TOTALS,UKRAINE,200,25,66,37.9,19,42,45.2,6,24,25.0,13,26,50.0,14,26,40,10,22,18,7,4,69,0
13622,317377,367_12_21,LITHUANIA,0,TOTALS,LITHUANIA,200,22,58,37.9,13,36,36.1,9,22,40.9,12,16,75.0,15,25,40,16,20,20,8,5,65,0
13623,317390,367_12_21,GERMANY,0,TOTALS,GERMANY,200,25,60,41.7,20,42,47.6,5,18,27.8,11,18,61.1,14,23,37,9,21,16,8,8,66,1
13624,317403,367_12_22,RUSSIA,0,TOTALS,RUSSIA,200,14,58,24.1,13,47,27.7,1,11,9.1,30,39,76.9,17,29,46,9,20,18,8,4,59,0
13625,317416,367_12_22,LATVIA,0,TOTALS,LATVIA,200,23,63,36.5,15,35,42.9,8,28,28.6,12,16,75.0,13,31,44,13,30,18,10,9,66,1
13626,317429,367_12_23,FRANCE,0,TOTALS,FRANCE,200,24,50,48.0,14,30,46.7,10,20,50.0,12,18,66.7,10,25,35,12,18,18,11,2,70,1
13627,317442,367_12_23,GREECE,0,TOTALS,GREECE,200,23,54,42.6,19,34,55.9,4,20,20.0,9,14,64.3,9,19,28,15,23,17,7,2,59,0
13628,317455,367_12_24,CROATIA,0,TOTALS,CROATIA,200,21,53,39.6,19,44,43.2,2,9,22.2,34,45,75.6,10,47,57,16,21,20,6,5,78,1
13629,317468,367_12_24,ENGLAND,0,TOTALS,ENGLAND,200,19,79,24.1,14,46,30.4,5,33,15.2,11,19,57.9,16,26,42,10,29,9,7,1,54,0
13630,317481,367_12_25,GREECE,0,TOTALS,GREECE,200,19,54,35.2,16,42,38.1,3,12,25.0,12,17,70.6,13,28,41,9,21,14,4,4,53,0
13631,317494,367_12_25,SERBIA,0,TOTALS,SERBIA,200,22,63,34.9,17,42,40.5,5,21,23.8,13,22,59.1,16,24,40,10,24,9,10,3,62,1
13632,317507,367_12_26,UKRAINE,0,TOTALS,UKRAINE,200,19,66,28.8,13,40,32.5,6,26,23.1,13,23,56.5,17,19,36,14,15,11,7,3,57,0
13633,317520,367_12_26,TURKEY,0,TOTALS,TURKEY,200,30,62,48.4,28,54,51.9,2,8,25.0,10,17,58.8,13,35,48,17,21,19,1,6,72,1
13634,317533,367_12_27,ENGLAND,0,TOTALS,ENGLAND,200,28,66,42.4,25,45,55.6,3,21,14.3,27,38,71.1,16,36,52,16,22,22,9,3,86,1
13635,317546,367_12_27,CZECH REPUBLIC,0,TOTALS,CZECH REPUBLIC,200,29,77,37.7,25,52,48.1,4,25,16.0,15,28,53.6,18,26,44,15,29,20,12,2,77,0
13636,317559,367_12_28,LITHUANIA,0,TOTALS,LITHUANIA,200,21,52,40.4,12,27,44.4,9,25,36.0,5,8,62.5,10,27,37,15,22,21,7,4,56,1
13637,317572,367_12_28,FRANCE,0,TOTALS,FRANCE,200,19,53,35.8,17,42,40.5,2,11,18.2,11,16,68.8,11,23,34,9,14,17,11,2,51,0
13638,317585,367_12_29,LATVIA,0,TOTALS,LATVIA,200,24,67,35.8,14,41,34.1,10,26,38.5,9,17,52.9,13,25,38,17,29,15,13,5,67,0
13639,317598,367_12_29,ITALY,0,TOTALS,ITALY,200,26,69,37.7,20,56,35.7,6,13,46.2,18,26,69.2,22,32,54,11,20,21,8,10,76,1
13640,317611,367_12_30,RUSSIA,0,TOTALS,RUSSIA,200,26,65,40.0,24,46,52.2,2,19,10.5,17,29,58.6,15,33,48,16,18,14,11,3,71,1
13641,317624,367_12_30,SLOVENIA,0,TOTALS,SLOVENIA,200,25,76,32.9,20,51,39.2,5,25,20.0,8,9,88.9,18,28,46,8,25,15,9,1,63,0
13642,317637,367_12_31,CROATIA,0,TOTALS,CROATIA,200,30,58,51.7,27,47,57.4,3,11,27.3,16,25,64.0,9,28,37,13,23,20,11,4,79,1
13643,317650,367_12_31,SPAIN,0,TOTALS,SPAIN,200,23,64,35.9,19,52,36.5,4,12,33.3,17,22,77.3,13,23,36,10,23,20,14,4,67,0
13644,317663,367_12_32,POLAND,0,TOTALS,POLAND,200,27,64,42.2,19,43,44.2,8,21,38.1,18,27,66.7,18,25,43,12,26,21,17,11,80,1
13645,317676,367_12_32,GERMANY,0,TOTALS,GERMANY,200,21,63,33.3,20,54,37.0,1,9,11.1,20,26,76.9,20,22,42,11,28,25,8,0,63,0
13646,317689,367_12_33,SERBIA,0,TOTALS,SERBIA,200,21,53,39.6,15,34,44.1,6,19,31.6,8,12,66.7,11,29,40,13,21,17,4,0,56,1
13647,317702,367_12_33,FRANCE,0,TOTALS,FRANCE,200,18,51,35.3,12,36,33.3,6,15,40.0,11,20,55.0,6,23,29,5,15,12,6,2,53,0
13648,317715,367_12_34,ITALY,0,TOTALS,ITALY,200,35,67,52.2,28,50,56.0,7,17,41.2,6,7,85.7,13,28,41,21,25,20,12,1,83,1
13649,317728,367_12_34,UKRAINE,0,TOTALS,UKRAINE,200,19,61,31.1,13,35,37.1,6,26,23.1,21,32,65.6,17,17,34,12,13,16,6,1,65,0
13650,317741,367_12_35,SLOVENIA,0,TOTALS,SLOVENIA,200,33,79,41.8,24,50,48.0,9,29,31.0,8,15,53.3,17,32,49,13,19,7,8,4,83,1
13651,317754,367_12_35,ENGLAND,0,TOTALS,ENGLAND,200,29,76,38.2,21,51,41.2,8,25,32.0,3,9,33.3,18,33,51,16,15,13,4,2,69,0
13652,317767,367_12_36,POLAND,0,TOTALS,POLAND,200,26,63,41.3,23,48,47.9,3,15,20.0,22,39,56.4,7,27,34,15,28,11,14,4,77,1
13653,317780,367_12_36,LITHUANIA,0,TOTALS,LITHUANIA,200,24,62,38.7,21,41,51.2,3,21,14.3,18,29,62.1,16,38,54,13,33,26,4,5,69,0
13654,317793,367_12_37,LATVIA,0,TOTALS,LATVIA,200,25,62,40.3,19,43,44.2,6,19,31.6,16,25,64.0,13,25,38,12,28,20,11,2,72,0
13655,317806,367_12_37,CROATIA,0,TOTALS,CROATIA,200,26,57,45.6,21,45,46.7,5,12,41.7,19,32,59.4,12,26,38,19,23,20,12,5,76,1
13656,317819,367_12_38,CZECH REPUBLIC,0,TOTALS,CZECH REPUBLIC,200,22,61,36.1,18,44,40.9,4,17,23.5,18,39,46.2,17,24,41,10,24,17,13,5,66,0
13657,317832,367_12_38,RUSSIA,0,TOTALS,RUSSIA,200,26,59,44.1,20,43,46.5,6,16,37.5,18,30,60.0,14,32,46,17,24,22,9,3,76,1
13658,317845,367_12_39,TURKEY,0,TOTALS,TURKEY,200,30,68,44.1,24,49,49.0,6,19,31.6,5,7,71.4,14,25,39,15,17,13,12,4,71,1
13659,317858,367_12_39,SPAIN,0,TOTALS,SPAIN,200,22,60,36.7,19,47,40.4,3,13,23.1,9,13,69.2,13,24,37,6,15,17,7,3,56,0
13660,317871,367_12_40,GERMANY,0,TOTALS,GERMANY,200,18,57,31.6,12,35,34.3,6,22,27.3,16,25,64.0,20,27,47,9,19,17,9,2,58,1
13661,317884,367_12_40,GREECE,0,TOTALS,GREECE,200,18,62,29.0,12,39,30.8,6,23,26.1,5,7,71.4,18,24,42,9,22,16,10,3,47,0
13662,317897,367_12_41,SERBIA,0,TOTALS,SERBIA,200,27,68,39.7,20,51,39.2,7,17,41.2,9,14,64.3,13,32,45,13,24,14,6,7,70,1
13663,317910,367_12_41,POLAND,0,TOTALS,POLAND,200,25,64,39.1,25,53,47.2,0,11,0.0,12,27,44.4,15,29,44,11,17,15,7,3,62,0
13664,317923,367_12_42,UKRAINE,0,TOTALS,UKRAINE,200,25,71,35.2,17,40,42.5,8,31,25.8,9,14,64.3,17,23,40,8,13,11,3,4,67,0
13665,317936,367_12_42,CROATIA,0,TOTALS,CROATIA,200,30,63,47.6,25,46,54.3,5,17,29.4,5,10,50.0,14,34,48,8,15,14,7,5,70,1
13666,317949,367_12_43,ENGLAND,0,TOTALS,ENGLAND,200,23,65,35.4,19,40,47.5,4,25,16.0,7,13,53.8,13,28,41,9,20,16,7,2,57,0
13667,317962,367_12_43,RUSSIA,0,TOTALS,RUSSIA,200,25,61,41.0,19,43,44.2,6,18,33.3,12,22,54.5,13,30,43,12,14,14,10,1,68,1
13668,317975,367_12_44,GREECE,0,TOTALS,GREECE,200,16,60,26.7,12,42,28.6,4,18,22.2,20,25,80.0,13,24,37,8,18,14,11,6,56,0
13669,317988,367_12_44,LITHUANIA,0,TOTALS,LITHUANIA,200,28,58,48.3,21,40,52.5,7,18,38.9,12,17,70.6,9,36,45,20,23,15,6,3,75,1
13670,318001,367_12_45,TURKEY,0,TOTALS,TURKEY,200,25,63,39.7,20,48,41.7,5,15,33.3,13,21,61.9,20,21,41,16,25,20,9,4,68,0
13671,318014,367_12_45,LATVIA,0,TOTALS,LATVIA,200,25,59,42.4,17,39,43.6,8,20,40.0,19,34,55.9,19,21,40,17,21,18,9,5,77,1
13672,318027,367_12_46,SLOVENIA,0,TOTALS,SLOVENIA,200,23,69,33.3,17,47,36.2,6,22,27.3,14,26,53.8,25,20,45,12,26,19,14,2,66,0
13673,318040,367_12_46,CZECH REPUBLIC,0,TOTALS,CZECH REPUBLIC,200,29,70,41.4,25,56,44.6,4,14,28.6,17,25,68.0,23,26,49,11,23,19,8,5,79,1
13674,318053,367_12_47,FRANCE,0,TOTALS,FRANCE,200,20,53,37.7,18,31,58.1,2,22,9.1,13,20,65.0,12,19,31,7,15,18,13,5,55,1
13675,318066,367_12_47,GERMANY,0,TOTALS,GERMANY,200,16,42,38.1,8,26,30.8,8,16,50.0,9,14,64.3,7,23,30,10,22,26,5,0,49,0
13676,318079,367_12_48,SPAIN,0,TOTALS,SPAIN,200,25,58,43.1,22,41,53.7,3,17,17.6,9,15,60.0,9,24,33,9,20,20,10,5,62,0
13677,318092,367_12_48,ITALY,0,TOTALS,ITALY,200,30,64,46.9,27,54,50.0,3,10,30.0,11,15,73.3,10,27,37,11,23,17,14,2,74,1
13678,318105,367_12_49,CZECH REPUBLIC,0,TOTALS,CZECH REPUBLIC,200,30,70,42.9,28,57,49.1,2,13,15.4,5,13,38.5,16,23,39,6,19,15,15,2,67,1
13679,318118,367_12_49,ENGLAND,0,TOTALS,ENGLAND,200,22,61,36.1,14,34,41.2,8,27,29.6,11,13,84.6,16,28,44,12,15,20,5,2,63,0
13680,318131,367_12_50,ITALY,0,TOTALS,ITALY,200,29,68,42.6,23,52,44.2,6,16,37.5,18,27,66.7,16,23,39,13,18,18,17,4,82,1
13681,318144,367_12_50,POLAND,0,TOTALS,POLAND,200,31,68,45.6,25,55,45.5,6,13,46.2,11,12,91.7,13,26,39,14,23,22,10,1,79,0
13682,318157,367_12_51,SLOVENIA,0,TOTALS,SLOVENIA,200,21,59,35.6,18,45,40.0,3,14,21.4,12,20,60.0,16,21,37,8,37,25,6,3,57,1
13683,318170,367_12_51,RUSSIA,0,TOTALS,RUSSIA,200,30,58,51.7,19,36,52.8,11,22,50.0,31,39,79.5,9,25,34,18,21,11,14,6,102,0
13684,318183,367_12_52,SERBIA,0,TOTALS,SERBIA,200,26,62,41.9,20,41,48.8,6,21,28.6,10,18,55.6,14,23,37,8,22,8,5,6,68,1
13685,318196,367_12_52,SPAIN,0,TOTALS,SPAIN,200,28,66,42.4,24,56,42.9,4,10,40.0,7,12,58.3,16,27,43,12,18,10,2,1,67,0
13686,318209,367_12_53,UKRAINE,0,TOTALS,UKRAINE,200,22,63,34.9,14,41,34.1,8,22,36.4,12,15,80.0,19,20,39,9,11,18,9,3,64,0
13687,318222,367_12_53,GREECE,0,TOTALS,GREECE,200,31,58,53.4,25,48,52.1,6,10,60.0,12,16,75.0,8,21,29,18,22,13,10,8,80,1
13688,318235,367_12_54,TURKEY,0,TOTALS,TURKEY,200,25,58,43.1,21,43,48.8,4,15,26.7,13,20,65.0,11,26,37,14,14,13,6,8,67,1
13689,318248,367_12_54,GERMANY,0,TOTALS,GERMANY,200,23,71,32.4,21,54,38.9,2,17,11.8,8,12,66.7,20,27,47,10,23,15,7,1,56,0
13690,318261,367_12_55,LITHUANIA,0,TOTALS,LITHUANIA,200,26,55,47.3,17,33,51.5,9,22,40.9,11,21,52.4,12,23,35,17,21,19,7,1,72,0
13691,318274,367_12_55,LATVIA,0,TOTALS,LATVIA,200,28,60,46.7,17,32,53.1,11,28,39.3,17,22,77.3,13,22,35,15,22,14,10,0,84,1
13692,318287,367_12_56,FRANCE,0,TOTALS,FRANCE,200,29,73,39.7,22,52,42.3,7,21,33.3,2,2,100.0,18,20,38,12,15,15,12,2,67,1
13693,318300,367_12_56,CROATIA,0,TOTALS,CROATIA,200,25,52,48.1,17,35,48.6,8,17,47.1,6,11,54.5,9,24,33,15,15,21,9,0,64,0
13694,318313,367_12_57,RUSSIA,0,TOTALS,RUSSIA,200,23,57,40.4,17,37,45.9,6,20,30.0,17,26,65.4,16,29,45,15,17,19,6,3,69,1
13695,318326,367_12_57,CZECH REPUBLIC,0,TOTALS,CZECH REPUBLIC,200,25,64,39.1,22,53,41.5,3,11,27.3,14,18,77.8,11,21,32,16,19,10,13,5,67,0
13696,318339,367_12_58,POLAND,0,TOTALS,POLAND,200,33,67,49.3,26,50,52.0,7,17,41.2,9,17,52.9,14,26,40,11,20,21,9,2,82,1
13697,318352,367_12_58,CROATIA,0,TOTALS,CROATIA,200,25,63,39.7,21,46,45.7,4,17,23.5,22,30,73.3,13,24,37,14,19,22,13,2,76,0
13698,318365,367_12_59,ENGLAND,0,TOTALS,ENGLAND,200,25,59,42.4,20,41,48.8,5,18,27.8,9,14,64.3,11,29,40,13,19,24,5,0,64,0
13699,318378,367_12_59,SLOVENIA,0,TOTALS,SLOVENIA,200,24,75,32.0,18,49,36.7,6,26,23.1,12,13,92.3,21,24,45,9,22,17,12,3,66,1
13700,318391,367_12_60,GERMANY,0,TOTALS,GERMANY,200,33,56,58.9,28,44,63.6,5,12,41.7,17,28,60.7,18,26,44,15,30,24,10,7,88,1
13701,318404,367_12_60,SPAIN,0,TOTALS,SPAIN,200,22,58,37.9,18,42,42.9,4,16,25.0,16,29,55.2,16,9,25,10,28,19,11,0,64,0
13702,318417,367_12_61,UKRAINE,0,TOTALS,UKRAINE,200,25,60,41.7,19,38,50.0,6,22,27.3,15,29,51.7,13,26,39,8,21,18,4,3,71,0
13703,318430,367_12_61,LITHUANIA,0,TOTALS,LITHUANIA,200,33,73,45.2,27,56,48.2,6,17,35.3,10,17,58.8,17,27,44,18,26,12,9,4,82,1
13704,318443,367_12_62,ITALY,0,TOTALS,ITALY,200,25,72,34.7,19,49,38.8,6,23,26.1,15,20,75.0,18,24,42,6,19,14,12,0,71,0
13705,318456,367_12_62,FRANCE,0,TOTALS,FRANCE,200,32,64,50.0,26,49,53.1,6,15,40.0,10,19,52.6,12,32,44,20,21,17,6,7,80,1
13706,318469,367_12_63,GREECE,0,TOTALS,GREECE,200,26,63,41.3,21,45,46.7,5,18,27.8,6,8,75.0,18,28,46,11,15,15,7,4,63,1
13707,318482,367_12_63,LATVIA,0,TOTALS,LATVIA,200,16,55,29.1,11,27,40.7,5,28,17.9,9,13,69.2,11,20,31,10,10,12,4,4,46,0
13708,318495,367_12_64,TURKEY,0,TOTALS,TURKEY,200,23,61,37.7,20,51,39.2,3,10,30.0,18,26,69.2,8,29,37,10,13,11,6,8,67,1
13709,318508,367_12_64,SERBIA,0,TOTALS,SERBIA,200,24,70,34.3,20,47,42.6,4,23,17.4,10,11,90.9,16,33,49,10,25,15,6,0,62,0
13710,318521,367_12_65,RUSSIA,0,TOTALS,RUSSIA,225,25,66,37.9,20,50,40.0,5,16,31.2,17,29,58.6,14,36,50,8,14,20,14,3,72,1
13711,318534,367_12_65,ENGLAND,0,TOTALS,ENGLAND,225,28,71,39.4,21,49,42.9,7,22,31.8,6,13,46.2,10,28,38,19,20,21,9,1,69,0
13712,318547,367_12_66,CROATIA,0,TOTALS,CROATIA,200,27,55,49.1,24,38,63.2,3,17,17.6,15,23,65.2,6,30,36,14,32,22,6,7,72,0
13713,318560,367_12_66,SPAIN,0,TOTALS,SPAIN,200,29,67,43.3,28,59,47.5,1,8,12.5,20,39,51.3,18,27,45,15,25,14,14,2,79,1
13714,318573,367_12_67,CZECH REPUBLIC,0,TOTALS,CZECH REPUBLIC,200,23,66,34.8,14,45,31.1,9,21,42.9,11,16,68.8,20,24,44,14,15,22,9,4,66,0
13715,318586,367_12_67,SLOVENIA,0,TOTALS,SLOVENIA,200,30,76,39.5,21,47,44.7,9,29,31.0,9,13,69.2,23,22,45,20,20,15,14,5,78,1
13716,318599,367_12_68,POLAND,0,TOTALS,POLAND,200,19,64,29.7,14,42,33.3,5,22,22.7,16,24,66.7,12,23,35,9,23,16,9,4,59,0
13717,318612,367_12_68,GERMANY,0,TOTALS,GERMANY,200,25,65,38.5,20,50,40.0,5,15,33.3,19,28,67.9,21,34,55,13,24,20,5,5,74,1
13718,318625,367_12_69,ITALY,0,TOTALS,ITALY,200,22,69,31.9,17,49,34.7,5,20,25.0,20,27,74.1,9,28,37,6,21,9,10,2,69,0
13719,318638,367_12_69,SERBIA,0,TOTALS,SERBIA,200,32,68,47.1,26,54,48.1,6,14,42.9,13,21,61.9,12,41,53,19,26,15,6,2,83,1
13720,318651,367_12_70,FRANCE,0,TOTALS,FRANCE,200,23,58,39.7,20,42,47.6,3,16,18.8,12,16,75.0,9,23,32,11,17,14,9,5,61,0
13721,318664,367_12_70,TURKEY,0,TOTALS,TURKEY,200,24,61,39.3,19,36,52.8,5,25,20.0,13,20,65.0,17,25,42,14,18,17,6,1,66,1
13722,318677,368_12_01,NORWAY,0,TOTALS,NORWAY,200,14,43,32.6,12,33,36.4,2,10,20.0,11,16,68.8,7,16,23,3,18,17,6,1,41,0
13723,318690,368_12_01,HUNGARY,0,TOTALS,HUNGARY,200,32,66,48.5,25,45,55.6,7,21,33.3,19,27,70.4,18,25,43,7,14,9,10,3,90,1
13724,318703,368_12_02,LUXEMBOURG,0,TOTALS,LUXEMBOURG,200,25,79,31.6,24,62,38.7,1,17,5.9,12,22,54.5,20,30,50,9,14,21,16,7,63,0
13725,318716,368_12_02,BELARUS,0,TOTALS,BELARUS,200,28,85,32.9,23,59,39.0,5,26,19.2,6,14,42.9,29,38,67,16,21,25,12,7,67,1
13726,318729,368_12_03,SWEDEN,0,TOTALS,SWEDEN,200,29,62,46.8,26,48,54.2,3,14,21.4,6,8,75.0,10,36,46,16,24,18,5,5,67,1
13727,318742,368_12_03,FINLAND,0,TOTALS,FINLAND,200,18,56,32.1,10,40,25.0,8,16,50.0,13,21,61.9,5,24,29,10,16,11,9,1,57,0
13728,318755,368_12_04,AUSTRIA,0,TOTALS,AUSTRIA,200,17,52,32.7,17,43,39.5,0,9,0.0,23,30,76.7,14,24,38,4,13,35,10,3,57,0
13729,318768,368_12_04,SWITZERLAND,0,TOTALS,SWITZERLAND,200,30,70,42.9,29,59,49.2,1,11,9.1,11,14,78.6,15,21,36,10,26,18,20,3,72,1
13730,318781,368_12_05,NETHERLANDS,0,TOTALS,NETHERLANDS,200,16,63,25.4,11,37,29.7,5,26,19.2,3,12,25.0,16,28,44,6,18,17,9,1,40,0
13731,318794,368_12_05,PORTUGAL,0,TOTALS,PORTUGAL,200,16,44,36.4,11,27,40.7,5,17,29.4,11,18,61.1,6,31,37,11,14,22,6,1,48,1
13732,318807,368_12_06,ROMANIA,0,TOTALS,ROMANIA,200,20,68,29.4,16,42,38.1,4,26,15.4,7,14,50.0,22,29,51,7,25,25,17,3,51,0
13733,318820,368_12_06,GEORGIA,0,TOTALS,GEORGIA,200,17,51,33.3,12,36,33.3,5,15,33.3,16,31,51.6,13,34,47,9,15,27,9,5,55,1
13734,318833,368_12_07,SLOVAK REPUBLIC,0,TOTALS,SLOVAK REPUBLIC,200,16,58,27.6,11,38,28.9,5,20,25.0,10,14,71.4,14,31,45,12,19,28,8,3,47,0
13735,318846,368_12_07,MKD,0,TOTALS,MKD,200,32,73,43.8,23,46,50.0,9,27,33.3,11,20,55.0,16,29,45,17,18,12,19,2,84,1
13736,318859,368_12_08,BELGIUM,0,TOTALS,BELGIUM,200,24,66,36.4,20,51,39.2,4,15,26.7,9,14,64.3,11,29,40,12,25,15,13,2,61,0
13737,318872,368_12_08,DENMARK,0,TOTALS,DENMARK,200,24,55,43.6,19,39,48.7,5,16,31.2,13,22,59.1,8,34,42,14,14,19,4,4,66,1
13738,318885,368_12_09,BOSNIA AND HERZEGOVINA,0,TOTALS,BOSNIA AND HERZEGOVINA,200,25,65,38.5,17,43,39.5,8,22,36.4,24,36,66.7,16,24,40,12,33,23,11,3,82,0
13739,318898,368_12_09,ESTONIA,0,TOTALS,ESTONIA,200,27,53,50.9,20,34,58.8,7,19,36.8,22,43,51.2,12,27,39,13,26,28,9,1,83,1
13740,318911,368_12_10,HUNGARY,0,TOTALS,HUNGARY,200,35,67,52.2,31,58,53.4,4,9,44.4,14,24,58.3,15,22,37,23,14,11,13,4,88,1
13741,318924,368_12_10,AUSTRIA,0,TOTALS,AUSTRIA,200,24,46,52.2,22,40,55.0,2,6,33.3,7,14,50.0,3,21,24,8,19,25,5,4,57,0
13742,318937,368_12_11,ISRAEL,0,TOTALS,ISRAEL,200,19,54,35.2,12,37,32.4,7,17,41.2,7,10,70.0,5,22,27,10,25,19,10,2,52,0
13743,318950,368_12_11,SWEDEN,0,TOTALS,SWEDEN,200,23,53,43.4,16,35,45.7,7,18,38.9,12,20,60.0,11,34,45,7,16,22,11,1,65,1
13744,318963,368_12_12,PORTUGAL,0,TOTALS,PORTUGAL,200,17,62,27.4,13,45,28.9,4,17,23.5,14,21,66.7,21,31,52,6,18,18,13,4,52,1
13745,318976,368_12_12,NORWAY,0,TOTALS,NORWAY,200,13,56,23.2,10,34,29.4,3,22,13.6,4,9,44.4,14,25,39,4,26,26,10,4,33,0
13746,318989,368_12_13,FINLAND,0,TOTALS,FINLAND,200,32,82,39.0,23,56,41.1,9,26,34.6,16,19,84.2,19,25,44,8,23,18,13,4,89,1
13747,319002,368_12_13,LUXEMBOURG,0,TOTALS,LUXEMBOURG,200,29,74,39.2,23,60,38.3,6,14,42.9,18,28,64.3,25,31,56,6,19,22,8,2,82,0
13748,319015,368_12_14,SWITZERLAND,0,TOTALS,SWITZERLAND,200,22,44,50.0,17,35,48.6,5,9,55.6,17,28,60.7,9,28,37,11,27,30,8,3,66,1
13749,319028,368_12_14,NETHERLANDS,0,TOTALS,NETHERLANDS,200,19,65,29.2,18,50,36.0,1,15,6.7,16,24,66.7,21,17,38,4,32,21,15,1,55,0
13750,319041,368_12_15,MONTENEGRO,0,TOTALS,MONTENEGRO,200,26,76,34.2,25,64,39.1,1,12,8.3,13,23,56.5,25,30,55,5,18,23,12,3,66,1
13751,319054,368_12_15,ROMANIA,0,TOTALS,ROMANIA,200,22,70,31.4,20,52,38.5,2,18,11.1,7,14,50.0,22,27,49,6,20,24,12,4,53,0
13752,319067,368_12_16,BULGARIA,0,TOTALS,BULGARIA,200,14,43,32.6,12,34,35.3,2,9,22.2,13,17,76.5,9,20,29,4,14,26,6,1,43,0
13753,319080,368_12_16,BELGIUM,0,TOTALS,BELGIUM,200,31,67,46.3,28,53,52.8,3,14,21.4,10,15,66.7,15,25,40,14,18,13,17,2,75,1
13754,319093,368_12_17,GEORGIA,0,TOTALS,GEORGIA,200,16,66,24.2,13,44,29.5,3,22,13.6,17,32,53.1,11,24,35,8,24,24,13,5,52,0
13755,319106,368_12_17,BOSNIA AND HERZEGOVINA,0,TOTALS,BOSNIA AND HERZEGOVINA,200,30,72,41.7,24,50,48.0,6,22,27.3,16,25,64.0,22,41,63,11,26,25,10,1,82,1
13756,319119,368_12_18,DENMARK,0,TOTALS,DENMARK,200,21,57,36.8,16,42,38.1,5,15,33.3,14,19,73.7,15,34,49,14,17,20,3,4,61,0
13757,319132,368_12_18,SLOVAK REPUBLIC,0,TOTALS,SLOVAK REPUBLIC,200,25,69,36.2,21,47,44.7,4,22,18.2,10,13,76.9,12,22,34,9,18,6,10,4,64,1
13758,319145,368_12_19,NETHERLANDS,0,TOTALS,NETHERLANDS,200,14,43,32.6,12,32,37.5,2,11,18.2,18,34,52.9,15,26,41,7,17,26,13,0,48,1
13759,319158,368_12_19,AUSTRIA,0,TOTALS,AUSTRIA,200,14,47,29.8,12,34,35.3,2,13,15.4,6,14,42.9,10,23,33,8,27,28,11,0,36,0
13760,319171,368_12_20,BELARUS,0,TOTALS,BELARUS,200,26,67,38.8,21,47,44.7,5,20,25.0,12,22,54.5,14,40,54,10,27,29,8,8,69,0
13761,319184,368_12_20,FINLAND,0,TOTALS,FINLAND,200,28,74,37.8,24,56,42.9,4,18,22.2,21,30,70.0,11,31,42,10,23,19,20,4,81,1
13762,319197,368_12_21,PORTUGAL,0,TOTALS,PORTUGAL,200,25,67,37.3,20,49,40.8,5,18,27.8,9,11,81.8,17,33,50,12,19,19,7,3,64,1
13763,319210,368_12_21,HUNGARY,0,TOTALS,HUNGARY,200,19,57,33.3,15,43,34.9,4,14,28.6,12,19,63.2,10,26,36,12,14,17,5,2,54,0
13764,319223,368_12_22,ESTONIA,0,TOTALS,ESTONIA,200,17,67,25.4,10,34,29.4,7,33,21.2,11,18,61.1,22,27,49,11,24,15,10,4,52,0
13765,319236,368_12_22,GEORGIA,0,TOTALS,GEORGIA,200,20,50,40.0,13,35,37.1,7,15,46.7,12,22,54.5,9,27,36,8,16,16,6,2,59,1
13766,319249,368_12_23,SLOVAK REPUBLIC,0,TOTALS,SLOVAK REPUBLIC,200,25,63,39.7,22,41,53.7,3,22,13.6,12,15,80.0,16,26,42,8,21,22,12,6,65,0
13767,319262,368_12_23,BULGARIA,0,TOTALS,BULGARIA,200,27,57,47.4,24,47,51.1,3,10,30.0,11,21,52.4,8,24,32,8,16,14,13,1,68,1
13768,319275,368_12_24,LUXEMBOURG,0,TOTALS,LUXEMBOURG,200,21,62,33.9,13,45,28.9,8,17,47.1,15,25,60.0,17,31,48,11,21,24,6,4,65,0
13769,319288,368_12_24,ISRAEL,0,TOTALS,ISRAEL,200,29,71,40.8,24,54,44.4,5,17,29.4,8,14,57.1,13,28,41,14,27,16,15,3,71,1
13770,319301,368_12_25,MKD,0,TOTALS,MKD,200,22,63,34.9,19,46,41.3,3,17,17.6,14,20,70.0,9,29,38,4,20,12,15,2,61,1
13771,319314,368_12_25,DENMARK,0,TOTALS,DENMARK,200,19,60,31.7,16,46,34.8,3,14,21.4,11,17,64.7,15,33,48,8,16,21,5,4,52,0
13772,319327,368_12_26,BOSNIA AND HERZEGOVINA,0,TOTALS,BOSNIA AND HERZEGOVINA,200,30,61,49.2,24,44,54.5,6,17,35.3,12,21,57.1,13,21,34,16,25,26,6,1,78,0
13773,319340,368_12_26,MONTENEGRO,0,TOTALS,MONTENEGRO,200,36,71,50.7,29,54,53.7,7,17,41.2,14,18,77.8,17,23,40,21,20,23,15,3,93,1
13774,319353,368_12_27,NORWAY,0,TOTALS,NORWAY,200,19,67,28.4,16,49,32.7,3,18,16.7,2,7,28.6,13,28,41,10,23,16,5,3,43,0
13775,319366,368_12_27,SWITZERLAND,0,TOTALS,SWITZERLAND,200,19,67,28.4,17,59,28.8,2,8,25.0,15,27,55.6,25,36,61,9,15,16,7,1,55,1
13776,319379,368_12_28,HUNGARY,0,TOTALS,HUNGARY,200,24,53,45.3,22,44,50.0,2,9,22.2,16,21,76.2,13,33,46,13,11,21,1,5,66,1
13777,319392,368_12_28,NETHERLANDS,0,TOTALS,NETHERLANDS,200,23,73,31.5,17,56,30.4,6,17,35.3,3,4,75.0,16,19,35,8,21,13,9,3,55,0
13778,319405,368_12_29,SWEDEN,0,TOTALS,SWEDEN,200,35,75,46.7,26,54,48.1,9,21,42.9,6,10,60.0,15,39,54,10,10,17,10,5,85,1
13779,319418,368_12_29,LUXEMBOURG,0,TOTALS,LUXEMBOURG,200,22,69,31.9,19,51,37.3,3,18,16.7,2,5,40.0,7,29,36,11,11,21,11,2,49,0
13780,319431,368_12_30,BELGIUM,0,TOTALS,BELGIUM,200,28,59,47.5,26,49,53.1,2,10,20.0,9,13,69.2,9,26,35,19,21,16,9,4,67,1
13781,319444,368_12_30,SLOVAK REPUBLIC,0,TOTALS,SLOVAK REPUBLIC,200,21,55,38.2,15,33,45.5,6,22,27.3,11,21,52.4,13,24,37,7,20,20,7,1,59,0
13782,319457,368_12_31,MONTENEGRO,0,TOTALS,MONTENEGRO,200,35,74,47.3,34,65,52.3,1,9,11.1,12,24,50.0,14,33,47,13,23,18,19,3,83,1
13783,319470,368_12_31,ESTONIA,0,TOTALS,ESTONIA,200,17,59,28.8,13,40,32.5,4,19,21.1,7,18,38.9,14,29,43,8,22,32,6,3,45,0
13784,319483,368_12_32,SWITZERLAND,0,TOTALS,SWITZERLAND,200,14,46,30.4,14,36,38.9,0,10,0.0,10,16,62.5,14,22,36,3,16,28,7,2,38,0
13785,319496,368_12_32,PORTUGAL,0,TOTALS,PORTUGAL,200,28,68,41.2,23,54,42.6,5,14,35.7,11,16,68.8,18,18,36,17,17,14,19,4,72,1
13786,319509,368_12_33,ROMANIA,0,TOTALS,ROMANIA,200,26,71,36.6,24,52,46.2,2,19,10.5,12,19,63.2,14,34,48,10,28,26,12,1,66,0
13787,319522,368_12_33,BOSNIA AND HERZEGOVINA,0,TOTALS,BOSNIA AND HERZEGOVINA,200,26,73,35.6,24,55,43.6,2,18,11.1,21,36,58.3,23,32,55,14,22,19,18,1,75,1
13788,319535,368_12_34,AUSTRIA,0,TOTALS,AUSTRIA,225,24,73,32.9,20,54,37.0,4,19,21.1,9,20,45.0,16,26,42,13,18,10,13,4,61,0
13789,319548,368_12_34,NORWAY,0,TOTALS,NORWAY,225,25,70,35.7,22,49,44.9,3,21,14.3,9,15,60.0,20,38,58,16,20,22,2,3,62,1
13790,319561,368_12_35,ISRAEL,0,TOTALS,ISRAEL,200,31,72,43.1,30,63,47.6,1,9,11.1,14,32,43.8,11,34,45,18,30,15,20,1,77,1
13791,319574,368_12_35,BELARUS,0,TOTALS,BELARUS,200,16,61,26.2,9,45,20.0,7,16,43.8,17,34,50.0,19,38,57,7,23,25,7,1,56,0
13792,319587,368_12_36,BULGARIA,0,TOTALS,BULGARIA,200,27,73,37.0,20,50,40.0,7,23,30.4,14,28,50.0,23,21,44,17,19,13,8,1,75,0
13793,319600,368_12_36,MKD,0,TOTALS,MKD,200,33,64,51.6,21,42,50.0,12,22,54.5,11,14,78.6,11,28,39,15,25,15,9,4,89,1
13794,319613,368_12_37,SWITZERLAND,0,TOTALS,SWITZERLAND,200,21,69,30.4,18,56,32.1,3,13,23.1,1,3,33.3,17,24,41,8,12,23,11,0,46,0
13795,319626,368_12_37,HUNGARY,0,TOTALS,HUNGARY,200,29,62,46.8,28,50,56.0,1,12,8.3,6,10,60.0,9,32,41,15,7,18,16,7,65,1
13796,319639,368_12_38,GEORGIA,0,TOTALS,GEORGIA,200,19,64,29.7,14,38,36.8,5,26,19.2,5,9,55.6,13,22,35,14,11,18,9,2,48,0
13797,319652,368_12_38,MONTENEGRO,0,TOTALS,MONTENEGRO,200,29,69,42.0,22,44,50.0,7,25,28.0,8,11,72.7,17,31,48,17,16,18,12,3,73,1
13798,319665,368_12_39,NORWAY,0,TOTALS,NORWAY,200,10,51,19.6,8,41,19.5,2,10,20.0,19,31,61.3,16,22,38,7,13,15,5,2,41,0
13799,319678,368_12_39,NETHERLANDS,0,TOTALS,NETHERLANDS,200,24,61,39.3,16,37,43.2,8,24,33.3,8,8,100.0,15,29,44,15,26,16,9,4,64,1
13800,319691,368_12_40,BELARUS,0,TOTALS,BELARUS,200,24,62,38.7,16,40,40.0,8,22,36.4,15,25,60.0,18,27,45,15,23,22,10,5,71,0
13801,319704,368_12_40,SWEDEN,0,TOTALS,SWEDEN,200,31,76,40.8,30,60,50.0,1,16,6.2,15,29,51.7,25,26,51,9,21,19,18,7,78,1
13802,319717,368_12_41,MKD,0,TOTALS,MKD,200,14,60,23.3,11,36,30.6,3,24,12.5,18,24,75.0,10,29,39,6,18,16,10,2,49,0
13803,319730,368_12_41,BELGIUM,0,TOTALS,BELGIUM,200,22,58,37.9,18,43,41.9,4,15,26.7,11,19,57.9,10,38,48,11,18,20,10,2,59,1
13804,319743,368_12_42,ESTONIA,0,TOTALS,ESTONIA,200,23,56,41.1,20,39,51.3,3,17,17.6,4,8,50.0,9,30,39,15,17,30,7,0,53,0
13805,319756,368_12_42,ROMANIA,0,TOTALS,ROMANIA,200,21,60,35.0,18,45,40.0,3,15,20.0,14,17,82.4,10,25,35,8,18,25,18,6,59,1
13806,319769,368_12_43,DENMARK,0,TOTALS,DENMARK,200,21,63,33.3,17,42,40.5,4,21,19.0,14,21,66.7,15,34,49,13,13,17,9,8,60,1
13807,319782,368_12_43,BULGARIA,0,TOTALS,BULGARIA,200,23,71,32.4,19,55,34.5,4,16,25.0,7,12,58.3,16,29,45,13,19,13,11,3,57,0
13808,319795,368_12_44,FINLAND,0,TOTALS,FINLAND,200,14,60,23.3,6,34,17.6,8,26,30.8,16,25,64.0,19,35,54,9,28,17,3,0,52,0
13809,319808,368_12_44,ISRAEL,0,TOTALS,ISRAEL,200,17,55,30.9,15,42,35.7,2,13,15.4,17,33,51.5,11,29,40,10,26,9,9,2,53,1
13810,319821,368_12_45,PORTUGAL,0,TOTALS,PORTUGAL,200,18,69,26.1,17,56,30.4,1,13,7.7,6,12,50.0,21,30,51,5,25,20,13,2,43,1
13811,319834,368_12_45,AUSTRIA,0,TOTALS,AUSTRIA,200,13,44,29.5,13,34,38.2,0,10,0.0,14,32,43.8,9,32,41,5,9,24,10,3,40,0
13812,319847,368_12_46,LUXEMBOURG,0,TOTALS,LUXEMBOURG,200,42,69,60.9,35,60,58.3,7,9,77.8,8,13,61.5,9,20,29,17,12,14,10,2,99,1
13813,319860,368_12_46,SLOVAK REPUBLIC,0,TOTALS,SLOVAK REPUBLIC,200,30,66,45.5,28,49,57.1,2,17,11.8,8,12,66.7,15,20,35,11,14,23,7,5,70,0
13814,319873,368_12_47,AUSTRIA,0,TOTALS,AUSTRIA,200,19,58,32.8,17,43,39.5,2,15,13.3,11,22,50.0,13,28,41,8,18,22,7,3,51,0
13815,319886,368_12_47,ESTONIA,0,TOTALS,ESTONIA,200,20,48,41.7,14,31,45.2,6,17,35.3,14,25,56.0,4,27,31,11,19,21,12,5,60,1
13816,319899,368_12_48,MONTENEGRO,0,TOTALS,MONTENEGRO,200,17,66,25.8,16,57,28.1,1,9,11.1,7,16,43.8,15,28,43,6,16,23,12,2,42,0
13817,319912,368_12_48,HUNGARY,0,TOTALS,HUNGARY,200,24,68,35.3,22,61,36.1,2,7,28.6,4,9,44.4,17,38,55,14,21,26,12,9,54,1
13818,319925,368_12_49,FINLAND,0,TOTALS,FINLAND,200,35,61,57.4,29,48,60.4,6,13,46.2,7,11,63.6,12,30,42,11,14,18,7,1,83,1
13819,319938,368_12_49,BULGARIA,0,TOTALS,BULGARIA,200,19,59,32.2,17,41,41.5,2,18,11.1,10,16,62.5,10,18,28,4,14,17,9,2,50,0
13820,319951,368_12_50,SWEDEN,0,TOTALS,SWEDEN,200,24,77,31.2,18,49,36.7,6,28,21.4,10,18,55.6,25,37,62,11,18,16,4,3,64,0
13821,319964,368_12_50,MKD,0,TOTALS,MKD,200,26,62,41.9,22,35,62.9,4,27,14.8,11,16,68.8,4,35,39,9,18,8,7,4,67,1
13822,319977,368_12_51,GEORGIA,0,TOTALS,GEORGIA,200,18,49,36.7,13,33,39.4,5,16,31.2,12,16,75.0,5,26,31,8,16,18,5,1,53,0
13823,319990,368_12_51,NETHERLANDS,0,TOTALS,NETHERLANDS,200,29,70,41.4,19,46,41.3,10,24,41.7,8,13,61.5,16,27,43,9,15,10,8,3,76,1
13824,320003,368_12_52,ISRAEL,0,TOTALS,ISRAEL,200,24,59,40.7,22,45,48.9,2,14,14.3,9,17,52.9,6,24,30,6,27,14,12,2,59,0
13825,320016,368_12_52,BELGIUM,0,TOTALS,BELGIUM,200,19,52,36.5,16,42,38.1,3,10,30.0,19,28,67.9,13,32,45,10,13,19,5,2,60,1
13826,320029,368_12_53,BELARUS,0,TOTALS,BELARUS,200,33,72,45.8,27,51,52.9,6,21,28.6,17,34,50.0,15,34,49,15,20,14,13,2,89,1
13827,320042,368_12_53,DENMARK,0,TOTALS,DENMARK,200,25,74,33.8,19,49,38.8,6,25,24.0,15,24,62.5,20,30,50,14,24,23,9,4,71,0
13828,320055,368_12_54,BOSNIA AND HERZEGOVINA,0,TOTALS,BOSNIA AND HERZEGOVINA,200,20,57,35.1,16,45,35.6,4,12,33.3,25,33,75.8,16,37,53,11,21,34,11,6,69,1
13829,320068,368_12_54,PORTUGAL,0,TOTALS,PORTUGAL,200,19,61,31.1,18,39,46.2,1,22,4.5,13,22,59.1,11,25,36,10,26,27,16,2,52,0
13830,320081,368_12_55,ROMANIA,0,TOTALS,ROMANIA,200,38,76,50.0,36,69,52.2,2,7,28.6,12,21,57.1,23,26,49,13,23,23,18,8,90,1
13831,320094,368_12_55,SWITZERLAND,0,TOTALS,SWITZERLAND,200,26,69,37.7,22,57,38.6,4,12,33.3,12,23,52.2,24,19,43,15,18,30,10,2,68,0
13832,320107,368_12_56,ESTONIA,0,TOTALS,ESTONIA,200,22,60,36.7,17,42,40.5,5,18,27.8,14,22,63.6,15,30,45,12,18,14,11,2,63,1
13833,320120,368_12_56,NORWAY,0,TOTALS,NORWAY,200,16,55,29.1,12,34,35.3,4,21,19.0,8,12,66.7,7,28,35,5,21,19,5,0,44,0
13834,320133,368_12_57,BELGIUM,0,TOTALS,BELGIUM,200,26,57,45.6,23,45,51.1,3,12,25.0,4,8,50.0,14,28,42,17,16,22,7,1,59,0
13835,320146,368_12_57,SWEDEN,0,TOTALS,SWEDEN,200,26,66,39.4,21,46,45.7,5,20,25.0,8,16,50.0,16,16,32,15,8,9,8,4,65,1
13836,320159,368_12_58,DENMARK,0,TOTALS,DENMARK,200,28,54,51.9,26,44,59.1,2,10,20.0,21,27,77.8,9,31,40,5,25,18,4,4,79,1
13837,320172,368_12_58,FINLAND,0,TOTALS,FINLAND,200,22,63,34.9,18,50,36.0,4,13,30.8,17,31,54.8,17,19,36,12,25,10,8,2,65,0
13838,320185,368_12_59,PORTUGAL,0,TOTALS,PORTUGAL,200,22,61,36.1,19,44,43.2,3,17,17.6,4,9,44.4,9,16,25,12,23,19,9,6,51,0
13839,320198,368_12_59,MONTENEGRO,0,TOTALS,MONTENEGRO,200,31,58,53.4,24,41,58.5,7,17,41.2,21,31,67.7,16,32,48,20,14,21,15,3,90,1
13840,320211,368_12_60,BULGARIA,0,TOTALS,BULGARIA,200,32,62,51.6,28,48,58.3,4,14,28.6,4,7,57.1,6,27,33,9,20,22,6,2,72,0
13841,320224,368_12_60,BELARUS,0,TOTALS,BELARUS,200,27,69,39.1,24,45,53.3,3,24,12.5,19,26,73.1,18,23,41,14,13,13,15,6,76,1
13842,320237,368_12_61,MKD,0,TOTALS,MKD,200,26,62,41.9,22,39,56.4,4,23,17.4,13,22,59.1,8,23,31,9,24,15,14,4,69,0
13843,320250,368_12_61,ISRAEL,0,TOTALS,ISRAEL,200,25,66,37.9,17,45,37.8,8,21,38.1,18,24,75.0,15,30,45,11,18,17,8,3,76,1
13844,320263,368_12_62,SWITZERLAND,0,TOTALS,SWITZERLAND,200,20,65,30.8,18,53,34.0,2,12,16.7,10,17,58.8,19,30,49,12,19,16,4,2,52,0
13845,320276,368_12_62,GEORGIA,0,TOTALS,GEORGIA,200,25,64,39.1,18,41,43.9,7,23,30.4,12,21,57.1,10,30,40,11,17,10,11,8,69,1
13846,320289,368_12_63,HUNGARY,0,TOTALS,HUNGARY,200,24,62,38.7,20,51,39.2,4,11,36.4,11,20,55.0,12,24,36,15,24,21,10,2,63,1
13847,320302,368_12_63,BOSNIA AND HERZEGOVINA,0,TOTALS,BOSNIA AND HERZEGOVINA,200,16,53,30.2,14,44,31.8,2,9,22.2,18,35,51.4,17,30,47,4,23,22,8,1,52,0
13848,320315,368_12_64,NETHERLANDS,0,TOTALS,NETHERLANDS,200,20,68,29.4,13,50,26.0,7,18,38.9,9,19,47.4,19,27,46,11,16,13,6,4,56,1
13849,320328,368_12_64,ROMANIA,0,TOTALS,ROMANIA,200,20,54,37.0,16,33,48.5,4,21,19.0,8,14,57.1,9,32,41,6,17,20,6,6,52,0
13850,320341,368_12_65,DENMARK,0,TOTALS,DENMARK,200,39,69,56.5,30,52,57.7,9,17,52.9,8,13,61.5,15,28,43,20,19,12,8,6,95,1
13851,320354,368_12_65,SWITZERLAND,0,TOTALS,SWITZERLAND,200,18,63,28.6,15,52,28.8,3,11,27.3,10,15,66.7,16,18,34,6,17,19,6,2,49,0
13852,320367,368_12_66,ISRAEL,0,TOTALS,ISRAEL,200,27,57,47.4,22,44,50.0,5,13,38.5,14,21,66.7,15,18,33,10,12,14,15,2,73,1
13853,320380,368_12_66,PORTUGAL,0,TOTALS,PORTUGAL,200,25,54,46.3,19,34,55.9,6,20,30.0,8,13,61.5,12,18,30,16,17,20,7,1,64,0
13854,320393,368_12_67,ROMANIA,0,TOTALS,ROMANIA,200,30,68,44.1,28,55,50.9,2,13,15.4,14,17,82.4,14,27,41,11,19,19,12,6,76,1
13855,320406,368_12_67,BULGARIA,0,TOTALS,BULGARIA,200,28,67,41.8,24,50,48.0,4,17,23.5,10,18,55.6,16,22,38,11,17,20,12,8,70,0
13856,320419,368_12_68,BOSNIA AND HERZEGOVINA,0,TOTALS,BOSNIA AND HERZEGOVINA,200,29,71,40.8,27,53,50.9,2,18,11.1,19,27,70.4,23,29,52,13,17,16,7,2,79,1
13857,320432,368_12_68,MKD,0,TOTALS,MKD,200,27,67,40.3,17,39,43.6,10,28,35.7,5,10,50.0,13,20,33,7,23,16,9,3,69,0
13858,320445,368_12_69,BELARUS,0,TOTALS,BELARUS,200,26,64,40.6,21,42,50.0,5,22,22.7,17,32,53.1,14,35,49,8,20,25,17,5,74,1
13859,320458,368_12_69,GEORGIA,0,TOTALS,GEORGIA,200,25,70,35.7,18,44,40.9,7,26,26.9,9,16,56.2,13,30,43,13,21,26,12,2,66,0
13860,320471,368_12_70,SWEDEN,0,TOTALS,SWEDEN,200,26,66,39.4,20,46,43.5,6,20,30.0,8,12,66.7,14,24,38,10,20,16,12,2,66,0
13861,320484,368_12_70,MONTENEGRO,0,TOTALS,MONTENEGRO,200,25,53,47.2,17,36,47.2,8,17,47.1,13,22,59.1,7,26,33,14,18,17,5,2,71,1
13862,320497,368_12_71,NETHERLANDS,0,TOTALS,NETHERLANDS,200,31,61,50.8,25,45,55.6,6,16,37.5,8,10,80.0,7,27,34,14,20,14,9,4,76,1
13863,320510,368_12_71,FINLAND,0,TOTALS,FINLAND,200,21,70,30.0,16,39,41.0,5,31,16.1,12,15,80.0,21,21,42,2,14,17,5,0,59,0
13864,320523,368_12_72,HUNGARY,0,TOTALS,HUNGARY,200,17,46,37.0,15,34,44.1,2,12,16.7,12,21,57.1,7,27,34,9,17,18,7,2,48,0
13865,320536,368_12_72,BELGIUM,0,TOTALS,BELGIUM,200,20,65,30.8,18,54,33.3,2,11,18.2,8,12,66.7,21,25,46,5,20,16,11,1,50,1
13866,320549,368_12_73,SLOVAK REPUBLIC,0,TOTALS,SLOVAK REPUBLIC,200,32,68,47.1,23,46,50.0,9,22,40.9,11,13,84.6,15,24,39,17,20,9,10,6,84,1
13867,320562,368_12_73,NORWAY,0,TOTALS,NORWAY,200,15,50,30.0,12,35,34.3,3,15,20.0,12,20,60.0,13,20,33,6,20,21,7,5,45,0
13868,320575,368_12_74,BELARUS,0,TOTALS,BELARUS,200,19,64,29.7,16,42,38.1,3,22,13.6,22,36,61.1,17,26,43,5,17,23,12,6,63,0
13869,320588,368_12_74,NETHERLANDS,0,TOTALS,NETHERLANDS,200,30,67,44.8,27,53,50.9,3,14,21.4,8,15,53.3,13,29,42,8,25,21,13,8,71,1
13870,320601,368_12_75,LUXEMBOURG,0,TOTALS,LUXEMBOURG,200,28,65,43.1,22,51,43.1,6,14,42.9,11,22,50.0,11,16,27,14,13,16,13,2,73,1
13871,320614,368_12_75,ESTONIA,0,TOTALS,ESTONIA,200,44,68,64.7,37,51,72.5,7,17,41.2,7,13,53.8,13,32,45,27,16,24,10,4,102,0
13872,320627,368_12_76,PORTUGAL,0,TOTALS,PORTUGAL,200,22,65,33.8,18,51,35.3,4,14,28.6,8,20,40.0,18,31,49,9,22,28,12,2,56,0
13873,320640,368_12_76,MKD,0,TOTALS,MKD,200,21,63,33.3,14,41,34.1,7,22,31.8,21,29,72.4,11,31,42,11,19,22,13,4,70,1
13874,320653,368_12_77,SWITZERLAND,0,TOTALS,SWITZERLAND,200,26,49,53.1,24,43,55.8,2,6,33.3,8,14,57.1,4,34,38,10,17,18,5,2,62,0
13875,320666,368_12_77,BULGARIA,0,TOTALS,BULGARIA,200,25,80,31.2,20,57,35.1,5,23,21.7,8,12,66.7,22,22,44,14,14,9,10,1,63,1
13876,320679,368_12_78,ISRAEL,0,TOTALS,ISRAEL,200,23,64,35.9,16,46,34.8,7,18,38.9,12,19,63.2,10,31,41,10,22,19,11,2,65,0
13877,320692,368_12_78,BOSNIA AND HERZEGOVINA,0,TOTALS,BOSNIA AND HERZEGOVINA,200,25,63,39.7,18,39,46.2,7,24,29.2,14,28,50.0,14,33,47,7,21,16,9,2,71,1
13878,320705,368_12_79,DENMARK,0,TOTALS,DENMARK,200,34,67,50.7,29,55,52.7,5,12,41.7,18,26,69.2,11,31,42,17,17,10,11,6,91,1
13879,320718,368_12_79,ROMANIA,0,TOTALS,ROMANIA,200,28,65,43.1,25,53,47.2,3,12,25.0,8,20,40.0,13,25,38,13,24,17,7,6,67,0
13880,320731,368_12_80,GEORGIA,0,TOTALS,GEORGIA,200,18,71,25.4,17,56,30.4,1,15,6.7,11,17,64.7,13,28,41,9,20,21,10,5,48,0
13881,320744,368_12_80,FINLAND,0,TOTALS,FINLAND,200,33,75,44.0,26,47,55.3,7,28,25.0,16,25,64.0,18,41,59,23,17,24,14,4,89,1
13882,320757,368_12_81,SWEDEN,0,TOTALS,SWEDEN,200,34,64,53.1,27,48,56.2,7,16,43.8,4,5,80.0,11,34,45,17,12,17,6,1,79,1
13883,320770,368_12_81,HUNGARY,0,TOTALS,HUNGARY,200,24,62,38.7,20,39,51.3,4,23,17.4,3,12,25.0,8,20,28,11,13,16,8,4,55,0
13884,320783,368_12_82,MONTENEGRO,0,TOTALS,MONTENEGRO,200,19,47,40.4,17,36,47.2,2,11,18.2,6,11,54.5,9,27,36,12,12,28,10,3,46,0
13885,320796,368_12_82,BELGIUM,0,TOTALS,BELGIUM,200,24,62,38.7,19,48,39.6,5,14,35.7,3,4,75.0,11,20,31,12,16,20,17,1,56,1
13886,320809,369_12_01,PRINCIPALITY OF MONACO,0,TOTALS,PRINCIPALITY OF MONACO,200,23,85,27.1,20,63,31.7,3,22,13.6,4,12,33.3,25,28,53,6,17,24,20,1,53,1
13887,320822,369_12_01,WALES,0,TOTALS,WALES,200,20,55,36.4,19,48,39.6,1,7,14.3,8,16,50.0,10,37,47,3,13,35,12,3,49,0
13888,320835,369_12_02,MALTA,0,TOTALS,MALTA,200,18,59,30.5,18,53,34.0,0,6,0.0,12,26,46.2,12,31,43,2,19,28,13,2,48,0
13889,320848,369_12_02,SAN MARINO,0,TOTALS,SAN MARINO,200,28,83,33.7,24,60,40.0,4,23,17.4,8,16,50.0,25,39,64,6,22,22,15,5,68,1
13890,320861,369_12_03,ANDORRA,0,TOTALS,ANDORRA,200,19,77,24.7,19,65,29.2,0,12,0.0,5,13,38.5,15,22,37,3,25,20,12,3,43,0
13891,320874,369_12_03,GIBRALTAR,0,TOTALS,GIBRALTAR,200,24,71,33.8,18,60,30.0,6,11,54.5,14,25,56.0,18,30,48,11,19,18,8,9,68,1
13892,320887,369_12_04,MALTA,0,TOTALS,MALTA,200,22,71,31.0,17,58,29.3,5,13,38.5,5,9,55.6,14,17,31,7,17,21,15,1,54,0
13893,320900,369_12_04,PRINCIPALITY OF MONACO,0,TOTALS,PRINCIPALITY OF MONACO,200,24,62,38.7,20,50,40.0,4,12,33.3,14,25,56.0,19,24,43,5,17,28,11,2,66,1
13894,320913,369_12_05,SAN MARINO,0,TOTALS,SAN MARINO,200,20,74,27.0,18,53,34.0,2,21,9.5,13,32,40.6,12,23,35,4,21,17,15,2,55,1
13895,320926,369_12_05,WALES,0,TOTALS,WALES,200,18,54,33.3,14,41,34.1,4,13,30.8,14,22,63.6,10,31,41,6,28,30,6,2,54,0
13896,320939,369_12_06,SCOTLAND,0,TOTALS,SCOTLAND,200,31,73,42.5,27,61,44.3,4,12,33.3,9,20,45.0,22,35,57,15,11,22,19,3,75,1
13897,320952,369_12_06,ANDORRA,0,TOTALS,ANDORRA,200,16,64,25.0,15,57,26.3,1,7,14.3,1,4,25.0,15,24,39,4,19,31,15,1,34,0
13898,320965,369_12_07,WALES,0,TOTALS,WALES,200,23,58,39.7,23,55,41.8,0,3,0.0,11,28,39.3,21,33,54,4,13,31,12,4,57,0
13899,320978,369_12_07,MALTA,0,TOTALS,MALTA,200,24,65,36.9,21,58,36.2,3,7,42.9,8,18,44.4,13,22,35,11,24,21,19,1,59,1
13900,320991,369_12_08,PRINCIPALITY OF MONACO,0,TOTALS,PRINCIPALITY OF MONACO,200,36,79,45.6,31,65,47.7,5,14,35.7,5,18,27.8,21,38,59,11,20,21,20,1,82,1
13901,321004,369_12_08,SAN MARINO,0,TOTALS,SAN MARINO,200,9,55,16.4,6,24,25.0,3,31,9.7,11,23,47.8,13,26,39,1,15,34,9,2,32,0
13902,321017,369_12_09,GIBRALTAR,0,TOTALS,GIBRALTAR,200,18,56,32.1,15,48,31.2,3,8,37.5,2,5,40.0,6,20,26,4,15,26,6,4,41,0
13903,321030,369_12_09,SCOTLAND,0,TOTALS,SCOTLAND,200,27,76,35.5,19,51,37.3,8,25,32.0,8,11,72.7,22,29,51,16,13,21,16,4,70,1
13904,321043,369_12_10,WALES,0,TOTALS,WALES,200,27,72,37.5,25,60,41.7,2,12,16.7,9,29,31.0,17,30,47,3,23,34,13,1,65,0
13905,321056,369_12_10,ANDORRA,0,TOTALS,ANDORRA,200,31,77,40.3,30,68,44.1,1,9,11.1,21,29,72.4,14,32,46,17,24,27,18,2,84,1
13906,321069,369_12_11,SCOTLAND,0,TOTALS,SCOTLAND,200,30,73,41.1,27,63,42.9,3,10,30.0,9,15,60.0,19,28,47,7,16,22,11,6,72,1
13907,321082,369_12_11,SAN MARINO,0,TOTALS,SAN MARINO,200,12,62,19.4,8,40,20.0,4,22,18.2,4,10,40.0,16,21,37,5,12,23,9,1,32,0
13908,321095,369_12_12,PRINCIPALITY OF MONACO,0,TOTALS,PRINCIPALITY OF MONACO,200,32,74,43.2,23,46,50.0,9,28,32.1,5,12,41.7,18,42,60,16,21,18,7,2,78,1
13909,321108,369_12_12,GIBRALTAR,0,TOTALS,GIBRALTAR,200,14,75,18.7,13,59,22.0,1,16,6.2,8,23,34.8,25,26,51,4,18,17,10,4,37,0
13910,321121,369_12_13,ANDORRA,0,TOTALS,ANDORRA,200,31,63,49.2,30,57,52.6,1,6,16.7,13,19,68.4,8,30,38,11,17,31,12,4,76,1
13911,321134,369_12_13,MALTA,0,TOTALS,MALTA,200,28,77,36.4,27,71,38.0,1,6,16.7,10,20,50.0,10,20,30,8,21,24,14,2,67,0
13912,321147,369_12_14,GIBRALTAR,0,TOTALS,GIBRALTAR,200,20,74,27.0,16,63,25.4,4,11,36.4,6,14,42.9,15,34,49,8,21,27,11,4,50,1
13913,321160,369_12_14,SAN MARINO,0,TOTALS,SAN MARINO,200,13,74,17.6,10,42,23.8,3,32,9.4,16,30,53.3,19,31,50,7,19,19,15,6,45,0
13914,321173,369_12_15,PRINCIPALITY OF MONACO,0,TOTALS,PRINCIPALITY OF MONACO,200,21,68,30.9,14,44,31.8,7,24,29.2,12,22,54.5,18,32,50,6,19,17,7,5,61,1
13915,321186,369_12_15,SCOTLAND,0,TOTALS,SCOTLAND,200,20,67,29.9,17,47,36.2,3,20,15.0,10,18,55.6,18,32,50,4,19,21,9,2,53,0
13916,325110,373_12_01,NEW ZEALAND,0,TOTALS,NEW ZEALAND,200,22,44,50.0,19,35,54.3,3,9,33.3,17,26,65.4,7,17,24,10,17,26,7,3,64,0
13917,325123,373_12_01,AUSTRALIA,0,TOTALS,AUSTRALIA,200,35,74,47.3,26,47,55.3,9,27,33.3,6,10,60.0,21,15,36,19,24,14,10,1,85,1
13918,325136,373_12_02,AUSTRALIA,0,TOTALS,AUSTRALIA,200,36,67,53.7,28,38,73.7,8,29,27.6,15,22,68.2,13,24,37,29,20,16,14,9,95,1
13919,325149,373_12_02,NEW ZEALAND,0,TOTALS,NEW ZEALAND,200,25,64,39.1,21,54,38.9,4,10,40.0,16,20,80.0,12,15,27,11,21,20,7,1,70,0
13920,325161,373_12_03,NEW ZEALAND,0,TOTALS,NEW ZEALAND,200,24,58,41.4,20,48,41.7,4,10,40.0,8,12,66.7,9,16,25,16,15,26,11,1,60,0
13921,325174,373_12_03,AUSTRALIA,0,TOTALS,AUSTRALIA,200,37,65,56.9,29,42,69.0,8,23,34.8,11,13,84.6,9,23,32,21,14,15,15,8,93,1
13922,325264,375_13_01,SPAIN,0,TOTALS,SPAIN,200,30,55,54.5,19,28,67.9,11,27,40.7,10,17,58.8,6,24,30,12,25,20,4,1,81,1
13923,325277,375_13_01,CANADA,0,TOTALS,CANADA,200,24,62,38.7,18,46,39.1,6,16,37.5,16,23,69.6,16,20,36,4,23,19,9,0,70,0
13924,325290,375_13_02,SENEGAL,0,TOTALS,SENEGAL,200,19,80,23.8,17,60,28.3,2,20,10.0,6,23,26.1,20,19,39,4,23,13,9,2,46,0
13925,325303,375_13_02,AUSTRALIA,0,TOTALS,AUSTRALIA,200,30,60,50.0,18,33,54.5,12,27,44.4,18,27,66.7,12,41,53,19,18,16,9,7,90,1
13926,325317,375_13_03,CROATIA,0,TOTALS,CROATIA,225,48,88,54.5,39,62,62.9,9,26,34.6,14,18,77.8,22,21,43,35,28,18,8,1,119,0
13927,325330,375_13_03,KOREA,0,TOTALS,KOREA,200,32,58,55.2,22,36,61.1,10,22,45.5,15,20,75.0,6,14,20,20,20,17,4,5,89,1
13928,325343,375_13_04,SERBIA,0,TOTALS,SERBIA,200,24,54,44.4,19,37,51.4,5,17,29.4,12,18,66.7,7,33,40,8,19,16,7,1,65,1
13929,325356,375_13_04,BRAZIL,0,TOTALS,BRAZIL,200,17,55,30.9,11,25,44.0,6,30,20.0,10,15,66.7,7,25,32,4,24,15,9,1,50,0
13930,325369,375_13_05,CZECH REPUBLIC,0,TOTALS,CZECH REPUBLIC,200,28,66,42.4,16,41,39.0,12,25,48.0,6,12,50.0,15,18,33,12,18,13,10,3,74,0
13931,325382,375_13_05,LITHUANIA,0,TOTALS,LITHUANIA,200,26,55,47.3,19,37,51.4,7,18,38.9,18,25,72.0,10,24,34,10,17,16,5,2,77,1
13932,325395,375_13_06,CHINA,0,TOTALS,CHINA,200,23,64,35.9,22,49,44.9,1,15,6.7,14,19,73.7,15,27,42,13,18,14,5,9,61,1
13933,325408,375_13_06,RUSSIA,0,TOTALS,RUSSIA,200,25,66,37.9,21,51,41.2,4,15,26.7,5,10,50.0,10,24,34,15,21,13,6,4,59,0
13934,325421,375_13_07,IRAN,0,TOTALS,IRAN,200,31,64,48.4,27,46,58.7,4,18,22.2,18,25,72.0,8,36,44,12,19,20,7,7,84,1
13935,325434,375_13_07,ARGENTINA,0,TOTALS,ARGENTINA,200,26,74,35.1,13,41,31.7,13,33,39.4,8,17,47.1,13,24,37,18,25,17,8,2,73,0
13936,325447,375_13_08,COTE D'IVOIRE,0,TOTALS,COTE D'IVOIRE,200,10,55,18.2,7,44,15.9,3,11,27.3,6,12,50.0,6,20,26,1,13,21,7,3,29,0
13937,325460,375_13_08,USA,0,TOTALS,USA,200,38,75,50.7,35,66,53.0,3,9,33.3,9,15,60.0,18,41,59,21,11,13,12,5,88,1
13938,325473,375_13_09,BRAZIL,0,TOTALS,BRAZIL,200,25,62,40.3,22,42,52.4,3,20,15.0,19,23,82.6,10,31,41,18,29,23,12,3,72,1
13939,325486,375_13_09,SENEGAL,0,TOTALS,SENEGAL,200,17,61,27.9,15,43,34.9,2,18,11.1,20,34,58.8,18,24,42,7,23,27,7,1,56,0
13940,325499,375_13_10,CANADA,0,TOTALS,CANADA,200,28,77,36.4,27,63,42.9,1,14,7.1,9,15,60.0,16,25,41,11,26,18,12,4,66,0
13941,325512,375_13_10,CROATIA,0,TOTALS,CROATIA,200,27,67,40.3,21,40,52.5,6,27,22.2,19,25,76.0,17,35,52,15,21,24,11,1,79,1
13942,325525,375_13_11,KOREA,0,TOTALS,KOREA,200,25,65,38.5,18,40,45.0,7,25,28.0,13,16,81.2,10,23,33,15,25,15,5,5,70,1
13943,325538,375_13_11,SPAIN,0,TOTALS,SPAIN,200,39,74,52.7,32,57,56.1,7,17,41.2,19,32,59.4,17,30,47,21,18,9,7,5,104,0
13944,325551,375_13_12,AUSTRALIA,0,TOTALS,AUSTRALIA,200,21,56,37.5,19,42,45.2,2,14,14.3,13,23,56.5,12,16,28,9,20,13,7,1,57,0
13945,325564,375_13_12,SERBIA,0,TOTALS,SERBIA,200,31,58,53.4,26,45,57.8,5,13,38.5,11,17,64.7,11,29,40,14,23,15,8,4,78,1
13946,325577,375_13_13,ARGENTINA,0,TOTALS,ARGENTINA,200,25,65,38.5,17,40,42.5,8,25,32.0,18,23,78.3,13,32,45,15,24,15,9,2,76,1
13947,325590,375_13_13,CZECH REPUBLIC,0,TOTALS,CZECH REPUBLIC,200,19,60,31.7,16,40,40.0,3,20,15.0,14,18,77.8,9,31,40,8,20,19,7,2,55,0
13948,325603,375_13_14,RUSSIA,0,TOTALS,RUSSIA,200,28,57,49.1,22,33,66.7,6,24,25.0,16,24,66.7,11,38,49,20,20,16,13,3,78,1
13949,325616,375_13_14,COTE D'IVOIRE,0,TOTALS,COTE D'IVOIRE,200,15,58,25.9,14,48,29.2,1,10,10.0,12,23,52.2,12,22,34,2,20,20,11,0,43,0
13950,325629,375_13_15,LITHUANIA,0,TOTALS,LITHUANIA,200,29,67,43.3,22,44,50.0,7,23,30.4,16,20,80.0,17,31,48,19,16,14,13,5,81,1
13951,325642,375_13_15,IRAN,0,TOTALS,IRAN,200,15,54,27.8,14,44,31.8,1,10,10.0,9,18,50.0,13,22,35,4,21,24,9,7,40,0
13952,325655,375_13_16,USA,0,TOTALS,USA,200,44,83,53.0,37,62,59.7,7,21,33.3,18,29,62.1,30,23,53,15,14,10,23,4,113,0
13953,325668,375_13_16,CHINA,0,TOTALS,CHINA,200,19,43,44.2,10,24,41.7,9,19,47.4,10,13,76.9,4,12,16,5,19,32,7,2,57,1
13954,325681,375_13_17,CROATIA,0,TOTALS,CROATIA,200,26,55,47.3,16,30,53.3,10,25,40.0,14,21,66.7,8,24,32,13,28,21,6,3,76,0
13955,325694,375_13_17,SPAIN,0,TOTALS,SPAIN,200,31,65,47.7,26,43,60.5,5,22,22.7,19,27,70.4,10,20,30,14,24,11,7,0,86,1
13956,325707,375_13_18,BRAZIL,0,TOTALS,BRAZIL,200,18,75,24.0,15,58,25.9,3,17,17.6,6,9,66.7,20,24,44,8,17,13,11,5,45,0
13957,325720,375_13_18,AUSTRALIA,0,TOTALS,AUSTRALIA,200,27,62,43.5,16,38,42.1,11,24,45.8,8,14,57.1,9,39,48,17,15,17,8,7,73,1
13958,325733,375_13_19,CANADA,0,TOTALS,CANADA,200,35,82,42.7,30,66,45.5,5,16,31.2,18,29,62.1,28,29,57,12,23,15,4,5,93,1
13959,325746,375_13_19,KOREA,0,TOTALS,KOREA,200,26,62,41.9,20,42,47.6,6,20,30.0,17,27,63.0,7,17,24,10,21,13,7,3,75,0
13960,325759,375_13_20,SENEGAL,0,TOTALS,SENEGAL,200,17,63,27.0,12,40,30.0,5,23,21.7,10,19,52.6,16,24,40,4,26,20,2,2,49,0
13961,325772,375_13_20,SERBIA,0,TOTALS,SERBIA,200,26,60,43.3,18,35,51.4,8,25,32.0,20,27,74.1,12,27,39,14,22,13,8,1,80,1
13962,325785,375_13_21,CHINA,0,TOTALS,CHINA,200,30,64,46.9,18,31,58.1,12,33,36.4,9,14,64.3,11,37,48,20,19,21,12,9,81,1
13963,325798,375_13_21,COTE D'IVOIRE,0,TOTALS,COTE D'IVOIRE,200,15,69,21.7,10,53,18.9,5,16,31.2,13,19,68.4,17,24,41,7,16,20,10,5,48,0
13964,325811,375_13_22,IRAN,0,TOTALS,IRAN,200,17,61,27.9,15,39,38.5,2,22,9.1,14,25,56.0,9,34,43,7,20,11,9,4,50,0
13965,325824,375_13_22,CZECH REPUBLIC,0,TOTALS,CZECH REPUBLIC,200,22,64,34.4,15,36,41.7,7,28,25.0,9,15,60.0,12,41,53,10,20,14,6,5,60,1
13966,325837,375_13_23,LITHUANIA,0,TOTALS,LITHUANIA,200,29,67,43.3,23,42,54.8,6,25,24.0,12,14,85.7,11,35,46,12,20,13,8,2,76,1
13967,325850,375_13_23,ARGENTINA,0,TOTALS,ARGENTINA,200,26,66,39.4,22,47,46.8,4,19,21.1,10,18,55.6,10,29,39,13,16,12,9,0,66,0
13968,325863,375_13_24,USA,0,TOTALS,USA,200,46,81,56.8,41,58,70.7,5,23,21.7,18,29,62.1,20,32,52,18,23,12,15,3,115,0
13969,325876,375_13_24,RUSSIA,0,TOTALS,RUSSIA,200,17,51,33.3,12,33,36.4,5,18,27.8,8,23,34.8,8,19,27,8,22,27,6,0,47,1
13970,325889,375_13_25,SENEGAL,0,TOTALS,SENEGAL,200,16,61,26.2,14,41,34.1,2,20,10.0,17,28,60.7,22,24,46,8,28,26,8,7,51,0
13971,325902,375_13_25,COTE D'IVOIRE,0,TOTALS,COTE D'IVOIRE,200,17,62,27.4,17,51,33.3,0,11,0.0,19,38,50.0,22,26,48,4,25,22,16,6,53,1
13972,325915,375_13_26,ARGENTINA,0,TOTALS,ARGENTINA,200,24,66,36.4,19,45,42.2,5,21,23.8,10,16,62.5,10,19,29,14,24,21,10,3,63,0
13973,325928,375_13_26,CROATIA,0,TOTALS,CROATIA,200,30,64,46.9,27,47,57.4,3,17,17.6,22,30,73.3,14,34,48,17,25,21,10,4,85,1
13974,325941,375_13_27,CHINA,0,TOTALS,CHINA,200,25,58,43.1,10,27,37.0,15,31,48.4,23,28,82.1,12,27,39,18,15,12,3,9,88,1
13975,325954,375_13_27,AUSTRALIA,0,TOTALS,AUSTRALIA,200,29,74,39.2,13,38,34.2,16,36,44.4,5,11,45.5,20,19,39,19,20,11,5,4,79,0
13976,325967,375_13_28,RUSSIA,0,TOTALS,RUSSIA,200,20,59,33.9,17,38,44.7,3,21,14.3,3,8,37.5,9,22,31,10,22,15,5,7,46,0
13977,325980,375_13_28,SERBIA,0,TOTALS,SERBIA,200,23,55,41.8,18,43,41.9,5,12,41.7,9,21,42.9,10,28,38,8,17,12,10,6,60,1
13978,325993,375_13_29,USA,0,TOTALS,USA,200,35,77,45.5,28,51,54.9,7,26,26.9,14,22,63.6,12,38,50,14,23,15,13,3,91,1
13979,326006,375_13_29,BRAZIL,0,TOTALS,BRAZIL,200,24,69,34.8,21,53,39.6,3,16,18.8,15,24,62.5,12,32,44,10,22,22,5,5,66,0
13980,326019,375_13_30,KOREA,0,TOTALS,KOREA,225,33,78,42.3,20,41,48.8,13,37,35.1,17,23,73.9,10,28,38,13,20,12,12,2,96,1
13981,326032,375_13_30,CZECH REPUBLIC,0,TOTALS,CZECH REPUBLIC,225,35,79,44.3,28,63,44.4,7,16,43.8,18,23,78.3,18,37,55,20,22,16,7,3,95,0
13982,326045,375_13_31,LITHUANIA,0,TOTALS,LITHUANIA,200,27,67,40.3,14,34,41.2,13,33,39.4,15,17,88.2,11,27,38,16,20,16,7,5,82,1
13983,326058,375_13_31,CANADA,0,TOTALS,CANADA,200,30,72,41.7,24,52,46.2,6,20,30.0,10,19,52.6,16,29,45,12,21,15,11,3,76,0
13984,326071,375_13_32,IRAN,0,TOTALS,IRAN,200,22,52,42.3,17,35,48.6,5,17,29.4,10,18,55.6,8,22,30,9,17,20,8,5,59,0
13985,326084,375_13_32,SPAIN,0,TOTALS,SPAIN,200,27,62,43.5,19,38,50.0,8,24,33.3,6,8,75.0,12,24,36,17,21,21,9,1,68,1
13986,326097,375_13_33,SENEGAL,0,TOTALS,SENEGAL,200,34,91,37.4,31,75,41.3,3,16,18.8,17,25,68.0,40,24,64,7,15,18,10,4,88,1
13987,326110,375_13_33,KOREA,0,TOTALS,KOREA,200,28,63,44.4,14,30,46.7,14,33,42.4,9,13,69.2,8,20,28,22,19,19,5,1,79,0
13988,326123,375_13_34,BRAZIL,0,TOTALS,BRAZIL,225,29,73,39.7,24,58,41.4,5,15,33.3,15,22,68.2,15,24,39,11,22,16,12,0,78,0
13989,326136,375_13_34,RUSSIA,0,TOTALS,RUSSIA,225,31,61,50.8,21,36,58.3,10,25,40.0,10,17,58.8,5,31,36,20,27,21,7,3,82,1
13990,326149,375_13_35,CANADA,0,TOTALS,CANADA,200,32,67,47.8,23,49,46.9,9,18,50.0,22,36,61.1,14,24,38,19,12,4,14,7,95,1
13991,326162,375_13_35,IRAN,0,TOTALS,IRAN,200,24,65,36.9,19,42,45.2,5,23,21.7,4,8,50.0,15,27,42,11,26,21,2,2,57,0
13992,326175,375_13_36,SPAIN,0,TOTALS,SPAIN,200,27,62,43.5,22,40,55.0,5,22,22.7,15,22,68.2,13,28,41,12,17,17,4,2,74,1
13993,326188,375_13_36,ARGENTINA,0,TOTALS,ARGENTINA,200,20,56,35.7,11,30,36.7,9,26,34.6,9,14,64.3,6,17,23,10,22,14,8,3,58,0
13994,326201,375_13_37,COTE D'IVOIRE,0,TOTALS,COTE D'IVOIRE,200,20,78,25.6,20,68,29.4,0,10,0.0,19,31,61.3,17,32,49,5,21,17,15,3,59,0
13995,326214,375_13_37,CZECH REPUBLIC,0,TOTALS,CZECH REPUBLIC,200,25,66,37.9,22,46,47.8,3,20,15.0,16,26,61.5,12,44,56,18,25,26,8,4,69,1
13996,326227,375_13_38,SERBIA,0,TOTALS,SERBIA,200,32,79,40.5,27,51,52.9,5,28,17.9,7,14,50.0,22,32,54,12,16,9,7,1,76,1
13997,326240,375_13_38,CHINA,0,TOTALS,CHINA,200,17,58,29.3,13,34,38.2,4,24,16.7,12,15,80.0,9,26,35,6,17,16,5,3,50,0
13998,326253,375_13_39,CROATIA,0,TOTALS,CROATIA,200,34,67,50.7,23,37,62.2,11,30,36.7,12,20,60.0,11,32,43,18,15,12,3,5,91,1
13999,326266,375_13_39,LITHUANIA,0,TOTALS,LITHUANIA,200,33,78,42.3,22,53,41.5,11,25,44.0,13,16,81.2,14,25,39,15,20,6,6,4,90,0
14000,326279,375_13_40,AUSTRALIA,0,TOTALS,AUSTRALIA,200,19,58,32.8,13,33,39.4,6,25,24.0,7,17,41.2,15,19,34,8,19,23,3,2,51,0
14001,326292,375_13_40,USA,0,TOTALS,USA,200,39,75,52.0,35,61,57.4,4,14,28.6,12,16,75.0,16,28,44,16,20,8,18,2,94,1
14002,326305,375_13_41,KOREA,0,TOTALS,KOREA,200,29,60,48.3,20,34,58.8,9,26,34.6,6,9,66.7,9,22,31,18,18,21,8,3,73,1
14003,326318,375_13_41,COTE D'IVOIRE,0,TOTALS,COTE D'IVOIRE,200,29,72,40.3,28,65,43.1,1,7,14.3,8,13,61.5,20,22,42,7,16,20,6,4,67,0
14004,326331,375_13_42,ARGENTINA,0,TOTALS,ARGENTINA,200,21,61,34.4,20,47,42.6,1,14,7.1,19,26,73.1,13,23,36,8,30,11,5,2,62,0
14005,326344,375_13_42,CANADA,0,TOTALS,CANADA,200,24,64,37.5,19,47,40.4,5,17,29.4,25,39,64.1,17,31,48,6,22,12,7,0,78,1
14006,326357,375_13_43,LITHUANIA,0,TOTALS,LITHUANIA,200,23,59,39.0,22,35,62.9,1,24,4.2,14,18,77.8,9,32,41,8,32,16,5,1,61,1
14007,326370,375_13_43,SPAIN,0,TOTALS,SPAIN,200,20,62,32.3,16,35,45.7,4,27,14.8,15,26,57.7,14,23,37,6,21,8,4,6,59,0
14008,326383,375_13_44,IRAN,0,TOTALS,IRAN,200,24,62,38.7,20,47,42.6,4,15,26.7,8,12,66.7,10,24,34,7,18,20,9,5,60,0
14009,326396,375_13_44,CROATIA,0,TOTALS,CROATIA,200,28,67,41.8,19,40,47.5,9,27,33.3,16,22,72.7,17,27,44,17,18,17,12,3,81,1
14010,326409,375_13_45,CZECH REPUBLIC,0,TOTALS,CZECH REPUBLIC,200,29,62,46.8,20,39,51.3,9,23,39.1,13,20,65.0,10,29,39,14,16,16,6,1,80,1
14011,326422,375_13_45,SENEGAL,0,TOTALS,SENEGAL,200,31,79,39.2,25,60,41.7,6,19,31.6,10,18,55.6,18,27,45,7,21,10,7,3,78,0
14012,326435,375_13_46,CHINA,0,TOTALS,CHINA,191,24,56,42.9,12,27,44.4,12,29,41.4,17,20,85.0,6,16,22,13,16,16,13,1,77,0
14013,326448,375_13_46,BRAZIL,0,TOTALS,BRAZIL,200,35,59,59.3,27,40,67.5,8,19,42.1,9,12,75.0,10,28,38,17,18,19,8,1,87,1
14014,326461,375_13_47,RUSSIA,0,TOTALS,RUSSIA,200,27,59,45.8,24,46,52.2,3,13,23.1,4,5,80.0,12,23,35,8,14,16,4,5,61,0
14015,326474,375_13_47,AUSTRALIA,0,TOTALS,AUSTRALIA,200,31,63,49.2,23,47,48.9,8,16,50.0,8,9,88.9,9,20,29,10,12,7,10,0,78,1
14016,326487,375_13_48,USA,0,TOTALS,USA,200,31,69,44.9,30,67,44.8,1,2,50.0,8,15,53.3,24,22,46,6,25,15,12,4,71,1
14017,326500,375_13_48,SERBIA,0,TOTALS,SERBIA,200,21,51,41.2,15,31,48.4,6,20,30.0,14,21,66.7,10,17,27,9,21,18,7,1,62,0
14018,326513,375_13_49,IRAN,0,TOTALS,IRAN,200,21,59,35.6,17,43,39.5,4,16,25.0,7,18,38.9,11,21,32,6,19,18,11,2,53,0
14019,326526,375_13_49,BRAZIL,0,TOTALS,BRAZIL,200,23,55,41.8,17,33,51.5,6,22,27.3,11,15,73.3,13,28,41,10,23,19,9,5,63,1
14020,326539,375_13_50,ARGENTINA,0,TOTALS,ARGENTINA,200,25,74,33.8,23,61,37.7,2,13,15.4,7,13,53.8,20,25,45,6,20,14,8,1,59,0
14021,326552,375_13_50,RUSSIA,0,TOTALS,RUSSIA,200,23,52,44.2,16,31,51.6,7,21,33.3,10,17,58.8,6,30,36,6,16,13,8,8,63,1
14022,326565,375_13_51,LITHUANIA,0,TOTALS,LITHUANIA,200,36,70,51.4,30,54,55.6,6,16,37.5,11,22,50.0,17,35,52,14,15,8,6,5,89,1
14023,326578,375_13_51,CHINA,0,TOTALS,CHINA,200,20,59,33.9,11,35,31.4,9,24,37.5,9,15,60.0,5,22,27,6,22,11,6,2,58,0
14024,326591,375_13_52,SPAIN,0,TOTALS,SPAIN,200,25,71,35.2,21,48,43.8,4,23,17.4,22,30,73.3,19,25,44,5,31,19,11,6,76,0
14025,326604,375_13_52,AUSTRALIA,0,TOTALS,AUSTRALIA,200,26,62,41.9,15,34,44.1,11,28,39.3,24,26,92.3,10,24,34,15,29,20,7,2,87,1
14026,326617,375_13_53,CROATIA,0,TOTALS,CROATIA,200,20,53,37.7,12,28,42.9,8,25,32.0,18,23,78.3,3,27,30,12,22,13,7,1,66,0
14027,326630,375_13_53,SERBIA,0,TOTALS,SERBIA,200,25,60,41.7,16,32,50.0,9,28,32.1,14,24,58.3,10,31,41,12,24,11,5,0,73,1
14028,326643,375_13_54,CANADA,0,TOTALS,CANADA,200,24,68,35.3,18,48,37.5,6,20,30.0,13,28,46.4,14,21,35,11,22,19,4,5,67,1
14029,326656,375_13_54,USA,0,TOTALS,USA,200,42,80,52.5,35,57,61.4,7,23,30.4,18,25,72.0,19,35,54,19,26,14,11,8,109,0
14030,326669,375_13_55,IRAN,0,TOTALS,IRAN,200,25,58,43.1,17,36,47.2,8,22,36.4,21,28,75.0,14,32,46,11,16,15,8,5,79,1
14031,326682,375_13_55,ARGENTINA,0,TOTALS,ARGENTINA,200,28,70,40.0,25,44,56.8,3,26,11.5,9,15,60.0,13,19,32,8,26,11,6,1,68,0
14032,326695,375_13_56,BRAZIL,0,TOTALS,BRAZIL,200,20,68,29.4,15,44,34.1,5,24,20.8,8,11,72.7,13,26,39,8,22,18,13,2,53,0
14033,326708,375_13_56,RUSSIA,0,TOTALS,RUSSIA,200,22,50,44.0,16,34,47.1,6,16,37.5,10,17,58.8,5,34,39,9,18,20,9,5,60,1
14034,326721,375_13_57,SPAIN,0,TOTALS,SPAIN,200,30,73,41.1,25,56,44.6,5,17,29.4,10,17,58.8,20,25,45,14,18,12,8,3,75,1
14035,326734,375_13_57,CROATIA,0,TOTALS,CROATIA,200,24,54,44.4,15,31,48.4,9,23,39.1,7,9,77.8,5,26,31,17,21,19,5,1,64,0
14036,326747,375_13_58,CHINA,0,TOTALS,CHINA,275,34,84,40.5,23,41,56.1,11,43,25.6,21,30,70.0,13,36,49,19,27,18,3,10,100,0
14037,326760,375_13_58,CANADA,0,TOTALS,CANADA,275,39,94,41.5,33,77,42.9,6,17,35.3,26,40,65.0,20,39,59,14,26,8,11,4,110,1
14038,326773,375_13_59,AUSTRALIA,0,TOTALS,AUSTRALIA,200,22,59,37.3,13,35,37.1,9,24,37.5,5,13,38.5,7,17,24,10,16,9,6,4,58,0
14039,326786,375_13_59,SERBIA,0,TOTALS,SERBIA,200,26,54,48.1,23,40,57.5,3,14,21.4,8,12,66.7,10,32,42,12,20,15,5,0,63,1
14040,326799,375_13_60,LITHUANIA,0,TOTALS,LITHUANIA,200,21,58,36.2,18,40,45.0,3,18,16.7,15,24,62.5,11,15,26,6,15,19,5,3,60,1
14041,326812,375_13_60,USA,0,TOTALS,USA,200,44,74,59.5,38,62,61.3,6,12,50.0,6,7,85.7,14,28,42,19,21,16,10,5,100,0
14042,326825,375_13_61,CROATIA,0,TOTALS,CROATIA,200,29,64,45.3,23,45,51.1,6,19,31.6,16,19,84.2,12,22,34,19,9,11,8,2,80,0
14043,326838,375_13_61,CHINA,0,TOTALS,CHINA,200,35,67,52.2,16,33,48.5,19,34,55.9,5,7,71.4,10,23,33,19,13,13,6,2,94,1
14044,326851,375_13_62,SPAIN,0,TOTALS,SPAIN,200,25,68,36.8,21,52,40.4,4,16,25.0,18,26,69.2,13,26,39,10,28,11,7,7,72,1
14045,326864,375_13_62,CANADA,0,TOTALS,CANADA,200,23,63,36.5,20,45,44.4,3,18,16.7,19,31,61.3,17,34,51,8,26,19,4,2,68,0
14046,326877,375_13_63,AUSTRALIA,0,TOTALS,AUSTRALIA,225,39,83,47.0,28,47,59.6,11,36,30.6,11,22,50.0,17,34,51,16,30,14,4,5,100,0
14047,326890,375_13_63,LITHUANIA,0,TOTALS,LITHUANIA,225,34,83,41.0,24,60,40.0,10,23,43.5,28,42,66.7,19,29,48,13,23,11,10,2,106,1
14048,326903,375_13_64,SERBIA,0,TOTALS,SERBIA,200,22,48,45.8,13,28,46.4,9,20,45.0,15,24,62.5,6,22,28,14,14,17,4,2,68,0
14049,326916,375_13_64,USA,0,TOTALS,USA,200,36,71,50.7,32,57,56.1,4,14,28.6,6,14,42.9,17,22,39,15,23,12,11,4,82,1
14050,328567,377_13_01,CAF,0,TOTALS,CAF,200,23,57,40.4,18,35,51.4,5,22,22.7,15,27,55.6,10,28,38,10,24,13,2,3,66,0
14051,328580,377_13_01,MOZAMBIQUE,0,TOTALS,MOZAMBIQUE,200,26,69,37.7,21,48,43.8,5,21,23.8,13,19,68.4,15,28,43,13,23,8,5,0,70,1
14052,328593,377_13_02,EGYPT,0,TOTALS,EGYPT,200,24,65,36.9,18,36,50.0,6,29,20.7,16,29,55.2,14,19,33,15,20,13,10,2,70,0
14053,328606,377_13_02,SENEGAL,0,TOTALS,SENEGAL,200,28,52,53.8,24,41,58.5,4,11,36.4,12,19,63.2,5,29,34,12,24,18,5,3,72,1
14054,328619,377_13_03,COTE D'IVOIRE,0,TOTALS,COTE D'IVOIRE,200,25,66,37.9,20,47,42.6,5,19,26.3,9,17,52.9,14,33,47,13,10,8,7,6,64,1
14055,328632,377_13_03,ALGERIA,0,TOTALS,ALGERIA,200,21,63,33.3,20,50,40.0,1,13,7.7,4,8,50.0,11,28,39,12,17,12,1,3,47,0
14056,328645,377_13_04,ANGOLA,0,TOTALS,ANGOLA,200,23,59,39.0,12,26,46.2,11,33,33.3,18,28,64.3,17,28,45,14,20,15,10,1,75,1
14057,328658,377_13_04,CAPE VERDE,0,TOTALS,CAPE VERDE,200,16,51,31.4,14,31,45.2,2,20,10.0,16,20,80.0,10,22,32,4,24,17,10,0,50,0
14058,328670,377_13_05,RWANDA,0,TOTALS,RWANDA,200,33,71,46.5,26,45,57.8,7,26,26.9,7,9,77.8,12,25,37,20,13,12,6,1,80,1
14059,328683,377_13_05,BURKINA FASO,0,TOTALS,BURKINA FASO,200,26,57,45.6,23,43,53.5,3,14,21.4,6,8,75.0,7,25,32,8,12,19,6,3,61,0
14060,328696,377_13_06,CAMEROON,0,TOTALS,CAMEROON,200,27,60,45.0,22,41,53.7,5,19,26.3,15,31,48.4,15,30,45,14,22,13,8,0,74,1
14061,328708,377_13_06,REPUBLIC OF CONGO,0,TOTALS,REPUBLIC OF CONGO,200,17,49,34.7,15,26,57.7,2,23,8.7,7,19,36.8,6,23,29,10,24,20,9,2,43,0
14062,328721,377_13_07,NIGERIA,0,TOTALS,NIGERIA,200,28,70,40.0,24,52,46.2,4,18,22.2,14,23,60.9,21,30,51,17,17,16,7,4,74,1
14063,328732,377_13_07,MALI,0,TOTALS,MALI,200,23,66,34.8,17,38,44.7,6,28,21.4,7,9,77.8,11,25,36,8,18,17,4,2,59,0
14064,328745,377_13_08,TUNISIA,0,TOTALS,TUNISIA,200,19,50,38.0,14,31,45.2,5,19,26.3,13,33,39.4,11,28,39,6,25,19,9,2,56,1
14065,328758,377_13_08,MOROCCO,0,TOTALS,MOROCCO,200,19,51,37.3,17,34,50.0,2,17,11.8,14,25,56.0,7,30,37,10,29,21,6,0,54,0
14066,328771,377_13_09,CAPE VERDE,0,TOTALS,CAPE VERDE,200,31,69,44.9,23,44,52.3,8,25,32.0,20,36,55.6,17,26,43,17,27,8,4,3,90,1
14067,328784,377_13_09,CAF,0,TOTALS,CAF,200,24,56,42.9,14,34,41.2,10,22,45.5,24,34,70.6,9,25,34,11,27,10,5,0,82,0
14068,328797,377_13_10,ALGERIA,0,TOTALS,ALGERIA,200,22,52,42.3,18,38,47.4,4,14,28.6,19,28,67.9,12,36,48,15,20,17,2,5,67,1
14069,328810,377_13_10,EGYPT,0,TOTALS,EGYPT,200,24,75,32.0,14,45,31.1,10,30,33.3,5,7,71.4,15,22,37,11,21,12,6,2,63,0
14070,328823,377_13_11,SENEGAL,0,TOTALS,SENEGAL,200,17,56,30.4,13,35,37.1,4,21,19.0,8,19,42.1,8,29,37,5,23,18,5,5,46,0
14071,328836,377_13_11,COTE D'IVOIRE,0,TOTALS,COTE D'IVOIRE,200,26,68,38.2,17,45,37.8,9,23,39.1,13,28,46.4,17,36,53,18,20,16,7,7,74,1
14072,328849,377_13_12,MOZAMBIQUE,0,TOTALS,MOZAMBIQUE,200,22,57,38.6,13,28,46.4,9,29,31.0,20,24,83.3,9,13,22,5,23,21,9,1,73,0
14073,328862,377_13_12,ANGOLA,0,TOTALS,ANGOLA,200,31,59,52.5,21,35,60.0,10,24,41.7,19,26,73.1,11,26,37,15,26,23,13,1,91,1
14074,328875,377_13_13,MOROCCO,0,TOTALS,MOROCCO,200,33,69,47.8,25,45,55.6,8,24,33.3,13,21,61.9,17,30,47,22,19,15,13,2,87,1
14075,328887,377_13_13,RWANDA,0,TOTALS,RWANDA,200,18,61,29.5,10,36,27.8,8,25,32.0,13,17,76.5,14,21,35,8,20,19,8,1,57,0
14076,328900,377_13_14,BURKINA FASO,0,TOTALS,BURKINA FASO,200,17,52,32.7,14,40,35.0,3,12,25.0,8,22,36.4,16,19,35,6,30,29,5,2,45,1
14077,328913,377_13_14,TUNISIA,0,TOTALS,TUNISIA,200,34,64,53.1,23,38,60.5,11,26,42.3,21,37,56.8,15,26,41,21,17,15,14,3,100,0
14078,328925,377_13_15,REPUBLIC OF CONGO,0,TOTALS,REPUBLIC OF CONGO,200,27,70,38.6,13,27,48.1,14,43,32.6,7,16,43.8,7,17,24,16,31,14,8,0,75,0
14079,328938,377_13_15,NIGERIA,0,TOTALS,NIGERIA,200,32,52,61.5,30,44,68.2,2,8,25.0,27,40,67.5,10,39,49,13,20,26,5,3,93,1
14080,328949,377_13_16,MALI,0,TOTALS,MALI,200,13,52,25.0,12,38,31.6,1,14,7.1,8,14,57.1,9,24,33,6,23,34,4,1,35,0
14081,328962,377_13_16,CAMEROON,0,TOTALS,CAMEROON,200,31,72,43.1,24,44,54.5,7,28,25.0,20,27,74.1,19,29,48,18,19,14,21,2,89,1
14082,328975,377_13_17,MOZAMBIQUE,0,TOTALS,MOZAMBIQUE,200,16,55,29.1,9,31,29.0,7,24,29.2,14,29,48.3,9,28,37,8,21,14,5,4,53,0
14083,328988,377_13_17,CAPE VERDE,0,TOTALS,CAPE VERDE,200,21,62,33.9,13,38,34.2,8,24,33.3,15,23,65.2,13,34,47,13,25,17,7,3,65,1
14084,329001,377_13_18,SENEGAL,0,TOTALS,SENEGAL,200,25,64,39.1,21,45,46.7,4,19,21.1,8,17,47.1,11,20,31,14,24,10,6,5,62,1
14085,329014,377_13_18,ALGERIA,0,TOTALS,ALGERIA,200,22,59,37.3,21,50,42.0,1,9,11.1,12,22,54.5,15,29,44,6,19,16,2,1,57,0
14086,329027,377_13_19,COTE D'IVOIRE,0,TOTALS,COTE D'IVOIRE,200,29,65,44.6,26,52,50.0,3,13,23.1,8,16,50.0,10,28,38,11,24,16,9,5,69,1
14087,329040,377_13_19,EGYPT,0,TOTALS,EGYPT,200,22,65,33.8,18,45,40.0,4,20,20.0,14,21,66.7,19,27,46,10,18,19,3,2,62,0
14088,329053,377_13_20,ANGOLA,0,TOTALS,ANGOLA,200,31,71,43.7,23,41,56.1,8,30,26.7,15,17,88.2,15,37,52,16,18,19,5,2,85,1
14089,329066,377_13_20,CAF,0,TOTALS,CAF,200,29,73,39.7,19,42,45.2,10,31,32.3,12,21,57.1,7,25,32,13,18,11,6,3,80,0
14090,329079,377_13_21,BURKINA FASO,0,TOTALS,BURKINA FASO,200,25,60,41.7,20,49,40.8,5,11,45.5,8,14,57.1,12,26,38,14,23,29,8,1,63,0
14091,329092,377_13_21,MOROCCO,0,TOTALS,MOROCCO,200,28,66,42.4,19,46,41.3,9,20,45.0,19,30,63.3,13,24,37,15,17,16,12,5,84,1
14092,329104,377_13_22,REPUBLIC OF CONGO,0,TOTALS,REPUBLIC OF CONGO,200,33,68,48.5,22,41,53.7,11,27,40.7,10,18,55.6,14,23,37,18,24,19,9,4,87,1
14093,329115,377_13_22,MALI,0,TOTALS,MALI,200,23,56,41.1,17,41,41.5,6,15,40.0,25,37,67.6,16,26,42,7,22,22,8,1,77,0
14094,329128,377_13_23,TUNISIA,0,TOTALS,TUNISIA,225,33,72,45.8,24,44,54.5,9,28,32.1,8,15,53.3,9,35,44,22,16,19,6,3,83,1
14095,329140,377_13_23,RWANDA,0,TOTALS,RWANDA,225,32,82,39.0,25,59,42.4,7,23,30.4,10,15,66.7,14,34,48,17,13,16,8,4,81,0
14096,329153,377_13_24,NIGERIA,0,TOTALS,NIGERIA,200,34,67,50.7,30,53,56.6,4,14,28.6,19,29,65.5,10,32,42,18,22,16,6,5,91,1
14097,329166,377_13_24,CAMEROON,0,TOTALS,CAMEROON,200,29,62,46.8,19,33,57.6,10,29,34.5,16,29,55.2,7,28,35,16,27,20,6,3,84,0
14098,329179,377_13_25,MOROCCO,0,TOTALS,MOROCCO,225,31,84,36.9,25,60,41.7,6,24,25.0,18,22,81.8,22,31,53,11,25,16,11,4,86,1
14099,329192,377_13_25,ALGERIA,0,TOTALS,ALGERIA,225,29,77,37.7,28,66,42.4,1,11,9.1,22,32,68.8,21,32,53,20,22,18,9,5,81,0
14100,329205,377_13_26,CAMEROON,0,TOTALS,CAMEROON,200,27,56,48.2,25,39,64.1,2,17,11.8,19,25,76.0,10,32,42,20,16,23,13,1,75,1
14101,329218,377_13_26,MOZAMBIQUE,0,TOTALS,MOZAMBIQUE,200,15,56,26.8,9,28,32.1,6,28,21.4,6,12,50.0,9,20,29,7,24,28,11,2,42,0
14102,329231,377_13_27,COTE D'IVOIRE,0,TOTALS,COTE D'IVOIRE,200,35,68,51.5,29,49,59.2,6,19,31.6,24,41,58.5,13,32,45,13,15,8,14,4,100,0
14103,329244,377_13_27,BURKINA FASO,0,TOTALS,BURKINA FASO,200,25,61,41.0,18,48,37.5,7,13,53.8,3,11,27.3,9,26,35,12,30,24,2,4,60,1
14104,329257,377_13_28,ANGOLA,0,TOTALS,ANGOLA,200,32,72,44.4,22,38,57.9,10,34,29.4,8,9,88.9,21,30,51,15,21,19,13,3,82,1
14105,329268,377_13_28,MALI,0,TOTALS,MALI,200,10,57,17.5,7,43,16.3,3,14,21.4,13,20,65.0,15,17,32,3,10,21,6,1,36,0
14106,329281,377_13_29,TUNISIA,0,TOTALS,TUNISIA,200,23,61,37.7,17,37,45.9,6,24,25.0,15,23,65.2,11,23,34,13,26,21,8,6,67,0
14107,329294,377_13_29,EGYPT,0,TOTALS,EGYPT,200,27,63,42.9,20,45,44.4,7,18,38.9,16,24,66.7,16,27,43,7,22,17,5,2,77,1
14108,329307,377_13_30,CAPE VERDE,0,TOTALS,CAPE VERDE,200,22,63,34.9,18,41,43.9,4,22,18.2,19,28,67.9,18,32,50,10,13,17,9,3,67,1
14109,329319,377_13_30,REPUBLIC OF CONGO,0,TOTALS,REPUBLIC OF CONGO,200,24,65,36.9,17,38,44.7,7,27,25.9,5,8,62.5,9,25,34,11,22,14,9,0,60,0
14110,329332,377_13_31,SENEGAL,0,TOTALS,SENEGAL,200,26,60,43.3,19,33,57.6,7,27,25.9,8,16,50.0,10,38,48,19,13,22,6,9,67,1
14111,329344,377_13_31,RWANDA,0,TOTALS,RWANDA,200,22,79,27.8,17,48,35.4,5,31,16.1,8,12,66.7,20,25,45,11,17,15,7,0,57,0
14112,329357,377_13_32,NIGERIA,0,TOTALS,NIGERIA,200,46,90,51.1,39,73,53.4,7,17,41.2,13,15,86.7,24,34,58,17,15,17,8,7,112,0
14113,329370,377_13_32,CAF,0,TOTALS,CAF,200,28,72,38.9,18,39,46.2,10,33,30.3,9,16,56.2,13,20,33,14,16,16,4,3,75,1
14114,329381,377_13_33,MALI,0,TOTALS,MALI,225,27,67,40.3,22,44,50.0,5,23,21.7,12,19,63.2,14,25,39,10,20,19,6,5,71,1
14115,329394,377_13_33,BURKINA FASO,0,TOTALS,BURKINA FASO,225,25,66,37.9,19,50,38.0,6,16,37.5,14,22,63.6,15,26,41,12,20,20,8,1,70,0
14116,329406,377_13_34,REPUBLIC OF CONGO,0,TOTALS,REPUBLIC OF CONGO,200,25,63,39.7,19,32,59.4,6,31,19.4,7,11,63.6,12,27,39,14,20,25,9,0,63,0
14117,329419,377_13_34,CAF,0,TOTALS,CAF,200,20,59,33.9,10,30,33.3,10,29,34.5,14,27,51.9,14,26,40,8,15,23,11,1,64,1
14118,329432,377_13_35,ANGOLA,0,TOTALS,ANGOLA,200,30,64,46.9,19,34,55.9,11,30,36.7,24,33,72.7,15,23,38,17,33,10,8,0,95,1
14119,329445,377_13_35,MOROCCO,0,TOTALS,MOROCCO,200,22,54,40.7,19,38,50.0,3,16,18.8,26,42,61.9,11,24,35,15,27,17,5,3,73,0
14120,329458,377_13_36,ALGERIA,0,TOTALS,ALGERIA,200,26,64,40.6,25,55,45.5,1,9,11.1,3,12,25.0,15,29,44,15,11,23,6,3,56,0
14121,329471,377_13_36,MOZAMBIQUE,0,TOTALS,MOZAMBIQUE,200,32,78,41.0,21,54,38.9,11,24,45.8,3,8,37.5,14,27,41,15,16,14,15,3,78,1
14122,329484,377_13_37,EGYPT,0,TOTALS,EGYPT,200,25,68,36.8,18,46,39.1,7,22,31.8,17,27,63.0,17,34,51,13,18,16,4,2,74,1
14123,329497,377_13_37,CAPE VERDE,0,TOTALS,CAPE VERDE,200,23,70,32.9,17,48,35.4,6,22,27.3,21,30,70.0,14,30,44,6,23,10,8,4,73,0
14124,329510,377_13_38,TUNISIA,0,TOTALS,TUNISIA,200,31,67,46.3,21,42,50.0,10,25,40.0,4,14,28.6,19,24,43,12,10,10,5,0,76,1
14125,329522,377_13_38,RWANDA,0,TOTALS,RWANDA,200,22,54,40.7,18,36,50.0,4,18,22.2,6,9,66.7,8,20,28,10,18,15,7,0,54,0
14126,329535,377_13_39,COTE D'IVOIRE,0,TOTALS,COTE D'IVOIRE,200,25,54,46.3,16,33,48.5,9,21,42.9,12,17,70.6,11,24,35,14,29,22,5,1,71,1
14127,329548,377_13_39,CAMEROON,0,TOTALS,CAMEROON,200,16,51,31.4,8,29,27.6,8,22,36.4,16,26,61.5,13,20,33,12,22,25,14,1,56,0
14128,329561,377_13_40,NIGERIA,0,TOTALS,NIGERIA,200,20,55,36.4,16,39,41.0,4,16,25.0,19,31,61.3,16,28,44,12,15,15,8,5,63,0
14129,329574,377_13_40,SENEGAL,0,TOTALS,SENEGAL,200,25,56,44.6,18,40,45.0,7,16,43.8,7,17,41.2,9,23,32,12,21,14,5,3,64,1
14130,329587,377_13_41,CAMEROON,0,TOTALS,CAMEROON,200,27,64,42.2,20,41,48.8,7,23,30.4,18,30,60.0,18,19,37,14,25,26,13,0,79,1
14131,329600,377_13_41,MOROCCO,0,TOTALS,MOROCCO,200,28,54,51.9,24,39,61.5,4,15,26.7,16,23,69.6,11,22,33,10,25,27,11,3,76,0
14132,329613,377_13_42,CAPE VERDE,0,TOTALS,CAPE VERDE,200,29,73,39.7,17,39,43.6,12,34,35.3,9,14,64.3,15,24,39,14,18,10,9,1,79,1
14133,329626,377_13_42,NIGERIA,0,TOTALS,NIGERIA,200,28,64,43.8,19,38,50.0,9,26,34.6,11,17,64.7,14,29,43,20,14,15,3,1,76,0
14134,329639,377_13_43,MOROCCO,0,TOTALS,MOROCCO,200,32,69,46.4,24,51,47.1,8,18,44.4,15,25,60.0,8,13,21,15,16,13,7,1,87,1
14135,329652,377_13_43,NIGERIA,0,TOTALS,NIGERIA,200,42,73,57.5,35,58,60.3,7,15,46.7,14,16,87.5,16,33,49,27,16,21,8,4,105,0
14136,329665,377_13_44,CAMEROON,0,TOTALS,CAMEROON,200,24,59,40.7,15,29,51.7,9,30,30.0,17,23,73.9,9,32,41,16,19,18,6,3,74,1
14137,329678,377_13_44,CAPE VERDE,0,TOTALS,CAPE VERDE,200,16,64,25.0,12,38,31.6,4,26,15.4,17,24,70.8,16,27,43,7,23,16,6,2,53,0
14138,329691,377_13_45,EGYPT,0,TOTALS,EGYPT,200,22,65,33.8,15,40,37.5,7,25,28.0,19,31,61.3,14,36,50,10,15,10,5,2,70,1
14139,329704,377_13_45,SENEGAL,0,TOTALS,SENEGAL,200,24,77,31.2,19,54,35.2,5,23,21.7,10,14,71.4,19,32,51,14,20,10,3,8,63,0
14140,329717,377_13_46,COTE D'IVOIRE,0,TOTALS,COTE D'IVOIRE,200,19,65,29.2,17,46,37.0,2,19,10.5,19,28,67.9,16,31,47,5,20,18,9,2,59,0
14141,329730,377_13_46,ANGOLA,0,TOTALS,ANGOLA,200,20,62,32.3,8,30,26.7,12,32,37.5,14,24,58.3,13,31,44,13,24,20,9,1,66,1
14142,329743,377_13_47,COTE D'IVOIRE,0,TOTALS,COTE D'IVOIRE,200,16,61,26.2,10,30,33.3,6,31,19.4,18,32,56.2,21,28,49,15,14,12,8,3,56,0
14143,329756,377_13_47,SENEGAL,0,TOTALS,SENEGAL,200,23,55,41.8,16,35,45.7,7,20,35.0,4,11,36.4,7,31,38,14,24,15,6,1,57,1
14144,329769,377_13_48,ANGOLA,0,TOTALS,ANGOLA,200,22,69,31.9,17,44,38.6,5,25,20.0,8,10,80.0,21,34,55,10,20,15,10,2,57,1
14145,329782,377_13_48,EGYPT,0,TOTALS,EGYPT,200,13,57,22.8,9,30,30.0,4,27,14.8,10,19,52.6,15,24,39,8,16,21,5,3,40,0
14146,331541,382_13_01,IRAN,0,TOTALS,IRAN,200,47,77,61.0,42,60,70.0,5,17,29.4,16,24,66.7,12,36,48,31,10,11,7,3,115,0
14147,331553,382_13_01,MALAYSIA,0,TOTALS,MALAYSIA,200,9,47,19.1,4,25,16.0,5,22,22.7,2,2,100.0,2,21,23,6,21,35,2,1,25,1
14148,331566,382_13_02,JORDAN,0,TOTALS,JORDAN,200,31,67,46.3,19,39,48.7,12,28,42.9,13,21,61.9,12,21,33,17,31,15,4,3,87,0
14149,331579,382_13_02,CHINESE TAIPEI,0,TOTALS,CHINESE TAIPEI,200,32,60,53.3,26,43,60.5,6,17,35.3,21,38,55.3,12,31,43,17,20,14,6,3,91,1
14150,331592,382_13_03,JAPAN,0,TOTALS,JAPAN,200,27,64,42.2,20,47,42.6,7,17,41.2,13,17,76.5,9,29,38,13,21,8,4,2,74,0
14151,331605,382_13_03,QATAR,0,TOTALS,QATAR,200,24,66,36.4,14,39,35.9,10,27,37.0,17,22,77.3,14,31,45,11,20,11,0,4,75,1
14152,331618,382_13_04,CHINA,0,TOTALS,CHINA,200,21,55,38.2,21,41,51.2,0,14,0.0,17,26,65.4,16,22,38,10,26,18,4,2,59,0
14153,331631,382_13_04,KOREA,0,TOTALS,KOREA,200,19,46,41.3,18,38,47.4,1,8,12.5,24,30,80.0,7,21,28,14,22,16,4,1,63,1
14154,331644,382_13_05,INDIA,0,TOTALS,INDIA,225,33,77,42.9,31,64,48.4,2,13,15.4,12,26,46.2,19,36,55,15,26,22,5,3,80,0
14155,331657,382_13_05,BAHRAIN,0,TOTALS,BAHRAIN,225,26,69,37.7,17,40,42.5,9,29,31.0,21,31,67.7,12,32,44,13,25,21,5,4,82,1
14156,331670,382_13_06,KINGDOM OF SAUDI ARABIA,0,TOTALS,KINGDOM OF SAUDI ARABIA,200,17,64,26.6,10,34,29.4,7,30,23.3,25,38,65.8,13,30,43,11,17,10,3,2,66,0
14157,331683,382_13_06,PHILIPPINES,0,TOTALS,PHILIPPINES,200,32,76,42.1,24,50,48.0,8,26,30.8,6,10,60.0,15,37,52,17,30,14,2,6,78,1
14158,331696,382_13_07,KAZAKHSTAN,0,TOTALS,KAZAKHSTAN,200,29,67,43.3,21,40,52.5,8,27,29.6,15,25,60.0,25,24,49,18,19,18,2,2,81,1
14159,331709,382_13_07,THAILAND,0,TOTALS,THAILAND,200,24,52,46.2,19,34,55.9,5,18,27.8,14,20,70.0,7,16,23,13,21,18,4,2,67,0
14160,331722,382_13_08,CHINA,0,TOTALS,CHINA,200,45,76,59.2,33,50,66.0,12,26,46.2,11,19,57.9,17,26,43,27,9,4,7,3,113,0
14161,331734,382_13_08,MALAYSIA,0,TOTALS,MALAYSIA,200,8,44,18.2,5,27,18.5,3,17,17.6,3,4,75.0,7,21,28,3,17,33,1,0,22,1
14162,331747,382_13_09,CHINESE TAIPEI,0,TOTALS,CHINESE TAIPEI,200,33,70,47.1,16,32,50.0,17,38,44.7,7,10,70.0,15,31,46,30,21,11,5,3,90,1
14163,331760,382_13_09,KINGDOM OF SAUDI ARABIA,0,TOTALS,KINGDOM OF SAUDI ARABIA,200,24,70,34.3,22,55,40.0,2,15,13.3,17,22,77.3,18,25,43,3,14,13,1,1,67,0
14164,331773,382_13_10,JAPAN,0,TOTALS,JAPAN,200,29,62,46.8,23,47,48.9,6,15,40.0,12,16,75.0,10,32,42,20,15,11,5,2,76,1
14165,331786,382_13_10,HONG KONG,0,TOTALS,HONG KONG,200,23,69,33.3,15,45,33.3,8,24,33.3,5,9,55.6,15,25,40,13,18,15,3,0,59,0
14166,331799,382_13_11,KOREA,0,TOTALS,KOREA,200,22,62,35.5,16,40,40.0,6,22,27.3,15,21,71.4,15,22,37,13,23,7,4,5,65,0
14167,331812,382_13_11,IRAN,0,TOTALS,IRAN,200,28,67,41.8,27,55,49.1,1,12,8.3,19,30,63.3,21,26,47,15,23,8,3,6,76,1
14168,331825,382_13_12,KAZAKHSTAN,0,TOTALS,KAZAKHSTAN,225,23,73,31.5,14,39,35.9,9,34,26.5,24,31,77.4,21,29,50,15,32,15,7,1,79,1
14169,331838,382_13_12,BAHRAIN,0,TOTALS,BAHRAIN,225,20,55,36.4,14,36,38.9,6,19,31.6,30,37,81.1,7,30,37,11,25,23,4,2,76,0
14170,331851,382_13_13,JORDAN,0,TOTALS,JORDAN,200,24,61,39.3,15,36,41.7,9,25,36.0,14,24,58.3,18,28,46,12,18,19,4,2,71,0
14171,331864,382_13_13,PHILIPPINES,0,TOTALS,PHILIPPINES,200,26,67,38.8,14,40,35.0,12,27,44.4,13,19,68.4,15,23,38,16,20,13,4,6,77,1
14172,331877,382_13_14,THAILAND,0,TOTALS,THAILAND,200,26,68,38.2,21,54,38.9,5,14,35.7,8,16,50.0,14,25,39,11,21,20,4,5,65,0
14173,331890,382_13_14,INDIA,0,TOTALS,INDIA,200,33,81,40.7,27,59,45.8,6,22,27.3,17,29,58.6,28,32,60,10,18,19,4,6,89,1
14174,331902,382_13_15,MALAYSIA,0,TOTALS,MALAYSIA,200,21,56,37.5,12,32,37.5,9,24,37.5,7,8,87.5,7,19,26,15,21,20,5,0,58,0
14175,331915,382_13_15,KOREA,0,TOTALS,KOREA,200,31,65,47.7,25,40,62.5,6,25,24.0,12,21,57.1,17,26,43,26,17,19,5,3,80,1
14176,331928,382_13_16,INDIA,0,TOTALS,INDIA,200,26,54,48.1,20,37,54.1,6,17,35.3,9,16,56.2,14,21,35,10,19,22,1,5,67,0
14177,331941,382_13_16,KAZAKHSTAN,0,TOTALS,KAZAKHSTAN,200,30,70,42.9,24,50,48.0,6,20,30.0,14,17,82.4,19,19,38,19,18,13,6,1,80,1
14178,331954,382_13_17,HONG KONG,0,TOTALS,HONG KONG,200,26,67,38.8,17,39,43.6,9,28,32.1,3,6,50.0,9,28,37,12,16,14,5,0,64,0
14179,331967,382_13_17,QATAR,0,TOTALS,QATAR,200,31,70,44.3,16,30,53.3,15,40,37.5,10,18,55.6,15,31,46,21,8,15,3,2,87,1
14180,331980,382_13_18,IRAN,0,TOTALS,IRAN,200,23,59,39.0,20,44,45.5,3,15,20.0,21,30,70.0,16,21,37,16,20,15,11,1,70,1
14181,331993,382_13_18,CHINA,0,TOTALS,CHINA,200,19,46,41.3,14,27,51.9,5,19,26.3,8,16,50.0,10,23,33,9,27,22,5,2,51,0
14182,332006,382_13_19,BAHRAIN,0,TOTALS,BAHRAIN,200,30,61,49.2,26,46,56.5,4,15,26.7,22,27,81.5,15,36,51,16,20,19,3,3,86,1
14183,332019,382_13_19,THAILAND,0,TOTALS,THAILAND,200,20,68,29.4,15,43,34.9,5,25,20.0,17,26,65.4,15,19,34,9,20,8,6,2,62,0
14184,332032,382_13_20,PHILIPPINES,0,TOTALS,PHILIPPINES,200,28,74,37.8,18,46,39.1,10,28,35.7,13,20,65.0,16,23,39,12,21,8,5,5,79,0
14185,332045,382_13_20,CHINESE TAIPEI,0,TOTALS,CHINESE TAIPEI,200,30,56,53.6,15,26,57.7,15,30,50.0,9,14,64.3,5,32,37,23,16,17,1,3,84,1
14186,332058,382_13_21,KINGDOM OF SAUDI ARABIA,0,TOTALS,KINGDOM OF SAUDI ARABIA,200,15,57,26.3,14,40,35.0,1,17,5.9,16,30,53.3,14,26,40,7,17,16,4,0,47,0
14187,332071,382_13_21,JORDAN,0,TOTALS,JORDAN,200,25,62,40.3,20,41,48.8,5,21,23.8,8,12,66.7,14,33,47,13,23,13,5,3,63,1
14188,332084,382_13_22,QATAR,0,TOTALS,QATAR,200,28,65,43.1,21,38,55.3,7,27,25.9,12,20,60.0,14,27,41,16,16,7,2,4,75,1
14189,332097,382_13_22,JORDAN,0,TOTALS,JORDAN,200,22,62,35.5,15,40,37.5,7,22,31.8,10,14,71.4,13,27,40,12,17,11,2,3,61,0
14190,332110,382_13_23,IRAN,0,TOTALS,IRAN,200,35,62,56.5,21,36,58.3,14,26,53.8,18,23,78.3,13,34,47,22,24,16,5,5,102,0
14191,332123,382_13_23,INDIA,0,TOTALS,INDIA,200,19,63,30.2,15,46,32.6,4,17,23.5,16,28,57.1,14,15,29,13,24,14,3,4,58,1
14192,332136,382_13_24,CHINESE TAIPEI,0,TOTALS,CHINESE TAIPEI,200,34,59,57.6,20,32,62.5,14,27,51.9,12,16,75.0,5,36,41,24,15,14,7,5,94,1
14193,332149,382_13_24,HONG KONG,0,TOTALS,HONG KONG,200,21,71,29.6,14,42,33.3,7,29,24.1,6,10,60.0,14,23,37,12,17,15,3,0,55,0
14194,332162,382_13_25,KAZAKHSTAN,0,TOTALS,KAZAKHSTAN,200,23,59,39.0,18,35,51.4,5,24,20.8,16,20,80.0,13,27,40,13,30,13,0,2,67,0
14195,332175,382_13_25,CHINA,0,TOTALS,CHINA,200,23,59,39.0,16,38,42.1,7,21,33.3,20,30,66.7,11,24,35,14,21,10,1,2,73,1
14196,332187,382_13_26,MALAYSIA,0,TOTALS,MALAYSIA,200,18,62,29.0,8,34,23.5,10,28,35.7,10,13,76.9,7,24,31,11,29,22,4,4,56,0
14197,332200,382_13_26,THAILAND,0,TOTALS,THAILAND,200,22,56,39.3,17,47,36.2,5,9,55.6,22,39,56.4,19,38,57,10,14,23,7,1,71,1
14198,332213,382_13_27,PHILIPPINES,0,TOTALS,PHILIPPINES,200,30,61,49.2,18,41,43.9,12,20,60.0,18,21,85.7,5,25,30,24,22,10,11,5,90,1
14199,332226,382_13_27,JAPAN,0,TOTALS,JAPAN,200,26,70,37.1,20,52,38.5,6,18,33.3,13,15,86.7,21,27,48,12,19,19,2,4,71,0
14200,332239,382_13_28,KOREA,0,TOTALS,KOREA,200,36,64,56.2,30,40,75.0,6,24,25.0,18,24,75.0,15,24,39,28,17,16,12,9,96,1
14201,332252,382_13_28,BAHRAIN,0,TOTALS,BAHRAIN,200,17,44,38.6,10,32,31.2,7,12,58.3,10,14,71.4,4,17,21,4,22,30,3,4,51,0
14202,332265,382_13_29,JORDAN,0,TOTALS,JORDAN,200,30,69,43.5,23,41,56.1,7,28,25.0,13,17,76.5,18,33,51,17,12,17,6,1,80,1
14203,332278,382_13_29,HONG KONG,0,TOTALS,HONG KONG,200,21,64,32.8,16,43,37.2,5,21,23.8,7,9,77.8,13,21,34,13,16,18,4,2,54,0
14204,332291,382_13_30,BAHRAIN,0,TOTALS,BAHRAIN,200,23,61,37.7,15,36,41.7,8,25,32.0,2,2,100.0,8,23,31,12,16,15,6,4,56,0
14205,332304,382_13_30,IRAN,0,TOTALS,IRAN,200,27,60,45.0,19,37,51.4,8,23,34.8,13,21,61.9,14,30,44,24,11,12,4,2,75,1
14206,332317,382_13_31,JAPAN,0,TOTALS,JAPAN,200,29,64,45.3,24,45,53.3,5,19,26.3,13,18,72.2,10,25,35,19,22,10,4,2,76,0
14207,332330,382_13_31,CHINESE TAIPEI,0,TOTALS,CHINESE TAIPEI,200,26,67,38.8,20,46,43.5,6,21,28.6,21,24,87.5,18,27,45,12,18,13,6,1,79,1
14208,332343,382_13_32,CHINA,0,TOTALS,CHINA,200,26,59,44.1,19,36,52.8,7,23,30.4,20,31,64.5,12,28,40,16,19,10,6,3,79,1
14209,332356,382_13_32,INDIA,0,TOTALS,INDIA,200,17,50,34.0,16,39,41.0,1,11,9.1,10,14,71.4,7,28,35,8,24,22,3,2,45,0
14210,332369,382_13_33,THAILAND,0,TOTALS,THAILAND,200,29,64,45.3,25,48,52.1,4,16,25.0,18,25,72.0,14,27,41,14,26,25,7,5,80,0
14211,332382,382_13_33,KINGDOM OF SAUDI ARABIA,0,TOTALS,KINGDOM OF SAUDI ARABIA,200,32,67,47.8,24,41,58.5,8,26,30.8,21,31,67.7,12,22,34,25,22,16,4,0,93,1
14212,332395,382_13_34,PHILIPPINES,0,TOTALS,PHILIPPINES,200,26,65,40.0,19,41,46.3,7,24,29.2,21,24,87.5,10,43,53,13,18,13,0,5,80,1
14213,332408,382_13_34,QATAR,0,TOTALS,QATAR,200,26,79,32.9,21,53,39.6,5,26,19.2,13,20,65.0,14,29,43,13,20,7,4,1,70,0
14214,332421,382_13_35,KAZAKHSTAN,0,TOTALS,KAZAKHSTAN,200,20,63,31.7,14,40,35.0,6,23,26.1,1,4,25.0,16,23,39,5,21,13,3,0,47,0
14215,332434,382_13_35,KOREA,0,TOTALS,KOREA,200,27,60,45.0,18,35,51.4,9,25,36.0,8,13,61.5,13,28,41,18,12,13,4,2,71,1
14216,332447,382_13_36,JAPAN,0,TOTALS,JAPAN,200,20,65,30.8,15,46,32.6,5,19,26.3,11,18,61.1,13,23,36,12,21,10,5,4,56,0
14217,332460,382_13_36,JORDAN,0,TOTALS,JORDAN,200,24,58,41.4,19,36,52.8,5,22,22.7,12,21,57.1,15,35,50,9,17,20,4,4,65,1
14218,332473,382_13_37,IRAN,0,TOTALS,IRAN,200,34,57,59.6,29,43,67.4,5,14,35.7,12,20,60.0,11,22,33,20,15,14,8,1,85,1
14219,332486,382_13_37,KAZAKHSTAN,0,TOTALS,KAZAKHSTAN,200,19,55,34.5,12,34,35.3,7,21,33.3,8,10,80.0,14,16,30,12,21,23,6,2,53,0
14220,332499,382_13_38,CHINESE TAIPEI,0,TOTALS,CHINESE TAIPEI,200,25,59,42.4,20,36,55.6,5,23,21.7,13,19,68.4,9,25,34,11,17,15,9,0,68,0
14221,332512,382_13_38,QATAR,0,TOTALS,QATAR,200,27,72,37.5,22,47,46.8,5,25,20.0,12,14,85.7,20,29,49,12,22,15,4,1,71,1
14222,332525,382_13_39,BAHRAIN,0,TOTALS,BAHRAIN,200,27,70,38.6,23,52,44.2,4,18,22.2,8,11,72.7,6,26,32,14,13,8,5,3,66,0
14223,332538,382_13_39,CHINA,0,TOTALS,CHINA,200,33,65,50.8,24,43,55.8,9,22,40.9,13,17,76.5,8,39,47,16,13,9,2,1,88,1
14224,332551,382_13_40,HONG KONG,0,TOTALS,HONG KONG,200,21,75,28.0,14,43,32.6,7,32,21.9,6,10,60.0,20,32,52,10,21,11,4,0,55,0
14225,332564,382_13_40,PHILIPPINES,0,TOTALS,PHILIPPINES,200,23,60,38.3,18,36,50.0,5,24,20.8,16,19,84.2,8,31,39,11,13,8,2,4,67,1
14226,332577,382_13_41,INDIA,0,TOTALS,INDIA,200,22,59,37.3,17,42,40.5,5,17,29.4,5,8,62.5,7,20,27,8,23,16,2,1,54,0
14227,332590,382_13_41,KOREA,0,TOTALS,KOREA,200,33,60,55.0,22,37,59.5,11,23,47.8,18,23,78.3,8,31,39,27,13,10,10,10,95,1
14228,332603,382_13_42,BAHRAIN,0,TOTALS,BAHRAIN,200,29,52,55.8,18,28,64.3,11,24,45.8,10,13,76.9,6,17,23,17,14,12,3,2,79,0
14229,332616,382_13_42,HONG KONG,0,TOTALS,HONG KONG,200,32,67,47.8,21,39,53.8,11,28,39.3,12,15,80.0,19,17,36,21,14,9,2,0,87,1
14230,332629,382_13_43,JAPAN,0,TOTALS,JAPAN,200,26,64,40.6,24,48,50.0,2,16,12.5,19,27,70.4,10,30,40,15,16,13,5,4,73,1
14231,332642,382_13_43,INDIA,0,TOTALS,INDIA,200,23,60,38.3,18,39,46.2,5,21,23.8,13,18,72.2,10,29,39,10,24,20,6,1,64,0
14232,332655,382_13_44,IRAN,0,TOTALS,IRAN,200,33,64,51.6,23,42,54.8,10,22,45.5,18,21,85.7,14,32,46,21,22,15,8,5,94,1
14233,332668,382_13_44,JORDAN,0,TOTALS,JORDAN,200,15,53,28.3,10,31,32.3,5,22,22.7,15,25,60.0,9,18,27,11,22,18,6,5,50,0
14234,332681,382_13_45,CHINESE TAIPEI,0,TOTALS,CHINESE TAIPEI,200,36,60,60.0,26,40,65.0,10,20,50.0,14,20,70.0,8,24,32,21,18,13,6,5,96,1
14235,332694,382_13_45,CHINA,0,TOTALS,CHINA,200,30,67,44.8,23,43,53.5,7,24,29.2,11,16,68.8,15,19,34,19,17,13,4,1,78,0
14236,332707,382_13_46,PHILIPPINES,0,TOTALS,PHILIPPINES,200,31,65,47.7,18,35,51.4,13,30,43.3,13,16,81.2,6,37,43,23,20,9,3,7,88,1
14237,332720,382_13_46,KAZAKHSTAN,0,TOTALS,KAZAKHSTAN,200,21,69,30.4,13,44,29.5,8,25,32.0,8,10,80.0,10,29,39,13,16,12,1,1,58,0
14238,332733,382_13_47,KOREA,0,TOTALS,KOREA,200,31,69,44.9,23,48,47.9,8,21,38.1,9,11,81.8,10,29,39,19,20,11,8,2,79,1
14239,332746,382_13_47,QATAR,0,TOTALS,QATAR,200,16,55,29.1,14,38,36.8,2,17,11.8,18,24,75.0,14,26,40,11,15,17,2,5,52,0
14240,332759,382_13_48,INDIA,0,TOTALS,INDIA,200,21,57,36.8,17,37,45.9,4,20,20.0,29,38,76.3,14,27,41,10,26,13,1,4,75,1
14241,332772,382_13_48,BAHRAIN,0,TOTALS,BAHRAIN,200,23,56,41.1,19,43,44.2,4,13,30.8,15,25,60.0,10,27,37,9,27,13,4,7,65,0
14242,332785,382_13_49,HONG KONG,0,TOTALS,HONG KONG,200,18,57,31.6,15,34,44.1,3,23,13.0,11,19,57.9,19,24,43,12,17,24,3,1,50,0
14243,332798,382_13_49,JAPAN,0,TOTALS,JAPAN,200,34,69,49.3,31,55,56.4,3,14,21.4,8,9,88.9,12,27,39,16,18,11,7,1,79,1
14244,332811,382_13_50,CHINA,0,TOTALS,CHINA,200,29,53,54.7,28,44,63.6,1,9,11.1,20,32,62.5,5,27,32,21,19,11,5,0,79,1
14245,332824,382_13_50,JORDAN,0,TOTALS,JORDAN,200,27,62,43.5,19,38,50.0,8,24,33.3,14,19,73.7,11,22,33,17,26,13,4,4,76,0
14246,332837,382_13_51,IRAN,0,TOTALS,IRAN,200,35,72,48.6,33,54,61.1,2,18,11.1,7,13,53.8,17,31,48,19,19,14,8,1,79,1
14247,332850,382_13_51,CHINESE TAIPEI,0,TOTALS,CHINESE TAIPEI,200,25,60,41.7,21,36,58.3,4,24,16.7,6,9,66.7,5,21,26,14,10,17,4,1,60,0
14248,332863,382_13_52,PHILIPPINES,0,TOTALS,PHILIPPINES,200,37,74,50.0,29,53,54.7,8,21,38.1,4,6,66.7,19,24,43,11,20,7,2,6,86,1
14249,332876,382_13_52,KOREA,0,TOTALS,KOREA,200,28,63,44.4,20,41,48.8,8,22,36.4,15,17,88.2,12,20,32,20,10,8,1,6,79,0
14250,332889,382_13_53,KAZAKHSTAN,0,TOTALS,KAZAKHSTAN,200,27,70,38.6,23,45,51.1,4,25,16.0,9,12,75.0,15,26,41,16,24,15,2,0,67,0
14251,332902,382_13_53,QATAR,0,TOTALS,QATAR,200,22,57,38.6,19,41,46.3,3,16,18.8,25,32,78.1,10,28,38,10,16,13,4,3,72,1
14252,332915,382_13_54,JORDAN,0,TOTALS,JORDAN,200,34,58,58.6,23,40,57.5,11,18,61.1,9,18,50.0,6,33,39,27,18,13,4,2,88,1
14253,332928,382_13_54,KAZAKHSTAN,0,TOTALS,KAZAKHSTAN,200,21,62,33.9,14,38,36.8,7,24,29.2,10,14,71.4,10,22,32,8,19,14,6,2,59,0
14254,332941,382_13_55,QATAR,0,TOTALS,QATAR,200,33,67,49.3,27,42,64.3,6,25,24.0,13,18,72.2,10,24,34,18,23,16,9,0,85,0
14255,332954,382_13_55,CHINA,0,TOTALS,CHINA,200,33,62,53.2,25,44,56.8,8,18,44.4,22,29,75.9,10,27,37,16,20,17,4,2,96,1
14256,332967,382_13_56,CHINESE TAIPEI,0,TOTALS,CHINESE TAIPEI,200,20,55,36.4,15,35,42.9,5,20,25.0,12,21,57.1,10,24,34,12,13,17,4,2,57,0
14257,332980,382_13_56,KOREA,0,TOTALS,KOREA,200,29,65,44.6,18,41,43.9,11,24,45.8,6,6,100.0,11,26,37,21,22,12,5,6,75,1
14258,332993,382_13_57,PHILIPPINES,0,TOTALS,PHILIPPINES,200,22,69,31.9,12,35,34.3,10,34,29.4,17,23,73.9,13,21,34,14,26,10,10,0,71,0
14259,333006,382_13_57,IRAN,0,TOTALS,IRAN,200,30,61,49.2,27,44,61.4,3,17,17.6,22,26,84.6,13,38,51,20,21,19,2,2,85,1
14260,333955,384_13_01,INDIA,0,TOTALS,INDIA,225,35,91,38.5,26,60,43.3,9,31,29.0,18,29,62.1,25,38,63,14,19,26,8,2,97,1
14261,333968,384_13_01,JORDAN,0,TOTALS,JORDAN,225,38,100,38.0,34,75,45.3,4,25,16.0,20,25,80.0,25,36,61,15,28,17,16,5,100,0
14262,333981,384_13_02,CHINESE TAIPEI,0,TOTALS,CHINESE TAIPEI,200,43,105,41.0,34,70,48.6,9,35,25.7,14,22,63.6,27,32,59,17,24,20,22,1,109,0
14263,333994,384_13_02,KAZAKHSTAN,0,TOTALS,KAZAKHSTAN,200,28,71,39.4,24,57,42.1,4,14,28.6,22,34,64.7,14,34,48,11,19,36,7,2,82,1
14264,334007,384_13_03,KOREA,0,TOTALS,KOREA,200,46,95,48.4,43,78,55.1,3,17,17.6,23,44,52.3,23,34,57,18,28,27,33,4,118,0
14265,334020,384_13_03,THAILAND,0,TOTALS,THAILAND,200,26,73,35.6,26,61,42.6,0,12,0.0,13,27,48.1,19,35,54,4,32,48,11,4,65,1
14266,334033,384_13_04,CHINA,0,TOTALS,CHINA,200,41,80,51.2,37,64,57.8,4,16,25.0,9,19,47.4,19,40,59,11,22,15,12,10,95,1
14267,334046,384_13_04,SYRIA,0,TOTALS,SYRIA,200,22,71,31.0,13,46,28.3,9,25,36.0,8,18,44.4,14,27,41,8,20,21,4,2,61,0
14268,334059,384_13_05,MALAYSIA,0,TOTALS,MALAYSIA,200,23,82,28.0,12,41,29.3,11,41,26.8,11,15,73.3,17,30,47,4,17,22,8,1,68,1
14269,334072,384_13_05,IRAN,0,TOTALS,IRAN,200,44,90,48.9,37,59,62.7,7,31,22.6,9,18,50.0,20,44,64,13,16,20,14,3,104,0
14270,334085,384_13_06,BAHRAIN,0,TOTALS,BAHRAIN,200,30,90,33.3,24,64,37.5,6,26,23.1,19,36,52.8,22,53,75,13,15,14,11,5,85,1
14271,334098,384_13_06,HONG KONG,0,TOTALS,HONG KONG,200,23,84,27.4,16,55,29.1,7,29,24.1,7,12,58.3,11,46,57,9,26,24,4,4,60,0
14272,334111,384_13_07,HONG KONG,0,TOTALS,HONG KONG,200,19,69,27.5,14,54,25.9,5,15,33.3,5,9,55.6,17,21,38,8,15,26,6,0,48,1
14273,334124,384_13_07,CHINA,0,TOTALS,CHINA,200,41,90,45.6,34,66,51.5,7,24,29.2,11,24,45.8,34,35,69,20,15,20,16,8,100,0
14274,334137,384_13_08,SYRIA,0,TOTALS,SYRIA,200,29,65,44.6,25,48,52.1,4,17,23.5,12,20,60.0,11,40,51,3,24,23,10,1,74,1
14275,334150,384_13_08,BAHRAIN,0,TOTALS,BAHRAIN,200,22,79,27.8,20,55,36.4,2,24,8.3,17,27,63.0,23,30,53,5,20,18,14,5,63,0
14276,334163,384_13_09,THAILAND,0,TOTALS,THAILAND,200,17,72,23.6,14,49,28.6,3,23,13.0,19,34,55.9,23,24,47,8,28,21,15,5,56,0
14277,334176,384_13_09,MALAYSIA,0,TOTALS,MALAYSIA,200,23,64,35.9,20,54,37.0,3,10,30.0,16,26,61.5,20,36,56,8,27,29,6,4,65,1
14278,334189,384_13_10,JORDAN,0,TOTALS,JORDAN,200,19,71,26.8,18,58,31.0,1,13,7.7,18,34,52.9,18,40,58,4,16,17,5,4,57,0
14279,334202,384_13_10,JAPAN,0,TOTALS,JAPAN,200,36,97,37.1,34,87,39.1,2,10,20.0,13,20,65.0,25,43,68,20,22,8,9,4,87,1
14280,334215,384_13_11,IRAN,0,TOTALS,IRAN,200,31,88,35.2,27,70,38.6,4,18,22.2,12,20,60.0,28,31,59,7,16,27,7,4,78,0
14281,334228,384_13_11,KOREA,0,TOTALS,KOREA,200,37,88,42.0,31,66,47.0,6,22,27.3,12,18,66.7,19,32,51,8,21,21,16,1,92,1
14282,334241,384_13_12,KAZAKHSTAN,0,TOTALS,KAZAKHSTAN,200,28,81,34.6,20,54,37.0,8,27,29.6,24,42,57.1,27,27,54,5,21,26,8,2,88,0
14283,334254,384_13_12,PHILIPPINES,0,TOTALS,PHILIPPINES,200,35,86,40.7,29,59,49.2,6,27,22.2,14,24,58.3,27,34,61,11,33,25,13,6,90,1
14284,334267,384_13_13,CHINA,0,TOTALS,CHINA,200,37,73,50.7,34,59,57.6,3,14,21.4,15,24,62.5,19,43,62,15,20,24,14,8,92,1
14285,334280,384_13_13,BAHRAIN,0,TOTALS,BAHRAIN,200,16,76,21.1,15,61,24.6,1,15,6.7,10,21,47.6,20,21,41,4,21,21,11,5,43,0
14286,334293,384_13_14,HONG KONG,0,TOTALS,HONG KONG,200,27,89,30.3,17,48,35.4,10,41,24.4,2,3,66.7,18,30,48,8,18,10,10,0,66,0
14287,334306,384_13_14,SYRIA,0,TOTALS,SYRIA,200,28,67,41.8,25,50,50.0,3,17,17.6,16,27,59.3,17,43,60,3,7,19,4,1,75,1
14288,334319,384_13_15,KOREA,0,TOTALS,KOREA,200,41,94,43.6,33,67,49.3,8,27,29.6,15,20,75.0,23,33,56,21,22,15,12,4,105,0
14289,334332,384_13_15,MALAYSIA,0,TOTALS,MALAYSIA,200,27,76,35.5,21,55,38.2,6,21,28.6,12,23,52.2,21,30,51,13,19,26,6,2,72,1
14290,334345,384_13_16,JAPAN,0,TOTALS,JAPAN,200,34,82,41.5,31,66,47.0,3,16,18.8,14,19,73.7,18,32,50,10,22,13,10,9,85,1
14291,334358,384_13_16,INDIA,0,TOTALS,INDIA,200,26,72,36.1,21,56,37.5,5,16,31.2,14,29,48.3,19,31,50,4,17,18,4,4,71,0
14292,334371,384_13_17,IRAN,0,TOTALS,IRAN,200,24,73,32.9,17,51,33.3,7,22,31.8,16,28,57.1,19,46,65,9,23,23,11,10,71,1
14293,334384,384_13_17,THAILAND,0,TOTALS,THAILAND,200,18,73,24.7,15,54,27.8,3,19,15.8,12,23,52.2,17,35,52,4,20,24,12,6,51,0
14294,334397,384_13_18,PHILIPPINES,0,TOTALS,PHILIPPINES,200,36,82,43.9,36,77,46.8,0,5,0.0,18,27,66.7,25,36,61,13,17,21,6,8,90,0
14295,334410,384_13_18,CHINESE TAIPEI,0,TOTALS,CHINESE TAIPEI,200,33,87,37.9,21,56,37.5,12,31,38.7,17,24,70.8,19,24,43,11,24,11,11,7,95,1
14296,334423,384_13_19,CHINA,0,TOTALS,CHINA,200,51,95,53.7,44,65,67.7,7,30,23.3,10,17,58.8,27,45,72,21,11,12,10,6,119,0
14297,334436,384_13_19,MALAYSIA,0,TOTALS,MALAYSIA,200,20,79,25.3,14,44,31.8,6,35,17.1,6,10,60.0,17,18,35,7,13,18,7,3,52,1
14298,334449,384_13_20,JORDAN,0,TOTALS,JORDAN,200,21,72,29.2,14,46,30.4,7,26,26.9,11,16,68.8,17,34,51,8,19,22,7,2,60,0
14299,334462,384_13_20,PHILIPPINES,0,TOTALS,PHILIPPINES,200,27,85,31.8,21,62,33.9,6,23,26.1,13,25,52.0,27,34,61,8,16,16,14,1,73,1
14300,334475,384_13_21,BAHRAIN,0,TOTALS,BAHRAIN,200,30,70,42.9,27,60,45.0,3,10,30.0,19,32,59.4,15,37,52,7,25,22,9,7,82,1
14301,334488,384_13_21,KOREA,0,TOTALS,KOREA,200,26,83,31.3,23,65,35.4,3,18,16.7,24,33,72.7,23,32,55,5,29,22,14,2,79,0
14302,334501,384_13_22,JAPAN,0,TOTALS,JAPAN,200,41,78,52.6,36,67,53.7,5,11,45.5,7,10,70.0,15,32,47,22,27,16,11,5,94,1
14303,334514,384_13_22,KAZAKHSTAN,0,TOTALS,KAZAKHSTAN,200,25,73,34.2,21,53,39.6,4,20,20.0,20,30,66.7,16,27,43,10,10,13,3,5,74,0
14304,334527,384_13_23,SYRIA,0,TOTALS,SYRIA,200,19,61,31.1,16,47,34.0,3,14,21.4,5,7,71.4,17,29,46,2,14,21,6,3,46,0
14305,334540,384_13_23,IRAN,0,TOTALS,IRAN,200,24,74,32.4,19,51,37.3,5,23,21.7,8,14,57.1,24,26,50,8,16,11,9,11,61,1
14306,334553,384_13_24,INDIA,0,TOTALS,INDIA,200,25,68,36.8,23,51,45.1,2,17,11.8,17,26,65.4,13,32,45,5,18,18,3,6,69,0
14307,334566,384_13_24,CHINESE TAIPEI,0,TOTALS,CHINESE TAIPEI,200,33,80,41.2,31,65,47.7,2,15,13.3,12,17,70.6,16,34,50,11,19,15,14,6,80,1
14308,334579,384_13_25,KOREA,0,TOTALS,KOREA,200,48,80,60.0,39,56,69.6,9,24,37.5,11,15,73.3,9,27,36,23,13,11,19,3,116,0
14309,334592,384_13_25,SYRIA,0,TOTALS,SYRIA,200,32,81,39.5,22,62,35.5,10,19,52.6,8,11,72.7,24,23,47,6,17,25,5,1,82,1
14310,334605,384_13_26,PHILIPPINES,0,TOTALS,PHILIPPINES,200,38,76,50.0,35,69,50.7,3,7,42.9,15,22,68.2,12,46,58,9,24,15,9,1,94,1
14311,334618,384_13_26,JAPAN,0,TOTALS,JAPAN,200,28,82,34.1,25,62,40.3,3,20,15.0,17,25,68.0,14,28,42,13,19,16,7,3,76,0
14312,334631,384_13_27,MALAYSIA,0,TOTALS,MALAYSIA,200,33,95,34.7,22,58,37.9,11,37,29.7,6,11,54.5,24,29,53,10,23,18,13,2,83,0
14313,334644,384_13_27,BAHRAIN,0,TOTALS,BAHRAIN,200,32,82,39.0,27,60,45.0,5,22,22.7,25,32,78.1,25,41,66,9,11,20,12,5,94,1
14314,334657,384_13_28,CHINESE TAIPEI,0,TOTALS,CHINESE TAIPEI,200,29,85,34.1,19,46,41.3,10,39,25.6,13,23,56.5,25,29,54,10,21,17,12,3,81,1
14315,334670,384_13_28,JORDAN,0,TOTALS,JORDAN,200,28,68,41.2,28,60,46.7,0,8,0.0,12,29,41.4,18,37,55,6,17,24,12,8,68,0
14316,334683,384_13_29,IRAN,0,TOTALS,IRAN,200,20,71,28.2,18,56,32.1,2,15,13.3,9,13,69.2,18,19,37,6,14,14,3,4,51,0
14317,334696,384_13_29,CHINA,0,TOTALS,CHINA,200,34,72,47.2,32,58,55.2,2,14,14.3,7,11,63.6,22,32,54,14,14,16,11,4,77,1
14318,334709,384_13_30,KAZAKHSTAN,0,TOTALS,KAZAKHSTAN,200,28,83,33.7,25,64,39.1,3,19,15.8,6,18,33.3,29,24,53,10,18,22,7,2,65,0
14319,334722,384_13_30,INDIA,0,TOTALS,INDIA,200,28,62,45.2,26,53,49.1,2,9,22.2,10,17,58.8,14,30,44,5,18,25,12,3,68,1
14320,334735,384_13_31,CHINA,0,TOTALS,CHINA,200,37,62,59.7,33,52,63.5,4,10,40.0,5,6,83.3,11,35,46,7,15,22,4,10,83,1
14321,334748,384_13_31,KOREA,0,TOTALS,KOREA,200,28,72,38.9,24,52,46.2,4,20,20.0,11,16,68.8,10,13,23,15,10,9,14,2,71,0
14322,334761,384_13_32,SYRIA,0,TOTALS,SYRIA,200,33,65,50.8,26,41,63.4,7,24,29.2,9,13,69.2,10,37,47,8,13,15,9,3,82,1
14323,334774,384_13_32,MALAYSIA,0,TOTALS,MALAYSIA,200,22,81,27.2,16,48,33.3,6,33,18.2,7,12,58.3,25,25,50,5,18,14,8,1,57,0
14324,334787,384_13_33,JORDAN,0,TOTALS,JORDAN,200,18,75,24.0,16,62,25.8,2,13,15.4,24,34,70.6,21,29,50,9,24,22,10,4,62,0
14325,334800,384_13_33,KAZAKHSTAN,0,TOTALS,KAZAKHSTAN,200,37,76,48.7,29,55,52.7,8,21,38.1,17,27,63.0,15,38,53,22,26,12,14,2,99,1
14326,334813,384_13_34,JAPAN,0,TOTALS,JAPAN,200,38,79,48.1,35,73,47.9,3,6,50.0,17,20,85.0,17,38,55,9,21,19,9,8,96,1
14327,334826,384_13_34,CHINESE TAIPEI,0,TOTALS,CHINESE TAIPEI,200,29,78,37.2,28,63,44.4,1,15,6.7,17,27,63.0,14,26,40,6,17,14,10,2,76,0
14328,334839,384_13_35,BAHRAIN,0,TOTALS,BAHRAIN,200,24,61,39.3,20,51,39.2,4,10,40.0,18,25,72.0,9,33,42,3,9,12,12,3,70,1
14329,334852,384_13_35,IRAN,0,TOTALS,IRAN,200,20,59,33.9,16,32,50.0,4,27,14.8,6,9,66.7,9,31,40,2,21,20,6,9,50,0
14330,334865,384_13_36,INDIA,0,TOTALS,INDIA,200,22,75,29.3,10,37,27.0,12,38,31.6,11,17,64.7,21,30,51,8,15,21,5,4,67,0
14331,334878,384_13_36,PHILIPPINES,0,TOTALS,PHILIPPINES,200,31,83,37.3,25,53,47.2,6,30,20.0,10,15,66.7,21,35,56,12,20,13,16,3,78,1
14332,334891,384_13_37,MALAYSIA,0,TOTALS,MALAYSIA,225,33,82,40.2,25,62,40.3,8,20,40.0,8,20,40.0,27,31,58,15,18,22,6,2,82,1
14333,334904,384_13_37,INDIA,0,TOTALS,INDIA,225,27,79,34.2,18,50,36.0,9,29,31.0,17,23,73.9,21,28,49,14,22,18,9,4,80,0
14334,334917,384_13_38,SYRIA,0,TOTALS,SYRIA,200,18,57,31.6,14,39,35.9,4,18,22.2,15,29,51.7,13,30,43,4,12,16,8,1,55,0
14335,334930,384_13_38,JORDAN,0,TOTALS,JORDAN,200,27,70,38.6,20,46,43.5,7,24,29.2,5,9,55.6,15,33,48,11,20,18,10,3,66,1
14336,334943,384_13_39,KOREA,0,TOTALS,KOREA,200,27,68,39.7,23,55,41.8,4,13,30.8,13,24,54.2,13,28,41,4,15,14,14,4,71,0
14337,334956,384_13_39,JAPAN,0,TOTALS,JAPAN,200,32,76,42.1,30,72,41.7,2,4,50.0,9,17,52.9,20,33,53,9,16,18,11,4,75,1
14338,334969,384_13_40,BAHRAIN,0,TOTALS,BAHRAIN,200,22,52,42.3,20,43,46.5,2,9,22.2,21,34,61.8,9,22,31,2,11,15,10,8,67,0
14339,334982,384_13_40,CHINESE TAIPEI,0,TOTALS,CHINESE TAIPEI,200,28,77,36.4,23,61,37.7,5,16,31.2,9,14,64.3,29,26,55,7,27,20,12,2,70,1
14340,334995,384_13_41,IRAN,0,TOTALS,IRAN,200,22,66,33.3,18,45,40.0,4,21,19.0,4,17,23.5,17,21,38,9,8,16,6,7,52,0
14341,335008,384_13_41,PHILIPPINES,0,TOTALS,PHILIPPINES,200,34,74,45.9,28,52,53.8,6,22,27.3,5,9,55.6,20,33,53,15,14,11,11,2,79,1
14342,335021,384_13_42,CHINA,0,TOTALS,CHINA,200,42,79,53.2,39,70,55.7,3,9,33.3,15,21,71.4,10,41,51,18,13,14,11,8,102,0
14343,335034,384_13_42,KAZAKHSTAN,0,TOTALS,KAZAKHSTAN,200,30,87,34.5,25,65,38.5,5,22,22.7,10,13,76.9,17,29,46,13,13,17,5,0,75,1
14344,335047,384_13_43,INDIA,0,TOTALS,INDIA,200,32,76,42.1,25,59,42.4,7,17,41.2,10,14,71.4,20,28,48,9,17,14,9,8,81,1
14345,335060,384_13_43,SYRIA,0,TOTALS,SYRIA,200,24,58,41.4,18,41,43.9,6,17,35.3,13,25,52.0,11,25,36,6,13,17,8,3,67,0
14346,335073,384_13_44,MALAYSIA,0,TOTALS,MALAYSIA,200,28,67,41.8,15,33,45.5,13,34,38.2,17,29,58.6,13,33,46,13,20,20,12,0,86,1
14347,335086,384_13_44,JORDAN,0,TOTALS,JORDAN,200,32,74,43.2,25,55,45.5,7,19,36.8,9,18,50.0,14,31,45,8,19,19,13,1,80,0
14348,335099,384_13_45,KAZAKHSTAN,0,TOTALS,KAZAKHSTAN,200,28,80,35.0,24,55,43.6,4,25,16.0,15,21,71.4,22,33,55,8,15,22,10,4,75,0
14349,335112,384_13_45,KOREA,0,TOTALS,KOREA,200,37,86,43.0,28,59,47.5,9,27,33.3,5,9,55.6,16,30,46,11,18,17,12,0,88,1
14350,335125,384_13_46,BAHRAIN,0,TOTALS,BAHRAIN,200,22,62,35.5,18,44,40.9,4,18,22.2,8,16,50.0,15,28,43,3,21,26,10,4,56,0
14351,335138,384_13_46,IRAN,0,TOTALS,IRAN,200,33,81,40.7,30,62,48.4,3,19,15.8,10,22,45.5,28,30,58,11,15,17,21,8,79,1
14352,335151,384_13_47,CHINA,0,TOTALS,CHINA,200,38,82,46.3,31,63,49.2,7,19,36.8,16,24,66.7,28,35,63,9,15,21,8,9,99,1
14353,335164,384_13_47,JAPAN,0,TOTALS,JAPAN,200,27,82,32.9,22,61,36.1,5,21,23.8,19,21,90.5,19,19,38,9,22,13,11,7,78,0
14354,335177,384_13_48,CHINESE TAIPEI,0,TOTALS,CHINESE TAIPEI,200,29,79,36.7,19,47,40.4,10,32,31.2,4,7,57.1,15,27,42,11,13,11,7,3,72,0
14355,335190,384_13_48,PHILIPPINES,0,TOTALS,PHILIPPINES,200,30,80,37.5,22,60,36.7,8,20,40.0,9,12,75.0,22,37,59,14,12,15,8,2,77,1
14356,335203,384_13_49,KAZAKHSTAN,0,TOTALS,KAZAKHSTAN,200,39,90,43.3,27,58,46.6,12,32,37.5,7,10,70.0,24,37,61,20,15,9,12,5,97,1
14357,335216,384_13_49,BAHRAIN,0,TOTALS,BAHRAIN,200,16,67,23.9,12,50,24.0,4,17,23.5,6,8,75.0,14,28,42,3,9,24,6,2,42,0
14358,335229,384_13_50,KOREA,0,TOTALS,KOREA,200,25,71,35.2,19,48,39.6,6,23,26.1,10,13,76.9,18,29,47,9,15,17,15,2,66,1
14359,335242,384_13_50,IRAN,0,TOTALS,IRAN,200,23,60,38.3,19,48,39.6,4,12,33.3,3,13,23.1,12,30,42,6,13,20,11,5,53,0
14360,335255,384_13_51,JAPAN,0,TOTALS,JAPAN,200,33,65,50.8,29,59,49.2,4,6,66.7,15,25,60.0,11,36,47,16,23,25,11,4,85,1
14361,335268,384_13_51,CHINESE TAIPEI,0,TOTALS,CHINESE TAIPEI,200,26,70,37.1,22,53,41.5,4,17,23.5,16,31,51.6,13,29,42,7,20,17,13,3,72,0
14362,335281,384_13_52,CHINA,0,TOTALS,CHINA,200,28,67,41.8,23,51,45.1,5,16,31.2,24,32,75.0,19,33,52,13,9,13,7,6,85,1
14363,335294,384_13_52,PHILIPPINES,0,TOTALS,PHILIPPINES,200,32,83,38.6,25,58,43.1,7,25,28.0,7,9,77.8,20,22,42,11,21,10,5,4,78,0
14364,336238,386_13_01,JAMAICA,0,TOTALS,JAMAICA,200,22,66,33.3,19,51,37.3,3,15,20.0,17,22,77.3,6,30,36,12,23,7,6,4,64,0
14365,336251,386_13_01,CANADA,0,TOTALS,CANADA,200,32,74,43.2,24,53,45.3,8,21,38.1,13,16,81.2,11,36,47,16,17,10,3,2,85,1
14366,336264,386_13_02,ARGENTINA,0,TOTALS,ARGENTINA,200,35,63,55.6,20,33,60.6,15,30,50.0,10,11,90.9,9,38,47,21,20,15,3,6,95,1
14367,336277,386_13_02,PARAGUAY,0,TOTALS,PARAGUAY,200,19,67,28.4,13,40,32.5,6,27,22.2,16,21,76.2,10,20,30,5,15,8,8,3,60,0
14368,336290,386_13_03,PUERTO RICO,0,TOTALS,PUERTO RICO,200,24,58,41.4,22,45,48.9,2,13,15.4,22,28,78.6,8,32,40,11,21,12,4,5,72,1
14369,336303,386_13_03,BRAZIL,0,TOTALS,BRAZIL,200,23,64,35.9,19,47,40.4,4,17,23.5,15,20,75.0,8,31,39,13,21,9,2,1,65,0
14370,336316,386_13_04,VENEZUELA,0,TOTALS,VENEZUELA,200,20,59,33.9,17,41,41.5,3,18,16.7,13,19,68.4,12,27,39,9,28,14,3,3,56,0
14371,336329,386_13_04,MEXICO,0,TOTALS,MEXICO,200,22,67,32.8,19,45,42.2,3,22,13.6,18,26,69.2,19,27,46,11,20,10,3,5,65,1
14372,336342,386_13_05,URUGUAY,0,TOTALS,URUGUAY,200,26,58,44.8,20,38,52.6,6,20,30.0,10,15,66.7,12,31,43,14,26,19,6,6,68,1
14373,336355,386_13_05,JAMAICA,0,TOTALS,JAMAICA,200,18,62,29.0,12,42,28.6,6,20,30.0,24,29,82.8,14,24,38,14,15,11,10,3,66,0
14374,336368,386_13_06,CANADA,0,TOTALS,CANADA,200,23,66,34.8,20,52,38.5,3,14,21.4,18,22,81.8,12,33,45,8,27,13,1,3,67,0
14375,336381,386_13_06,PUERTO RICO,0,TOTALS,PUERTO RICO,200,26,59,44.1,16,33,48.5,10,26,38.5,21,34,61.8,4,34,38,14,18,9,4,2,83,1
14376,336394,386_13_07,DOMINICAN REPUBLIC,0,TOTALS,DOMINICAN REPUBLIC,200,34,63,54.0,23,44,52.3,11,19,57.9,12,17,70.6,8,37,45,13,24,15,3,5,91,1
14377,336407,386_13_07,ARGENTINA,0,TOTALS,ARGENTINA,200,25,70,35.7,19,42,45.2,6,28,21.4,16,21,76.2,8,22,30,14,19,9,6,1,72,0
14378,336420,386_13_08,PARAGUAY,0,TOTALS,PARAGUAY,200,23,58,39.7,15,29,51.7,8,29,27.6,16,23,69.6,9,22,31,8,20,16,5,0,70,0
14379,336433,386_13_08,VENEZUELA,0,TOTALS,VENEZUELA,200,26,53,49.1,18,26,69.2,8,27,29.6,15,23,65.2,10,30,40,14,23,16,8,5,75,1
14380,336446,386_13_09,BRAZIL,0,TOTALS,BRAZIL,200,22,61,36.1,16,43,37.2,6,18,33.3,12,19,63.2,14,24,38,9,21,13,3,0,62,0
14381,336459,386_13_09,CANADA,0,TOTALS,CANADA,200,31,67,46.3,23,48,47.9,8,19,42.1,21,26,80.8,14,25,39,16,17,6,10,3,91,1
14382,336472,386_13_10,MEXICO,0,TOTALS,MEXICO,200,30,63,47.6,20,36,55.6,10,27,37.0,17,22,77.3,12,30,42,19,21,12,8,5,87,1
14383,336485,386_13_10,PARAGUAY,0,TOTALS,PARAGUAY,200,25,59,42.4,21,43,48.8,4,16,25.0,11,21,52.4,8,23,31,11,22,16,6,0,65,0
14384,336498,386_13_11,VENEZUELA,0,TOTALS,VENEZUELA,200,24,72,33.3,16,41,39.0,8,31,25.8,14,20,70.0,19,24,43,11,22,8,7,5,70,1
14385,336511,386_13_11,DOMINICAN REPUBLIC,0,TOTALS,DOMINICAN REPUBLIC,200,19,54,35.2,14,39,35.9,5,15,33.3,22,23,95.7,11,30,41,6,13,15,6,3,65,0
14386,336524,386_13_12,PUERTO RICO,0,TOTALS,PUERTO RICO,200,35,66,53.0,20,37,54.1,15,29,51.7,8,11,72.7,10,23,33,19,13,10,9,3,93,1
14387,336537,386_13_12,URUGUAY,0,TOTALS,URUGUAY,200,25,60,41.7,13,34,38.2,12,26,46.2,7,12,58.3,13,21,34,15,16,19,5,4,69,0
14388,336550,386_13_13,DOMINICAN REPUBLIC,0,TOTALS,DOMINICAN REPUBLIC,200,22,61,36.1,17,45,37.8,5,16,31.2,12,16,75.0,10,20,30,10,18,12,6,2,61,0
14389,336563,386_13_13,MEXICO,0,TOTALS,MEXICO,200,33,61,54.1,24,37,64.9,9,24,37.5,10,11,90.9,8,31,39,13,19,14,5,4,85,1
14390,336576,386_13_14,JAMAICA,0,TOTALS,JAMAICA,200,28,62,45.2,25,52,48.1,3,10,30.0,23,31,74.2,11,25,36,12,31,15,6,2,82,0
14391,336589,386_13_14,PUERTO RICO,0,TOTALS,PUERTO RICO,200,26,63,41.3,21,38,55.3,5,25,20.0,31,38,81.6,14,24,38,12,24,12,6,1,88,1
14392,336602,386_13_15,URUGUAY,0,TOTALS,URUGUAY,200,22,56,39.3,15,37,40.5,7,19,36.8,28,38,73.7,9,27,36,16,23,10,6,5,79,1
14393,336615,386_13_15,BRAZIL,0,TOTALS,BRAZIL,200,27,63,42.9,25,44,56.8,2,19,10.5,17,23,73.9,11,27,38,13,27,11,5,1,73,0
14394,336628,386_13_16,ARGENTINA,0,TOTALS,ARGENTINA,200,29,57,50.9,19,40,47.5,10,17,58.8,9,17,52.9,7,26,33,16,13,12,6,3,77,1
14395,336641,386_13_16,VENEZUELA,0,TOTALS,VENEZUELA,200,29,66,43.9,21,41,51.2,8,25,32.0,5,7,71.4,10,26,36,16,23,11,9,1,71,0
14396,336654,386_13_17,PARAGUAY,0,TOTALS,PARAGUAY,200,18,52,34.6,10,31,32.3,8,21,38.1,10,13,76.9,9,20,29,12,23,22,5,0,54,0
14397,336667,386_13_17,DOMINICAN REPUBLIC,0,TOTALS,DOMINICAN REPUBLIC,200,28,67,41.8,23,49,46.9,5,18,27.8,22,29,75.9,18,24,42,12,14,11,12,2,83,1
14398,336680,386_13_18,MEXICO,0,TOTALS,MEXICO,200,31,72,43.1,24,44,54.5,7,28,25.0,9,14,64.3,14,23,37,10,20,11,2,3,78,0
14399,336693,386_13_18,ARGENTINA,0,TOTALS,ARGENTINA,200,35,61,57.4,21,40,52.5,14,21,66.7,14,23,60.9,7,26,33,27,17,7,3,2,98,1
14400,336706,386_13_19,BRAZIL,0,TOTALS,BRAZIL,200,32,72,44.4,27,50,54.0,5,22,22.7,7,8,87.5,9,32,41,18,21,9,4,1,76,0
14401,336719,386_13_19,JAMAICA,0,TOTALS,JAMAICA,200,27,67,40.3,23,51,45.1,4,16,25.0,20,23,87.0,8,31,39,6,14,6,7,3,78,1
14402,336732,386_13_20,CANADA,0,TOTALS,CANADA,200,31,63,49.2,16,34,47.1,15,29,51.7,16,20,80.0,12,28,40,19,20,12,5,4,93,1
14403,336745,386_13_20,URUGUAY,0,TOTALS,URUGUAY,200,23,57,40.4,12,29,41.4,11,28,39.3,10,12,83.3,7,20,27,15,25,14,6,3,67,0
14404,336758,386_13_21,DOMINICAN REPUBLIC,0,TOTALS,DOMINICAN REPUBLIC,200,31,68,45.6,28,47,59.6,3,21,14.3,13,20,65.0,7,35,42,15,16,7,4,1,78,1
14405,336771,386_13_21,JAMAICA,0,TOTALS,JAMAICA,200,21,64,32.8,17,49,34.7,4,15,26.7,14,19,73.7,10,33,43,8,19,11,1,0,60,0
14406,336784,386_13_22,MEXICO,0,TOTALS,MEXICO,200,25,65,38.5,20,43,46.5,5,22,22.7,12,15,80.0,10,26,36,10,15,11,9,1,67,0
14407,336797,386_13_22,CANADA,0,TOTALS,CANADA,200,31,66,47.0,15,38,39.5,16,28,57.1,11,14,78.6,11,30,41,14,21,15,7,2,89,1
14408,336810,386_13_23,ARGENTINA,0,TOTALS,ARGENTINA,200,29,64,45.3,19,34,55.9,10,30,33.3,12,16,75.0,5,26,31,20,18,12,5,2,80,0
14409,336823,386_13_23,PUERTO RICO,0,TOTALS,PUERTO RICO,200,35,70,50.0,23,39,59.0,12,31,38.7,12,15,80.0,9,26,35,16,20,11,9,2,94,1
14410,336836,386_13_24,VENEZUELA,0,TOTALS,VENEZUELA,200,25,58,43.1,18,37,48.6,7,21,33.3,13,22,59.1,12,24,36,14,18,12,12,5,70,1
14411,336849,386_13_24,URUGUAY,0,TOTALS,URUGUAY,200,23,58,39.7,16,37,43.2,7,21,33.3,11,14,78.6,12,23,35,7,19,18,6,3,64,0
14412,336862,386_13_25,JAMAICA,0,TOTALS,JAMAICA,200,32,71,45.1,28,56,50.0,4,15,26.7,13,19,68.4,12,36,48,3,23,12,9,6,81,1
14413,336875,386_13_25,ARGENTINA,0,TOTALS,ARGENTINA,200,24,61,39.3,15,31,48.4,9,30,30.0,18,27,66.7,3,28,31,16,15,11,7,4,75,0
14414,336888,386_13_26,URUGUAY,0,TOTALS,URUGUAY,200,27,58,46.6,19,36,52.8,8,22,36.4,11,14,78.6,12,25,37,15,21,15,3,2,73,0
14415,336901,386_13_26,MEXICO,0,TOTALS,MEXICO,200,32,62,51.6,23,42,54.8,9,20,45.0,14,21,66.7,9,22,31,15,16,7,8,2,87,1
14416,336914,386_13_27,CANADA,0,TOTALS,CANADA,200,22,65,33.8,18,40,45.0,4,25,16.0,11,14,78.6,20,31,51,9,21,16,2,2,59,0
14417,336927,386_13_27,VENEZUELA,0,TOTALS,VENEZUELA,200,20,55,36.4,10,33,30.3,10,22,45.5,14,20,70.0,6,24,30,14,20,10,9,3,64,1
14418,336940,386_13_28,PUERTO RICO,0,TOTALS,PUERTO RICO,200,31,72,43.1,26,51,51.0,5,21,23.8,17,24,70.8,13,20,33,12,26,7,7,5,84,0
14419,336953,386_13_28,DOMINICAN REPUBLIC,0,TOTALS,DOMINICAN REPUBLIC,200,31,60,51.7,22,41,53.7,9,19,47.4,28,35,80.0,13,30,43,16,16,10,3,3,99,1
14420,336966,386_13_29,MEXICO,0,TOTALS,MEXICO,200,35,55,63.6,20,29,69.0,15,26,57.7,15,19,78.9,4,20,24,19,19,7,4,3,100,0
14421,336979,386_13_29,JAMAICA,0,TOTALS,JAMAICA,200,32,62,51.6,27,47,57.4,5,15,33.3,20,23,87.0,9,19,28,11,19,7,3,0,89,1
14422,336992,386_13_30,ARGENTINA,0,TOTALS,ARGENTINA,200,35,63,55.6,26,39,66.7,9,24,37.5,10,11,90.9,9,29,38,18,14,14,9,5,89,1
14423,337005,386_13_30,URUGUAY,0,TOTALS,URUGUAY,200,22,60,36.7,14,32,43.8,8,28,28.6,11,16,68.8,13,18,31,8,20,17,6,1,63,0
14424,337018,386_13_31,DOMINICAN REPUBLIC,0,TOTALS,DOMINICAN REPUBLIC,200,29,51,56.9,20,33,60.6,9,18,50.0,14,16,87.5,3,19,22,13,18,15,6,4,81,1
14425,337031,386_13_31,CANADA,0,TOTALS,CANADA,200,29,58,50.0,22,37,59.5,7,21,33.3,9,14,64.3,12,20,32,9,18,16,7,3,74,0
14426,337044,386_13_32,VENEZUELA,0,TOTALS,VENEZUELA,225,32,68,47.1,20,38,52.6,12,30,40.0,9,15,60.0,17,23,40,20,17,15,8,2,85,0
14427,337057,386_13_32,PUERTO RICO,0,TOTALS,PUERTO RICO,225,32,62,51.6,20,37,54.1,12,25,48.0,10,17,58.8,10,23,33,13,14,13,9,4,86,1
14428,337070,386_13_33,URUGUAY,0,TOTALS,URUGUAY,200,27,59,45.8,21,42,50.0,6,17,35.3,18,29,62.1,11,23,34,15,23,12,8,3,78,0
14429,337083,386_13_33,DOMINICAN REPUBLIC,0,TOTALS,DOMINICAN REPUBLIC,200,29,60,48.3,21,40,52.5,8,20,40.0,20,27,74.1,11,25,36,14,23,15,8,2,86,1
14430,337096,386_13_34,CANADA,0,TOTALS,CANADA,200,28,71,39.4,25,53,47.2,3,18,16.7,8,10,80.0,12,29,41,7,22,10,6,2,67,0
14431,337109,386_13_34,ARGENTINA,0,TOTALS,ARGENTINA,200,26,57,45.6,19,34,55.9,7,23,30.4,14,19,73.7,4,31,35,15,16,10,3,3,73,1
14432,337122,386_13_35,PUERTO RICO,0,TOTALS,PUERTO RICO,200,22,58,37.9,13,33,39.4,9,25,36.0,6,12,50.0,7,31,38,14,15,14,7,4,59,0
14433,337135,386_13_35,MEXICO,0,TOTALS,MEXICO,200,26,66,39.4,17,40,42.5,9,26,34.6,5,12,41.7,13,31,44,17,13,14,4,5,66,1
14434,337148,386_13_36,JAMAICA,0,TOTALS,JAMAICA,200,30,65,46.2,23,48,47.9,7,17,41.2,18,22,81.8,10,25,35,13,19,13,6,2,85,0
14435,337161,386_13_36,VENEZUELA,0,TOTALS,VENEZUELA,200,36,63,57.1,26,37,70.3,10,26,38.5,13,15,86.7,2,30,32,22,16,11,9,6,95,1
14436,337174,386_13_37,MEXICO,0,TOTALS,MEXICO,200,30,67,44.8,25,47,53.2,5,20,25.0,11,15,73.3,15,30,45,13,13,14,11,4,76,1
14437,337187,386_13_37,ARGENTINA,0,TOTALS,ARGENTINA,200,25,59,42.4,17,35,48.6,8,24,33.3,12,16,75.0,6,24,30,12,19,14,8,3,70,0
14438,337200,386_13_38,DOMINICAN REPUBLIC,0,TOTALS,DOMINICAN REPUBLIC,200,23,58,39.7,15,42,35.7,8,16,50.0,13,18,72.2,8,32,40,12,20,18,3,3,67,0
14439,337213,386_13_38,PUERTO RICO,0,TOTALS,PUERTO RICO,200,28,69,40.6,20,45,44.4,8,24,33.3,15,17,88.2,10,29,39,13,18,10,12,2,79,1
14440,337226,386_13_39,DOMINICAN REPUBLIC,0,TOTALS,DOMINICAN REPUBLIC,200,34,70,48.6,30,54,55.6,4,16,25.0,21,28,75.0,14,29,43,10,23,12,2,3,93,1
14441,337239,386_13_39,ARGENTINA,0,TOTALS,ARGENTINA,200,39,65,60.0,29,42,69.0,10,23,43.5,15,30,50.0,6,23,29,24,24,6,4,3,103,0
14442,337252,386_13_40,PUERTO RICO,0,TOTALS,PUERTO RICO,200,32,63,50.8,23,39,59.0,9,24,37.5,16,18,88.9,5,22,27,12,25,9,8,0,89,0
14443,337265,386_13_40,MEXICO,0,TOTALS,MEXICO,200,32,62,51.6,26,44,59.1,6,18,33.3,21,28,75.0,11,26,37,10,17,12,4,3,91,1
14444,337890,388_13_01,DOMINICAN REPUBLIC,0,TOTALS,DOMINICAN REPUBLIC,200,28,61,45.9,24,48,50.0,4,13,30.8,17,20,85.0,8,28,36,11,16,13,7,1,77,0
14445,337903,388_13_01,BRAZIL,0,TOTALS,BRAZIL,200,31,67,46.3,23,49,46.9,8,18,44.4,8,10,80.0,8,27,35,15,17,9,9,4,78,1
14446,337916,388_13_02,CANADA,0,TOTALS,CANADA,200,28,62,45.2,22,49,44.9,6,13,46.2,9,14,64.3,11,27,38,9,22,15,6,3,71,0
14447,337929,388_13_02,PUERTO RICO,0,TOTALS,PUERTO RICO,200,27,59,45.8,20,40,50.0,7,19,36.8,17,25,68.0,9,28,37,15,20,10,9,4,78,1
14448,337942,388_13_03,ARGENTINA,0,TOTALS,ARGENTINA,200,29,65,44.6,13,38,34.2,16,27,59.3,9,10,90.0,10,26,36,16,15,14,5,1,83,1
14449,337955,388_13_03,CANADA,0,TOTALS,CANADA,200,25,62,40.3,15,36,41.7,10,26,38.5,14,18,77.8,13,26,39,10,16,10,12,1,74,0
14450,337968,388_13_04,DOMINICAN REPUBLIC,0,TOTALS,DOMINICAN REPUBLIC,200,26,58,44.8,23,44,52.3,3,14,21.4,23,29,79.3,10,27,37,12,22,9,4,3,78,0
14451,337981,388_13_04,PUERTO RICO,0,TOTALS,PUERTO RICO,200,30,74,40.5,19,46,41.3,11,28,39.3,13,17,76.5,20,20,40,16,28,10,2,6,84,1
14452,337994,388_13_05,BRAZIL,0,TOTALS,BRAZIL,200,27,61,44.3,17,38,44.7,10,23,43.5,6,18,33.3,9,24,33,14,30,12,5,1,70,0
14453,338007,388_13_05,ARGENTINA,0,TOTALS,ARGENTINA,200,26,55,47.3,18,38,47.4,8,17,47.1,30,33,90.9,6,31,37,6,25,10,5,0,90,1
14454,338020,388_13_06,CANADA,0,TOTALS,CANADA,200,26,79,32.9,19,59,32.2,7,20,35.0,9,11,81.8,20,25,45,10,20,11,8,2,68,0
14455,338033,388_13_06,DOMINICAN REPUBLIC,0,TOTALS,DOMINICAN REPUBLIC,200,25,55,45.5,18,37,48.6,7,18,38.9,17,23,73.9,7,33,40,12,18,14,5,5,74,1
14456,338046,388_13_07,PUERTO RICO,0,TOTALS,PUERTO RICO,200,29,60,48.3,26,47,55.3,3,13,23.1,23,33,69.7,6,23,29,10,21,5,8,4,84,1
14457,338059,388_13_07,BRAZIL,0,TOTALS,BRAZIL,200,26,51,51.0,16,33,48.5,10,18,55.6,19,25,76.0,3,28,31,16,26,14,0,2,81,0
14458,338072,388_13_08,ARGENTINA,0,TOTALS,ARGENTINA,200,27,65,41.5,17,40,42.5,10,25,40.0,10,13,76.9,9,30,39,19,21,12,3,3,74,1
14459,338085,388_13_08,DOMINICAN REPUBLIC,0,TOTALS,DOMINICAN REPUBLIC,200,21,66,31.8,17,47,36.2,4,19,21.1,21,27,77.8,18,29,47,9,19,10,9,4,67,0
14460,338098,388_13_09,BRAZIL,0,TOTALS,BRAZIL,200,28,58,48.3,21,39,53.8,7,19,36.8,14,20,70.0,9,26,35,16,20,12,6,0,77,1
14461,338111,388_13_09,CANADA,0,TOTALS,CANADA,200,24,60,40.0,18,41,43.9,6,19,31.6,16,21,76.2,13,22,35,12,21,12,9,6,70,0
14462,338124,388_13_10,PUERTO RICO,0,TOTALS,PUERTO RICO,200,35,66,53.0,23,41,56.1,12,25,48.0,7,11,63.6,14,21,35,17,25,13,5,2,89,1
14463,338137,388_13_10,ARGENTINA,0,TOTALS,ARGENTINA,200,25,52,48.1,18,30,60.0,7,22,31.8,24,29,82.8,6,22,28,14,20,10,8,2,81,0
14464,338660,390_13_01,MEXICO,0,TOTALS,MEXICO,200,27,70,38.6,15,40,37.5,12,30,40.0,16,22,72.7,14,34,48,21,21,14,7,8,82,1
14465,338673,390_13_01,COSTA RICA,0,TOTALS,COSTA RICA,200,18,64,28.1,16,48,33.3,2,16,12.5,7,19,36.8,11,24,35,6,20,19,9,2,45,0
14466,338686,390_13_02,EL SALVADOR,0,TOTALS,EL SALVADOR,200,25,61,41.0,16,33,48.5,9,28,32.1,8,19,42.1,14,24,38,16,18,12,4,10,67,1
14467,338697,390_13_02,HONDURAS,0,TOTALS,HONDURAS,200,23,63,36.5,16,45,35.6,7,18,38.9,8,18,44.4,14,24,38,7,16,11,2,0,61,0
14468,338708,390_13_03,HONDURAS,0,TOTALS,HONDURAS,200,15,56,26.8,14,46,30.4,1,10,10.0,15,27,55.6,10,24,34,11,18,17,2,2,46,0
14469,338721,390_13_03,MEXICO,0,TOTALS,MEXICO,200,35,83,42.2,27,51,52.9,8,32,25.0,12,19,63.2,19,32,51,19,22,8,6,7,90,1
14470,338734,390_13_04,COSTA RICA,0,TOTALS,COSTA RICA,200,17,70,24.3,17,51,33.3,0,19,0.0,12,21,57.1,11,26,37,4,20,11,10,2,46,0
14471,338747,390_13_04,EL SALVADOR,0,TOTALS,EL SALVADOR,200,20,65,30.8,15,42,35.7,5,23,21.7,7,19,36.8,20,42,62,9,17,22,6,6,52,1
14472,338758,390_13_05,HONDURAS,0,TOTALS,HONDURAS,200,18,52,34.6,14,37,37.8,4,15,26.7,19,37,51.4,7,33,40,6,22,17,3,8,59,0
14473,338771,390_13_05,COSTA RICA,0,TOTALS,COSTA RICA,200,22,73,30.1,19,56,33.9,3,17,17.6,15,29,51.7,14,28,42,13,25,7,9,3,62,1
14474,338784,390_13_06,EL SALVADOR,0,TOTALS,EL SALVADOR,200,20,69,29.0,18,51,35.3,2,18,11.1,5,15,33.3,12,28,40,11,16,18,6,3,47,0
14475,338797,390_13_06,MEXICO,0,TOTALS,MEXICO,200,24,66,36.4,16,35,45.7,8,31,25.8,4,6,66.7,13,33,46,13,17,20,10,6,60,1
14476,338963,392_13_01,ARGENTINA,0,TOTALS,ARGENTINA,200,28,76,36.8,25,60,41.7,3,16,18.8,15,33,45.5,26,36,62,15,21,15,10,5,74,1
14477,338976,392_13_01,BAHAMAS,0,TOTALS,BAHAMAS,200,19,62,30.6,13,44,29.5,6,18,33.3,9,23,39.1,15,31,46,9,26,20,1,10,53,0
14478,338989,392_13_02,MEXICO,0,TOTALS,MEXICO,200,8,65,12.3,5,50,10.0,3,15,20.0,12,18,66.7,16,16,32,4,17,32,4,1,31,1
14479,339002,392_13_02,USA,0,TOTALS,USA,200,56,98,57.1,50,80,62.5,6,18,33.3,12,22,54.5,29,44,73,29,14,12,23,15,130,0
14480,339015,392_13_03,URUGUAY,0,TOTALS,URUGUAY,200,24,58,41.4,19,38,50.0,5,20,25.0,9,17,52.9,14,29,43,16,25,19,4,2,62,0
14481,339028,392_13_03,CHILE,0,TOTALS,CHILE,200,23,56,41.1,15,38,39.5,8,18,44.4,10,23,43.5,11,24,35,9,15,14,12,3,64,1
14482,339041,392_13_04,CANADA,0,TOTALS,CANADA,200,29,68,42.6,21,50,42.0,8,18,44.4,10,28,35.7,12,35,47,16,21,16,12,7,76,1
14483,339054,392_13_04,PUERTO RICO,0,TOTALS,PUERTO RICO,200,22,62,35.5,18,50,36.0,4,12,33.3,15,22,68.2,10,34,44,10,24,19,5,2,63,0
14484,339067,392_13_05,BAHAMAS,0,TOTALS,BAHAMAS,200,24,52,46.2,22,46,47.8,2,6,33.3,27,45,60.0,18,47,65,15,13,36,13,9,77,1
14485,339080,392_13_05,MEXICO,0,TOTALS,MEXICO,200,21,90,23.3,17,73,23.3,4,17,23.5,8,12,66.7,25,21,46,8,30,23,17,4,54,0
14486,339093,392_13_06,CHILE,0,TOTALS,CHILE,200,14,50,28.0,11,36,30.6,3,14,21.4,9,15,60.0,11,22,33,8,11,27,10,4,40,0
14487,339106,392_13_06,CANADA,0,TOTALS,CANADA,200,37,78,47.4,29,51,56.9,8,27,29.6,5,11,45.5,22,29,51,17,18,14,12,3,87,1
14488,339119,392_13_07,USA,0,TOTALS,USA,200,32,68,47.1,26,51,51.0,6,17,35.3,26,41,63.4,17,28,45,12,24,19,12,16,96,1
14489,339132,392_13_07,ARGENTINA,0,TOTALS,ARGENTINA,200,23,69,33.3,15,48,31.2,8,21,38.1,18,22,81.8,19,26,45,20,33,27,7,1,72,0
14490,339145,392_13_08,PUERTO RICO,0,TOTALS,PUERTO RICO,200,19,58,32.8,14,37,37.8,5,21,23.8,22,34,64.7,17,24,41,14,17,13,9,4,65,1
14491,339158,392_13_08,URUGUAY,0,TOTALS,URUGUAY,200,24,60,40.0,17,33,51.5,7,27,25.9,4,13,30.8,15,29,44,15,22,21,4,2,59,0
14492,339171,392_13_09,USA,0,TOTALS,USA,200,48,91,52.7,42,77,54.5,6,14,42.9,19,42,45.2,27,41,68,27,12,13,23,16,121,0
14493,339184,392_13_09,BAHAMAS,0,TOTALS,BAHAMAS,200,21,80,26.2,17,64,26.6,4,16,25.0,6,12,50.0,21,29,50,10,23,31,6,2,52,1
14494,339197,392_13_10,ARGENTINA,0,TOTALS,ARGENTINA,200,31,59,52.5,27,45,60.0,4,14,28.6,15,30,50.0,14,36,50,28,16,22,15,11,81,1
14495,339210,392_13_10,MEXICO,0,TOTALS,MEXICO,200,21,77,27.3,21,66,31.8,0,11,0.0,9,17,52.9,25,23,48,6,22,21,9,2,51,0
14496,339223,392_13_11,PUERTO RICO,0,TOTALS,PUERTO RICO,200,26,69,37.7,22,57,38.6,4,12,33.3,6,13,46.2,18,43,61,13,19,18,5,4,62,1
14497,339236,392_13_11,CHILE,0,TOTALS,CHILE,200,20,64,31.2,16,42,38.1,4,22,18.2,8,22,36.4,10,29,39,9,16,10,8,1,52,0
14498,339249,392_13_12,URUGUAY,0,TOTALS,URUGUAY,200,17,56,30.4,12,38,31.6,5,18,27.8,14,22,63.6,10,31,41,11,25,23,6,2,53,0
14499,339262,392_13_12,CANADA,0,TOTALS,CANADA,200,24,73,32.9,19,50,38.0,5,23,21.7,22,36,61.1,24,33,57,19,22,11,17,3,75,1
14500,339275,392_13_13,BAHAMAS,0,TOTALS,BAHAMAS,200,25,78,32.1,22,55,40.0,3,23,13.0,13,23,56.5,21,20,41,14,28,18,16,4,66,0
14501,339288,392_13_13,URUGUAY,0,TOTALS,URUGUAY,200,22,51,43.1,19,40,47.5,3,11,27.3,25,44,56.8,16,35,51,19,18,26,6,4,72,1
14502,339301,392_13_14,CHILE,0,TOTALS,CHILE,200,25,64,39.1,15,37,40.5,10,27,37.0,12,21,57.1,12,32,44,22,12,13,8,1,72,1
14503,339314,392_13_14,MEXICO,0,TOTALS,MEXICO,200,26,75,34.7,21,55,38.2,5,20,25.0,7,12,58.3,18,32,50,9,16,15,11,3,64,0
14504,339327,392_13_15,USA,0,TOTALS,USA,200,38,92,41.3,37,71,52.1,1,21,4.8,16,27,59.3,38,30,68,17,10,20,17,8,93,1
14505,339340,392_13_15,PUERTO RICO,0,TOTALS,PUERTO RICO,200,25,72,34.7,17,48,35.4,8,24,33.3,6,10,60.0,20,17,37,15,22,28,11,6,64,0
14506,339353,392_13_16,CANADA,0,TOTALS,CANADA,225,23,68,33.8,17,49,34.7,6,19,31.6,12,22,54.5,13,30,43,10,18,13,9,9,64,0
14507,339366,392_13_16,ARGENTINA,0,TOTALS,ARGENTINA,225,25,69,36.2,20,46,43.5,5,23,21.7,10,24,41.7,19,36,55,13,19,17,8,3,65,1
14508,339379,392_13_17,BAHAMAS,0,TOTALS,BAHAMAS,200,19,74,25.7,16,57,28.1,3,17,17.6,19,27,70.4,25,28,53,13,18,24,21,4,60,1
14509,339392,392_13_17,MEXICO,0,TOTALS,MEXICO,200,25,74,33.8,23,61,37.7,2,13,15.4,6,20,30.0,26,31,57,11,17,30,16,6,58,0
14510,339405,392_13_18,URUGUAY,0,TOTALS,URUGUAY,200,25,60,41.7,16,36,44.4,9,24,37.5,6,11,54.5,15,26,41,21,22,17,5,1,65,0
14511,339418,392_13_18,CHILE,0,TOTALS,CHILE,200,22,51,43.1,16,37,43.2,6,14,42.9,16,25,64.0,9,20,29,10,11,14,9,3,66,1
14512,339431,392_13_19,PUERTO RICO,0,TOTALS,PUERTO RICO,200,20,68,29.4,15,48,31.2,5,20,25.0,5,10,50.0,12,27,39,10,21,13,4,10,50,0
14513,339444,392_13_19,CANADA,0,TOTALS,CANADA,200,20,60,33.3,17,43,39.5,3,17,17.6,19,25,76.0,11,38,49,8,13,12,6,3,62,1
14514,339457,392_13_20,USA,0,TOTALS,USA,200,33,75,44.0,27,55,49.1,6,20,30.0,22,31,71.0,23,38,61,22,20,18,12,15,94,1
14515,339470,392_13_20,ARGENTINA,0,TOTALS,ARGENTINA,200,19,78,24.4,15,51,29.4,4,27,14.8,6,10,60.0,20,22,42,16,24,22,7,1,48,0
14516,340003,394_13_01,VENEZUELA,0,TOTALS,VENEZUELA,200,36,94,38.3,32,77,41.6,4,17,23.5,27,48,56.2,27,40,67,24,10,17,27,7,103,0
14517,340016,394_13_01,BOLIVIA,0,TOTALS,BOLIVIA,200,20,80,25.0,16,48,33.3,4,32,12.5,3,6,50.0,13,30,43,18,28,38,8,6,47,1
14518,340029,394_13_02,BRAZIL,0,TOTALS,BRAZIL,200,33,80,41.2,29,62,46.8,4,18,22.2,14,22,63.6,22,27,49,13,14,11,16,1,84,1
14519,340042,394_13_02,ECUADOR,0,TOTALS,ECUADOR,200,13,45,28.9,8,27,29.6,5,18,27.8,6,13,46.2,5,26,31,7,19,27,7,1,37,0
14520,340055,394_13_03,URUGUAY,0,TOTALS,URUGUAY,200,33,80,41.2,29,58,50.0,4,22,18.2,17,23,73.9,24,45,69,14,13,22,5,1,87,1
14521,340068,394_13_03,PARAGUAY,0,TOTALS,PARAGUAY,200,25,77,32.5,16,37,43.2,9,40,22.5,5,10,50.0,10,24,34,15,23,12,12,2,64,0
14522,340081,394_13_04,COLOMBIA,0,TOTALS,COLOMBIA,200,25,64,39.1,24,57,42.1,1,7,14.3,24,36,66.7,20,25,45,15,27,19,16,1,75,0
14523,340094,394_13_04,BRAZIL,0,TOTALS,BRAZIL,200,24,59,40.7,19,40,47.5,5,19,26.3,23,34,67.6,17,24,41,14,28,22,8,8,76,1
14524,340107,394_13_05,ECUADOR,0,TOTALS,ECUADOR,200,25,66,37.9,21,48,43.8,4,18,22.2,13,20,65.0,13,25,38,13,21,21,8,15,67,0
14525,340120,394_13_05,VENEZUELA,0,TOTALS,VENEZUELA,200,21,77,27.3,12,49,24.5,9,28,32.1,23,29,79.3,23,27,50,11,25,22,12,3,74,1
14526,340133,394_13_06,ARGENTINA,0,TOTALS,ARGENTINA,200,32,72,44.4,28,52,53.8,4,20,20.0,14,20,70.0,11,31,42,20,18,20,29,4,82,1
14527,340146,394_13_06,PERU,0,TOTALS,PERU,200,11,46,23.9,9,33,27.3,2,13,15.4,10,20,50.0,6,26,32,4,16,32,9,2,34,0
14528,340159,394_13_07,BOLIVIA,0,TOTALS,BOLIVIA,200,19,76,25.0,15,52,28.8,4,24,16.7,5,15,33.3,12,27,39,8,17,22,14,5,47,0
14529,340172,394_13_07,ECUADOR,0,TOTALS,ECUADOR,200,30,79,38.0,27,68,39.7,3,11,27.3,8,15,53.3,24,46,70,18,13,26,10,5,71,1
14530,340185,394_13_08,URUGUAY,0,TOTALS,URUGUAY,200,17,49,34.7,15,33,45.5,2,16,12.5,20,26,76.9,5,26,31,10,20,17,9,3,56,0
14531,340198,394_13_08,ARGENTINA,0,TOTALS,ARGENTINA,200,26,74,35.1,21,47,44.7,5,27,18.5,6,11,54.5,23,29,52,14,20,18,11,2,63,1
14532,340211,394_13_09,VENEZUELA,0,TOTALS,VENEZUELA,200,30,74,40.5,25,55,45.5,5,19,26.3,10,15,66.7,16,30,46,14,18,30,12,3,75,0
14533,340224,394_13_09,COLOMBIA,0,TOTALS,COLOMBIA,200,36,84,42.9,35,65,53.8,1,19,5.3,14,19,73.7,19,29,48,18,18,20,17,5,87,1
14534,340237,394_13_10,BRAZIL,0,TOTALS,BRAZIL,200,24,62,38.7,20,46,43.5,4,16,25.0,12,29,41.4,16,40,56,15,26,22,8,12,64,1
14535,340250,394_13_10,VENEZUELA,0,TOTALS,VENEZUELA,200,17,69,24.6,16,56,28.6,1,13,7.7,18,28,64.3,15,31,46,5,25,14,11,2,53,0
14536,340263,394_13_11,COLOMBIA,0,TOTALS,COLOMBIA,200,44,85,51.8,40,68,58.8,4,17,23.5,15,27,55.6,21,33,54,27,18,27,30,6,107,0
14537,340276,394_13_11,BOLIVIA,0,TOTALS,BOLIVIA,200,19,66,28.8,15,49,30.6,4,17,23.5,15,21,71.4,15,28,43,10,22,40,9,4,57,1
14538,340289,394_13_12,PERU,0,TOTALS,PERU,200,27,64,42.2,24,48,50.0,3,16,18.8,18,31,58.1,14,49,63,15,20,26,6,6,75,1
14539,340302,394_13_12,PARAGUAY,0,TOTALS,PARAGUAY,200,22,89,24.7,19,61,31.1,3,28,10.7,12,23,52.2,22,27,49,13,25,13,15,4,59,0
14540,340315,394_13_13,ECUADOR,0,TOTALS,ECUADOR,200,19,67,28.4,15,48,31.2,4,19,21.1,14,22,63.6,16,27,43,10,14,26,12,6,56,0
14541,340328,394_13_13,COLOMBIA,0,TOTALS,COLOMBIA,200,30,72,41.7,25,55,45.5,5,17,29.4,11,17,64.7,18,32,50,13,21,23,14,4,76,1
14542,340341,394_13_14,BOLIVIA,0,TOTALS,BOLIVIA,200,14,65,21.5,10,42,23.8,4,23,17.4,0,0,0.0,13,15,28,7,18,33,9,4,32,1
14543,340354,394_13_14,BRAZIL,0,TOTALS,BRAZIL,200,43,82,52.4,38,69,55.1,5,13,38.5,20,28,71.4,24,38,62,26,2,18,24,5,111,0
14544,340367,394_13_15,PARAGUAY,0,TOTALS,PARAGUAY,200,21,68,30.9,12,38,31.6,9,30,30.0,6,8,75.0,17,20,37,8,19,26,4,5,57,1
14545,340380,394_13_15,ARGENTINA,0,TOTALS,ARGENTINA,200,49,77,63.6,37,57,64.9,12,20,60.0,11,20,55.0,12,30,42,39,11,9,17,5,121,0
14546,340393,394_13_16,PERU,0,TOTALS,PERU,200,21,58,36.2,18,42,42.9,3,16,18.8,6,11,54.5,10,27,37,7,12,26,6,1,51,0
14547,340406,394_13_16,URUGUAY,0,TOTALS,URUGUAY,200,31,67,46.3,21,39,53.8,10,28,35.7,11,16,68.8,10,27,37,25,15,16,14,2,83,1
14548,340419,394_13_17,VENEZUELA,0,TOTALS,VENEZUELA,200,39,88,44.3,30,64,46.9,9,24,37.5,24,34,70.6,28,40,68,23,21,17,13,6,111,0
14549,340432,394_13_17,PARAGUAY,0,TOTALS,PARAGUAY,200,23,79,29.1,17,44,38.6,6,35,17.1,9,16,56.2,16,21,37,17,25,25,9,4,61,1
14550,340445,394_13_18,PERU,0,TOTALS,PERU,200,19,67,28.4,11,41,26.8,8,26,30.8,5,14,35.7,8,32,40,7,26,19,4,1,51,0
14551,340458,394_13_18,ECUADOR,0,TOTALS,ECUADOR,200,23,64,35.9,21,51,41.2,2,13,15.4,22,37,59.5,14,43,57,9,14,16,10,8,70,1
14552,340471,394_13_19,ARGENTINA,0,TOTALS,ARGENTINA,200,30,66,45.5,21,39,53.8,9,27,33.3,20,27,74.1,12,25,37,21,20,14,10,0,89,1
14553,340484,394_13_19,COLOMBIA,0,TOTALS,COLOMBIA,200,23,58,39.7,16,36,44.4,7,22,31.8,17,25,68.0,13,27,40,10,18,19,10,5,70,0
14554,340497,394_13_20,BRAZIL,0,TOTALS,BRAZIL,200,24,60,40.0,17,36,47.2,7,24,29.2,16,24,66.7,8,26,34,13,22,7,2,2,71,0
14555,340510,394_13_20,URUGUAY,0,TOTALS,URUGUAY,200,27,57,47.4,14,28,50.0,13,29,44.8,17,24,70.8,5,28,33,14,20,12,3,4,84,1
14556,340523,394_13_21,PARAGUAY,0,TOTALS,PARAGUAY,200,18,82,22.0,10,46,21.7,8,36,22.2,17,33,51.5,17,29,46,12,25,15,8,2,61,0
14557,340536,394_13_21,PERU,0,TOTALS,PERU,200,31,69,44.9,24,49,49.0,7,20,35.0,27,35,77.1,13,52,65,16,24,22,8,4,96,1
14558,340549,394_13_22,VENEZUELA,0,TOTALS,VENEZUELA,200,32,71,45.1,28,58,48.3,4,13,30.8,16,23,69.6,14,38,52,10,18,20,13,9,84,1
14559,340562,394_13_22,ECUADOR,0,TOTALS,ECUADOR,200,25,75,33.3,21,61,34.4,4,14,28.6,7,12,58.3,13,27,40,9,15,21,11,10,61,0
14560,340575,394_13_23,COLOMBIA,0,TOTALS,COLOMBIA,200,20,72,27.8,17,51,33.3,3,21,14.3,13,21,61.9,9,22,31,8,21,22,12,4,56,0
14561,340588,394_13_23,BRAZIL,0,TOTALS,BRAZIL,200,36,70,51.4,32,57,56.1,4,13,30.8,18,27,66.7,15,47,62,26,22,28,13,5,94,1
14562,340601,394_13_24,ARGENTINA,0,TOTALS,ARGENTINA,200,31,60,51.7,17,37,45.9,14,23,60.9,16,20,80.0,12,36,48,17,18,15,7,1,92,1
14563,340614,394_13_24,URUGUAY,0,TOTALS,URUGUAY,200,18,67,26.9,14,41,34.1,4,26,15.4,13,17,76.5,13,19,32,11,20,11,7,3,53,0
14564,341147,396_13_01,BRITISH VIRGIN ISLANDS,0,TOTALS,BRITISH VIRGIN ISLANDS,200,25,68,36.8,20,49,40.8,5,19,26.3,16,24,66.7,17,28,45,8,25,28,14,9,71,0
14565,341159,396_13_01,EL SALVADOR,0,TOTALS,EL SALVADOR,200,26,74,35.1,25,67,37.3,1,7,14.3,22,33,66.7,22,29,51,13,17,27,18,2,75,1
14566,341172,396_13_02,BAHAMAS,0,TOTALS,BAHAMAS,200,22,68,32.4,20,53,37.7,2,15,13.3,22,39,56.4,21,33,54,9,16,23,15,6,68,1
14567,341184,396_13_02,VIRGIN ISLANDS,0,TOTALS,VIRGIN ISLANDS,200,26,81,32.1,21,62,33.9,5,19,26.3,7,11,63.6,24,32,56,10,28,25,15,7,64,0
14568,341197,396_13_03,MEXICO,0,TOTALS,MEXICO,200,17,63,27.0,16,48,33.3,1,15,6.7,18,26,69.2,16,24,40,5,20,25,14,5,53,0
14569,341210,396_13_03,DOMINICAN REPUBLIC,0,TOTALS,DOMINICAN REPUBLIC,200,25,67,37.3,22,56,39.3,3,11,27.3,20,27,74.1,20,31,51,11,25,24,17,5,73,1
14570,341223,396_13_04,COSTA RICA,0,TOTALS,COSTA RICA,200,19,70,27.1,16,60,26.7,3,10,30.0,10,27,37.0,12,31,43,7,18,32,10,4,51,0
14571,341235,396_13_04,PUERTO RICO,0,TOTALS,PUERTO RICO,200,41,94,43.6,40,81,49.4,1,13,7.7,13,23,56.5,27,48,75,17,22,21,28,5,96,1
14572,341248,396_13_05,DOMINICAN REPUBLIC,0,TOTALS,DOMINICAN REPUBLIC,200,34,73,46.6,27,56,48.2,7,17,41.2,23,32,71.9,22,36,58,20,18,22,15,5,98,1
14573,341261,396_13_05,BRITISH VIRGIN ISLANDS,0,TOTALS,BRITISH VIRGIN ISLANDS,200,17,58,29.3,15,46,32.6,2,12,16.7,9,19,47.4,10,21,31,5,27,29,15,3,45,0
14574,341274,396_13_06,COSTA RICA,0,TOTALS,COSTA RICA,200,24,75,32.0,21,59,35.6,3,16,18.8,23,32,71.9,17,19,36,7,20,25,17,4,74,1
14575,341287,396_13_06,BAHAMAS,0,TOTALS,BAHAMAS,200,46,78,59.0,39,57,68.4,7,21,33.3,17,24,70.8,16,38,54,19,24,24,22,6,116,0
14576,341299,396_13_07,EL SALVADOR,0,TOTALS,EL SALVADOR,200,17,64,26.6,15,55,27.3,2,9,22.2,8,12,66.7,17,18,35,4,22,22,5,0,44,0
14577,341312,396_13_07,MEXICO,0,TOTALS,MEXICO,200,32,69,46.4,26,50,52.0,6,19,31.6,16,21,76.2,19,31,50,17,15,15,11,4,86,1
14578,341324,396_13_08,PUERTO RICO,0,TOTALS,PUERTO RICO,200,29,66,43.9,22,47,46.8,7,19,36.8,19,24,79.2,11,19,30,16,20,16,9,2,84,0
14579,341336,396_13_08,VIRGIN ISLANDS,0,TOTALS,VIRGIN ISLANDS,200,33,67,49.3,26,47,55.3,7,20,35.0,17,32,53.1,22,28,50,17,23,19,5,4,90,1
14580,341348,396_13_09,EL SALVADOR,0,TOTALS,EL SALVADOR,200,10,56,17.9,7,38,18.4,3,18,16.7,0,2,0.0,9,25,34,4,11,31,8,1,23,0
14581,341361,396_13_09,DOMINICAN REPUBLIC,0,TOTALS,DOMINICAN REPUBLIC,200,37,79,46.8,33,63,52.4,4,16,25.0,3,10,30.0,22,36,58,21,9,14,18,5,81,1
14582,341373,396_13_10,VIRGIN ISLANDS,0,TOTALS,VIRGIN ISLANDS,200,27,79,34.2,22,58,37.9,5,21,23.8,19,27,70.4,29,30,59,15,14,21,14,3,78,1
14583,341386,396_13_10,COSTA RICA,0,TOTALS,COSTA RICA,200,22,62,35.5,16,42,38.1,6,20,30.0,8,16,50.0,14,21,35,18,19,20,14,4,58,0
14584,341399,396_13_11,MEXICO,0,TOTALS,MEXICO,200,33,76,43.4,25,53,47.2,8,23,34.8,23,27,85.2,21,29,50,22,14,21,17,3,97,1
14585,341412,396_13_11,BRITISH VIRGIN ISLANDS,0,TOTALS,BRITISH VIRGIN ISLANDS,200,26,70,37.1,19,45,42.2,7,25,28.0,10,18,55.6,17,24,41,12,24,24,12,3,69,0
14586,341424,396_13_12,PUERTO RICO,0,TOTALS,PUERTO RICO,200,33,74,44.6,27,61,44.3,6,13,46.2,13,15,86.7,14,26,40,10,18,17,11,5,85,1
14587,341437,396_13_12,BAHAMAS,0,TOTALS,BAHAMAS,200,26,73,35.6,23,50,46.0,3,23,13.0,11,18,61.1,22,28,50,8,23,24,8,5,66,0
14588,341449,396_13_13,EL SALVADOR,0,TOTALS,EL SALVADOR,200,28,79,35.4,27,68,39.7,1,11,9.1,14,26,53.8,22,32,54,8,15,11,6,1,71,1
14589,341462,396_13_13,COSTA RICA,0,TOTALS,COSTA RICA,200,21,70,30.0,18,48,37.5,3,22,13.6,6,17,35.3,17,29,46,9,24,21,7,7,51,0
14590,341475,396_13_14,BAHAMAS,0,TOTALS,BAHAMAS,200,32,95,33.7,24,68,35.3,8,27,29.6,17,31,54.8,39,37,76,20,25,28,18,9,89,1
14591,341488,396_13_14,BRITISH VIRGIN ISLANDS,0,TOTALS,BRITISH VIRGIN ISLANDS,200,31,71,43.7,25,56,44.6,6,15,40.0,14,34,41.2,15,33,48,16,25,26,12,7,82,0
14592,341501,396_13_15,DOMINICAN REPUBLIC,0,TOTALS,DOMINICAN REPUBLIC,200,31,62,50.0,22,43,51.2,9,19,47.4,13,20,65.0,16,36,52,17,20,21,10,2,84,1
14593,341513,396_13_15,VIRGIN ISLANDS,0,TOTALS,VIRGIN ISLANDS,200,11,53,20.8,10,37,27.0,1,16,6.2,13,25,52.0,10,16,26,1,20,22,12,4,36,0
14594,341525,396_13_16,PUERTO RICO,0,TOTALS,PUERTO RICO,200,27,70,38.6,24,58,41.4,3,12,25.0,16,21,76.2,17,32,49,14,27,11,9,2,73,1
14595,341538,396_13_16,MEXICO,0,TOTALS,MEXICO,200,19,63,30.2,18,49,36.7,1,14,7.1,16,27,59.3,19,28,47,7,17,15,5,5,55,0
14596,341551,396_13_17,BRITISH VIRGIN ISLANDS,0,TOTALS,BRITISH VIRGIN ISLANDS,200,28,69,40.6,24,55,43.6,4,14,28.6,28,35,80.0,13,34,47,11,19,28,22,7,88,1
14597,341564,396_13_17,COSTA RICA,0,TOTALS,COSTA RICA,200,35,87,40.2,30,67,44.8,5,20,25.0,9,20,45.0,25,31,56,18,28,29,22,5,84,0
14598,341577,396_13_18,BAHAMAS,0,TOTALS,BAHAMAS,200,30,68,44.1,28,57,49.1,2,11,18.2,9,18,50.0,22,42,64,8,18,24,10,6,71,1
14599,341589,396_13_18,EL SALVADOR,0,TOTALS,EL SALVADOR,200,19,64,29.7,17,50,34.0,2,14,14.3,9,22,40.9,9,22,31,9,15,14,8,6,49,0
14600,341602,396_13_19,MEXICO,0,TOTALS,MEXICO,200,21,62,33.9,14,41,34.1,7,21,33.3,13,17,76.5,14,28,42,13,18,24,8,9,62,1
14601,341614,396_13_19,VIRGIN ISLANDS,0,TOTALS,VIRGIN ISLANDS,200,21,71,29.6,17,43,39.5,4,28,14.3,14,21,66.7,25,30,55,9,22,22,17,4,60,0
14602,341626,396_13_20,PUERTO RICO,0,TOTALS,PUERTO RICO,200,24,68,35.3,20,49,40.8,4,19,21.1,6,9,66.7,8,24,32,9,18,18,5,5,58,0
14603,341639,396_13_20,DOMINICAN REPUBLIC,0,TOTALS,DOMINICAN REPUBLIC,200,33,72,45.8,31,55,56.4,2,17,11.8,17,24,70.8,19,36,55,12,16,15,13,6,85,1
14604,342117,398_13_01,ISRAEL,0,TOTALS,ISRAEL,225,24,70,34.3,18,53,34.0,6,17,35.3,17,32,53.1,12,36,48,12,30,12,7,3,71,0
14605,342130,398_13_01,GREAT BRITAIN,0,TOTALS,GREAT BRITAIN,225,22,63,34.9,17,43,39.5,5,20,25.0,26,35,74.3,11,40,51,8,27,18,4,1,75,1
14606,342143,398_13_02,LATVIA,0,TOTALS,LATVIA,200,34,66,51.5,23,37,62.2,11,29,37.9,7,10,70.0,10,29,39,20,30,14,3,3,86,1
14607,342156,398_13_02,BOSNIA AND HERZEGOVINA,0,TOTALS,BOSNIA AND HERZEGOVINA,200,23,66,34.8,21,51,41.2,2,15,13.3,27,32,84.4,13,22,35,4,18,7,10,1,75,0
14608,342169,398_13_03,GEORGIA,0,TOTALS,GEORGIA,200,30,61,49.2,22,36,61.1,8,25,32.0,16,28,57.1,11,24,35,16,21,5,6,3,84,1
14609,342182,398_13_03,POLAND,0,TOTALS,POLAND,200,26,60,43.3,23,44,52.3,3,16,18.8,12,19,63.2,14,25,39,18,27,12,1,4,67,0
14610,342195,398_13_04,TURKEY,0,TOTALS,TURKEY,200,19,60,31.7,15,38,39.5,4,22,18.2,13,24,54.2,14,33,47,13,24,14,6,2,55,0
14611,342208,398_13_04,FINLAND,0,TOTALS,FINLAND,200,19,61,31.1,8,30,26.7,11,31,35.5,12,19,63.2,10,29,39,12,22,14,4,3,61,1
14612,342221,398_13_05,SPAIN,0,TOTALS,SPAIN,200,22,52,42.3,14,33,42.4,8,19,42.1,16,23,69.6,6,35,41,14,17,12,6,4,68,1
14613,342234,398_13_05,CROATIA,0,TOTALS,CROATIA,200,15,59,25.4,13,42,31.0,2,17,11.8,8,12,66.7,8,30,38,5,24,13,6,2,40,0
14614,342247,398_13_06,BELGIUM,0,TOTALS,BELGIUM,200,23,61,37.7,16,44,36.4,7,17,41.2,4,7,57.1,13,25,38,12,21,15,5,0,57,0
14615,342260,398_13_06,UKRAINE,0,TOTALS,UKRAINE,200,19,51,37.3,9,29,31.0,10,22,45.5,10,17,58.8,8,24,32,14,14,15,5,4,58,1
14616,342273,398_13_07,MKD,0,TOTALS,MKD,200,31,63,49.2,21,42,50.0,10,21,47.6,8,12,66.7,8,25,33,15,22,13,6,2,80,0
14617,342286,398_13_07,MONTENEGRO,0,TOTALS,MONTENEGRO,200,26,61,42.6,19,41,46.3,7,20,35.0,22,28,78.6,10,27,37,9,18,10,6,1,81,1
14618,342299,398_13_08,SWEDEN,0,TOTALS,SWEDEN,200,18,50,36.0,11,35,31.4,7,15,46.7,8,16,50.0,6,13,19,7,30,17,4,0,51,0
14619,342312,398_13_08,GREECE,0,TOTALS,GREECE,200,27,47,57.4,21,32,65.6,6,15,40.0,19,33,57.6,12,29,41,13,21,18,3,8,79,1
14620,342325,398_13_09,FRANCE,0,TOTALS,FRANCE,200,28,55,50.9,19,30,63.3,9,25,36.0,9,15,60.0,4,14,18,15,22,13,6,2,74,0
14621,342338,398_13_09,GERMANY,0,TOTALS,GERMANY,200,31,52,59.6,22,37,59.5,9,15,60.0,9,14,64.3,6,23,29,17,22,18,3,1,80,1
14622,342351,398_13_10,SERBIA,0,TOTALS,SERBIA,200,23,62,37.1,18,45,40.0,5,17,29.4,12,18,66.7,12,30,42,9,18,11,5,0,63,1
14623,342364,398_13_10,LITHUANIA,0,TOTALS,LITHUANIA,200,22,57,38.6,16,35,45.7,6,22,27.3,6,12,50.0,8,28,36,8,24,12,5,1,56,0
14624,342377,398_13_11,CZECH REPUBLIC,0,TOTALS,CZECH REPUBLIC,200,26,67,38.8,24,57,42.1,2,10,20.0,6,15,40.0,12,29,41,17,20,12,6,4,60,0
14625,342390,398_13_11,SLOVENIA,0,TOTALS,SLOVENIA,200,22,64,34.4,17,41,41.5,5,23,21.7,13,24,54.2,15,33,48,13,16,12,7,7,62,1
14626,342403,398_13_12,RUSSIA,0,TOTALS,RUSSIA,200,23,62,37.1,12,35,34.3,11,27,40.7,12,19,63.2,12,18,30,14,23,13,10,3,69,0
14627,342416,398_13_12,ITALY,0,TOTALS,ITALY,200,27,57,47.4,20,38,52.6,7,19,36.8,15,21,71.4,13,24,37,15,22,16,8,3,76,1
14628,342429,398_13_13,UKRAINE,0,TOTALS,UKRAINE,200,23,50,46.0,15,28,53.6,8,22,36.4,20,27,74.1,7,25,32,16,24,21,3,1,74,1
14629,342442,398_13_13,ISRAEL,0,TOTALS,ISRAEL,200,21,51,41.2,17,35,48.6,4,16,25.0,21,27,77.8,8,20,28,15,25,13,8,1,67,0
14630,342455,398_13_14,MONTENEGRO,0,TOTALS,MONTENEGRO,200,24,64,37.5,17,42,40.5,7,22,31.8,17,23,73.9,12,25,37,11,25,12,2,2,72,0
14631,342468,398_13_14,LATVIA,0,TOTALS,LATVIA,200,25,49,51.0,17,27,63.0,8,22,36.4,15,26,57.7,4,30,34,16,24,12,0,2,73,1
14632,342481,398_13_15,CROATIA,0,TOTALS,CROATIA,200,31,57,54.4,20,35,57.1,11,22,50.0,4,9,44.4,6,23,29,18,21,11,2,0,77,1
14633,342494,398_13_15,GEORGIA,0,TOTALS,GEORGIA,200,31,63,49.2,24,43,55.8,7,20,35.0,7,13,53.8,10,20,30,11,15,6,6,2,76,0
14634,342507,398_13_16,FINLAND,0,TOTALS,FINLAND,200,28,58,48.3,20,37,54.1,8,21,38.1,17,22,77.3,11,28,39,20,17,15,6,6,81,1
14635,342520,398_13_16,SWEDEN,0,TOTALS,SWEDEN,200,22,64,34.4,14,41,34.1,8,23,34.8,8,11,72.7,16,21,37,12,24,21,5,1,60,0
14636,342533,398_13_17,GERMANY,0,TOTALS,GERMANY,225,22,55,40.0,15,33,45.5,7,22,31.8,22,31,71.0,4,33,37,15,21,20,3,2,73,0
14637,342546,398_13_17,BELGIUM,0,TOTALS,BELGIUM,225,28,71,39.4,17,41,41.5,11,30,36.7,10,13,76.9,11,30,41,21,26,18,10,3,77,1
14638,342559,398_13_18,BOSNIA AND HERZEGOVINA,0,TOTALS,BOSNIA AND HERZEGOVINA,200,21,59,35.6,15,40,37.5,6,19,31.6,19,28,67.9,12,23,35,9,21,16,5,2,67,0
14639,342572,398_13_18,SERBIA,0,TOTALS,SERBIA,200,31,61,50.8,24,38,63.2,7,23,30.4,8,13,61.5,9,30,39,16,25,16,10,1,77,1
14640,342585,398_13_19,POLAND,0,TOTALS,POLAND,200,27,60,45.0,21,43,48.8,6,17,35.3,8,14,57.1,11,29,40,14,15,16,2,3,68,0
14641,342598,398_13_19,CZECH REPUBLIC,0,TOTALS,CZECH REPUBLIC,200,28,72,38.9,26,61,42.6,2,11,18.2,11,15,73.3,15,23,38,19,15,8,9,0,69,1
14642,342611,398_13_20,ITALY,0,TOTALS,ITALY,200,36,66,54.5,25,47,53.2,11,19,57.9,7,11,63.6,8,21,29,11,23,4,4,2,90,1
14643,342624,398_13_20,TURKEY,0,TOTALS,TURKEY,200,25,50,50.0,16,32,50.0,9,18,50.0,16,28,57.1,10,24,34,16,20,10,1,0,75,0
14644,342637,398_13_21,GREAT BRITAIN,0,TOTALS,GREAT BRITAIN,200,26,66,39.4,17,39,43.6,9,27,33.3,4,8,50.0,12,22,34,10,17,17,5,1,65,0
14645,342650,398_13_21,FRANCE,0,TOTALS,FRANCE,200,37,66,56.1,30,45,66.7,7,21,33.3,7,10,70.0,8,30,38,18,13,12,7,4,88,1
14646,342663,398_13_22,LITHUANIA,0,TOTALS,LITHUANIA,200,25,55,45.5,23,47,48.9,2,8,25.0,23,33,69.7,10,26,36,11,21,15,7,3,75,1
14647,342676,398_13_22,MKD,0,TOTALS,MKD,200,23,63,36.5,17,35,48.6,6,28,21.4,15,20,75.0,16,23,39,8,27,15,7,3,67,0
14648,342689,398_13_23,SLOVENIA,0,TOTALS,SLOVENIA,200,27,58,46.6,19,37,51.4,8,21,38.1,16,20,80.0,6,20,26,14,24,5,4,2,78,1
14649,342702,398_13_23,SPAIN,0,TOTALS,SPAIN,200,24,54,44.4,16,36,44.4,8,18,44.4,13,21,61.9,12,26,38,12,22,14,2,2,69,0
14650,342715,398_13_24,GREECE,0,TOTALS,GREECE,200,31,60,51.7,25,43,58.1,6,17,35.3,12,17,70.6,13,19,32,14,18,17,10,0,80,1
14651,342728,398_13_24,RUSSIA,0,TOTALS,RUSSIA,200,28,55,50.9,21,34,61.8,7,21,33.3,8,9,88.9,6,18,24,12,21,17,6,4,71,0
14652,342741,398_13_25,GERMANY,0,TOTALS,GERMANY,200,25,54,46.3,12,22,54.5,13,32,40.6,20,24,83.3,7,25,32,19,22,13,0,4,83,0
14653,342754,398_13_25,UKRAINE,0,TOTALS,UKRAINE,200,32,71,45.1,19,42,45.2,13,29,44.8,11,16,68.8,14,21,35,14,23,6,5,1,88,1
14654,342767,398_13_26,MONTENEGRO,0,TOTALS,MONTENEGRO,200,24,68,35.3,16,39,41.0,8,29,27.6,14,19,73.7,22,26,48,10,19,11,1,4,70,0
14655,342780,398_13_26,BOSNIA AND HERZEGOVINA,0,TOTALS,BOSNIA AND HERZEGOVINA,200,28,69,40.6,19,48,39.6,9,21,42.9,11,16,68.8,16,25,41,14,20,7,1,1,76,1
14656,342793,398_13_27,BELGIUM,0,TOTALS,BELGIUM,200,28,58,48.3,22,42,52.4,6,16,37.5,14,21,66.7,10,24,34,17,29,18,4,0,76,1
14657,342806,398_13_27,GREAT BRITAIN,0,TOTALS,GREAT BRITAIN,200,22,58,37.9,16,34,47.1,6,24,25.0,21,31,67.7,12,23,35,9,21,15,7,1,71,0
14658,342819,398_13_28,LATVIA,0,TOTALS,LATVIA,200,20,61,32.8,12,30,40.0,8,31,25.8,11,16,68.8,4,22,26,10,25,9,7,1,59,0
14659,342832,398_13_28,LITHUANIA,0,TOTALS,LITHUANIA,200,23,49,46.9,18,37,48.6,5,12,41.7,16,25,64.0,9,39,48,12,21,18,1,2,67,1
14660,342845,398_13_29,FRANCE,0,TOTALS,FRANCE,200,32,56,57.1,26,42,61.9,6,14,42.9,12,14,85.7,8,27,35,21,17,17,6,0,82,1
14661,342858,398_13_29,ISRAEL,0,TOTALS,ISRAEL,200,23,56,41.1,19,40,47.5,4,16,25.0,13,14,92.9,5,18,23,14,18,15,9,0,63,0
14662,342871,398_13_30,MKD,0,TOTALS,MKD,200,28,62,45.2,19,36,52.8,9,26,34.6,24,30,80.0,16,32,48,10,26,14,5,0,89,1
14663,342884,398_13_30,SERBIA,0,TOTALS,SERBIA,200,23,65,35.4,16,40,40.0,7,25,28.0,22,31,71.0,14,22,36,6,27,8,3,3,75,0
14664,342897,398_13_31,SPAIN,0,TOTALS,SPAIN,200,22,68,32.4,16,42,38.1,6,26,23.1,10,13,76.9,12,33,45,14,13,14,12,3,60,1
14665,342910,398_13_31,CZECH REPUBLIC,0,TOTALS,CZECH REPUBLIC,200,15,62,24.2,12,46,26.1,3,16,18.8,6,8,75.0,13,33,46,9,14,20,6,1,39,0
14666,342923,398_13_32,RUSSIA,0,TOTALS,RUSSIA,200,21,58,36.2,18,41,43.9,3,17,17.6,17,24,70.8,11,20,31,14,21,24,12,8,62,0
14667,342936,398_13_32,SWEDEN,0,TOTALS,SWEDEN,200,31,65,47.7,26,51,51.0,5,14,35.7,14,19,73.7,15,29,44,14,25,22,13,0,81,1
14668,342949,398_13_33,CROATIA,0,TOTALS,CROATIA,200,24,57,42.1,15,34,44.1,9,23,39.1,17,27,63.0,13,24,37,21,19,17,4,1,74,1
14669,342962,398_13_33,POLAND,0,TOTALS,POLAND,200,26,62,41.9,17,33,51.5,9,29,31.0,9,16,56.2,12,25,37,18,23,17,7,4,70,0
14670,342975,398_13_34,ITALY,0,TOTALS,ITALY,200,23,57,40.4,19,45,42.2,4,12,33.3,12,18,66.7,10,37,47,10,17,13,2,3,62,1
14671,342988,398_13_34,FINLAND,0,TOTALS,FINLAND,200,18,66,27.3,15,40,37.5,3,26,11.5,5,11,45.5,11,25,36,5,23,11,2,2,44,0
14672,343001,398_13_35,GEORGIA,0,TOTALS,GEORGIA,200,21,62,33.9,16,38,42.1,5,24,20.8,21,30,70.0,20,25,45,12,23,13,6,0,68,0
14673,343014,398_13_35,SLOVENIA,0,TOTALS,SLOVENIA,200,27,61,44.3,18,34,52.9,9,27,33.3,9,17,52.9,10,25,35,12,27,14,5,3,72,1
14674,343027,398_13_36,TURKEY,0,TOTALS,TURKEY,200,21,49,42.9,17,32,53.1,4,17,23.5,15,24,62.5,7,18,25,12,20,12,4,0,61,0
14675,343040,398_13_36,GREECE,0,TOTALS,GREECE,200,32,52,61.5,22,37,59.5,10,15,66.7,10,18,55.6,7,23,30,21,24,12,5,1,84,1
14676,343053,398_13_37,GREAT BRITAIN,0,TOTALS,GREAT BRITAIN,200,25,67,37.3,13,37,35.1,12,30,40.0,19,25,76.0,18,22,40,10,18,7,3,5,81,1
14677,343066,398_13_37,GERMANY,0,TOTALS,GERMANY,200,28,62,45.2,20,40,50.0,8,22,36.4,10,13,76.9,14,23,37,7,27,15,2,2,74,0
14678,343079,398_13_38,BOSNIA AND HERZEGOVINA,0,TOTALS,BOSNIA AND HERZEGOVINA,200,21,55,38.2,14,36,38.9,7,19,36.8,13,16,81.2,14,31,45,11,22,16,3,2,62,1
14679,343092,398_13_38,MKD,0,TOTALS,MKD,200,21,66,31.8,18,41,43.9,3,25,12.0,9,15,60.0,16,18,34,8,18,9,7,0,54,0
14680,343105,398_13_39,POLAND,0,TOTALS,POLAND,200,18,54,33.3,12,34,35.3,6,20,30.0,11,13,84.6,12,24,36,8,18,21,3,1,53,0
14681,343118,398_13_39,SPAIN,0,TOTALS,SPAIN,200,33,63,52.4,21,35,60.0,12,28,42.9,11,14,78.6,6,24,30,23,15,8,11,1,89,1
14682,343131,398_13_40,FINLAND,0,TOTALS,FINLAND,250,23,76,30.3,14,41,34.1,9,35,25.7,31,44,70.5,19,33,52,16,29,14,10,4,86,1
14683,343144,398_13_40,RUSSIA,0,TOTALS,RUSSIA,250,26,67,38.8,22,42,52.4,4,25,16.0,27,43,62.8,12,40,52,16,32,15,5,1,83,0
14684,343157,398_13_41,UKRAINE,0,TOTALS,UKRAINE,200,24,59,40.7,11,33,33.3,13,26,50.0,10,18,55.6,7,25,32,9,24,13,3,2,71,0
14685,343170,398_13_41,FRANCE,0,TOTALS,FRANCE,200,27,65,41.5,21,47,44.7,6,18,33.3,17,24,70.8,15,31,46,9,24,12,1,4,77,1
14686,343183,398_13_42,SERBIA,0,TOTALS,SERBIA,200,28,62,45.2,23,44,52.3,5,18,27.8,19,24,79.2,14,25,39,15,24,15,6,5,80,1
14687,343196,398_13_42,LATVIA,0,TOTALS,LATVIA,200,22,54,40.7,14,30,46.7,8,24,33.3,19,30,63.3,10,23,33,10,24,15,5,3,71,0
14688,343209,398_13_43,CZECH REPUBLIC,0,TOTALS,CZECH REPUBLIC,200,35,64,54.7,32,51,62.7,3,13,23.1,22,31,71.0,13,28,41,20,18,12,6,1,95,1
14689,343222,398_13_43,GEORGIA,0,TOTALS,GEORGIA,200,30,68,44.1,24,41,58.5,6,27,22.2,13,19,68.4,13,21,34,13,24,10,3,2,79,0
14690,343235,398_13_44,GREECE,0,TOTALS,GREECE,200,26,54,48.1,19,34,55.9,7,20,35.0,13,17,76.5,7,26,33,14,18,14,3,1,72,0
14691,343248,398_13_44,ITALY,0,TOTALS,ITALY,200,30,58,51.7,22,39,56.4,8,19,42.1,13,17,76.5,4,20,24,9,18,5,6,0,81,1
14692,343261,398_13_45,ISRAEL,0,TOTALS,ISRAEL,200,34,59,57.6,24,43,55.8,10,16,62.5,9,15,60.0,5,25,30,23,21,9,5,2,87,1
14693,343274,398_13_45,BELGIUM,0,TOTALS,BELGIUM,200,25,58,43.1,19,36,52.8,6,22,27.3,13,21,61.9,9,22,31,13,18,11,4,2,69,0
14694,343287,398_13_46,LITHUANIA,0,TOTALS,LITHUANIA,225,27,59,45.8,17,36,47.2,10,23,43.5,13,18,72.2,7,24,31,17,18,10,2,2,77,1
14695,343300,398_13_46,MONTENEGRO,0,TOTALS,MONTENEGRO,225,27,71,38.0,21,42,50.0,6,29,20.7,10,16,62.5,19,25,44,10,21,14,3,1,70,0
14696,343313,398_13_47,SLOVENIA,0,TOTALS,SLOVENIA,225,23,73,31.5,15,43,34.9,8,30,26.7,20,28,71.4,18,35,53,14,26,8,1,3,74,0
14697,343326,398_13_47,CROATIA,0,TOTALS,CROATIA,225,26,71,36.6,19,50,38.0,7,21,33.3,17,25,68.0,16,34,50,16,25,5,4,3,76,1
14698,343339,398_13_48,SWEDEN,0,TOTALS,SWEDEN,200,29,57,50.9,24,38,63.2,5,19,26.3,11,12,91.7,9,18,27,11,18,22,5,0,74,0
14699,343352,398_13_48,TURKEY,0,TOTALS,TURKEY,200,33,58,56.9,24,38,63.2,9,20,45.0,12,17,70.6,8,18,26,22,17,17,12,5,87,1
14700,343365,398_13_49,GREAT BRITAIN,0,TOTALS,GREAT BRITAIN,200,23,56,41.1,14,31,45.2,9,25,36.0,13,20,65.0,9,19,28,14,20,14,5,2,68,0
14701,343378,398_13_49,UKRAINE,0,TOTALS,UKRAINE,200,33,63,52.4,23,40,57.5,10,23,43.5,11,14,78.6,12,28,40,15,19,14,3,3,87,1
14702,343391,398_13_50,LATVIA,0,TOTALS,LATVIA,200,30,62,48.4,23,40,57.5,7,22,31.8,9,11,81.8,12,29,41,17,26,14,8,1,76,1
14703,343404,398_13_50,MKD,0,TOTALS,MKD,200,17,44,38.6,11,26,42.3,6,18,33.3,26,33,78.8,4,21,25,10,20,14,3,1,66,0
14704,343417,398_13_51,GEORGIA,0,TOTALS,GEORGIA,200,22,62,35.5,17,45,37.8,5,17,29.4,10,14,71.4,12,23,35,10,14,14,5,2,59,0
14705,343430,398_13_51,SPAIN,0,TOTALS,SPAIN,200,32,68,47.1,20,38,52.6,12,30,40.0,7,9,77.8,13,30,43,22,15,9,9,7,83,1
14706,343443,398_13_52,GREECE,0,TOTALS,GREECE,200,26,56,46.4,22,32,68.8,4,24,16.7,21,27,77.8,9,23,32,15,27,13,4,1,77,0
14707,343456,398_13_52,FINLAND,0,TOTALS,FINLAND,200,28,55,50.9,21,33,63.6,7,22,31.8,23,34,67.6,10,22,32,11,24,10,7,1,86,1
14708,343469,398_13_53,GERMANY,0,TOTALS,GERMANY,200,30,62,48.4,20,39,51.3,10,23,43.5,10,18,55.6,10,25,35,11,18,14,4,2,80,1
14709,343481,398_13_53,ISRAEL,0,TOTALS,ISRAEL,200,30,74,40.5,27,55,49.1,3,19,15.8,13,17,76.5,19,24,43,16,17,14,6,0,76,0
14710,343494,398_13_54,LITHUANIA,0,TOTALS,LITHUANIA,200,25,62,40.3,19,37,51.4,6,25,24.0,16,24,66.7,14,27,41,9,24,11,0,1,72,0
14711,343507,398_13_54,BOSNIA AND HERZEGOVINA,0,TOTALS,BOSNIA AND HERZEGOVINA,200,26,59,44.1,19,33,57.6,7,26,26.9,19,26,73.1,7,24,31,13,28,9,3,2,78,1
14712,343520,398_13_55,CROATIA,0,TOTALS,CROATIA,200,27,56,48.2,19,36,52.8,8,20,40.0,8,14,57.1,11,36,47,12,22,18,2,1,70,1
14713,343533,398_13_55,CZECH REPUBLIC,0,TOTALS,CZECH REPUBLIC,200,21,57,36.8,15,42,35.7,6,15,40.0,5,21,23.8,8,19,27,13,15,9,6,1,53,0
14714,343546,398_13_56,ITALY,0,TOTALS,ITALY,200,30,57,52.6,23,46,50.0,7,11,63.6,15,18,83.3,7,25,32,15,21,12,5,3,82,1
14715,343559,398_13_56,SWEDEN,0,TOTALS,SWEDEN,200,28,64,43.8,20,40,50.0,8,24,33.3,15,18,83.3,13,21,34,15,17,9,6,4,79,0
14716,343572,398_13_57,BELGIUM,0,TOTALS,BELGIUM,200,24,61,39.3,15,37,40.5,9,24,37.5,8,14,57.1,12,23,35,12,28,14,5,0,65,0
14717,343585,398_13_57,FRANCE,0,TOTALS,FRANCE,200,28,57,49.1,20,36,55.6,8,21,38.1,18,26,69.2,10,27,37,20,15,9,5,4,82,1
14718,343598,398_13_58,MONTENEGRO,0,TOTALS,MONTENEGRO,200,33,62,53.2,27,43,62.8,6,19,31.6,11,11,100.0,8,20,28,15,22,9,2,2,83,1
14719,343611,398_13_58,SERBIA,0,TOTALS,SERBIA,200,32,54,59.3,28,38,73.7,4,16,25.0,8,14,57.1,6,19,25,15,18,11,4,1,76,0
14720,343624,398_13_59,SLOVENIA,0,TOTALS,SLOVENIA,200,25,60,41.7,19,38,50.0,6,22,27.3,5,10,50.0,13,21,34,8,19,15,2,1,61,0
14721,343637,398_13_59,POLAND,0,TOTALS,POLAND,200,25,55,45.5,14,30,46.7,11,25,44.0,10,12,83.3,9,24,33,17,20,13,4,3,71,1
14722,343650,398_13_60,TURKEY,0,TOTALS,TURKEY,200,29,60,48.3,24,45,53.3,5,15,33.3,14,21,66.7,8,23,31,15,20,10,3,2,77,0
14723,343663,398_13_60,RUSSIA,0,TOTALS,RUSSIA,200,32,62,51.6,24,42,57.1,8,20,40.0,17,20,85.0,8,26,34,20,23,8,4,4,89,1
14724,343676,398_13_61,LATVIA,0,TOTALS,LATVIA,200,34,58,58.6,19,29,65.5,15,29,51.7,2,5,40.0,6,34,40,18,22,11,3,1,85,1
14725,343689,398_13_61,UKRAINE,0,TOTALS,UKRAINE,200,18,61,29.5,15,45,33.3,3,16,18.8,12,22,54.5,14,20,34,7,10,12,5,0,51,0
14726,343702,398_13_62,BELGIUM,0,TOTALS,BELGIUM,200,26,61,42.6,19,39,48.7,7,22,31.8,10,16,62.5,7,20,27,14,24,9,5,1,69,0
14727,343715,398_13_62,SERBIA,0,TOTALS,SERBIA,200,27,54,50.0,20,36,55.6,7,18,38.9,15,22,68.2,8,29,37,20,17,16,3,4,76,1
14728,343728,398_13_63,LITHUANIA,0,TOTALS,LITHUANIA,200,26,58,44.8,21,39,53.8,5,19,26.3,19,23,82.6,9,28,37,13,18,9,5,1,76,1
14729,343741,398_13_63,FRANCE,0,TOTALS,FRANCE,200,26,65,40.0,21,44,47.7,5,21,23.8,5,9,55.6,11,25,36,15,18,9,6,7,62,0
14730,343753,398_13_64,FINLAND,0,TOTALS,FINLAND,200,20,60,33.3,10,28,35.7,10,32,31.2,13,20,65.0,12,18,30,14,17,11,2,1,63,0
14731,343766,398_13_64,CROATIA,0,TOTALS,CROATIA,200,35,68,51.5,25,37,67.6,10,31,32.3,8,12,66.7,15,32,47,19,21,10,6,2,88,1
14732,343779,398_13_65,GREECE,0,TOTALS,GREECE,200,21,53,39.6,12,33,36.4,9,20,45.0,28,38,73.7,9,19,28,13,20,6,9,3,79,1
14733,343792,398_13_65,SPAIN,0,TOTALS,SPAIN,200,25,55,45.5,17,35,48.6,8,20,40.0,17,18,94.4,11,23,34,15,26,17,4,4,75,0
14734,343805,398_13_66,SLOVENIA,0,TOTALS,SLOVENIA,200,31,69,44.9,25,51,49.0,6,18,33.3,16,21,76.2,15,30,45,14,25,8,3,4,84,1
14735,343818,398_13_66,ITALY,0,TOTALS,ITALY,200,24,60,40.0,14,39,35.9,10,21,47.6,19,20,95.0,4,24,28,12,23,7,2,4,77,0
14736,343831,398_13_67,LITHUANIA,0,TOTALS,LITHUANIA,200,29,58,50.0,23,39,59.0,6,19,31.6,22,29,75.9,14,29,43,17,20,13,4,2,86,1
14737,343844,398_13_67,BELGIUM,0,TOTALS,BELGIUM,200,23,59,39.0,17,49,34.7,6,10,60.0,15,21,71.4,12,18,30,14,25,12,6,1,67,0
14738,343857,398_13_68,UKRAINE,0,TOTALS,UKRAINE,200,29,62,46.8,19,34,55.9,10,28,35.7,14,19,73.7,11,21,32,14,26,6,6,5,82,1
14739,343870,398_13_68,SERBIA,0,TOTALS,SERBIA,200,26,60,43.3,15,35,42.9,11,25,44.0,12,24,50.0,18,22,40,20,23,11,3,1,75,0
14740,343883,398_13_69,FRANCE,0,TOTALS,FRANCE,200,40,67,59.7,37,56,66.1,3,11,27.3,19,21,90.5,13,22,35,16,20,10,5,6,102,0
14741,343896,398_13_69,LATVIA,0,TOTALS,LATVIA,200,35,65,53.8,24,41,58.5,11,24,45.8,10,14,71.4,10,13,23,16,22,10,2,2,91,1
14742,343909,398_13_70,CROATIA,0,TOTALS,CROATIA,200,26,65,40.0,17,40,42.5,9,25,36.0,15,20,75.0,15,28,43,9,24,12,3,5,76,1
14743,343922,398_13_70,ITALY,0,TOTALS,ITALY,200,24,59,40.7,19,41,46.3,5,18,27.8,15,21,71.4,10,24,34,9,21,12,4,2,68,0
14744,343935,398_13_71,SPAIN,0,TOTALS,SPAIN,200,30,58,51.7,20,37,54.1,10,21,47.6,12,18,66.7,14,29,43,20,17,15,7,3,82,1
14745,343948,398_13_71,FINLAND,0,TOTALS,FINLAND,200,20,62,32.3,14,35,40.0,6,27,22.2,10,10,100.0,10,18,28,10,21,13,6,0,56,0
14746,343961,398_13_72,GREECE,0,TOTALS,GREECE,200,15,53,28.3,11,35,31.4,4,18,22.2,31,38,81.6,14,25,39,6,25,11,4,6,65,0
14747,343974,398_13_72,SLOVENIA,0,TOTALS,SLOVENIA,200,22,65,33.8,14,43,32.6,8,22,36.4,21,29,72.4,21,26,47,11,35,11,8,4,73,1
14748,343987,398_13_73,LATVIA,0,TOTALS,LATVIA,200,20,68,29.4,15,39,38.5,5,29,17.2,11,17,64.7,17,27,44,10,20,15,1,6,56,0
14749,344000,398_13_73,BELGIUM,0,TOTALS,BELGIUM,200,23,54,42.6,18,41,43.9,5,13,38.5,9,15,60.0,5,33,38,16,20,18,5,4,60,1
14750,344013,398_13_74,UKRAINE,0,TOTALS,UKRAINE,200,23,62,37.1,14,34,41.2,9,28,32.1,8,11,72.7,12,26,38,18,19,11,5,6,63,0
14751,344026,398_13_74,LITHUANIA,0,TOTALS,LITHUANIA,200,24,66,36.4,15,44,34.1,9,22,40.9,13,20,65.0,17,27,44,15,16,9,5,1,70,1
14752,344039,398_13_75,SERBIA,0,TOTALS,SERBIA,200,30,60,50.0,23,43,53.5,7,17,41.2,10,21,47.6,16,25,41,11,21,14,3,4,77,1
14753,344052,398_13_75,FRANCE,0,TOTALS,FRANCE,200,24,62,38.7,22,48,45.8,2,14,14.3,15,23,65.2,17,17,34,12,23,10,7,4,65,0
14754,344065,398_13_76,CROATIA,0,TOTALS,CROATIA,250,37,80,46.2,30,58,51.7,7,22,31.8,11,17,64.7,14,40,54,13,28,18,3,3,92,1
14755,344078,398_13_76,GREECE,0,TOTALS,GREECE,250,26,74,35.1,20,47,42.6,6,27,22.2,30,35,85.7,11,31,42,13,22,8,9,5,88,0
14756,344091,398_13_77,ITALY,0,TOTALS,ITALY,225,30,67,44.8,24,41,58.5,6,26,23.1,20,26,76.9,10,38,48,9,25,17,3,4,86,1
14757,344104,398_13_77,SPAIN,0,TOTALS,SPAIN,225,32,77,41.6,27,52,51.9,5,25,20.0,12,20,60.0,10,28,38,12,24,9,7,1,81,0
14758,344117,398_13_78,FINLAND,0,TOTALS,FINLAND,200,36,62,58.1,19,30,63.3,17,32,53.1,3,8,37.5,10,22,32,19,22,13,3,1,92,1
14759,344130,398_13_78,SLOVENIA,0,TOTALS,SLOVENIA,200,27,58,46.6,19,38,50.0,8,20,40.0,14,23,60.9,11,19,30,16,16,11,5,4,76,0
14760,344143,398_13_79,SERBIA,0,TOTALS,SERBIA,200,21,56,37.5,17,38,44.7,4,18,22.2,14,21,66.7,8,25,33,12,19,11,3,3,60,0
14761,344156,398_13_79,SPAIN,0,TOTALS,SPAIN,200,34,70,48.6,21,45,46.7,13,25,52.0,9,14,64.3,13,29,42,20,23,7,8,1,90,1
14762,344169,398_13_80,SLOVENIA,0,TOTALS,SLOVENIA,200,23,67,34.3,17,42,40.5,6,25,24.0,10,12,83.3,15,24,39,9,23,11,2,3,62,0
14763,344182,398_13_80,FRANCE,0,TOTALS,FRANCE,200,26,63,41.3,23,53,43.4,3,10,30.0,17,23,73.9,17,29,46,9,19,12,6,4,72,1
14764,344195,398_13_81,SERBIA,0,TOTALS,SERBIA,200,24,64,37.5,22,46,47.8,2,18,11.1,24,32,75.0,14,29,43,9,32,10,1,3,74,0
14765,344208,398_13_81,SLOVENIA,0,TOTALS,SLOVENIA,200,24,58,41.4,13,31,41.9,11,27,40.7,33,42,78.6,11,27,38,16,28,7,6,5,92,1
14766,344221,398_13_82,CROATIA,0,TOTALS,CROATIA,200,27,57,47.4,17,34,50.0,10,23,43.5,20,28,71.4,7,23,30,22,22,9,7,3,84,1
14767,344234,398_13_82,UKRAINE,0,TOTALS,UKRAINE,200,26,60,43.3,23,38,60.5,3,22,13.6,17,25,68.0,13,26,39,12,22,17,6,3,72,0
14768,344247,398_13_83,LITHUANIA,0,TOTALS,LITHUANIA,200,30,56,53.6,25,42,59.5,5,14,35.7,16,20,80.0,9,29,38,14,23,19,4,2,81,1
14769,344260,398_13_83,ITALY,0,TOTALS,ITALY,200,29,65,44.6,23,47,48.9,6,18,33.3,13,17,76.5,9,16,25,9,23,12,7,3,77,0
14770,344273,398_13_84,ITALY,0,TOTALS,ITALY,200,21,66,31.8,11,34,32.4,10,32,31.2,6,10,60.0,14,30,44,11,21,13,5,4,58,0
14771,344286,398_13_84,UKRAINE,0,TOTALS,UKRAINE,200,24,61,39.3,19,41,46.3,5,20,25.0,13,19,68.4,8,32,40,8,14,12,6,8,66,1
14772,344299,398_13_85,LITHUANIA,0,TOTALS,LITHUANIA,200,27,64,42.2,18,41,43.9,9,23,39.1,14,18,77.8,10,28,38,14,21,10,5,6,77,1
14773,344312,398_13_85,CROATIA,0,TOTALS,CROATIA,200,23,65,35.4,20,45,44.4,3,20,15.0,13,20,65.0,14,29,43,12,19,13,4,3,62,0
14774,344325,398_13_86,SPAIN,0,TOTALS,SPAIN,225,23,58,39.7,16,36,44.4,7,22,31.8,19,24,79.2,7,29,36,16,24,18,5,6,72,0
14775,344338,398_13_86,FRANCE,0,TOTALS,FRANCE,225,26,64,40.6,17,43,39.5,9,21,42.9,14,17,82.4,10,30,40,11,25,15,9,2,75,1
14776,344351,398_13_87,SERBIA,0,TOTALS,SERBIA,200,27,54,50.0,18,35,51.4,9,19,47.4,13,20,65.0,10,32,42,15,23,15,3,2,76,1
14777,344364,398_13_87,ITALY,0,TOTALS,ITALY,200,20,56,35.7,11,35,31.4,9,21,42.9,15,20,75.0,5,21,26,12,23,8,3,1,64,0
14778,344377,398_13_88,SLOVENIA,0,TOTALS,SLOVENIA,200,26,65,40.0,18,39,46.2,8,26,30.8,9,14,64.3,20,28,48,12,21,16,3,0,69,1
14779,344390,398_13_88,UKRAINE,0,TOTALS,UKRAINE,200,22,59,37.3,16,37,43.2,6,22,27.3,13,21,61.9,15,19,34,10,19,12,10,3,63,0
14780,344403,398_13_89,SPAIN,0,TOTALS,SPAIN,200,30,60,50.0,18,36,50.0,12,24,50.0,20,26,76.9,13,23,36,20,15,7,6,4,92,1
14781,344416,398_13_89,CROATIA,0,TOTALS,CROATIA,200,26,57,45.6,18,36,50.0,8,21,38.1,6,9,66.7,9,20,29,14,25,14,2,3,66,0
14782,344429,398_13_90,FRANCE,0,TOTALS,FRANCE,200,34,71,47.9,29,50,58.0,5,21,23.8,7,7,100.0,12,30,42,16,23,9,2,2,80,1
14783,344442,398_13_90,LITHUANIA,0,TOTALS,LITHUANIA,200,22,54,40.7,15,34,44.1,7,20,35.0,15,19,78.9,2,23,25,9,15,10,2,2,66,0
14784,344455,399_12_01,ICELAND,0,TOTALS,ICELAND,200,28,65,43.1,22,39,56.4,6,26,23.1,16,21,76.2,10,17,27,15,25,11,5,4,78,0
14785,344468,399_12_01,SERBIA,0,TOTALS,SERBIA,200,34,67,50.7,24,46,52.2,10,21,47.6,13,24,54.2,21,30,51,21,20,16,3,5,91,1
14786,344481,399_12_02,LUXEMBOURG,0,TOTALS,LUXEMBOURG,200,28,66,42.4,19,37,51.4,9,29,31.0,13,20,65.0,6,20,26,14,29,16,10,0,78,1
14787,344493,399_12_02,AZERBAIJAN,0,TOTALS,AZERBAIJAN,200,34,63,54.0,21,35,60.0,13,28,46.4,20,28,71.4,10,30,40,12,21,20,9,3,101,0
14788,344506,399_12_03,MONTENEGRO,0,TOTALS,MONTENEGRO,200,28,59,47.5,19,30,63.3,9,29,31.0,10,12,83.3,15,19,34,13,18,9,6,3,75,1
14789,344519,399_12_03,ISRAEL,0,TOTALS,ISRAEL,200,31,55,56.4,29,47,61.7,2,8,25.0,5,11,45.5,11,21,32,11,15,10,7,4,69,0
14790,344532,399_12_04,BULGARIA,0,TOTALS,BULGARIA,200,25,58,43.1,18,38,47.4,7,20,35.0,21,35,60.0,16,29,45,12,23,16,7,2,78,1
14791,344545,399_12_04,SWEDEN,0,TOTALS,SWEDEN,200,26,62,41.9,20,36,55.6,6,26,23.1,15,20,75.0,7,24,31,20,28,11,3,1,73,0
14792,344558,399_12_05,ROMANIA,0,TOTALS,ROMANIA,200,32,62,51.6,26,43,60.5,6,19,31.6,20,29,69.0,8,22,30,19,27,8,10,4,90,1
14793,344571,399_12_05,NETHERLANDS,0,TOTALS,NETHERLANDS,200,24,57,42.1,18,39,46.2,6,18,33.3,30,34,88.2,12,25,37,6,23,17,2,4,84,0
14794,344583,399_12_06,BOSNIA AND HERZEGOVINA,0,TOTALS,BOSNIA AND HERZEGOVINA,200,32,78,41.0,29,66,43.9,3,12,25.0,20,23,87.0,17,33,50,11,17,12,6,3,87,1
14795,344595,399_12_06,LATVIA,0,TOTALS,LATVIA,200,32,75,42.7,21,44,47.7,11,31,35.5,9,15,60.0,13,30,43,17,26,15,7,4,84,0
14796,344608,399_12_07,UKRAINE,0,TOTALS,UKRAINE,200,25,54,46.3,19,37,51.4,6,17,35.3,21,32,65.6,13,33,46,16,12,15,5,8,77,1
14797,344621,399_12_07,HUNGARY,0,TOTALS,HUNGARY,200,27,69,39.1,17,42,40.5,10,27,37.0,7,9,77.8,8,20,28,18,26,7,9,1,71,0
14798,344634,399_12_08,CYPRUS,0,TOTALS,CYPRUS,225,28,58,48.3,19,37,51.4,9,21,42.9,21,36,58.3,6,28,34,13,25,16,4,2,86,0
14799,344647,399_12_08,AUSTRIA,0,TOTALS,AUSTRIA,225,33,74,44.6,28,54,51.9,5,20,25.0,18,23,78.3,13,28,41,11,30,12,9,2,89,1
14800,344660,399_12_09,BELARUS,0,TOTALS,BELARUS,200,21,60,35.0,18,41,43.9,3,19,15.8,20,25,80.0,5,30,35,13,23,10,7,3,65,0
14801,344673,399_12_09,CZECH REPUBLIC,0,TOTALS,CZECH REPUBLIC,200,28,68,41.2,24,52,46.2,4,16,25.0,13,22,59.1,10,28,38,16,22,11,7,3,73,1
14802,344686,399_12_10,ESTONIA,0,TOTALS,ESTONIA,200,33,59,55.9,23,39,59.0,10,20,50.0,19,28,67.9,10,22,32,22,24,15,8,0,95,1
14803,344699,399_12_10,SLOVAK REPUBLIC,0,TOTALS,SLOVAK REPUBLIC,200,26,56,46.4,20,37,54.1,6,19,31.6,16,22,72.7,12,18,30,8,26,19,8,0,74,0
14804,347002,399_12_100,TURKEY,0,TOTALS,TURKEY,200,29,59,49.2,20,41,48.8,9,18,50.0,15,23,65.2,12,20,32,17,19,9,7,2,82,0
14805,347015,399_12_100,ITALY,0,TOTALS,ITALY,200,31,57,54.4,21,39,53.8,10,18,55.6,11,15,73.3,8,22,30,8,24,10,3,2,83,1
14806,347028,399_12_101,AUSTRIA,0,TOTALS,AUSTRIA,200,33,59,55.9,21,35,60.0,12,24,50.0,19,27,70.4,11,29,40,22,25,17,7,2,97,1
14807,347041,399_12_101,HUNGARY,0,TOTALS,HUNGARY,200,29,62,46.8,20,40,50.0,9,22,40.9,14,24,58.3,9,19,28,14,26,10,9,2,81,0
14808,347054,399_12_102,SERBIA,0,TOTALS,SERBIA,200,35,64,54.7,29,46,63.0,6,18,33.3,11,15,73.3,6,31,37,19,19,11,9,1,87,1
14809,347065,399_12_102,SLOVAK REPUBLIC,0,TOTALS,SLOVAK REPUBLIC,200,22,56,39.3,18,31,58.1,4,25,16.0,14,19,73.7,6,25,31,13,21,14,7,1,62,0
14810,347078,399_12_103,MONTENEGRO,0,TOTALS,MONTENEGRO,200,23,47,48.9,16,31,51.6,7,16,43.8,23,28,82.1,7,27,34,10,16,14,9,0,76,1
14811,347091,399_12_103,ESTONIA,0,TOTALS,ESTONIA,200,27,61,44.3,17,30,56.7,10,31,32.3,3,4,75.0,7,19,26,15,20,12,5,0,67,0
14812,347104,399_12_104,ISRAEL,0,TOTALS,ISRAEL,200,36,75,48.0,32,59,54.2,4,16,25.0,16,26,61.5,15,38,53,19,21,10,9,4,92,1
14813,347117,399_12_104,ICELAND,0,TOTALS,ICELAND,200,28,73,38.4,22,44,50.0,6,29,20.7,13,17,76.5,10,28,38,17,21,12,7,0,75,0
14814,347130,399_12_105,ICELAND,0,TOTALS,ICELAND,200,27,69,39.1,16,36,44.4,11,33,33.3,27,32,84.4,12,20,32,20,31,11,6,4,92,1
14815,347142,399_12_105,MONTENEGRO,0,TOTALS,MONTENEGRO,200,28,54,51.9,16,31,51.6,12,23,52.2,33,42,78.6,10,33,43,16,24,12,6,4,101,0
14816,347155,399_12_106,UKRAINE,0,TOTALS,UKRAINE,200,23,51,45.1,18,37,48.6,5,14,35.7,18,24,75.0,13,27,40,16,21,14,6,6,69,1
14817,347168,399_12_106,CYPRUS,0,TOTALS,CYPRUS,200,18,54,33.3,15,34,44.1,3,20,15.0,12,22,54.5,11,15,26,11,25,11,10,2,51,0
14818,347181,399_12_107,SWEDEN,0,TOTALS,SWEDEN,200,31,66,47.0,19,34,55.9,12,32,37.5,12,15,80.0,7,26,33,24,26,14,6,5,86,0
14819,347194,399_12_107,GERMANY,0,TOTALS,GERMANY,200,27,63,42.9,19,41,46.3,8,22,36.4,29,30,96.7,8,26,34,11,21,12,7,3,91,1
14820,347207,399_12_108,LATVIA,0,TOTALS,LATVIA,200,25,63,39.7,18,37,48.6,7,26,26.9,13,17,76.5,10,31,41,14,23,11,5,3,70,0
14821,347220,399_12_108,GEORGIA,0,TOTALS,GEORGIA,200,23,58,39.7,16,44,36.4,7,14,50.0,20,33,60.6,8,28,36,10,20,10,7,2,73,1
14822,347233,399_12_109,BULGARIA,0,TOTALS,BULGARIA,200,38,81,46.9,21,40,52.5,17,41,41.5,27,32,84.4,21,30,51,24,20,14,11,4,120,0
14823,347246,399_12_109,LUXEMBOURG,0,TOTALS,LUXEMBOURG,200,32,67,47.8,21,46,45.7,11,21,52.4,20,24,83.3,9,24,33,21,22,16,6,2,95,1
14824,344712,399_12_11,POLAND,0,TOTALS,POLAND,200,22,59,37.3,21,41,51.2,1,18,5.6,12,16,75.0,8,23,31,9,20,11,5,3,57,0
14825,344725,399_12_11,BELGIUM,0,TOTALS,BELGIUM,200,25,55,45.5,20,38,52.6,5,17,29.4,9,14,64.3,10,32,42,11,18,17,6,1,64,1
14826,347259,399_12_110,HUNGARY,0,TOTALS,HUNGARY,200,31,70,44.3,21,43,48.8,10,27,37.0,7,14,50.0,10,25,35,18,20,7,6,5,79,0
14827,347272,399_12_110,CROATIA,0,TOTALS,CROATIA,200,29,64,45.3,18,40,45.0,11,24,45.8,12,20,60.0,13,29,42,16,21,14,5,3,81,1
14828,347285,399_12_111,ESTONIA,0,TOTALS,ESTONIA,200,35,67,52.2,24,40,60.0,11,27,40.7,7,12,58.3,12,25,37,23,26,11,4,5,88,1
14829,347298,399_12_111,SERBIA,0,TOTALS,SERBIA,200,27,63,42.9,22,41,53.7,5,22,22.7,22,27,81.5,13,24,37,5,21,11,6,1,81,0
14830,347311,399_12_112,BOSNIA AND HERZEGOVINA,0,TOTALS,BOSNIA AND HERZEGOVINA,200,33,66,50.0,22,40,55.0,11,26,42.3,16,19,84.2,11,28,39,23,15,9,13,2,93,1
14831,347322,399_12_112,ROMANIA,0,TOTALS,ROMANIA,200,23,65,35.4,19,42,45.2,4,23,17.4,8,11,72.7,15,23,38,14,17,19,2,0,58,0
14832,347335,399_12_113,POLAND,0,TOTALS,POLAND,200,34,69,49.3,25,44,56.8,9,25,36.0,12,15,80.0,6,36,42,24,20,10,8,4,89,1
14833,347348,399_12_113,ALBANIA,0,TOTALS,ALBANIA,200,21,67,31.3,17,46,37.0,4,21,19.0,13,20,65.0,14,28,42,10,13,16,9,1,59,0
14834,347361,399_12_114,BELGIUM,0,TOTALS,BELGIUM,200,22,59,37.3,19,42,45.2,3,17,17.6,24,33,72.7,12,20,32,11,24,18,14,2,71,1
14835,347374,399_12_114,FINLAND,0,TOTALS,FINLAND,200,23,54,42.6,16,35,45.7,7,19,36.8,15,21,71.4,5,27,32,11,28,21,6,2,68,0
14836,347387,399_12_115,ITALY,0,TOTALS,ITALY,200,30,58,51.7,23,37,62.2,7,21,33.3,16,24,66.7,12,29,41,17,14,11,9,4,83,1
14837,347400,399_12_115,BELARUS,0,TOTALS,BELARUS,200,23,60,38.3,17,39,43.6,6,21,28.6,6,12,50.0,11,21,32,17,22,15,6,1,58,0
14838,347413,399_12_116,PORTUGAL,0,TOTALS,PORTUGAL,200,28,56,50.0,23,43,53.5,5,13,38.5,8,12,66.7,5,18,23,13,22,15,7,4,69,0
14839,347426,399_12_116,TURKEY,0,TOTALS,TURKEY,200,26,65,40.0,19,38,50.0,7,27,25.9,20,28,71.4,15,19,34,14,21,14,6,3,79,1
14840,347439,399_12_117,ISRAEL,0,TOTALS,ISRAEL,200,46,77,59.7,36,55,65.5,10,22,45.5,4,10,40.0,9,36,45,34,13,7,5,4,106,0
14841,347450,399_12_117,SLOVAK REPUBLIC,0,TOTALS,SLOVAK REPUBLIC,200,28,69,40.6,17,40,42.5,11,29,37.9,6,10,60.0,5,25,30,19,14,8,3,2,73,1
14842,347463,399_12_118,GEORGIA,0,TOTALS,GEORGIA,200,31,67,46.3,21,37,56.8,10,30,33.3,25,31,80.6,11,24,35,20,20,13,14,5,97,1
14843,347474,399_12_118,NETHERLANDS,0,TOTALS,NETHERLANDS,200,32,69,46.4,22,43,51.2,10,26,38.5,15,19,78.9,16,27,43,18,24,23,8,1,89,0
14844,347487,399_12_119,ESTONIA,0,TOTALS,ESTONIA,200,30,64,46.9,23,39,59.0,7,25,28.0,13,19,68.4,12,33,45,17,25,18,7,4,80,1
14845,347500,399_12_119,ICELAND,0,TOTALS,ICELAND,200,21,66,31.8,16,44,36.4,5,22,22.7,11,18,61.1,16,24,40,5,23,18,9,1,58,0
14846,344738,399_12_12,ALBANIA,0,TOTALS,ALBANIA,200,15,58,25.9,10,34,29.4,5,24,20.8,16,20,80.0,12,19,31,7,13,16,7,1,51,0
14847,344751,399_12_12,SWITZERLAND,0,TOTALS,SWITZERLAND,200,31,66,47.0,22,43,51.2,9,23,39.1,5,8,62.5,11,27,38,15,22,14,8,2,76,1
14848,347513,399_12_120,CROATIA,0,TOTALS,CROATIA,200,28,60,46.7,22,42,52.4,6,18,33.3,16,19,84.2,9,25,34,10,24,13,5,3,78,1
14849,347526,399_12_120,AUSTRIA,0,TOTALS,AUSTRIA,200,24,57,42.1,13,28,46.4,11,29,37.9,15,25,60.0,11,18,29,14,24,13,7,1,74,0
14850,347538,399_12_121,ROMANIA,0,TOTALS,ROMANIA,200,30,56,53.6,26,45,57.8,4,11,36.4,13,21,61.9,9,20,29,16,22,11,6,1,77,0
14851,347551,399_12_121,LATVIA,0,TOTALS,LATVIA,200,30,54,55.6,19,26,73.1,11,28,39.3,14,23,60.9,6,20,26,19,20,10,7,4,85,1
14852,347564,399_12_122,CYPRUS,0,TOTALS,CYPRUS,200,22,57,38.6,13,33,39.4,9,24,37.5,5,12,41.7,12,23,35,13,18,15,12,2,58,0
14853,347576,399_12_122,HUNGARY,0,TOTALS,HUNGARY,200,23,53,43.4,14,29,48.3,9,24,37.5,8,14,57.1,8,27,35,14,19,18,9,1,63,1
14854,347589,399_12_123,FINLAND,0,TOTALS,FINLAND,200,28,67,41.8,19,40,47.5,9,27,33.3,19,21,90.5,14,25,39,13,24,15,6,3,84,1
14855,347602,399_12_123,SWITZERLAND,0,TOTALS,SWITZERLAND,200,26,60,43.3,20,41,48.8,6,19,31.6,19,31,61.3,9,27,36,15,24,16,7,0,77,0
14856,347615,399_12_124,TURKEY,0,TOTALS,TURKEY,200,29,59,49.2,25,45,55.6,4,14,28.6,19,23,82.6,15,24,39,18,19,12,12,5,81,1
14857,347628,399_12_124,CZECH REPUBLIC,0,TOTALS,CZECH REPUBLIC,200,21,60,35.0,18,43,41.9,3,17,17.6,13,21,61.9,20,17,37,9,22,18,5,2,58,0
14858,347641,399_12_125,GERMANY,0,TOTALS,GERMANY,200,31,59,52.5,18,31,58.1,13,28,46.4,6,9,66.7,7,27,34,21,23,17,6,3,81,1
14859,347653,399_12_125,AZERBAIJAN,0,TOTALS,AZERBAIJAN,200,26,57,45.6,22,42,52.4,4,15,26.7,12,17,70.6,7,23,30,7,17,16,7,1,68,0
14860,347666,399_12_126,LUXEMBOURG,0,TOTALS,LUXEMBOURG,200,23,60,38.3,17,43,39.5,6,17,35.3,16,22,72.7,9,20,29,10,22,15,14,0,68,0
14861,347679,399_12_126,SWEDEN,0,TOTALS,SWEDEN,200,29,53,54.7,18,29,62.1,11,24,45.8,16,25,64.0,5,28,33,15,15,20,8,3,85,1
14862,347692,399_12_127,BELARUS,0,TOTALS,BELARUS,200,28,60,46.7,19,36,52.8,9,24,37.5,12,17,70.6,8,25,33,18,23,20,7,2,77,1
14863,347705,399_12_127,PORTUGAL,0,TOTALS,PORTUGAL,200,22,64,34.4,16,42,38.1,6,22,27.3,14,19,73.7,11,22,33,14,21,19,7,1,64,0
14864,347718,399_12_128,ALBANIA,0,TOTALS,ALBANIA,200,13,46,28.3,11,25,44.0,2,21,9.5,18,27,66.7,2,26,28,7,17,19,7,1,46,0
14865,347731,399_12_128,BELGIUM,0,TOTALS,BELGIUM,200,31,69,44.9,22,42,52.4,9,27,33.3,11,13,84.6,8,31,39,24,26,13,14,0,82,1
14866,347744,399_12_129,SERBIA,0,TOTALS,SERBIA,200,32,67,47.8,21,39,53.8,11,28,39.3,8,9,88.9,15,20,35,21,19,12,12,3,83,1
14867,347757,399_12_129,ISRAEL,0,TOTALS,ISRAEL,200,26,50,52.0,20,35,57.1,6,15,40.0,9,13,69.2,5,18,23,14,19,17,8,2,67,0
14868,344764,399_12_13,ITALY,0,TOTALS,ITALY,200,38,65,58.5,31,48,64.6,7,17,41.2,14,20,70.0,11,32,43,19,19,10,9,3,97,1
14869,344777,399_12_13,PORTUGAL,0,TOTALS,PORTUGAL,200,17,55,30.9,14,41,34.1,3,14,21.4,8,14,57.1,9,19,28,6,22,19,7,3,45,0
14870,347770,399_12_130,MONTENEGRO,0,TOTALS,MONTENEGRO,200,30,64,46.9,26,41,63.4,4,23,17.4,16,21,76.2,14,26,40,21,16,7,14,0,80,1
14871,347781,399_12_130,SLOVAK REPUBLIC,0,TOTALS,SLOVAK REPUBLIC,200,17,49,34.7,11,26,42.3,6,23,26.1,8,12,66.7,4,21,25,8,21,19,2,1,48,0
14872,344790,399_12_14,FINLAND,0,TOTALS,FINLAND,200,38,71,53.5,25,40,62.5,13,31,41.9,23,35,65.7,9,28,37,11,24,8,15,2,112,0
14873,344803,399_12_14,ALBANIA,0,TOTALS,ALBANIA,200,27,64,42.2,19,41,46.3,8,23,34.8,15,21,71.4,11,27,38,11,29,25,5,0,77,1
14874,344816,399_12_15,TURKEY,0,TOTALS,TURKEY,200,26,53,49.1,20,34,58.8,6,19,31.6,19,29,65.5,8,28,36,18,25,13,6,5,77,1
14875,344829,399_12_15,BELARUS,0,TOTALS,BELARUS,200,26,59,44.1,22,43,51.2,4,16,25.0,18,23,78.3,6,21,27,17,27,8,5,0,74,0
14876,344842,399_12_16,SWITZERLAND,0,TOTALS,SWITZERLAND,200,29,65,44.6,21,43,48.8,8,22,36.4,0,2,0.0,14,19,33,17,17,18,4,3,66,0
14877,344855,399_12_16,POLAND,0,TOTALS,POLAND,200,29,58,50.0,22,41,53.7,7,17,41.2,15,18,83.3,4,20,24,16,13,9,11,3,80,1
14878,344866,399_12_17,SLOVAK REPUBLIC,0,TOTALS,SLOVAK REPUBLIC,200,25,66,37.9,17,40,42.5,8,26,30.8,17,20,85.0,13,25,38,11,24,13,8,3,75,0
14879,344878,399_12_17,ICELAND,0,TOTALS,ICELAND,200,25,58,43.1,15,29,51.7,10,29,34.5,21,25,84.0,10,28,38,14,23,15,5,2,81,1
14880,344891,399_12_18,GERMANY,0,TOTALS,GERMANY,200,35,72,48.6,20,38,52.6,15,34,44.1,16,18,88.9,17,34,51,21,10,17,7,3,101,0
14881,344904,399_12_18,LUXEMBOURG,0,TOTALS,LUXEMBOURG,200,20,61,32.8,13,28,46.4,7,33,21.2,6,9,66.7,8,19,27,8,19,21,7,1,53,1
14882,344917,399_12_19,GEORGIA,0,TOTALS,GEORGIA,200,28,65,43.1,19,42,45.2,9,23,39.1,15,23,65.2,11,34,45,17,20,12,10,4,80,1
14883,344930,399_12_19,ROMANIA,0,TOTALS,ROMANIA,200,23,70,32.9,17,44,38.6,6,26,23.1,12,19,63.2,18,28,46,10,21,16,7,2,64,0
14884,344943,399_12_20,NETHERLANDS,0,TOTALS,NETHERLANDS,200,34,73,46.6,26,52,50.0,8,21,38.1,13,16,81.2,18,25,43,7,25,21,10,2,89,1
14885,344954,399_12_20,BOSNIA AND HERZEGOVINA,0,TOTALS,BOSNIA AND HERZEGOVINA,200,37,72,51.4,25,42,59.5,12,30,40.0,21,34,61.8,9,18,27,10,15,5,8,2,107,0
14886,344967,399_12_21,AZERBAIJAN,0,TOTALS,AZERBAIJAN,200,33,66,50.0,23,42,54.8,10,24,41.7,12,16,75.0,12,21,33,14,13,15,10,3,88,1
14887,344980,399_12_21,BULGARIA,0,TOTALS,BULGARIA,200,30,62,48.4,23,39,59.0,7,23,30.4,6,7,85.7,9,19,28,15,19,18,9,1,73,0
14888,344993,399_12_22,AUSTRIA,0,TOTALS,AUSTRIA,200,24,66,36.4,22,45,48.9,2,21,9.5,7,8,87.5,8,21,29,12,24,9,8,2,57,0
14889,345006,399_12_22,UKRAINE,0,TOTALS,UKRAINE,200,22,54,40.7,18,37,48.6,4,17,23.5,13,21,61.9,10,30,40,11,10,15,5,4,61,1
14890,345019,399_12_23,CZECH REPUBLIC,0,TOTALS,CZECH REPUBLIC,200,21,61,34.4,20,47,42.6,1,14,7.1,10,16,62.5,7,31,38,11,21,8,8,1,53,0
14891,345032,399_12_23,ITALY,0,TOTALS,ITALY,200,24,63,38.1,20,48,41.7,4,15,26.7,11,19,57.9,13,34,47,11,18,10,3,6,63,1
14892,345045,399_12_24,SERBIA,0,TOTALS,SERBIA,200,28,65,43.1,22,38,57.9,6,27,22.2,9,20,45.0,16,24,40,12,19,6,2,0,71,0
14893,345058,399_12_24,MONTENEGRO,0,TOTALS,MONTENEGRO,200,26,58,44.8,17,36,47.2,9,22,40.9,12,16,75.0,10,26,36,9,24,10,5,0,73,1
14894,345071,399_12_25,ISRAEL,0,TOTALS,ISRAEL,225,29,64,45.3,18,38,47.4,11,26,42.3,17,31,54.8,15,33,48,20,21,16,4,4,86,0
14895,345083,399_12_25,ESTONIA,0,TOTALS,ESTONIA,225,33,73,45.2,22,40,55.0,11,33,33.3,11,19,57.9,12,25,37,20,26,10,10,4,88,1
14896,345096,399_12_26,CROATIA,0,TOTALS,CROATIA,200,35,56,62.5,27,36,75.0,8,20,40.0,15,20,75.0,8,12,20,23,21,12,13,5,93,1
14897,345109,399_12_26,CYPRUS,0,TOTALS,CYPRUS,200,14,34,41.2,13,29,44.8,1,5,20.0,9,16,56.2,10,19,29,5,18,27,8,2,38,0
14898,345121,399_12_27,SLOVAK REPUBLIC,0,TOTALS,SLOVAK REPUBLIC,200,27,70,38.6,16,36,44.4,11,34,32.4,6,8,75.0,11,15,26,20,23,11,10,2,71,0
14899,345134,399_12_27,SERBIA,0,TOTALS,SERBIA,200,32,58,55.2,18,33,54.5,14,25,56.0,15,24,62.5,12,31,43,20,17,17,7,1,93,1
14900,345147,399_12_28,BULGARIA,0,TOTALS,BULGARIA,200,28,60,46.7,20,31,64.5,8,29,27.6,6,12,50.0,7,21,28,21,23,13,4,0,70,0
14901,345160,399_12_28,GERMANY,0,TOTALS,GERMANY,200,26,57,45.6,15,31,48.4,11,26,42.3,19,24,79.2,10,27,37,17,17,15,6,2,82,1
14902,345173,399_12_29,SWEDEN,0,TOTALS,SWEDEN,200,40,79,50.6,34,54,63.0,6,25,24.0,10,11,90.9,12,24,36,29,20,9,11,4,96,1
14903,345185,399_12_29,AZERBAIJAN,0,TOTALS,AZERBAIJAN,200,28,63,44.4,20,42,47.6,8,21,38.1,15,20,75.0,12,26,38,11,15,18,6,1,79,0
14904,345198,399_12_30,HUNGARY,0,TOTALS,HUNGARY,200,26,52,50.0,19,31,61.3,7,21,33.3,22,29,75.9,8,32,40,10,19,15,7,3,81,1
14905,345211,399_12_30,AUSTRIA,0,TOTALS,AUSTRIA,200,29,67,43.3,21,41,51.2,8,26,30.8,9,10,90.0,7,20,27,13,27,11,11,1,75,0
14906,345224,399_12_31,UKRAINE,0,TOTALS,UKRAINE,225,28,67,41.8,23,42,54.8,5,25,20.0,18,31,58.1,18,29,47,16,26,13,5,4,79,0
14907,345237,399_12_31,CROATIA,0,TOTALS,CROATIA,225,25,62,40.3,15,34,44.1,10,28,35.7,20,28,71.4,12,24,36,15,33,15,4,2,80,1
14908,345249,399_12_32,ICELAND,0,TOTALS,ICELAND,200,25,68,36.8,15,44,34.1,10,24,41.7,23,29,79.3,12,21,33,20,18,13,5,1,83,1
14909,345262,399_12_32,ISRAEL,0,TOTALS,ISRAEL,200,47,73,64.4,35,53,66.0,12,20,60.0,4,11,36.4,10,32,42,34,24,13,5,8,110,0
14910,345275,399_12_33,LATVIA,0,TOTALS,LATVIA,200,26,59,44.1,13,25,52.0,13,34,38.2,20,26,76.9,12,24,36,18,20,14,5,2,85,1
14911,345288,399_12_33,NETHERLANDS,0,TOTALS,NETHERLANDS,200,26,60,43.3,19,47,40.4,7,13,53.8,11,17,64.7,12,24,36,17,26,13,5,2,70,0
14912,345301,399_12_34,ESTONIA,0,TOTALS,ESTONIA,200,26,62,41.9,22,41,53.7,4,21,19.0,8,12,66.7,12,15,27,12,22,12,10,0,64,0
14913,345314,399_12_34,MONTENEGRO,0,TOTALS,MONTENEGRO,200,24,58,41.4,15,31,48.4,9,27,33.3,20,24,83.3,21,27,48,10,19,18,6,0,77,1
14914,345327,399_12_35,BOSNIA AND HERZEGOVINA,0,TOTALS,BOSNIA AND HERZEGOVINA,200,37,85,43.5,22,50,44.0,15,35,42.9,6,8,75.0,17,28,45,23,13,14,9,1,95,0
14915,345340,399_12_35,GEORGIA,0,TOTALS,GEORGIA,200,41,77,53.2,34,60,56.7,7,17,41.2,7,11,63.6,9,30,39,18,15,13,12,2,96,1
14916,345353,399_12_36,POLAND,0,TOTALS,POLAND,200,25,56,44.6,14,32,43.8,11,24,45.8,18,24,75.0,11,22,33,18,23,18,9,3,79,0
14917,345366,399_12_36,FINLAND,0,TOTALS,FINLAND,200,28,58,48.3,20,42,47.6,8,16,50.0,17,21,81.0,7,21,28,12,24,14,8,0,81,1
14918,345379,399_12_37,BELGIUM,0,TOTALS,BELGIUM,200,35,60,58.3,23,39,59.0,12,21,57.1,16,19,84.2,9,28,37,23,25,14,12,1,98,1
14919,345391,399_12_37,SWITZERLAND,0,TOTALS,SWITZERLAND,200,18,47,38.3,16,31,51.6,2,16,12.5,11,22,50.0,4,12,16,6,23,21,3,0,49,0
14920,345404,399_12_38,ITALY,0,TOTALS,ITALY,200,26,61,42.6,20,41,48.8,6,20,30.0,20,26,76.9,11,31,42,14,18,8,3,1,78,1
14921,345417,399_12_38,TURKEY,0,TOTALS,TURKEY,200,29,67,43.3,27,53,50.9,2,14,14.3,9,17,52.9,12,27,39,9,21,7,1,4,69,0
14922,345430,399_12_39,PORTUGAL,0,TOTALS,PORTUGAL,200,24,69,34.8,16,42,38.1,8,27,29.6,11,11,100.0,15,22,37,11,25,9,9,1,67,0
14923,345443,399_12_39,CZECH REPUBLIC,0,TOTALS,CZECH REPUBLIC,200,26,53,49.1,22,40,55.0,4,13,30.8,18,26,69.2,9,30,39,20,21,14,5,2,74,1
14924,345455,399_12_40,SLOVAK REPUBLIC,0,TOTALS,SLOVAK REPUBLIC,200,22,59,37.3,15,35,42.9,7,24,29.2,13,18,72.2,5,21,26,10,19,13,6,3,64,0
14925,345468,399_12_40,ISRAEL,0,TOTALS,ISRAEL,200,36,70,51.4,34,57,59.6,2,13,15.4,8,14,57.1,14,34,48,18,20,12,8,3,82,1
14926,345481,399_12_41,ROMANIA,0,TOTALS,ROMANIA,200,28,73,38.4,19,48,39.6,9,25,36.0,14,19,73.7,17,27,44,18,28,9,3,3,79,0
14927,345494,399_12_41,BOSNIA AND HERZEGOVINA,0,TOTALS,BOSNIA AND HERZEGOVINA,200,31,63,49.2,24,40,60.0,7,23,30.4,15,21,71.4,5,29,34,20,21,7,6,8,84,1
14928,345507,399_12_42,CYPRUS,0,TOTALS,CYPRUS,200,19,67,28.4,16,48,33.3,3,19,15.8,6,15,40.0,16,21,37,10,20,12,9,1,47,0
14929,345520,399_12_42,UKRAINE,0,TOTALS,UKRAINE,200,26,52,50.0,18,34,52.9,8,18,44.4,8,17,47.1,10,35,45,17,16,17,7,10,68,1
14930,345532,399_12_43,GEORGIA,0,TOTALS,GEORGIA,200,31,65,47.7,23,50,46.0,8,15,53.3,9,13,69.2,10,28,38,18,17,18,11,5,79,1
14931,345545,399_12_43,LATVIA,0,TOTALS,LATVIA,200,31,70,44.3,20,34,58.8,11,36,30.6,3,12,25.0,15,26,41,12,21,20,13,9,76,0
14932,345558,399_12_44,FINLAND,0,TOTALS,FINLAND,200,33,56,58.9,17,32,53.1,16,24,66.7,15,23,65.2,10,21,31,18,16,10,9,3,97,1
14933,345571,399_12_44,BELGIUM,0,TOTALS,BELGIUM,200,22,52,42.3,15,37,40.5,7,15,46.7,9,14,64.3,12,16,28,9,25,22,3,0,60,0
14934,345584,399_12_45,LUXEMBOURG,0,TOTALS,LUXEMBOURG,200,26,73,35.6,18,42,42.9,8,31,25.8,8,17,47.1,10,18,28,14,27,12,9,0,68,0
14935,345597,399_12_45,BULGARIA,0,TOTALS,BULGARIA,200,31,64,48.4,20,37,54.1,11,27,40.7,21,32,65.6,14,41,55,17,19,21,7,7,94,1
14936,345610,399_12_46,BELARUS,0,TOTALS,BELARUS,200,22,49,44.9,14,33,42.4,8,16,50.0,11,17,64.7,3,21,24,13,24,16,6,4,63,0
14937,345623,399_12_46,ITALY,0,TOTALS,ITALY,200,26,66,39.4,15,39,38.5,11,27,40.7,21,25,84.0,16,20,36,14,18,9,10,4,84,1
14938,345636,399_12_47,CROATIA,0,TOTALS,CROATIA,200,35,56,62.5,27,37,73.0,8,19,42.1,11,20,55.0,2,26,28,21,19,15,10,2,89,1
14939,345649,399_12_47,HUNGARY,0,TOTALS,HUNGARY,200,24,66,36.4,16,42,38.1,8,24,33.3,9,11,81.8,11,15,26,17,17,14,8,2,65,0
14940,345662,399_12_48,GERMANY,0,TOTALS,GERMANY,200,27,60,45.0,16,32,50.0,11,28,39.3,16,19,84.2,12,24,36,14,19,15,10,1,81,1
14941,345675,399_12_48,SWEDEN,0,TOTALS,SWEDEN,200,24,58,41.4,13,34,38.2,11,24,45.8,7,12,58.3,11,22,33,15,21,21,7,1,66,0
14942,345688,399_12_49,ALBANIA,0,TOTALS,ALBANIA,200,25,62,40.3,18,40,45.0,7,22,31.8,10,13,76.9,5,17,22,13,20,15,4,2,67,1
14943,345701,399_12_49,POLAND,0,TOTALS,POLAND,200,41,70,58.6,31,44,70.5,10,26,38.5,13,15,86.7,8,29,37,17,19,14,11,2,105,0
14944,345714,399_12_50,SERBIA,0,TOTALS,SERBIA,200,37,72,51.4,27,46,58.7,10,26,38.5,4,11,36.4,19,31,50,24,15,9,8,1,88,1
14945,345727,399_12_50,ESTONIA,0,TOTALS,ESTONIA,200,25,64,39.1,15,29,51.7,10,35,28.6,3,4,75.0,9,20,29,13,20,10,3,3,63,0
14946,345740,399_12_51,MONTENEGRO,0,TOTALS,MONTENEGRO,200,30,55,54.5,20,32,62.5,10,23,43.5,15,20,75.0,9,29,38,20,20,15,9,1,85,1
14947,345752,399_12_51,ICELAND,0,TOTALS,ICELAND,200,24,56,42.9,15,38,39.5,9,18,50.0,10,12,83.3,5,21,26,11,21,16,8,2,67,0
14948,345765,399_12_52,TURKEY,0,TOTALS,TURKEY,200,24,47,51.1,18,34,52.9,6,13,46.2,20,34,58.8,7,29,36,15,24,15,4,3,74,1
14949,345778,399_12_52,PORTUGAL,0,TOTALS,PORTUGAL,200,21,67,31.3,15,44,34.1,6,23,26.1,14,21,66.7,15,26,41,11,27,9,10,1,62,0
14950,345790,399_12_53,SLOVAK REPUBLIC,0,TOTALS,SLOVAK REPUBLIC,200,28,53,52.8,21,34,61.8,7,19,36.8,18,20,90.0,5,19,24,16,28,14,5,1,81,0
14951,345803,399_12_53,MONTENEGRO,0,TOTALS,MONTENEGRO,200,30,61,49.2,22,36,61.1,8,25,32.0,26,30,86.7,11,20,31,16,23,8,5,3,94,1
14952,345816,399_12_54,SWEDEN,0,TOTALS,SWEDEN,200,43,74,58.1,32,48,66.7,11,26,42.3,14,20,70.0,10,29,39,31,25,16,13,7,111,0
14953,345829,399_12_54,LUXEMBOURG,0,TOTALS,LUXEMBOURG,200,29,65,44.6,28,55,50.9,1,10,10.0,15,21,71.4,9,21,30,14,21,17,9,1,74,1
14954,345842,399_12_55,HUNGARY,0,TOTALS,HUNGARY,200,32,61,52.5,31,48,64.6,1,13,7.7,12,14,85.7,11,24,35,14,19,14,4,1,77,1
14955,345855,399_12_55,CYPRUS,0,TOTALS,CYPRUS,200,27,65,41.5,25,45,55.6,2,20,10.0,8,15,53.3,12,20,32,11,22,13,11,1,64,0
14956,345868,399_12_56,ICELAND,0,TOTALS,ICELAND,200,24,73,32.9,18,45,40.0,6,28,21.4,13,17,76.5,16,17,33,14,21,12,10,4,67,0
14957,345881,399_12_56,ESTONIA,0,TOTALS,ESTONIA,200,32,60,53.3,27,44,61.4,5,16,31.2,17,23,73.9,14,35,49,23,24,18,9,9,86,1
14958,345894,399_12_57,NETHERLANDS,0,TOTALS,NETHERLANDS,200,34,69,49.3,23,43,53.5,11,26,42.3,12,13,92.3,11,20,31,26,25,17,11,1,91,1
14959,345907,399_12_57,GEORGIA,0,TOTALS,GEORGIA,200,30,55,54.5,26,34,76.5,4,21,19.0,24,32,75.0,7,25,32,11,21,19,11,2,88,0
14960,345920,399_12_58,LATVIA,0,TOTALS,LATVIA,200,30,63,47.6,17,33,51.5,13,30,43.3,16,21,76.2,11,32,43,15,20,8,7,6,89,1
14961,345933,399_12_58,ROMANIA,0,TOTALS,ROMANIA,200,18,61,29.5,14,50,28.0,4,11,36.4,13,20,65.0,12,22,34,11,22,13,4,3,53,0
14962,345946,399_12_59,AZERBAIJAN,0,TOTALS,AZERBAIJAN,200,23,64,35.9,18,37,48.6,5,27,18.5,17,23,73.9,7,19,26,13,16,12,10,1,68,0
14963,345959,399_12_59,GERMANY,0,TOTALS,GERMANY,200,31,66,47.0,22,37,59.5,9,29,31.0,14,19,73.7,15,26,41,14,24,16,7,2,85,1
14964,345972,399_12_60,SWITZERLAND,0,TOTALS,SWITZERLAND,200,21,53,39.6,17,40,42.5,4,13,30.8,14,18,77.8,7,27,34,13,21,26,6,4,60,0
14965,345985,399_12_60,FINLAND,0,TOTALS,FINLAND,200,32,75,42.7,23,43,53.5,9,32,28.1,16,23,69.6,9,23,32,17,18,9,11,4,89,1
14966,345998,399_12_61,CZECH REPUBLIC,0,TOTALS,CZECH REPUBLIC,200,32,63,50.8,29,51,56.9,3,12,25.0,15,22,68.2,8,34,42,27,18,11,12,2,82,1
14967,346011,399_12_61,TURKEY,0,TOTALS,TURKEY,200,25,62,40.3,18,42,42.9,7,20,35.0,7,9,77.8,5,25,30,19,19,17,7,2,64,0
14968,346024,399_12_62,AUSTRIA,0,TOTALS,AUSTRIA,200,28,56,50.0,19,37,51.4,9,19,47.4,10,17,58.8,5,25,30,14,23,18,3,2,75,0
14969,346037,399_12_62,CROATIA,0,TOTALS,CROATIA,200,31,65,47.7,23,41,56.1,8,24,33.3,12,18,66.7,13,24,37,17,23,12,10,4,82,1
14970,346050,399_12_63,BELGIUM,0,TOTALS,BELGIUM,200,36,69,52.2,26,43,60.5,10,26,38.5,15,21,71.4,10,29,39,19,28,14,13,5,97,1
14971,346063,399_12_63,ALBANIA,0,TOTALS,ALBANIA,200,17,56,30.4,13,37,35.1,4,19,21.1,21,28,75.0,11,20,31,5,20,22,7,2,59,0
14972,346076,399_12_64,PORTUGAL,0,TOTALS,PORTUGAL,200,28,62,45.2,17,33,51.5,11,29,37.9,8,14,57.1,10,17,27,16,23,17,10,0,75,0
14973,346089,399_12_64,BELARUS,0,TOTALS,BELARUS,200,32,56,57.1,27,38,71.1,5,18,27.8,13,20,65.0,6,20,26,21,18,13,13,2,82,1
14974,346102,399_12_65,ISRAEL,0,TOTALS,ISRAEL,200,34,63,54.0,30,49,61.2,4,14,28.6,17,24,70.8,13,27,40,15,21,13,6,6,89,1
14975,346115,399_12_65,SERBIA,0,TOTALS,SERBIA,200,26,67,38.8,19,40,47.5,7,27,25.9,17,22,77.3,17,18,35,12,24,10,7,0,76,0
14976,346128,399_12_66,CZECH REPUBLIC,0,TOTALS,CZECH REPUBLIC,200,31,60,51.7,25,45,55.6,6,15,40.0,11,16,68.8,10,22,32,20,21,12,7,4,79,1
14977,346141,399_12_66,BELARUS,0,TOTALS,BELARUS,200,25,54,46.3,16,39,41.0,9,15,60.0,13,23,56.5,11,22,33,17,21,15,5,2,72,0
14978,346152,399_12_67,SLOVAK REPUBLIC,0,TOTALS,SLOVAK REPUBLIC,200,25,66,37.9,17,37,45.9,8,29,27.6,12,21,57.1,11,26,37,12,23,9,4,0,70,0
14979,346165,399_12_67,ESTONIA,0,TOTALS,ESTONIA,200,30,65,46.2,22,39,56.4,8,26,30.8,16,23,69.6,12,35,47,15,24,10,8,1,84,1
14980,346178,399_12_68,SWEDEN,0,TOTALS,SWEDEN,200,32,60,53.3,21,36,58.3,11,24,45.8,10,12,83.3,6,20,26,19,24,10,11,1,85,1
14981,346191,399_12_68,BULGARIA,0,TOTALS,BULGARIA,200,25,56,44.6,21,38,55.3,4,18,22.2,17,21,81.0,13,23,36,15,21,17,7,4,71,0
14982,346204,399_12_69,HUNGARY,0,TOTALS,HUNGARY,200,28,61,45.9,23,41,56.1,5,20,25.0,15,26,57.7,8,19,27,13,20,6,7,1,76,0
14983,346217,399_12_69,UKRAINE,0,TOTALS,UKRAINE,200,30,62,48.4,21,41,51.2,9,21,42.9,9,14,64.3,13,29,42,15,21,15,5,2,78,1
14984,346230,399_12_70,NETHERLANDS,0,TOTALS,NETHERLANDS,200,24,65,36.9,19,44,43.2,5,21,23.8,27,34,79.4,13,32,45,13,20,13,8,1,80,1
14985,346243,399_12_70,ROMANIA,0,TOTALS,ROMANIA,200,25,62,40.3,18,39,46.2,7,23,30.4,17,23,73.9,7,30,37,12,29,17,8,2,74,0
14986,346256,399_12_71,LATVIA,0,TOTALS,LATVIA,200,35,77,45.5,29,53,54.7,6,24,25.0,4,6,66.7,16,37,53,19,24,12,7,4,80,1
14987,346269,399_12_71,BOSNIA AND HERZEGOVINA,0,TOTALS,BOSNIA AND HERZEGOVINA,200,24,60,40.0,21,48,43.8,3,12,25.0,13,25,52.0,6,25,31,12,12,10,6,6,64,0
14988,346282,399_12_72,AZERBAIJAN,0,TOTALS,AZERBAIJAN,200,34,84,40.5,30,61,49.2,4,23,17.4,23,28,82.1,21,34,55,17,14,16,10,5,95,1
14989,346295,399_12_72,LUXEMBOURG,0,TOTALS,LUXEMBOURG,200,31,74,41.9,22,48,45.8,9,26,34.6,6,8,75.0,4,18,22,24,26,17,7,4,77,0
14990,346307,399_12_73,SWITZERLAND,0,TOTALS,SWITZERLAND,200,32,67,47.8,24,47,51.1,8,20,40.0,21,37,56.8,18,27,45,18,23,15,7,1,93,1
14991,346320,399_12_73,ALBANIA,0,TOTALS,ALBANIA,200,27,76,35.5,18,49,36.7,9,27,33.3,21,28,75.0,20,22,42,10,27,12,8,2,84,0
14992,346333,399_12_74,AUSTRIA,0,TOTALS,AUSTRIA,200,27,61,44.3,21,37,56.8,6,24,25.0,17,24,70.8,9,28,37,15,22,17,14,3,77,1
14993,346346,399_12_74,CYPRUS,0,TOTALS,CYPRUS,200,19,51,37.3,14,32,43.8,5,19,26.3,9,17,52.9,7,27,34,6,24,25,11,2,52,0
14994,346359,399_12_75,BELGIUM,0,TOTALS,BELGIUM,200,28,56,50.0,23,44,52.3,5,12,41.7,12,16,75.0,5,15,20,10,27,9,7,3,73,0
14995,346372,399_12_75,POLAND,0,TOTALS,POLAND,200,26,57,45.6,16,34,47.1,10,23,43.5,25,28,89.3,13,23,36,16,23,12,3,3,87,1
14996,346385,399_12_76,PORTUGAL,0,TOTALS,PORTUGAL,200,21,57,36.8,12,32,37.5,9,25,36.0,19,24,79.2,10,17,27,12,26,17,10,0,70,0
14997,346398,399_12_76,ITALY,0,TOTALS,ITALY,200,24,47,51.1,17,28,60.7,7,19,36.8,27,31,87.1,4,20,24,11,25,16,10,4,82,1
14998,346411,399_12_77,SERBIA,0,TOTALS,SERBIA,200,39,63,61.9,26,40,65.0,13,23,56.5,23,32,71.9,6,42,48,21,20,20,10,5,114,0
14999,346424,399_12_77,ICELAND,0,TOTALS,ICELAND,200,21,72,29.2,14,41,34.1,7,31,22.6,9,13,69.2,8,21,29,12,25,20,10,1,58,1
15000,346437,399_12_78,ISRAEL,0,TOTALS,ISRAEL,200,30,55,54.5,26,41,63.4,4,14,28.6,12,18,66.7,6,20,26,20,18,11,3,4,76,0
15001,346450,399_12_78,MONTENEGRO,0,TOTALS,MONTENEGRO,200,30,67,44.8,23,43,53.5,7,24,29.2,14,16,87.5,17,21,38,14,22,10,8,1,81,1
15002,346463,399_12_79,ICELAND,0,TOTALS,ICELAND,200,24,53,45.3,17,35,48.6,7,18,38.9,29,33,87.9,8,24,32,15,18,12,5,5,84,0
15003,346474,399_12_79,SLOVAK REPUBLIC,0,TOTALS,SLOVAK REPUBLIC,200,32,71,45.1,23,52,44.2,9,19,47.4,13,18,72.2,18,22,40,16,24,12,8,4,86,1
15004,346487,399_12_80,LUXEMBOURG,0,TOTALS,LUXEMBOURG,200,25,60,41.7,19,33,57.6,6,27,22.2,11,17,64.7,2,17,19,15,18,12,6,0,67,0
15005,346500,399_12_80,GERMANY,0,TOTALS,GERMANY,200,37,65,56.9,30,43,69.8,7,22,31.8,14,21,66.7,14,31,45,10,19,18,9,0,95,1
15006,346513,399_12_81,UKRAINE,0,TOTALS,UKRAINE,200,26,62,41.9,17,37,45.9,9,25,36.0,7,12,58.3,15,37,52,19,18,16,2,6,68,1
15007,346526,399_12_81,AUSTRIA,0,TOTALS,AUSTRIA,200,20,63,31.7,15,44,34.1,5,19,26.3,12,18,66.7,8,22,30,13,17,6,9,2,57,0
15008,346539,399_12_82,BULGARIA,0,TOTALS,BULGARIA,200,35,78,44.9,22,45,48.9,13,33,39.4,11,17,64.7,19,26,45,17,21,12,8,8,94,1
15009,346551,399_12_82,AZERBAIJAN,0,TOTALS,AZERBAIJAN,200,31,69,44.9,26,56,46.4,5,13,38.5,10,18,55.6,17,28,45,11,17,16,4,6,77,0
15010,346564,399_12_83,ROMANIA,0,TOTALS,ROMANIA,200,25,63,39.7,12,32,37.5,13,31,41.9,11,16,68.8,14,16,30,18,23,17,9,1,74,0
15011,346577,399_12_83,GEORGIA,0,TOTALS,GEORGIA,200,32,56,57.1,24,37,64.9,8,19,42.1,19,25,76.0,9,24,33,16,17,14,10,4,91,1
15012,346590,399_12_84,CYPRUS,0,TOTALS,CYPRUS,200,19,57,33.3,17,43,39.5,2,14,14.3,9,11,81.8,9,15,24,6,29,24,10,0,49,0
15013,346603,399_12_84,CROATIA,0,TOTALS,CROATIA,200,29,54,53.7,18,35,51.4,11,19,57.9,29,33,87.9,9,28,37,20,20,17,14,3,98,1
15014,346616,399_12_85,BELARUS,0,TOTALS,BELARUS,200,22,56,39.3,18,41,43.9,4,15,26.7,14,19,73.7,8,21,29,13,21,20,3,4,62,0
15015,346629,399_12_85,TURKEY,0,TOTALS,TURKEY,200,35,65,53.8,30,48,62.5,5,17,29.4,16,22,72.7,9,22,31,20,26,9,10,3,91,1
15016,346642,399_12_86,ESTONIA,0,TOTALS,ESTONIA,200,16,61,26.2,11,30,36.7,5,31,16.1,16,21,76.2,11,23,34,9,19,13,9,0,53,0
15017,346655,399_12_86,ISRAEL,0,TOTALS,ISRAEL,200,33,62,53.2,27,44,61.4,6,18,33.3,12,19,63.2,12,37,49,17,19,14,8,1,84,1
15018,346668,399_12_87,BOSNIA AND HERZEGOVINA,0,TOTALS,BOSNIA AND HERZEGOVINA,200,32,70,45.7,26,43,60.5,6,27,22.2,29,38,76.3,17,27,44,18,19,14,9,2,99,1
15019,346681,399_12_87,NETHERLANDS,0,TOTALS,NETHERLANDS,200,33,75,44.0,24,56,42.9,9,19,47.4,8,11,72.7,15,22,37,16,27,16,10,0,83,0
15020,346694,399_12_88,POLAND,0,TOTALS,POLAND,200,44,69,63.8,35,48,72.9,9,21,42.9,14,16,87.5,10,36,46,24,18,12,7,5,111,0
15021,346706,399_12_88,SWITZERLAND,0,TOTALS,SWITZERLAND,200,26,72,36.1,20,54,37.0,6,18,33.3,9,15,60.0,13,17,30,16,14,10,9,2,67,1
15022,346719,399_12_89,ALBANIA,0,TOTALS,ALBANIA,200,18,60,30.0,17,43,39.5,1,17,5.9,15,21,71.4,9,26,35,10,16,20,4,4,52,0
15023,346732,399_12_89,FINLAND,0,TOTALS,FINLAND,200,34,77,44.2,17,49,34.7,17,28,60.7,10,13,76.9,15,32,47,20,20,13,14,5,95,1
15024,346745,399_12_90,ITALY,0,TOTALS,ITALY,200,26,49,53.1,23,39,59.0,3,10,30.0,13,16,81.2,4,30,34,12,17,21,8,2,68,1
15025,346758,399_12_90,CZECH REPUBLIC,0,TOTALS,CZECH REPUBLIC,200,24,64,37.5,22,51,43.1,2,13,15.4,6,13,46.2,14,20,34,13,17,17,5,0,56,0
15026,346771,399_12_91,MONTENEGRO,0,TOTALS,MONTENEGRO,200,26,61,42.6,18,33,54.5,8,28,28.6,12,21,57.1,13,19,32,10,22,12,8,0,72,1
15027,346784,399_12_91,SERBIA,0,TOTALS,SERBIA,200,23,52,44.2,17,32,53.1,6,20,30.0,10,16,62.5,10,24,34,14,28,19,4,0,62,0
15028,346797,399_12_92,GEORGIA,0,TOTALS,GEORGIA,200,37,81,45.7,32,62,51.6,5,19,26.3,24,35,68.6,25,27,52,24,20,8,6,1,103,0
15029,346809,399_12_92,BOSNIA AND HERZEGOVINA,0,TOTALS,BOSNIA AND HERZEGOVINA,200,36,66,54.5,23,41,56.1,13,25,52.0,22,29,75.9,6,24,30,21,26,6,4,3,107,1
15030,346822,399_12_93,FINLAND,0,TOTALS,FINLAND,200,36,72,50.0,28,45,62.2,8,27,29.6,11,13,84.6,8,25,33,13,24,10,5,1,91,0
15031,346835,399_12_93,POLAND,0,TOTALS,POLAND,200,33,61,54.1,22,40,55.0,11,21,52.4,19,25,76.0,5,30,35,17,18,10,3,6,96,1
15032,346848,399_12_94,GERMANY,0,TOTALS,GERMANY,200,27,58,46.6,21,40,52.5,6,18,33.3,19,22,86.4,15,25,40,12,13,14,4,2,79,1
15033,346861,399_12_94,BULGARIA,0,TOTALS,BULGARIA,200,28,66,42.4,17,35,48.6,11,31,35.5,2,4,50.0,15,20,35,15,22,11,6,1,69,0
15034,346874,399_12_95,NETHERLANDS,0,TOTALS,NETHERLANDS,200,25,54,46.3,23,40,57.5,2,14,14.3,29,33,87.9,8,26,34,10,22,14,6,2,81,0
15035,346887,399_12_95,LATVIA,0,TOTALS,LATVIA,200,30,66,45.5,17,31,54.8,13,35,37.1,13,20,65.0,11,20,31,15,26,15,8,2,86,1
15036,346899,399_12_96,AZERBAIJAN,0,TOTALS,AZERBAIJAN,200,27,63,42.9,20,39,51.3,7,24,29.2,21,30,70.0,7,24,31,16,19,22,19,2,82,1
15037,346912,399_12_96,SWEDEN,0,TOTALS,SWEDEN,200,28,72,38.9,24,56,42.9,4,16,25.0,16,23,69.6,14,26,40,21,24,28,9,0,76,0
15038,346925,399_12_97,CROATIA,0,TOTALS,CROATIA,200,32,73,43.8,24,44,54.5,8,29,27.6,12,17,70.6,14,20,34,19,20,5,9,1,84,1
15039,346938,399_12_97,UKRAINE,0,TOTALS,UKRAINE,200,26,54,48.1,13,27,48.1,13,27,48.1,15,19,78.9,7,26,33,21,19,16,4,3,80,0
15040,346950,399_12_98,SWITZERLAND,0,TOTALS,SWITZERLAND,200,28,56,50.0,22,41,53.7,6,15,40.0,20,24,83.3,7,23,30,12,23,15,5,3,82,1
15041,346963,399_12_98,BELGIUM,0,TOTALS,BELGIUM,200,25,58,43.1,18,37,48.6,7,21,33.3,16,23,69.6,11,14,25,18,28,11,8,1,73,0
15042,346976,399_12_99,CZECH REPUBLIC,0,TOTALS,CZECH REPUBLIC,200,32,57,56.1,20,35,57.1,12,22,54.5,14,23,60.9,7,28,35,26,21,17,8,4,90,1
15043,346989,399_12_99,PORTUGAL,0,TOTALS,PORTUGAL,200,27,63,42.9,22,45,48.9,5,18,27.8,12,20,60.0,10,20,30,17,21,15,8,1,71,0
15044,351770,402_13_01,GERMANY,0,TOTALS,GERMANY,200,33,66,50.0,30,48,62.5,3,18,16.7,20,25,80.0,12,27,39,15,13,6,4,3,89,1
15045,351783,402_13_01,GEORGIA,0,TOTALS,GEORGIA,200,29,67,43.3,19,41,46.3,10,26,38.5,7,10,70.0,9,21,30,9,24,8,2,1,75,0
15046,351796,402_13_02,SPAIN,0,TOTALS,SPAIN,200,29,69,42.0,24,43,55.8,5,26,19.2,13,16,81.2,12,34,46,19,18,7,3,4,76,1
15047,351809,402_13_02,RUSSIA,0,TOTALS,RUSSIA,200,19,59,32.2,17,45,37.8,2,14,14.3,14,15,93.3,7,30,37,8,21,13,6,2,54,0
15048,351822,402_13_03,LATVIA,0,TOTALS,LATVIA,200,31,67,46.3,24,48,50.0,7,19,36.8,18,25,72.0,15,32,47,12,16,20,7,5,87,1
15049,351835,402_13_03,ISRAEL,0,TOTALS,ISRAEL,200,22,66,33.3,16,51,31.4,6,15,40.0,9,12,75.0,11,21,32,10,20,19,10,3,59,0
15050,351848,402_13_04,ITALY,0,TOTALS,ITALY,200,23,59,39.0,17,37,45.9,6,22,27.3,24,33,72.7,11,27,38,10,24,10,8,1,76,1
15051,351861,402_13_04,FRANCE,0,TOTALS,FRANCE,200,25,57,43.9,19,38,50.0,6,19,31.6,14,21,66.7,9,27,36,17,30,14,3,2,70,0
15052,351874,402_13_05,SERBIA,0,TOTALS,SERBIA,200,26,58,44.8,24,41,58.5,2,17,11.8,10,19,52.6,9,28,37,13,22,15,8,4,64,0
15053,351887,402_13_05,LITHUANIA,0,TOTALS,LITHUANIA,200,23,58,39.7,18,40,45.0,5,18,27.8,17,22,77.3,6,28,34,6,20,12,9,2,68,1
15054,351900,402_13_06,TURKEY,0,TOTALS,TURKEY,200,27,56,48.2,21,34,61.8,6,22,27.3,14,22,63.6,8,21,29,12,24,12,9,4,74,1
15055,351913,402_13_06,CROATIA,0,TOTALS,CROATIA,200,21,57,36.8,14,28,50.0,7,29,24.1,24,32,75.0,17,23,40,9,23,16,4,0,73,0
15056,351926,402_13_07,UKRAINE,0,TOTALS,UKRAINE,200,23,68,33.8,16,40,40.0,7,28,25.0,5,8,62.5,17,25,42,13,21,17,3,1,58,0
15057,351939,402_13_07,MONTENEGRO,0,TOTALS,MONTENEGRO,200,31,61,50.8,29,50,58.0,2,11,18.2,19,27,70.4,11,30,41,18,13,10,9,1,83,1
15058,351952,402_13_08,SLOVENIA,0,TOTALS,SLOVENIA,200,29,64,45.3,20,40,50.0,9,24,37.5,12,19,63.2,9,30,39,12,20,16,13,1,79,1
15059,351965,402_13_08,ESTONIA,0,TOTALS,ESTONIA,200,24,63,38.1,15,36,41.7,9,27,33.3,12,17,70.6,12,28,40,7,20,21,10,4,69,0
15060,351978,402_13_09,SWEDEN,0,TOTALS,SWEDEN,200,25,53,47.2,18,33,54.5,7,20,35.0,16,19,84.2,5,23,28,8,21,19,5,1,73,0
15061,351991,402_13_09,TURKEY,0,TOTALS,TURKEY,200,31,62,50.0,27,49,55.1,4,13,30.8,14,19,73.7,9,25,34,17,23,18,11,3,80,1
15062,352004,402_13_10,CZECH REPUBLIC,0,TOTALS,CZECH REPUBLIC,200,27,56,48.2,19,37,51.4,8,19,42.1,13,16,81.2,8,24,32,17,21,21,8,3,75,0
15063,352017,402_13_10,ITALY,0,TOTALS,ITALY,200,36,68,52.9,30,47,63.8,6,21,28.6,11,13,84.6,8,22,30,16,17,11,15,3,89,1
15064,352030,402_13_11,LITHUANIA,0,TOTALS,LITHUANIA,200,29,66,43.9,20,41,48.8,9,25,36.0,7,11,63.6,11,25,36,10,24,9,7,2,74,1
15065,352043,402_13_11,GERMANY,0,TOTALS,GERMANY,200,22,52,42.3,13,27,48.1,9,25,36.0,9,24,37.5,10,29,39,10,20,15,4,0,62,0
15066,352056,402_13_12,CROATIA,0,TOTALS,CROATIA,225,25,68,36.8,18,49,36.7,7,19,36.8,20,26,76.9,16,34,50,12,24,17,10,4,77,1
15067,352069,402_13_12,UKRAINE,0,TOTALS,UKRAINE,225,23,62,37.1,13,29,44.8,10,33,30.3,19,26,73.1,8,28,36,13,24,15,8,3,75,0
15068,352082,402_13_13,GREECE,0,TOTALS,GREECE,200,25,54,46.3,16,32,50.0,9,22,40.9,20,26,76.9,11,21,32,14,18,15,9,3,79,1
15069,352095,402_13_13,SERBIA,0,TOTALS,SERBIA,200,26,59,44.1,22,46,47.8,4,13,30.8,17,21,81.0,14,20,34,13,25,16,10,1,73,0
15070,352108,402_13_14,RUSSIA,0,TOTALS,RUSSIA,225,29,72,40.3,21,47,44.7,8,25,32.0,19,27,70.4,13,27,40,10,22,12,8,4,85,0
15071,352121,402_13_14,LATVIA,0,TOTALS,LATVIA,225,31,65,47.7,25,47,53.2,6,18,33.3,21,31,67.7,11,34,45,14,25,17,4,5,89,1
15072,352134,402_13_15,BULGARIA,0,TOTALS,BULGARIA,200,23,50,46.0,16,33,48.5,7,17,41.2,11,14,78.6,9,24,33,8,20,22,7,2,64,0
15073,352147,402_13_15,SPAIN,0,TOTALS,SPAIN,200,30,65,46.2,19,39,48.7,11,26,42.3,7,11,63.6,12,21,33,16,17,13,9,0,78,1
15074,352160,402_13_16,FRANCE,0,TOTALS,FRANCE,200,24,58,41.4,20,39,51.3,4,19,21.1,9,13,69.2,15,26,41,9,17,18,11,3,61,1
15075,352173,402_13_16,SLOVENIA,0,TOTALS,SLOVENIA,200,21,56,37.5,20,44,45.5,1,12,8.3,10,11,90.9,7,21,28,7,16,15,10,0,53,0
15076,352186,402_13_17,GERMANY,0,TOTALS,GERMANY,200,21,51,41.2,12,29,41.4,9,22,40.9,5,15,33.3,12,32,44,8,22,21,3,3,56,0
15077,352199,402_13_17,GREECE,0,TOTALS,GREECE,200,20,68,29.4,13,34,38.2,7,34,20.6,18,21,85.7,16,23,39,9,18,9,10,3,65,1
15078,352212,402_13_18,MONTENEGRO,0,TOTALS,MONTENEGRO,200,26,55,47.3,18,36,50.0,8,19,42.1,19,28,67.9,10,27,37,13,14,14,10,5,79,1
15079,352225,402_13_18,CROATIA,0,TOTALS,CROATIA,200,23,67,34.3,13,28,46.4,10,39,25.6,0,0,0.0,17,21,38,15,21,17,4,1,56,0
15080,352238,402_13_19,ISRAEL,0,TOTALS,ISRAEL,200,23,65,35.4,18,50,36.0,5,15,33.3,9,19,47.4,13,28,41,8,25,13,7,0,60,0
15081,352251,402_13_19,RUSSIA,0,TOTALS,RUSSIA,200,29,64,45.3,22,45,48.9,7,19,36.8,13,18,72.2,9,32,41,9,21,13,4,5,78,1
15082,352264,402_13_20,SLOVENIA,0,TOTALS,SLOVENIA,200,28,62,45.2,25,45,55.6,3,17,17.6,19,26,73.1,11,16,27,10,18,13,18,2,78,1
15083,352277,402_13_20,CZECH REPUBLIC,0,TOTALS,CZECH REPUBLIC,200,29,56,51.8,22,40,55.0,7,16,43.8,7,8,87.5,12,23,35,4,24,27,9,2,72,0
15084,352290,402_13_21,GEORGIA,0,TOTALS,GEORGIA,200,20,71,28.2,14,34,41.2,6,37,16.2,3,4,75.0,10,19,29,5,22,23,12,1,49,1
15085,352303,402_13_21,LITHUANIA,0,TOTALS,LITHUANIA,200,39,70,55.7,25,42,59.5,14,28,50.0,15,27,55.6,18,37,55,20,13,19,15,1,107,0
15086,352316,402_13_22,LATVIA,0,TOTALS,LATVIA,200,25,55,45.5,18,38,47.4,7,17,41.2,25,31,80.6,13,32,45,10,20,16,6,8,82,1
15087,352329,402_13_22,BULGARIA,0,TOTALS,BULGARIA,200,23,62,37.1,10,33,30.3,13,29,44.8,10,20,50.0,10,19,29,6,29,11,7,0,69,0
15088,352342,402_13_23,UKRAINE,0,TOTALS,UKRAINE,200,27,63,42.9,23,49,46.9,4,14,28.6,12,18,66.7,10,31,41,5,21,8,1,4,70,0
15089,352355,402_13_23,SWEDEN,0,TOTALS,SWEDEN,200,30,76,39.5,25,64,39.1,5,12,41.7,11,15,73.3,15,28,43,5,20,3,2,1,76,1
15090,352368,402_13_24,ESTONIA,0,TOTALS,ESTONIA,200,17,60,28.3,13,41,31.7,4,19,21.1,6,14,42.9,11,17,28,3,22,14,9,2,44,0
15091,352381,402_13_24,FRANCE,0,TOTALS,FRANCE,200,23,54,42.6,16,30,53.3,7,24,29.2,13,24,54.2,17,36,53,13,21,20,9,1,66,1
15092,352394,402_13_25,BULGARIA,0,TOTALS,BULGARIA,200,25,57,43.9,17,31,54.8,8,26,30.8,8,12,66.7,12,23,35,15,19,15,5,2,66,0
15093,352407,402_13_25,ISRAEL,0,TOTALS,ISRAEL,200,26,65,40.0,15,43,34.9,11,22,50.0,5,12,41.7,19,20,39,17,20,11,4,4,68,1
15094,352420,402_13_26,ITALY,0,TOTALS,ITALY,200,18,62,29.0,7,29,24.1,11,33,33.3,14,19,73.7,7,29,36,8,24,8,10,2,61,0
15095,352433,402_13_26,SLOVENIA,0,TOTALS,SLOVENIA,200,21,56,37.5,16,39,41.0,5,17,29.4,18,24,75.0,10,40,50,16,20,13,5,1,65,1
15096,352446,402_13_27,GREECE,0,TOTALS,GREECE,200,27,54,50.0,20,31,64.5,7,23,30.4,14,21,66.7,10,27,37,19,17,14,4,7,75,1
15097,352459,402_13_27,GEORGIA,0,TOTALS,GEORGIA,200,21,53,39.6,13,33,39.4,8,20,40.0,11,16,68.8,7,18,25,10,22,12,6,0,61,0
15098,352472,402_13_28,SWEDEN,0,TOTALS,SWEDEN,200,21,70,30.0,17,53,32.1,4,17,23.5,19,23,82.6,15,23,38,7,18,15,10,7,65,0
15099,352485,402_13_28,MONTENEGRO,0,TOTALS,MONTENEGRO,200,36,71,50.7,29,52,55.8,7,19,36.8,12,17,70.6,16,34,50,16,21,16,11,11,91,1
15100,352498,402_13_29,SERBIA,0,TOTALS,SERBIA,200,16,40,40.0,13,26,50.0,3,14,21.4,21,25,84.0,6,24,30,7,17,21,6,5,56,0
15101,352511,402_13_29,GERMANY,0,TOTALS,GERMANY,200,28,65,43.1,24,50,48.0,4,15,26.7,6,10,60.0,14,20,34,7,25,11,12,0,66,1
15102,352524,402_13_30,SPAIN,0,TOTALS,SPAIN,200,26,69,37.7,22,55,40.0,4,14,28.6,11,17,64.7,13,31,44,6,21,10,7,2,67,0
15103,352537,402_13_30,LATVIA,0,TOTALS,LATVIA,200,29,67,43.3,22,47,46.8,7,20,35.0,10,19,52.6,14,35,49,12,20,13,6,5,75,1
15104,352550,402_13_31,TURKEY,0,TOTALS,TURKEY,200,25,63,39.7,24,51,47.1,1,12,8.3,21,31,67.7,18,33,51,11,17,19,7,3,72,0
15105,352563,402_13_31,UKRAINE,0,TOTALS,UKRAINE,200,29,70,41.4,20,48,41.7,9,22,40.9,7,13,53.8,12,25,37,20,25,14,9,2,74,1
15106,352576,402_13_32,CZECH REPUBLIC,0,TOTALS,CZECH REPUBLIC,200,19,64,29.7,10,32,31.2,9,32,28.1,11,22,50.0,20,27,47,9,22,19,4,1,58,0
15107,352589,402_13_32,ESTONIA,0,TOTALS,ESTONIA,200,30,65,46.2,21,41,51.2,9,24,37.5,6,16,37.5,13,29,42,17,24,14,8,3,75,1
15108,352602,402_13_33,GEORGIA,0,TOTALS,GEORGIA,200,21,54,38.9,15,34,44.1,6,20,30.0,4,8,50.0,8,15,23,13,19,26,11,3,52,0
15109,352615,402_13_33,SERBIA,0,TOTALS,SERBIA,200,34,60,56.7,24,39,61.5,10,21,47.6,11,16,68.8,15,25,40,26,17,24,11,4,89,1
15110,352628,402_13_34,LITHUANIA,0,TOTALS,LITHUANIA,200,24,62,38.7,18,38,47.4,6,24,25.0,20,26,76.9,11,24,35,12,25,17,9,1,74,0
15111,352641,402_13_34,GREECE,0,TOTALS,GREECE,200,23,53,43.4,12,32,37.5,11,21,52.4,20,24,83.3,9,30,39,18,26,22,10,6,77,1
15112,352654,402_13_35,MONTENEGRO,0,TOTALS,MONTENEGRO,200,26,56,46.4,19,34,55.9,7,22,31.8,12,18,66.7,12,22,34,22,18,25,8,2,71,0
15113,352667,402_13_35,TURKEY,0,TOTALS,TURKEY,200,33,64,51.6,30,49,61.2,3,15,20.0,15,16,93.8,9,22,31,20,20,16,16,1,84,1
15114,352680,402_13_36,CROATIA,0,TOTALS,CROATIA,200,32,62,51.6,23,40,57.5,9,22,40.9,14,21,66.7,10,26,36,15,24,15,8,3,87,1
15115,352693,402_13_36,SWEDEN,0,TOTALS,SWEDEN,200,25,58,43.1,19,39,48.7,6,19,31.6,19,26,73.1,11,25,36,15,20,16,7,2,75,0
15116,352706,402_13_37,ISRAEL,0,TOTALS,ISRAEL,200,21,57,36.8,16,44,36.4,5,13,38.5,14,21,66.7,11,25,36,10,19,19,7,3,61,0
15117,352719,402_13_37,SPAIN,0,TOTALS,SPAIN,200,25,59,42.4,20,38,52.6,5,21,23.8,8,11,72.7,9,27,36,9,21,17,12,2,63,1
15118,352732,402_13_38,RUSSIA,0,TOTALS,RUSSIA,200,28,61,45.9,20,42,47.6,8,19,42.1,11,13,84.6,12,27,39,13,14,18,6,2,75,1
15119,352745,402_13_38,BULGARIA,0,TOTALS,BULGARIA,200,26,63,41.3,16,34,47.1,10,29,34.5,5,11,45.5,12,24,36,11,16,15,15,0,67,0
15120,352758,402_13_39,ESTONIA,0,TOTALS,ESTONIA,200,27,63,42.9,15,37,40.5,12,26,46.2,12,17,70.6,13,26,39,11,24,19,1,1,78,0
15121,352771,402_13_39,ITALY,0,TOTALS,ITALY,200,28,61,45.9,17,29,58.6,11,32,34.4,23,30,76.7,9,25,34,12,20,12,9,4,90,1
15122,352784,402_13_40,FRANCE,0,TOTALS,FRANCE,200,28,56,50.0,22,41,53.7,6,15,40.0,17,23,73.9,8,30,38,6,20,11,6,5,79,1
15123,352797,402_13_40,CZECH REPUBLIC,0,TOTALS,CZECH REPUBLIC,200,23,57,40.4,17,40,42.5,6,17,35.3,10,23,43.5,9,20,29,5,23,15,5,3,62,0
15124,352810,402_13_41,UKRAINE,0,TOTALS,UKRAINE,200,24,57,42.1,16,34,47.1,8,23,34.8,16,22,72.7,9,28,37,19,21,16,5,4,72,0
15125,352823,402_13_41,ISRAEL,0,TOTALS,ISRAEL,200,31,69,44.9,20,48,41.7,11,21,52.4,11,19,57.9,14,26,40,17,22,12,6,3,84,1
15126,352836,402_13_42,SWEDEN,0,TOTALS,SWEDEN,200,24,60,40.0,23,44,52.3,1,16,6.2,8,12,66.7,17,28,45,10,22,17,7,5,57,0
15127,352849,402_13_42,BULGARIA,0,TOTALS,BULGARIA,200,20,60,33.3,12,36,33.3,8,24,33.3,13,23,56.5,16,21,37,11,18,11,9,3,61,1
15128,352862,402_13_43,SERBIA,0,TOTALS,SERBIA,200,32,50,64.0,26,37,70.3,6,13,46.2,21,31,67.7,6,32,38,19,19,17,10,3,91,1
15129,352875,402_13_43,CZECH REPUBLIC,0,TOTALS,CZECH REPUBLIC,200,23,63,36.5,17,40,42.5,6,23,26.1,14,16,87.5,10,18,28,7,24,14,8,0,66,0
15130,352888,402_13_44,GEORGIA,0,TOTALS,GEORGIA,200,19,61,31.1,16,34,47.1,3,27,11.1,11,16,68.8,12,34,46,4,14,22,8,2,52,0
15131,352901,402_13_44,ESTONIA,0,TOTALS,ESTONIA,200,27,72,37.5,14,30,46.7,13,42,31.0,7,11,63.6,13,33,46,21,20,17,9,3,74,1
15132,352914,402_13_45,MONTENEGRO,0,TOTALS,MONTENEGRO,200,21,68,30.9,11,35,31.4,10,33,30.3,4,6,66.7,11,25,36,7,22,14,7,4,56,0
15133,352927,402_13_45,LITHUANIA,0,TOTALS,LITHUANIA,200,21,51,41.2,13,32,40.6,8,19,42.1,13,18,72.2,6,36,42,14,15,20,4,4,63,1
15134,352940,402_13_46,ITALY,0,TOTALS,ITALY,200,28,69,40.6,19,45,42.2,9,24,37.5,11,17,64.7,17,27,44,8,22,11,7,1,76,1
15135,352953,402_13_46,SPAIN,0,TOTALS,SPAIN,200,26,57,45.6,20,35,57.1,6,22,27.3,15,18,83.3,6,23,29,13,20,9,3,2,73,0
15136,352966,402_13_47,CROATIA,0,TOTALS,CROATIA,200,25,65,38.5,18,45,40.0,7,20,35.0,11,19,57.9,16,27,43,13,24,17,3,1,68,0
15137,352979,402_13_47,GREECE,0,TOTALS,GREECE,200,26,61,42.6,18,32,56.2,8,29,27.6,17,20,85.0,9,28,37,12,24,13,4,14,77,1
15138,352992,402_13_48,SLOVENIA,0,TOTALS,SLOVENIA,200,31,79,39.2,27,62,43.5,4,17,23.5,6,12,50.0,21,17,38,9,19,13,13,1,72,0
15139,353005,402_13_48,LATVIA,0,TOTALS,LATVIA,200,29,58,50.0,19,33,57.6,10,25,40.0,10,12,83.3,11,27,38,14,16,23,5,4,78,1
15140,353018,402_13_49,GERMANY,0,TOTALS,GERMANY,200,26,66,39.4,19,46,41.3,7,20,35.0,12,24,50.0,19,31,50,8,25,12,3,1,71,1
15141,353031,402_13_49,TURKEY,0,TOTALS,TURKEY,200,22,62,35.5,19,38,50.0,3,24,12.5,18,25,72.0,13,25,38,9,24,7,4,0,65,0
15142,353044,402_13_50,RUSSIA,0,TOTALS,RUSSIA,200,24,61,39.3,16,43,37.2,8,18,44.4,9,16,56.2,11,25,36,10,17,11,8,3,65,1
15143,353057,402_13_50,FRANCE,0,TOTALS,FRANCE,200,23,56,41.1,16,37,43.2,7,19,36.8,8,14,57.1,12,28,40,8,18,15,6,4,61,0
15144,353070,402_13_51,ISRAEL,0,TOTALS,ISRAEL,200,25,70,35.7,22,52,42.3,3,18,16.7,9,17,52.9,13,22,35,10,24,14,10,2,62,0
15145,353083,402_13_51,SERBIA,0,TOTALS,SERBIA,200,23,47,48.9,21,34,61.8,2,13,15.4,18,25,72.0,8,38,46,9,19,25,7,6,66,1
15146,353096,402_13_52,BULGARIA,0,TOTALS,BULGARIA,200,31,65,47.7,22,42,52.4,9,23,39.1,14,15,93.3,15,35,50,18,19,17,12,3,85,1
15147,353109,402_13_52,GEORGIA,0,TOTALS,GEORGIA,200,15,57,26.3,11,41,26.8,4,16,25.0,10,15,66.7,10,20,30,9,16,19,8,2,44,0
15148,353122,402_13_53,CZECH REPUBLIC,0,TOTALS,CZECH REPUBLIC,200,33,71,46.5,22,42,52.4,11,29,37.9,6,11,54.5,10,18,28,21,26,10,11,2,83,0
15149,353135,402_13_53,UKRAINE,0,TOTALS,UKRAINE,200,29,54,53.7,22,38,57.9,7,16,43.8,24,33,72.7,12,32,44,18,17,19,3,3,89,1
15150,353148,402_13_54,ESTONIA,0,TOTALS,ESTONIA,200,27,64,42.2,21,37,56.8,6,27,22.2,9,11,81.8,10,22,32,7,20,13,9,2,69,0
15151,353161,402_13_54,SWEDEN,0,TOTALS,SWEDEN,200,27,61,44.3,17,43,39.5,10,18,55.6,13,23,56.5,16,27,43,11,17,16,5,4,77,1
15152,353174,402_13_55,CROATIA,0,TOTALS,CROATIA,200,19,52,36.5,9,27,33.3,10,25,40.0,18,26,69.2,7,25,32,9,18,15,8,4,66,1
15153,353187,402_13_55,GERMANY,0,TOTALS,GERMANY,200,24,65,36.9,19,41,46.3,5,24,20.8,8,14,57.1,16,28,44,8,22,17,10,3,61,0
15154,353200,402_13_56,SLOVENIA,0,TOTALS,SLOVENIA,200,27,64,42.2,18,42,42.9,9,22,40.9,6,8,75.0,11,14,25,15,16,9,6,0,69,0
15155,353213,402_13_56,RUSSIA,0,TOTALS,RUSSIA,200,33,54,61.1,20,30,66.7,13,24,54.2,9,13,69.2,8,27,35,18,14,16,1,0,88,1
15156,353226,402_13_57,GREECE,0,TOTALS,GREECE,200,26,60,43.3,17,33,51.5,9,27,33.3,9,10,90.0,14,26,40,19,19,17,5,2,70,1
15157,353239,402_13_57,MONTENEGRO,0,TOTALS,MONTENEGRO,200,14,48,29.2,13,36,36.1,1,12,8.3,18,26,69.2,10,21,31,9,13,18,9,3,47,0
15158,353252,402_13_58,LATVIA,0,TOTALS,LATVIA,200,30,59,50.8,18,30,60.0,12,29,41.4,16,17,94.1,8,30,38,15,18,18,4,2,88,1
15159,353265,402_13_58,ITALY,0,TOTALS,ITALY,200,29,74,39.2,19,42,45.2,10,32,31.2,13,19,68.4,18,21,39,19,19,9,10,4,81,0
15160,353278,402_13_59,LITHUANIA,0,TOTALS,LITHUANIA,200,17,61,27.9,11,34,32.4,6,27,22.2,8,12,66.7,23,30,53,10,19,19,3,3,48,0
15161,353291,402_13_59,TURKEY,0,TOTALS,TURKEY,200,22,61,36.1,20,41,48.8,2,20,10.0,6,15,40.0,14,23,37,15,19,10,12,5,52,1
15162,353304,402_13_60,SPAIN,0,TOTALS,SPAIN,200,28,64,43.8,18,41,43.9,10,23,43.5,4,6,66.7,14,26,40,19,12,11,4,3,70,1
15163,353316,402_13_60,FRANCE,0,TOTALS,FRANCE,200,20,52,38.5,12,32,37.5,8,20,40.0,4,9,44.4,8,23,31,7,17,12,5,3,52,0
15164,353329,402_13_61,SERBIA,0,TOTALS,SERBIA,200,25,58,43.1,23,41,56.1,2,17,11.8,23,26,88.5,10,23,33,13,17,11,8,3,75,1
15165,353342,402_13_61,UKRAINE,0,TOTALS,UKRAINE,200,25,64,39.1,13,38,34.2,12,26,46.2,7,9,77.8,16,24,40,10,24,19,5,0,69,0
15166,353355,402_13_62,GEORGIA,0,TOTALS,GEORGIA,200,24,62,38.7,18,34,52.9,6,28,21.4,8,10,80.0,14,24,38,9,16,18,10,3,62,0
15167,353368,402_13_62,SWEDEN,0,TOTALS,SWEDEN,200,28,70,40.0,25,59,42.4,3,11,27.3,7,14,50.0,21,24,45,11,18,16,6,6,66,1
15168,353381,402_13_63,ISRAEL,0,TOTALS,ISRAEL,200,27,58,46.6,21,41,51.2,6,17,35.3,17,31,54.8,13,25,38,8,18,14,7,4,77,1
15169,353394,402_13_63,CZECH REPUBLIC,0,TOTALS,CZECH REPUBLIC,200,31,60,51.7,22,35,62.9,9,25,36.0,5,8,62.5,6,23,29,15,27,14,7,6,76,0
15170,353407,402_13_64,BULGARIA,0,TOTALS,BULGARIA,200,24,61,39.3,16,31,51.6,8,30,26.7,12,17,70.6,19,27,46,11,18,17,8,1,68,1
15171,353420,402_13_64,ESTONIA,0,TOTALS,ESTONIA,200,22,56,39.3,16,32,50.0,6,24,25.0,8,14,57.1,9,21,30,16,18,16,9,1,58,0
15172,353433,402_13_65,MONTENEGRO,0,TOTALS,MONTENEGRO,200,23,51,45.1,12,28,42.9,11,23,47.8,18,24,75.0,7,23,30,10,20,11,7,4,75,1
15173,353446,402_13_65,GERMANY,0,TOTALS,GERMANY,200,23,52,44.2,17,36,47.2,6,16,37.5,12,20,60.0,9,22,31,15,20,12,2,0,64,0
15174,353459,402_13_66,ITALY,0,TOTALS,ITALY,200,34,76,44.7,24,43,55.8,10,33,30.3,10,10,100.0,20,18,38,8,17,10,9,6,88,1
15175,353472,402_13_66,RUSSIA,0,TOTALS,RUSSIA,200,29,63,46.0,24,45,53.3,5,18,27.8,7,14,50.0,20,22,42,15,15,20,10,5,70,0
15176,353485,402_13_67,LITHUANIA,0,TOTALS,LITHUANIA,200,22,57,38.6,13,29,44.8,9,28,32.1,17,22,77.3,14,33,47,14,17,20,7,5,70,1
15177,353498,402_13_67,CROATIA,0,TOTALS,CROATIA,200,24,65,36.9,14,36,38.9,10,29,34.5,7,11,63.6,9,24,33,17,22,11,6,1,65,0
15178,353511,402_13_68,SPAIN,0,TOTALS,SPAIN,200,25,65,38.5,14,31,45.2,11,34,32.4,11,14,78.6,19,18,37,12,21,18,9,3,72,0
15179,353524,402_13_68,SLOVENIA,0,TOTALS,SLOVENIA,200,27,50,54.0,21,36,58.3,6,14,42.9,15,21,71.4,8,20,28,10,19,16,9,3,75,1
15180,353537,402_13_69,TURKEY,0,TOTALS,TURKEY,200,27,59,45.8,20,46,43.5,7,13,53.8,11,19,57.9,13,18,31,8,21,16,11,3,72,1
15181,353550,402_13_69,GREECE,0,TOTALS,GREECE,200,26,56,46.4,19,34,55.9,7,22,31.8,11,17,64.7,12,24,36,11,24,21,3,4,70,0
15182,353563,402_13_70,FRANCE,0,TOTALS,FRANCE,200,30,54,55.6,22,37,59.5,8,17,47.1,11,22,50.0,11,26,37,13,18,16,5,2,79,1
15183,353576,402_13_70,LATVIA,0,TOTALS,LATVIA,200,26,63,41.3,16,38,42.1,10,25,40.0,12,14,85.7,9,19,28,13,24,10,7,4,74,0
15184,353589,402_13_71,UKRAINE,0,TOTALS,UKRAINE,200,30,76,39.5,27,57,47.4,3,19,15.8,12,13,92.3,18,48,66,16,22,21,6,6,75,1
15185,353602,402_13_71,GEORGIA,0,TOTALS,GEORGIA,200,17,77,22.1,15,51,29.4,2,26,7.7,11,19,57.9,16,28,44,6,16,14,10,2,47,0
15186,353615,402_13_72,ESTONIA,0,TOTALS,ESTONIA,200,25,62,40.3,15,32,46.9,10,30,33.3,8,17,47.1,11,19,30,12,22,14,5,4,68,0
15187,353628,402_13_72,CZECH REPUBLIC,0,TOTALS,CZECH REPUBLIC,200,38,73,52.1,30,57,52.6,8,16,50.0,10,15,66.7,18,30,48,22,21,13,8,3,94,1
15188,353641,402_13_73,SERBIA,0,TOTALS,SERBIA,200,32,64,50.0,27,48,56.2,5,16,31.2,13,18,72.2,13,31,44,17,22,14,6,2,82,1
15189,353654,402_13_73,SWEDEN,0,TOTALS,SWEDEN,200,22,64,34.4,16,47,34.0,6,17,35.3,15,22,68.2,14,20,34,6,22,12,5,3,65,0
15190,353667,402_13_74,TURKEY,0,TOTALS,TURKEY,200,24,59,40.7,17,39,43.6,7,20,35.0,15,23,65.2,17,22,39,8,25,18,7,1,70,0
15191,353680,402_13_74,RUSSIA,0,TOTALS,RUSSIA,200,26,56,46.4,16,36,44.4,10,20,50.0,20,26,76.9,11,21,32,13,19,16,9,0,82,1
15192,353693,402_13_75,BULGARIA,0,TOTALS,BULGARIA,200,23,51,45.1,12,24,50.0,11,27,40.7,19,23,82.6,5,20,25,15,18,11,8,1,76,1
15193,353706,402_13_75,ISRAEL,0,TOTALS,ISRAEL,200,23,50,46.0,18,34,52.9,5,16,31.2,18,20,90.0,8,26,34,16,19,17,4,0,69,0
15194,353719,402_13_76,LATVIA,0,TOTALS,LATVIA,200,27,63,42.9,23,42,54.8,4,21,19.0,20,27,74.1,16,24,40,10,17,7,2,4,78,1
15195,353732,402_13_76,MONTENEGRO,0,TOTALS,MONTENEGRO,200,28,64,43.8,23,48,47.9,5,16,31.2,12,15,80.0,11,22,33,9,24,6,5,6,73,0
15196,353745,402_13_77,CROATIA,0,TOTALS,CROATIA,200,30,60,50.0,22,38,57.9,8,22,36.4,10,12,83.3,9,15,24,21,25,13,7,2,78,0
15197,353758,402_13_77,SLOVENIA,0,TOTALS,SLOVENIA,200,31,65,47.7,22,39,56.4,9,26,34.6,19,26,73.1,21,24,45,16,16,15,7,3,90,1
15198,353771,402_13_78,GREECE,0,TOTALS,GREECE,200,23,50,46.0,18,32,56.2,5,18,27.8,9,18,50.0,5,23,28,11,20,16,6,3,60,0
15199,353784,402_13_78,SPAIN,0,TOTALS,SPAIN,200,30,58,51.7,20,33,60.6,10,25,40.0,12,16,75.0,7,25,32,19,21,12,10,2,82,1
15200,353796,402_13_79,FRANCE,0,TOTALS,FRANCE,200,23,55,41.8,15,28,53.6,8,27,29.6,17,20,85.0,8,20,28,6,21,11,10,2,71,1
15201,353809,402_13_79,GERMANY,0,TOTALS,GERMANY,200,21,46,45.7,19,36,52.8,2,10,20.0,18,24,75.0,9,22,31,3,23,18,4,0,62,0
15202,353822,402_13_80,ITALY,0,TOTALS,ITALY,225,27,73,37.0,21,46,45.7,6,27,22.2,15,24,62.5,13,26,39,11,19,13,18,7,75,1
15203,353835,402_13_80,LITHUANIA,0,TOTALS,LITHUANIA,225,27,62,43.5,19,38,50.0,8,24,33.3,10,14,71.4,10,38,48,13,24,25,7,3,72,0
15204,353848,402_13_81,MONTENEGRO,0,TOTALS,MONTENEGRO,200,19,58,32.8,16,46,34.8,3,12,25.0,11,18,61.1,12,25,37,5,14,19,7,3,52,0
15205,353861,402_13_81,GREECE,0,TOTALS,GREECE,200,27,68,39.7,22,49,44.9,5,19,26.3,8,11,72.7,16,30,46,14,17,18,11,3,67,1
15206,353874,402_13_82,TURKEY,0,TOTALS,TURKEY,200,30,66,45.5,23,42,54.8,7,24,29.2,3,3,100.0,10,24,34,15,19,13,6,1,70,1
15207,353887,402_13_82,LITHUANIA,0,TOTALS,LITHUANIA,200,27,60,45.0,21,40,52.5,6,20,30.0,8,13,61.5,13,26,39,9,16,16,6,4,68,0
15208,353900,402_13_83,LATVIA,0,TOTALS,LATVIA,200,24,64,37.5,22,52,42.3,2,12,16.7,14,22,63.6,12,29,41,9,18,8,3,5,64,1
15209,353913,402_13_83,SPAIN,0,TOTALS,SPAIN,200,24,63,38.1,20,45,44.4,4,18,22.2,11,22,50.0,13,32,45,11,20,9,7,6,63,0
15210,353926,402_13_84,RUSSIA,0,TOTALS,RUSSIA,200,24,61,39.3,17,39,43.6,7,22,31.8,13,20,65.0,12,25,37,12,25,16,8,5,68,0
15211,353939,402_13_84,ITALY,0,TOTALS,ITALY,200,28,63,44.4,22,42,52.4,6,21,28.6,15,20,75.0,12,29,41,14,21,14,11,2,77,1
15212,353952,402_13_85,GEORGIA,0,TOTALS,GEORGIA,200,22,67,32.8,14,41,34.1,8,26,30.8,18,24,75.0,13,30,43,8,17,17,8,1,70,0
15213,353965,402_13_85,ESTONIA,0,TOTALS,ESTONIA,200,29,74,39.2,19,39,48.7,10,35,28.6,11,17,64.7,18,33,51,15,22,17,11,3,79,1
15214,353978,402_13_86,UKRAINE,0,TOTALS,UKRAINE,200,27,64,42.2,22,44,50.0,5,20,25.0,9,13,69.2,11,29,40,19,19,15,7,4,68,0
15215,353991,402_13_86,CZECH REPUBLIC,0,TOTALS,CZECH REPUBLIC,200,29,61,47.5,22,43,51.2,7,18,38.9,10,22,45.5,9,27,36,15,19,10,8,4,75,1
15216,354004,402_13_87,SLOVENIA,0,TOTALS,SLOVENIA,200,24,58,41.4,19,40,47.5,5,18,27.8,16,17,94.1,8,23,31,17,16,16,6,2,69,0
15217,354017,402_13_87,FRANCE,0,TOTALS,FRANCE,200,31,64,48.4,26,42,61.9,5,22,22.7,11,14,78.6,11,26,37,23,17,14,11,2,78,1
15218,354030,402_13_88,SWEDEN,0,TOTALS,SWEDEN,200,32,61,52.5,26,46,56.5,6,15,40.0,11,19,57.9,10,15,25,15,19,9,4,5,81,0
15219,354043,402_13_88,ISRAEL,0,TOTALS,ISRAEL,200,31,65,47.7,26,49,53.1,5,16,31.2,15,19,78.9,20,22,42,16,24,16,5,3,82,1
15220,354056,402_13_89,LITHUANIA,0,TOTALS,LITHUANIA,200,29,63,46.0,19,38,50.0,10,25,40.0,16,23,69.6,13,33,46,20,16,15,10,8,84,1
15221,354069,402_13_89,MONTENEGRO,0,TOTALS,MONTENEGRO,200,17,61,27.9,13,37,35.1,4,24,16.7,13,16,81.2,12,22,34,12,22,18,11,0,51,0
15222,354082,402_13_90,SERBIA,0,TOTALS,SERBIA,200,29,68,42.6,21,49,42.9,8,19,42.1,10,19,52.6,21,22,43,18,15,13,6,1,76,1
15223,354095,402_13_90,BULGARIA,0,TOTALS,BULGARIA,200,27,56,48.2,17,27,63.0,10,29,34.5,6,7,85.7,7,24,31,16,23,15,7,1,70,0
15224,354108,402_13_91,TURKEY,0,TOTALS,TURKEY,200,21,68,30.9,18,52,34.6,3,16,18.8,15,26,57.7,16,26,42,12,27,14,11,2,60,0
15225,354121,402_13_91,GREECE,0,TOTALS,GREECE,200,26,60,43.3,21,39,53.8,5,21,23.8,17,26,65.4,12,34,46,14,18,18,6,3,74,1
15226,354134,402_13_92,CROATIA,0,TOTALS,CROATIA,200,23,69,33.3,20,45,44.4,3,24,12.5,16,22,72.7,16,27,43,12,18,12,4,1,65,0
15227,354147,402_13_92,GERMANY,0,TOTALS,GERMANY,200,28,62,45.2,18,37,48.6,10,25,40.0,10,13,76.9,7,34,41,12,21,15,6,5,76,1
15228,354160,402_13_93,RUSSIA,0,TOTALS,RUSSIA,200,26,54,48.1,21,39,53.8,5,15,33.3,6,6,100.0,7,30,37,6,23,22,2,6,63,0
15229,354173,402_13_93,SPAIN,0,TOTALS,SPAIN,200,26,71,36.6,21,48,43.8,5,23,21.7,13,22,59.1,18,21,39,14,13,9,12,0,70,1
15230,354186,402_13_94,ITALY,0,TOTALS,ITALY,200,22,66,33.3,14,37,37.8,8,29,27.6,15,20,75.0,12,30,42,7,19,8,12,3,67,1
15231,354199,402_13_94,LATVIA,0,TOTALS,LATVIA,200,21,60,35.0,15,40,37.5,6,20,30.0,12,18,66.7,9,34,43,11,18,13,1,6,60,0
15232,354212,403_13_01,BELGIUM,0,TOTALS,BELGIUM,200,29,69,42.0,24,50,48.0,5,19,26.3,9,12,75.0,15,27,42,11,18,11,9,1,72,1
15233,354225,403_13_01,SWITZERLAND,0,TOTALS,SWITZERLAND,200,25,61,41.0,19,39,48.7,6,22,27.3,11,20,55.0,14,24,38,11,14,15,3,2,67,0
15234,354238,403_13_02,SLOVAK REPUBLIC,0,TOTALS,SLOVAK REPUBLIC,200,22,62,35.5,18,45,40.0,4,17,23.5,14,25,56.0,7,28,35,10,21,10,5,2,62,0
15235,354251,403_13_02,GREAT BRITAIN,0,TOTALS,GREAT BRITAIN,200,28,65,43.1,19,36,52.8,9,29,31.0,10,16,62.5,10,38,48,15,23,13,5,2,75,1
15236,354264,403_13_03,CYPRUS,0,TOTALS,CYPRUS,200,22,70,31.4,14,45,31.1,8,25,32.0,6,9,66.7,13,26,39,14,14,12,7,2,58,0
15237,354277,403_13_03,NETHERLANDS,0,TOTALS,NETHERLANDS,200,25,63,39.7,19,46,41.3,6,17,35.3,10,12,83.3,13,35,48,12,14,18,7,4,66,1
15238,354290,403_13_04,LUXEMBOURG,0,TOTALS,LUXEMBOURG,200,21,68,30.9,18,50,36.0,3,18,16.7,16,20,80.0,8,17,25,7,26,11,18,1,61,0
15239,354303,403_13_04,HUNGARY,0,TOTALS,HUNGARY,200,30,67,44.8,26,51,51.0,4,16,25.0,20,32,62.5,23,40,63,11,19,25,6,8,84,1
15240,354316,403_13_05,POLAND,0,TOTALS,POLAND,200,33,58,56.9,22,41,53.7,11,17,64.7,15,21,71.4,7,26,33,18,13,16,16,5,92,1
15241,354329,403_13_05,ROMANIA,0,TOTALS,ROMANIA,200,25,60,41.7,18,44,40.9,7,16,43.8,5,11,45.5,13,20,33,9,20,22,7,2,62,0
15242,354342,403_13_06,FINLAND,0,TOTALS,FINLAND,200,19,58,32.8,17,47,36.2,2,11,18.2,31,44,70.5,17,25,42,5,22,18,5,1,71,0
15243,354355,403_13_06,PORTUGAL,0,TOTALS,PORTUGAL,200,33,59,55.9,26,37,70.3,7,22,31.8,20,29,69.0,6,25,31,13,32,15,6,2,93,1
15244,354368,403_13_07,GREAT BRITAIN,0,TOTALS,GREAT BRITAIN,200,34,76,44.7,18,37,48.6,16,39,41.0,22,35,62.9,25,23,48,24,7,13,10,3,106,0
15245,354381,403_13_07,LUXEMBOURG,0,TOTALS,LUXEMBOURG,200,38,63,60.3,29,46,63.0,9,17,52.9,7,9,77.8,4,23,27,19,24,16,10,4,92,1
15246,354394,403_13_08,SWITZERLAND,0,TOTALS,SWITZERLAND,200,22,69,31.9,16,42,38.1,6,27,22.2,7,14,50.0,11,24,35,11,21,7,6,0,57,0
15247,354407,403_13_08,CYPRUS,0,TOTALS,CYPRUS,200,25,55,45.5,19,34,55.9,6,21,28.6,10,19,52.6,7,39,46,11,18,16,4,5,66,1
15248,354420,403_13_09,HUNGARY,0,TOTALS,HUNGARY,200,20,54,37.0,17,43,39.5,3,11,27.3,10,18,55.6,12,17,29,5,17,18,9,4,53,0
15249,354433,403_13_09,POLAND,0,TOTALS,POLAND,200,36,71,50.7,34,55,61.8,2,16,12.5,6,13,46.2,21,26,47,12,18,18,4,2,80,1
15250,354446,403_13_10,NETHERLANDS,0,TOTALS,NETHERLANDS,200,29,59,49.2,23,44,52.3,6,15,40.0,15,21,71.4,7,34,41,19,18,9,4,5,79,1
15251,354459,403_13_10,FINLAND,0,TOTALS,FINLAND,200,14,62,22.6,11,42,26.2,3,20,15.0,9,15,60.0,18,23,41,1,17,13,4,2,40,0
15252,354472,403_13_11,ROMANIA,0,TOTALS,ROMANIA,200,32,61,52.5,25,43,58.1,7,18,38.9,7,13,53.8,11,28,39,20,22,13,9,4,78,1
15253,354485,403_13_11,SLOVAK REPUBLIC,0,TOTALS,SLOVAK REPUBLIC,200,22,64,34.4,16,38,42.1,6,26,23.1,12,22,54.5,17,21,38,9,15,16,6,2,62,0
15254,354498,403_13_12,PORTUGAL,0,TOTALS,PORTUGAL,200,24,58,41.4,13,30,43.3,11,28,39.3,9,16,56.2,9,25,34,13,24,16,6,1,68,0
15255,354511,403_13_12,BELGIUM,0,TOTALS,BELGIUM,200,22,56,39.3,17,32,53.1,5,24,20.8,21,32,65.6,13,25,38,12,18,13,5,2,70,1
15256,354524,403_13_13,POLAND,0,TOTALS,POLAND,200,33,61,54.1,24,32,75.0,9,29,31.0,9,19,47.4,12,45,57,22,17,24,12,1,84,1
15257,354537,403_13_13,LUXEMBOURG,0,TOTALS,LUXEMBOURG,200,12,61,19.7,10,47,21.3,2,14,14.3,8,17,47.1,8,20,28,5,17,20,14,1,34,0
15258,354550,403_13_14,FINLAND,0,TOTALS,FINLAND,200,30,68,44.1,25,46,54.3,5,22,22.7,17,24,70.8,17,42,59,17,15,19,7,5,82,1
15259,354563,403_13_14,CYPRUS,0,TOTALS,CYPRUS,200,12,65,18.5,9,40,22.5,3,25,12.0,10,14,71.4,13,24,37,6,26,18,9,1,37,0
15260,354576,403_13_15,SLOVAK REPUBLIC,0,TOTALS,SLOVAK REPUBLIC,200,25,63,39.7,20,43,46.5,5,20,25.0,8,11,72.7,9,20,29,12,19,14,6,4,63,0
15261,354589,403_13_15,HUNGARY,0,TOTALS,HUNGARY,200,33,72,45.8,29,57,50.9,4,15,26.7,9,20,45.0,24,28,52,12,16,15,10,7,79,1
15262,354602,403_13_16,PORTUGAL,0,TOTALS,PORTUGAL,200,25,77,32.5,19,41,46.3,6,36,16.7,14,22,63.6,21,20,41,12,25,12,8,1,70,0
15263,354615,403_13_16,SWITZERLAND,0,TOTALS,SWITZERLAND,200,34,62,54.8,30,44,68.2,4,18,22.2,18,26,69.2,9,33,42,15,17,14,6,7,90,1
15264,354628,403_13_17,ROMANIA,0,TOTALS,ROMANIA,200,17,66,25.8,12,39,30.8,5,27,18.5,4,9,44.4,10,22,32,5,20,14,3,1,43,0
15265,354641,403_13_17,GREAT BRITAIN,0,TOTALS,GREAT BRITAIN,200,34,80,42.5,20,45,44.4,14,35,40.0,17,24,70.8,26,41,67,10,16,10,9,5,99,1
15266,354654,403_13_18,BELGIUM,0,TOTALS,BELGIUM,200,27,62,43.5,18,34,52.9,9,28,32.1,9,13,69.2,10,31,41,18,14,13,8,1,72,1
15267,354667,403_13_18,NETHERLANDS,0,TOTALS,NETHERLANDS,200,21,60,35.0,13,31,41.9,8,29,27.6,9,14,64.3,9,27,36,9,13,13,6,5,59,0
15268,354680,403_13_19,LUXEMBOURG,0,TOTALS,LUXEMBOURG,200,22,73,30.1,19,51,37.3,3,22,13.6,15,18,83.3,16,25,41,12,19,10,17,2,62,1
15269,354693,403_13_19,SLOVAK REPUBLIC,0,TOTALS,SLOVAK REPUBLIC,200,19,61,31.1,15,38,39.5,4,23,17.4,9,12,75.0,17,38,55,14,18,29,8,6,51,0
15270,354706,403_13_20,NETHERLANDS,0,TOTALS,NETHERLANDS,200,24,53,45.3,19,40,47.5,5,13,38.5,10,17,58.8,10,26,36,10,15,19,1,0,63,0
15271,354718,403_13_20,PORTUGAL,0,TOTALS,PORTUGAL,200,27,58,46.6,18,37,48.6,9,21,42.9,9,14,64.3,8,19,27,9,18,14,7,1,72,1
15272,354731,403_13_21,GREAT BRITAIN,0,TOTALS,GREAT BRITAIN,200,29,72,40.3,16,50,32.0,13,22,59.1,12,15,80.0,17,31,48,7,15,11,4,3,83,1
15273,354744,403_13_21,POLAND,0,TOTALS,POLAND,200,32,80,40.0,26,48,54.2,6,32,18.8,4,8,50.0,16,27,43,15,18,7,6,6,74,0
15274,354757,403_13_22,CYPRUS,0,TOTALS,CYPRUS,200,22,62,35.5,18,46,39.1,4,16,25.0,11,13,84.6,9,25,34,9,16,11,7,3,59,0
15275,354770,403_13_22,BELGIUM,0,TOTALS,BELGIUM,200,25,74,33.8,17,47,36.2,8,27,29.6,8,10,80.0,23,31,54,13,14,13,6,4,66,1
15276,354783,403_13_23,HUNGARY,0,TOTALS,HUNGARY,200,26,69,37.7,24,55,43.6,2,14,14.3,11,20,55.0,24,38,62,11,13,16,7,4,65,1
15277,354796,403_13_23,ROMANIA,0,TOTALS,ROMANIA,200,20,67,29.9,13,39,33.3,7,28,25.0,6,11,54.5,13,22,35,11,19,12,8,6,53,0
15278,354809,403_13_24,SWITZERLAND,0,TOTALS,SWITZERLAND,225,40,88,45.5,29,59,49.2,11,29,37.9,3,7,42.9,15,30,45,18,23,8,7,4,94,1
15279,354822,403_13_24,FINLAND,0,TOTALS,FINLAND,225,32,79,40.5,25,51,49.0,7,28,25.0,17,24,70.8,18,31,49,10,10,15,4,4,88,0
15280,354835,403_13_25,SLOVAK REPUBLIC,0,TOTALS,SLOVAK REPUBLIC,200,25,57,43.9,23,42,54.8,2,15,13.3,12,15,80.0,6,28,34,11,19,16,4,5,64,0
15281,354848,403_13_25,POLAND,0,TOTALS,POLAND,200,36,81,44.4,31,53,58.5,5,28,17.9,12,19,63.2,22,27,49,22,18,6,10,6,89,1
15282,354861,403_13_26,PORTUGAL,0,TOTALS,PORTUGAL,200,24,55,43.6,19,40,47.5,5,15,33.3,22,29,75.9,10,24,34,12,17,10,10,3,75,1
15283,354874,403_13_26,CYPRUS,0,TOTALS,CYPRUS,200,29,66,43.9,23,46,50.0,6,20,30.0,6,10,60.0,13,25,38,12,24,13,7,3,70,0
15284,354887,403_13_27,HUNGARY,0,TOTALS,HUNGARY,200,27,68,39.7,26,48,54.2,1,20,5.0,5,9,55.6,12,35,47,13,18,17,3,7,60,0
15285,354900,403_13_27,GREAT BRITAIN,0,TOTALS,GREAT BRITAIN,200,20,68,29.4,15,46,32.6,5,22,22.7,20,22,90.9,13,28,41,8,12,11,8,3,65,1
15286,354913,403_13_28,BELGIUM,0,TOTALS,BELGIUM,200,26,63,41.3,19,42,45.2,7,21,33.3,11,18,61.1,12,31,43,17,26,17,7,4,70,1
15287,354926,403_13_28,FINLAND,0,TOTALS,FINLAND,200,21,66,31.8,15,46,32.6,6,20,30.0,13,25,52.0,19,24,43,9,14,14,7,7,61,0
15288,354939,403_13_29,ROMANIA,0,TOTALS,ROMANIA,200,24,55,43.6,13,33,39.4,11,22,50.0,13,16,81.2,16,36,52,15,11,24,1,8,72,1
15289,354952,403_13_29,LUXEMBOURG,0,TOTALS,LUXEMBOURG,200,28,77,36.4,19,51,37.3,9,26,34.6,4,5,80.0,12,17,29,13,13,6,9,1,69,0
15290,354965,403_13_30,NETHERLANDS,0,TOTALS,NETHERLANDS,200,23,67,34.3,15,37,40.5,8,30,26.7,11,14,78.6,13,30,43,12,13,18,9,2,65,0
15291,354978,403_13_30,SWITZERLAND,0,TOTALS,SWITZERLAND,200,30,63,47.6,22,43,51.2,8,20,40.0,6,9,66.7,4,29,33,14,15,14,13,6,74,1
15292,354991,403_13_31,GREAT BRITAIN,0,TOTALS,GREAT BRITAIN,200,41,75,54.7,32,51,62.7,9,24,37.5,4,8,50.0,16,28,44,17,15,13,13,3,95,1
15293,355004,403_13_31,NETHERLANDS,0,TOTALS,NETHERLANDS,200,23,65,35.4,18,48,37.5,5,17,29.4,6,9,66.7,14,20,34,10,12,22,6,1,57,0
15294,355017,403_13_32,POLAND,0,TOTALS,POLAND,200,34,64,53.1,29,52,55.8,5,12,41.7,9,13,69.2,14,30,44,19,19,15,10,3,82,1
15295,355030,403_13_32,PORTUGAL,0,TOTALS,PORTUGAL,200,23,60,38.3,18,41,43.9,5,19,26.3,6,12,50.0,8,20,28,9,17,16,7,1,57,0
15296,355043,403_13_33,LUXEMBOURG,0,TOTALS,LUXEMBOURG,200,20,51,39.2,16,37,43.2,4,14,28.6,19,27,70.4,8,27,35,10,18,23,7,1,63,0
15297,355056,403_13_33,CYPRUS,0,TOTALS,CYPRUS,200,26,70,37.1,23,46,50.0,3,24,12.5,9,14,64.3,17,26,43,10,18,21,7,1,64,1
15298,355069,403_13_34,BELGIUM,0,TOTALS,BELGIUM,200,28,69,40.6,22,46,47.8,6,23,26.1,10,16,62.5,15,26,41,12,13,12,7,7,72,1
15299,355082,403_13_34,ROMANIA,0,TOTALS,ROMANIA,200,27,68,39.7,23,56,41.1,4,12,33.3,10,14,71.4,15,27,42,9,18,11,4,3,68,0
15300,355095,403_13_35,SLOVAK REPUBLIC,0,TOTALS,SLOVAK REPUBLIC,200,25,64,39.1,22,46,47.8,3,18,16.7,22,35,62.9,21,26,47,17,22,15,6,3,75,1
15301,355108,403_13_35,FINLAND,0,TOTALS,FINLAND,200,29,75,38.7,28,55,50.9,1,20,5.0,8,16,50.0,22,26,48,8,24,16,8,6,67,0
15302,355121,403_13_36,SWITZERLAND,0,TOTALS,SWITZERLAND,200,25,73,34.2,18,44,40.9,7,29,24.1,4,7,57.1,11,32,43,7,14,14,7,6,61,0
15303,355134,403_13_36,HUNGARY,0,TOTALS,HUNGARY,200,34,87,39.1,31,73,42.5,3,14,21.4,3,15,20.0,27,37,64,16,13,11,6,5,74,1
15304,355147,403_13_37,NETHERLANDS,0,TOTALS,NETHERLANDS,200,18,68,26.5,15,44,34.1,3,24,12.5,9,14,64.3,19,25,44,10,16,17,11,5,48,0
15305,355160,403_13_37,SWITZERLAND,0,TOTALS,SWITZERLAND,200,22,62,35.5,17,42,40.5,5,20,25.0,10,16,62.5,18,33,51,17,12,19,10,6,59,1
15306,355173,403_13_38,ROMANIA,0,TOTALS,ROMANIA,200,19,54,35.2,13,40,32.5,6,14,42.9,15,24,62.5,15,26,41,10,22,19,3,0,59,0
15307,355186,403_13_38,PORTUGAL,0,TOTALS,PORTUGAL,200,29,63,46.0,22,38,57.9,7,25,28.0,15,26,57.7,11,23,34,13,22,6,7,0,80,1
15308,355199,403_13_39,FINLAND,0,TOTALS,FINLAND,200,42,74,56.8,26,38,68.4,16,36,44.4,12,20,60.0,20,30,50,21,11,18,9,8,112,0
15309,355212,403_13_39,LUXEMBOURG,0,TOTALS,LUXEMBOURG,200,22,61,36.1,18,47,38.3,4,14,28.6,4,7,57.1,10,13,23,8,19,25,8,3,52,1
15310,355225,403_13_40,GREAT BRITAIN,0,TOTALS,GREAT BRITAIN,200,24,68,35.3,17,43,39.5,7,25,28.0,15,22,68.2,16,33,49,8,13,13,7,6,70,1
15311,355238,403_13_40,HUNGARY,0,TOTALS,HUNGARY,200,26,74,35.1,22,55,40.0,4,19,21.1,5,11,45.5,18,28,46,9,14,12,6,4,61,0
15312,355251,403_13_41,CYPRUS,0,TOTALS,CYPRUS,200,22,68,32.4,18,47,38.3,4,21,19.0,8,17,47.1,11,16,27,9,23,13,9,1,56,0
15313,355264,403_13_41,SLOVAK REPUBLIC,0,TOTALS,SLOVAK REPUBLIC,200,28,47,59.6,17,28,60.7,11,19,57.9,18,25,72.0,6,39,45,24,19,21,3,4,85,1
15314,355277,403_13_42,BELGIUM,0,TOTALS,BELGIUM,200,17,60,28.3,12,40,30.0,5,20,25.0,7,14,50.0,13,25,38,9,12,14,9,4,46,0
15315,355290,403_13_42,POLAND,0,TOTALS,POLAND,200,22,62,35.5,17,47,36.2,5,15,33.3,8,8,100.0,14,31,45,11,13,13,10,4,57,1
15316,355303,403_13_43,LUXEMBOURG,0,TOTALS,LUXEMBOURG,200,26,66,39.4,19,43,44.2,7,23,30.4,8,10,80.0,9,24,33,16,8,10,9,5,67,0
15317,355316,403_13_43,SLOVAK REPUBLIC,0,TOTALS,SLOVAK REPUBLIC,200,29,72,40.3,23,46,50.0,6,26,23.1,4,5,80.0,16,29,45,15,12,12,6,1,68,1
15318,355329,403_13_44,SWITZERLAND,0,TOTALS,SWITZERLAND,200,26,62,41.9,20,40,50.0,6,22,27.3,10,16,62.5,12,25,37,11,18,19,6,2,68,0
15319,355342,403_13_44,PORTUGAL,0,TOTALS,PORTUGAL,200,24,58,41.4,14,37,37.8,10,21,47.6,16,22,72.7,11,29,40,18,21,16,7,2,74,1
15320,355355,403_13_45,FINLAND,0,TOTALS,FINLAND,200,27,64,42.2,23,43,53.5,4,21,19.0,8,10,80.0,18,21,39,11,16,12,7,9,66,1
15321,355368,403_13_45,CYPRUS,0,TOTALS,CYPRUS,200,20,62,32.3,14,40,35.0,6,22,27.3,11,17,64.7,21,19,40,10,14,16,9,1,57,0
15322,355381,403_13_46,HUNGARY,0,TOTALS,HUNGARY,200,29,62,46.8,22,42,52.4,7,20,35.0,5,7,71.4,7,33,40,18,20,14,3,4,70,1
15323,355394,403_13_46,BELGIUM,0,TOTALS,BELGIUM,200,24,66,36.4,18,43,41.9,6,23,26.1,15,22,68.2,12,25,37,18,15,8,9,3,69,0
15324,355407,403_13_47,NETHERLANDS,0,TOTALS,NETHERLANDS,200,23,68,33.8,16,39,41.0,7,29,24.1,9,11,81.8,13,25,38,12,17,14,9,2,62,0
15325,355420,403_13_47,ROMANIA,0,TOTALS,ROMANIA,200,24,57,42.1,15,38,39.5,9,19,47.4,14,21,66.7,12,33,45,15,13,17,10,5,71,1
15326,355433,403_13_48,GREAT BRITAIN,0,TOTALS,GREAT BRITAIN,200,24,76,31.6,18,55,32.7,6,21,28.6,17,19,89.5,17,31,48,7,22,13,5,1,71,0
15327,355446,403_13_48,POLAND,0,TOTALS,POLAND,200,33,69,47.8,24,42,57.1,9,27,33.3,8,23,34.8,12,36,48,16,21,10,8,3,83,1
15328,358259,406_13_01,LITHUANIA,0,TOTALS,LITHUANIA,200,20,56,35.7,15,33,45.5,5,23,21.7,13,23,56.5,12,27,39,16,18,20,8,1,58,0
15329,358272,406_13_01,FRANCE,0,TOTALS,FRANCE,200,26,68,38.2,16,43,37.2,10,25,40.0,5,13,38.5,17,30,47,16,20,16,11,1,67,1
15330,358285,406_13_02,UKRAINE,0,TOTALS,UKRAINE,200,18,64,28.1,17,46,37.0,1,18,5.6,12,19,63.2,10,23,33,3,20,21,12,1,49,0
15331,358298,406_13_02,CROATIA,0,TOTALS,CROATIA,200,31,68,45.6,27,53,50.9,4,15,26.7,15,25,60.0,18,40,58,13,20,21,10,3,81,1
15332,358311,406_13_03,SERBIA,0,TOTALS,SERBIA,200,34,62,54.8,29,50,58.0,5,12,41.7,15,24,62.5,16,38,54,23,17,26,13,8,88,1
15333,358324,406_13_03,SLOVENIA,0,TOTALS,SLOVENIA,200,23,73,31.5,19,55,34.5,4,18,22.2,6,13,46.2,14,17,31,14,20,18,12,6,56,0
15334,358337,406_13_04,ITALY,0,TOTALS,ITALY,200,26,70,37.1,21,47,44.7,5,23,21.7,4,7,57.1,18,15,33,5,21,14,4,1,61,0
15335,358350,406_13_04,SPAIN,0,TOTALS,SPAIN,200,34,59,57.6,28,44,63.6,6,15,40.0,14,23,60.9,10,29,39,19,15,12,7,2,88,1
15336,358363,406_13_05,GREECE,0,TOTALS,GREECE,200,24,57,42.1,16,33,48.5,8,24,33.3,11,16,68.8,8,31,39,11,17,16,5,9,67,0
15337,358376,406_13_05,CZECH REPUBLIC,0,TOTALS,CZECH REPUBLIC,200,25,78,32.1,14,50,28.0,11,28,39.3,7,10,70.0,22,28,50,13,16,10,9,2,68,1
15338,358389,406_13_06,LATVIA,0,TOTALS,LATVIA,200,37,86,43.0,30,55,54.5,7,31,22.6,4,6,66.7,26,32,58,19,12,12,7,10,85,1
15339,358402,406_13_06,BULGARIA,0,TOTALS,BULGARIA,200,23,65,35.4,19,44,43.2,4,21,19.0,7,11,63.6,11,25,36,9,9,18,3,3,57,0
15340,358415,406_13_07,RUSSIA,0,TOTALS,RUSSIA,200,23,56,41.1,19,36,52.8,4,20,20.0,18,27,66.7,13,29,42,13,21,16,8,2,68,1
15341,358427,406_13_07,BOSNIA AND HERZEGOVINA,0,TOTALS,BOSNIA AND HERZEGOVINA,200,18,66,27.3,15,45,33.3,3,21,14.3,16,23,69.6,20,23,43,6,24,14,7,2,55,0
15342,358440,406_13_08,TURKEY,0,TOTALS,TURKEY,200,26,78,33.3,20,55,36.4,6,23,26.1,18,27,66.7,25,28,53,17,23,14,15,3,76,1
15343,358453,406_13_08,ENGLAND,0,TOTALS,ENGLAND,200,20,57,35.1,17,40,42.5,3,17,17.6,15,26,57.7,14,30,44,9,27,22,7,4,58,0
15344,358466,406_13_09,SLOVENIA,0,TOTALS,SLOVENIA,200,23,54,42.6,14,36,38.9,9,18,50.0,14,21,66.7,9,19,28,17,18,15,10,3,69,0
15345,358479,406_13_09,LITHUANIA,0,TOTALS,LITHUANIA,200,27,64,42.2,19,42,45.2,8,22,36.4,12,16,75.0,19,27,46,12,22,17,7,2,74,1
15346,358492,406_13_10,BULGARIA,0,TOTALS,BULGARIA,200,17,49,34.7,12,37,32.4,5,12,41.7,9,15,60.0,7,24,31,10,22,26,2,1,48,0
15347,358505,406_13_10,ITALY,0,TOTALS,ITALY,200,38,73,52.1,27,44,61.4,11,29,37.9,10,13,76.9,11,28,39,29,18,11,15,5,97,1
15348,358518,406_13_11,FRANCE,0,TOTALS,FRANCE,200,24,53,45.3,17,33,51.5,7,20,35.0,10,14,71.4,5,25,30,15,15,9,7,5,65,1
15349,358531,406_13_11,SERBIA,0,TOTALS,SERBIA,200,20,58,34.5,12,39,30.8,8,19,42.1,14,15,93.3,14,26,40,15,16,13,2,3,62,0
15350,358544,406_13_12,ENGLAND,0,TOTALS,ENGLAND,200,37,65,56.9,28,46,60.9,9,19,47.4,10,16,62.5,8,27,35,21,20,14,10,8,93,1
15351,358557,406_13_12,UKRAINE,0,TOTALS,UKRAINE,200,28,70,40.0,19,44,43.2,9,26,34.6,16,22,72.7,18,24,42,15,16,14,5,3,81,0
15352,358569,406_13_13,BOSNIA AND HERZEGOVINA,0,TOTALS,BOSNIA AND HERZEGOVINA,200,20,57,35.1,14,38,36.8,6,19,31.6,6,15,40.0,9,26,35,13,21,11,5,3,52,1
15353,358582,406_13_13,GREECE,0,TOTALS,GREECE,200,18,52,34.6,16,36,44.4,2,16,12.5,13,18,72.2,8,33,41,8,18,16,4,1,51,0
15354,358595,406_13_14,SPAIN,0,TOTALS,SPAIN,200,21,71,29.6,14,46,30.4,7,25,28.0,12,15,80.0,11,28,39,10,20,10,9,1,61,0
15355,358608,406_13_14,LATVIA,0,TOTALS,LATVIA,200,22,61,36.1,16,35,45.7,6,26,23.1,16,20,80.0,12,41,53,14,18,13,5,8,66,1
15356,358621,406_13_15,CZECH REPUBLIC,0,TOTALS,CZECH REPUBLIC,200,27,66,40.9,22,50,44.0,5,16,31.2,10,13,76.9,14,25,39,17,17,12,7,1,69,0
15357,358634,406_13_15,RUSSIA,0,TOTALS,RUSSIA,200,29,67,43.3,22,46,47.8,7,21,33.3,6,15,40.0,17,25,42,8,15,12,8,0,71,1
15358,358647,406_13_16,CROATIA,0,TOTALS,CROATIA,200,29,64,45.3,23,44,52.3,6,20,30.0,12,17,70.6,12,24,36,13,21,16,5,0,76,0
15359,358660,406_13_16,TURKEY,0,TOTALS,TURKEY,200,32,69,46.4,27,49,55.1,5,20,25.0,15,18,83.3,13,23,36,15,18,10,9,4,84,1
15360,358673,406_13_17,SLOVENIA,0,TOTALS,SLOVENIA,200,21,58,36.2,15,38,39.5,6,20,30.0,3,7,42.9,9,22,31,13,19,16,9,1,51,0
15361,358686,406_13_17,FRANCE,0,TOTALS,FRANCE,200,23,58,39.7,17,38,44.7,6,20,30.0,14,25,56.0,18,31,49,12,11,18,8,2,66,1
15362,358699,406_13_18,BULGARIA,0,TOTALS,BULGARIA,200,21,55,38.2,17,38,44.7,4,17,23.5,11,14,78.6,12,24,36,11,17,25,9,0,57,0
15363,358712,406_13_18,SPAIN,0,TOTALS,SPAIN,200,28,63,44.4,24,45,53.3,4,18,22.2,9,12,75.0,12,22,34,16,16,16,19,3,69,1
15364,358725,406_13_19,GREECE,0,TOTALS,GREECE,200,23,54,42.6,21,44,47.7,2,10,20.0,26,31,83.9,13,27,40,11,22,22,10,2,74,1
15365,358738,406_13_19,RUSSIA,0,TOTALS,RUSSIA,200,23,58,39.7,15,31,48.4,8,27,29.6,16,21,76.2,11,21,32,11,26,17,8,4,70,0
15366,358751,406_13_20,UKRAINE,0,TOTALS,UKRAINE,225,33,87,37.9,31,66,47.0,2,21,9.5,21,30,70.0,29,26,55,14,22,14,9,1,89,1
15367,358764,406_13_20,TURKEY,0,TOTALS,TURKEY,225,32,64,50.0,26,38,68.4,6,26,23.1,18,26,69.2,6,31,37,20,27,16,9,9,88,0
15368,358777,406_13_21,LITHUANIA,0,TOTALS,LITHUANIA,225,26,64,40.6,21,40,52.5,5,24,20.8,17,29,58.6,12,35,47,18,24,13,4,2,74,1
15369,358790,406_13_21,SERBIA,0,TOTALS,SERBIA,225,24,73,32.9,22,60,36.7,2,13,15.4,20,28,71.4,16,31,47,9,26,12,4,3,70,0
15370,358803,406_13_22,ITALY,0,TOTALS,ITALY,200,25,58,43.1,19,42,45.2,6,16,37.5,14,17,82.4,8,29,37,6,21,12,3,4,70,1
15371,358816,406_13_22,LATVIA,0,TOTALS,LATVIA,200,23,67,34.3,17,44,38.6,6,23,26.1,17,19,89.5,16,26,42,12,20,11,5,5,69,0
15372,358829,406_13_23,ENGLAND,0,TOTALS,ENGLAND,200,20,59,33.9,17,45,37.8,3,14,21.4,22,31,71.0,13,19,32,9,21,19,10,8,65,0
15373,358842,406_13_23,CROATIA,0,TOTALS,CROATIA,200,34,71,47.9,28,51,54.9,6,20,30.0,15,19,78.9,17,29,46,20,29,18,10,2,89,1
15374,358854,406_13_24,BOSNIA AND HERZEGOVINA,0,TOTALS,BOSNIA AND HERZEGOVINA,200,24,65,36.9,16,30,53.3,8,35,22.9,9,13,69.2,20,32,52,15,22,20,4,3,65,0
15375,358867,406_13_24,CZECH REPUBLIC,0,TOTALS,CZECH REPUBLIC,200,24,68,35.3,20,48,41.7,4,20,20.0,17,19,89.5,14,22,36,8,11,8,8,2,69,1
15376,358880,406_13_25,ITALY,0,TOTALS,ITALY,200,24,65,36.9,13,40,32.5,11,25,44.0,9,19,47.4,16,23,39,9,21,11,4,2,68,0
15377,358893,406_13_25,TURKEY,0,TOTALS,TURKEY,200,27,58,46.6,22,39,56.4,5,19,26.3,16,22,72.7,9,30,39,18,21,10,6,8,75,1
15378,358906,406_13_26,CZECH REPUBLIC,0,TOTALS,CZECH REPUBLIC,200,21,53,39.6,17,37,45.9,4,16,25.0,11,16,68.8,6,24,30,11,13,19,1,2,57,0
15379,358919,406_13_26,LITHUANIA,0,TOTALS,LITHUANIA,200,35,78,44.9,18,36,50.0,17,42,40.5,9,12,75.0,21,29,50,16,21,10,7,1,96,1
15380,358932,406_13_27,SLOVENIA,0,TOTALS,SLOVENIA,200,21,65,32.3,14,37,37.8,7,28,25.0,11,15,73.3,14,17,31,11,19,15,11,4,60,0
15381,358945,406_13_27,UKRAINE,0,TOTALS,UKRAINE,200,25,59,42.4,22,45,48.9,3,14,21.4,12,20,60.0,20,30,50,9,18,25,8,3,65,1
15382,358958,406_13_28,CROATIA,0,TOTALS,CROATIA,200,22,61,36.1,19,44,43.2,3,17,17.6,18,24,75.0,9,25,34,15,20,11,8,4,65,0
15383,358971,406_13_28,LATVIA,0,TOTALS,LATVIA,200,26,69,37.7,15,39,38.5,11,30,36.7,9,18,50.0,20,32,52,17,24,16,4,3,72,1
15384,358983,406_13_29,BOSNIA AND HERZEGOVINA,0,TOTALS,BOSNIA AND HERZEGOVINA,200,19,48,39.6,16,34,47.1,3,14,21.4,1,5,20.0,8,23,31,5,15,25,6,3,42,0
15385,358996,406_13_29,FRANCE,0,TOTALS,FRANCE,200,26,63,41.3,21,41,51.2,5,22,22.7,3,3,100.0,13,23,36,11,12,17,12,2,60,1
15386,359009,406_13_30,GREECE,0,TOTALS,GREECE,200,35,61,57.4,25,38,65.8,10,23,43.5,8,14,57.1,11,30,41,22,21,16,10,3,88,1
15387,359022,406_13_30,BULGARIA,0,TOTALS,BULGARIA,200,20,56,35.7,12,33,36.4,8,23,34.8,17,27,63.0,11,18,29,11,19,14,3,0,65,0
15388,359035,406_13_31,ENGLAND,0,TOTALS,ENGLAND,225,29,72,40.3,21,56,37.5,8,16,50.0,9,11,81.8,18,30,48,15,20,17,8,2,75,1
15389,359048,406_13_31,SPAIN,0,TOTALS,SPAIN,225,23,66,34.8,18,41,43.9,5,25,20.0,15,25,60.0,20,26,46,9,16,21,9,7,66,0
15390,359061,406_13_32,SERBIA,0,TOTALS,SERBIA,200,35,70,50.0,30,56,53.6,5,14,35.7,27,38,71.1,18,37,55,19,17,9,9,3,102,0
15391,359074,406_13_32,RUSSIA,0,TOTALS,RUSSIA,200,21,68,30.9,16,43,37.2,5,25,20.0,10,15,66.7,11,24,35,8,30,14,5,4,57,1
15392,359087,406_13_33,SPAIN,0,TOTALS,SPAIN,200,22,66,33.3,18,41,43.9,4,25,16.0,16,21,76.2,14,21,35,9,19,14,10,2,64,1
15393,359100,406_13_33,CROATIA,0,TOTALS,CROATIA,200,24,57,42.1,19,38,50.0,5,19,26.3,10,13,76.9,11,33,44,9,22,23,8,3,63,0
15394,359112,406_13_34,BOSNIA AND HERZEGOVINA,0,TOTALS,BOSNIA AND HERZEGOVINA,200,21,61,34.4,19,46,41.3,2,15,13.3,7,14,50.0,9,29,38,6,22,17,6,2,51,0
15395,359125,406_13_34,SERBIA,0,TOTALS,SERBIA,200,26,66,39.4,18,40,45.0,8,26,30.8,17,26,65.4,15,34,49,13,16,12,10,1,77,1
15396,359138,406_13_35,BULGARIA,0,TOTALS,BULGARIA,200,27,61,44.3,18,38,47.4,9,23,39.1,14,19,73.7,10,24,34,9,17,13,8,3,77,0
15397,359151,406_13_35,SLOVENIA,0,TOTALS,SLOVENIA,200,33,71,46.5,22,40,55.0,11,31,35.5,8,14,57.1,15,27,42,24,20,12,10,0,85,1
15398,359164,406_13_36,LATVIA,0,TOTALS,LATVIA,200,26,68,38.2,23,50,46.0,3,18,16.7,7,11,63.6,14,32,46,11,20,17,7,8,62,0
15399,359177,406_13_36,TURKEY,0,TOTALS,TURKEY,200,23,73,31.5,19,58,32.8,4,15,26.7,14,17,82.4,20,28,48,9,14,16,9,5,64,1
15400,359190,406_13_37,FRANCE,0,TOTALS,FRANCE,200,26,55,47.3,19,37,51.4,7,18,38.9,12,22,54.5,10,28,38,12,17,21,14,1,71,0
15401,359203,406_13_37,CZECH REPUBLIC,0,TOTALS,CZECH REPUBLIC,200,25,60,41.7,18,40,45.0,7,20,35.0,16,18,88.9,9,24,33,12,19,17,6,1,73,1
15402,359216,406_13_38,UKRAINE,0,TOTALS,UKRAINE,200,18,66,27.3,13,40,32.5,5,26,19.2,10,17,58.8,17,22,39,7,18,12,5,2,51,0
15403,359229,406_13_38,GREECE,0,TOTALS,GREECE,200,27,58,46.6,20,41,48.8,7,17,41.2,15,21,71.4,11,37,48,17,22,12,7,3,76,1
15404,359242,406_13_39,ENGLAND,0,TOTALS,ENGLAND,200,15,58,25.9,13,47,27.7,2,11,18.2,5,12,41.7,16,28,44,3,14,21,6,3,37,0
15405,359255,406_13_39,ITALY,0,TOTALS,ITALY,200,24,68,35.3,18,34,52.9,6,34,17.6,3,5,60.0,17,31,48,8,18,13,10,2,57,1
15406,359268,406_13_40,LITHUANIA,0,TOTALS,LITHUANIA,200,22,60,36.7,16,45,35.6,6,15,40.0,9,15,60.0,14,24,38,11,20,16,2,0,59,0
15407,359281,406_13_40,RUSSIA,0,TOTALS,RUSSIA,200,28,58,48.3,25,42,59.5,3,16,18.8,9,18,50.0,12,25,37,10,16,14,8,5,68,1
15408,359294,406_13_41,TURKEY,0,TOTALS,TURKEY,200,27,63,42.9,17,39,43.6,10,24,41.7,4,4,100.0,9,20,29,19,18,14,7,7,68,0
15409,359307,406_13_41,SPAIN,0,TOTALS,SPAIN,200,31,61,50.8,27,50,54.0,4,11,36.4,10,15,66.7,13,25,38,14,12,15,7,2,76,1
15410,359320,406_13_42,CZECH REPUBLIC,0,TOTALS,CZECH REPUBLIC,200,28,60,46.7,20,38,52.6,8,22,36.4,6,10,60.0,7,24,31,15,20,17,6,2,70,0
15411,359333,406_13_42,SERBIA,0,TOTALS,SERBIA,200,37,79,46.8,26,49,53.1,11,30,36.7,14,18,77.8,20,27,47,21,17,7,10,1,99,1
15412,359346,406_13_43,SLOVENIA,0,TOTALS,SLOVENIA,200,23,58,39.7,16,38,42.1,7,20,35.0,9,16,56.2,12,11,23,14,20,11,11,2,62,0
15413,359359,406_13_43,GREECE,0,TOTALS,GREECE,200,29,55,52.7,23,37,62.2,6,18,33.3,12,15,80.0,16,27,43,19,15,19,3,0,76,1
15414,359372,406_13_44,LATVIA,0,TOTALS,LATVIA,200,25,68,36.8,19,43,44.2,6,25,24.0,12,17,70.6,17,32,49,13,24,13,8,5,68,1
15415,359385,406_13_44,ENGLAND,0,TOTALS,ENGLAND,200,19,57,33.3,14,41,34.1,5,16,31.2,13,23,56.5,11,30,41,6,20,15,10,7,56,0
15416,359398,406_13_45,LITHUANIA,0,TOTALS,LITHUANIA,200,29,58,50.0,19,35,54.3,10,23,43.5,10,21,47.6,11,23,34,18,17,15,12,4,78,1
15417,359410,406_13_45,BOSNIA AND HERZEGOVINA,0,TOTALS,BOSNIA AND HERZEGOVINA,200,21,52,40.4,15,39,38.5,6,13,46.2,12,17,70.6,10,22,32,15,18,22,11,1,60,0
15418,359423,406_13_46,BULGARIA,0,TOTALS,BULGARIA,200,18,50,36.0,13,31,41.9,5,19,26.3,15,17,88.2,6,33,39,7,20,17,5,1,56,0
15419,359436,406_13_46,UKRAINE,0,TOTALS,UKRAINE,200,25,70,35.7,17,35,48.6,8,35,22.9,8,13,61.5,14,27,41,16,19,7,7,5,66,1
15420,359449,406_13_47,CROATIA,0,TOTALS,CROATIA,200,29,61,47.5,20,41,48.8,9,20,45.0,25,32,78.1,13,39,52,17,24,18,4,4,92,1
15421,359462,406_13_47,ITALY,0,TOTALS,ITALY,200,25,74,33.8,14,40,35.0,11,34,32.4,17,24,70.8,13,23,36,7,27,9,7,5,78,0
15422,359475,406_13_48,RUSSIA,0,TOTALS,RUSSIA,200,18,47,38.3,13,24,54.2,5,23,21.7,29,35,82.9,12,20,32,7,15,13,10,1,70,1
15423,359488,406_13_48,FRANCE,0,TOTALS,FRANCE,200,22,56,39.3,16,34,47.1,6,22,27.3,10,14,71.4,17,18,35,12,25,18,6,2,60,0
15424,359501,406_13_49,RUSSIA,0,TOTALS,RUSSIA,200,25,66,37.9,20,45,44.4,5,21,23.8,17,21,81.0,13,24,37,8,21,14,7,1,72,0
15425,359514,406_13_49,CROATIA,0,TOTALS,CROATIA,200,31,69,44.9,27,49,55.1,4,20,20.0,16,23,69.6,15,31,46,20,21,13,7,4,82,1
15426,359527,406_13_50,ITALY,0,TOTALS,ITALY,200,25,70,35.7,15,33,45.5,10,37,27.0,7,14,50.0,16,27,43,8,17,13,12,3,67,1
15427,359540,406_13_50,BULGARIA,0,TOTALS,BULGARIA,200,21,55,38.2,17,40,42.5,4,15,26.7,11,14,78.6,9,30,39,11,16,24,6,4,57,0
15428,359553,406_13_51,CZECH REPUBLIC,0,TOTALS,CZECH REPUBLIC,200,32,67,47.8,25,53,47.2,7,14,50.0,16,23,69.6,14,34,48,15,15,16,6,5,87,1
15429,359566,406_13_51,SLOVENIA,0,TOTALS,SLOVENIA,200,31,70,44.3,21,38,55.3,10,32,31.2,7,11,63.6,6,22,28,15,23,9,9,2,79,0
15430,359579,406_13_52,TURKEY,0,TOTALS,TURKEY,200,29,68,42.6,23,55,41.8,6,13,46.2,7,14,50.0,12,34,46,12,27,14,8,9,71,1
15431,359592,406_13_52,SERBIA,0,TOTALS,SERBIA,200,26,71,36.6,22,57,38.6,4,14,28.6,11,24,45.8,17,28,45,13,18,11,5,3,67,0
15432,359605,406_13_53,ENGLAND,0,TOTALS,ENGLAND,200,29,70,41.4,27,55,49.1,2,15,13.3,11,17,64.7,17,27,44,15,16,15,12,4,71,1
15433,359618,406_13_53,UKRAINE,0,TOTALS,UKRAINE,200,20,58,34.5,13,38,34.2,7,20,35.0,11,17,64.7,12,28,40,10,14,22,3,5,58,0
15434,359631,406_13_54,LATVIA,0,TOTALS,LATVIA,200,29,67,43.3,26,51,51.0,3,16,18.8,10,15,66.7,17,23,40,15,22,11,10,9,71,1
15435,359644,406_13_54,LITHUANIA,0,TOTALS,LITHUANIA,200,20,54,37.0,17,41,41.5,3,13,23.1,11,17,64.7,12,22,34,13,17,19,7,3,54,0
15436,359656,406_13_55,BOSNIA AND HERZEGOVINA,0,TOTALS,BOSNIA AND HERZEGOVINA,200,14,49,28.6,14,32,43.8,0,17,0.0,8,16,50.0,11,25,36,6,22,22,6,2,36,0
15437,359669,406_13_55,GREECE,0,TOTALS,GREECE,200,26,57,45.6,24,45,53.3,2,12,16.7,9,16,56.2,12,28,40,10,18,17,13,2,63,1
15438,359682,406_13_56,FRANCE,0,TOTALS,FRANCE,200,22,67,32.8,17,36,47.2,5,31,16.1,10,13,76.9,17,28,45,13,21,17,7,1,59,0
15439,359695,406_13_56,SPAIN,0,TOTALS,SPAIN,200,24,56,42.9,15,33,45.5,9,23,39.1,11,20,55.0,8,26,34,13,17,12,9,3,68,1
15440,359708,406_13_57,BULGARIA,0,TOTALS,BULGARIA,200,19,54,35.2,15,37,40.5,4,17,23.5,15,18,83.3,13,19,32,10,13,18,9,3,57,0
15441,359720,406_13_57,BOSNIA AND HERZEGOVINA,0,TOTALS,BOSNIA AND HERZEGOVINA,200,30,68,44.1,21,42,50.0,9,26,34.6,3,7,42.9,21,21,42,20,20,20,10,1,72,1
15442,359733,406_13_58,RUSSIA,0,TOTALS,RUSSIA,200,30,67,44.8,25,49,51.0,5,18,27.8,12,21,57.1,15,24,39,16,28,16,9,0,77,0
15443,359746,406_13_58,LITHUANIA,0,TOTALS,LITHUANIA,200,30,66,45.5,25,43,58.1,5,23,21.7,19,29,65.5,17,25,42,11,21,13,4,3,84,1
15444,359759,406_13_59,SLOVENIA,0,TOTALS,SLOVENIA,200,25,69,36.2,20,46,43.5,5,23,21.7,8,12,66.7,15,21,36,14,22,15,14,2,63,0
15445,359772,406_13_59,UKRAINE,0,TOTALS,UKRAINE,200,25,61,41.0,21,35,60.0,4,26,15.4,14,22,63.6,15,29,44,16,15,25,9,4,68,1
15446,359785,406_13_60,SERBIA,0,TOTALS,SERBIA,200,29,61,47.5,22,37,59.5,7,24,29.2,12,15,80.0,10,38,48,19,20,20,9,5,77,1
15447,359798,406_13_60,FRANCE,0,TOTALS,FRANCE,200,24,67,35.8,20,44,45.5,4,23,17.4,14,20,70.0,9,24,33,8,16,14,12,4,66,0
15448,359811,406_13_61,ITALY,0,TOTALS,ITALY,200,27,57,47.4,18,35,51.4,9,22,40.9,19,26,73.1,8,26,34,13,25,11,11,1,82,1
15449,359824,406_13_61,GREECE,0,TOTALS,GREECE,200,18,49,36.7,12,32,37.5,6,17,35.3,20,31,64.5,12,24,36,12,22,19,6,2,62,0
15450,359837,406_13_62,CROATIA,0,TOTALS,CROATIA,200,25,66,37.9,20,52,38.5,5,14,35.7,17,25,68.0,17,36,53,10,23,18,5,2,72,1
15451,359850,406_13_62,LATVIA,0,TOTALS,LATVIA,200,25,67,37.3,20,44,45.5,5,23,21.7,13,16,81.2,8,25,33,11,23,9,10,4,68,0
15452,359863,406_13_63,CZECH REPUBLIC,0,TOTALS,CZECH REPUBLIC,200,24,57,42.1,17,41,41.5,7,16,43.8,7,11,63.6,9,24,33,9,17,25,2,4,62,0
15453,359876,406_13_63,ENGLAND,0,TOTALS,ENGLAND,200,34,80,42.5,31,62,50.0,3,18,16.7,14,17,82.4,22,26,48,12,16,12,14,4,85,1
15454,359889,406_13_64,TURKEY,0,TOTALS,TURKEY,200,30,71,42.3,23,53,43.4,7,18,38.9,10,27,37.0,21,24,45,17,22,16,8,3,77,1
15455,359902,406_13_64,SPAIN,0,TOTALS,SPAIN,200,28,65,43.1,23,46,50.0,5,19,26.3,14,19,73.7,15,27,42,15,24,17,8,5,75,0
15456,359915,406_13_65,ITALY,0,TOTALS,ITALY,200,21,62,33.9,15,38,39.5,6,24,25.0,11,19,57.9,14,27,41,10,27,20,9,6,59,0
15457,359928,406_13_65,ENGLAND,0,TOTALS,ENGLAND,200,19,56,33.9,13,39,33.3,6,17,35.3,25,32,78.1,14,29,43,10,18,20,11,0,69,1
15458,359941,406_13_66,BULGARIA,0,TOTALS,BULGARIA,200,30,54,55.6,20,38,52.6,10,16,62.5,12,17,70.6,6,27,33,16,16,22,11,1,82,1
15459,359954,406_13_66,SLOVENIA,0,TOTALS,SLOVENIA,200,31,68,45.6,26,46,56.5,5,22,22.7,8,12,66.7,12,19,31,19,15,17,10,3,75,0
15460,359967,406_13_67,RUSSIA,0,TOTALS,RUSSIA,200,20,69,29.0,16,49,32.7,4,20,20.0,7,11,63.6,17,22,39,10,12,11,3,3,51,0
15461,359980,406_13_67,FRANCE,0,TOTALS,FRANCE,200,36,70,51.4,30,47,63.8,6,23,26.1,11,20,55.0,16,35,51,20,9,8,7,2,89,1
15462,359992,406_13_68,BOSNIA AND HERZEGOVINA,0,TOTALS,BOSNIA AND HERZEGOVINA,250,39,84,46.4,34,64,53.1,5,20,25.0,13,22,59.1,19,39,58,20,24,16,7,5,96,1
15463,360005,406_13_68,UKRAINE,0,TOTALS,UKRAINE,250,29,85,34.1,21,47,44.7,8,38,21.1,19,28,67.9,20,27,47,15,21,15,9,3,85,0
15464,360018,406_13_69,LITHUANIA,0,TOTALS,LITHUANIA,200,22,65,33.8,19,44,43.2,3,21,14.3,16,21,76.2,15,27,42,9,25,10,9,2,63,1
15465,360031,406_13_69,SERBIA,0,TOTALS,SERBIA,200,19,55,34.5,18,37,48.6,1,18,5.6,17,23,73.9,12,32,44,9,23,19,6,7,56,0
15466,360044,406_13_70,GREECE,0,TOTALS,GREECE,200,29,58,50.0,19,38,50.0,10,20,50.0,17,19,89.5,8,26,34,16,18,12,11,2,85,1
15467,360057,406_13_70,CZECH REPUBLIC,0,TOTALS,CZECH REPUBLIC,200,25,66,37.9,22,49,44.9,3,17,17.6,12,12,100.0,13,23,36,11,16,14,6,3,65,0
15468,360070,406_13_71,LATVIA,0,TOTALS,LATVIA,200,22,65,33.8,16,42,38.1,6,23,26.1,6,11,54.5,17,30,47,12,20,20,8,10,56,0
15469,360083,406_13_71,SPAIN,0,TOTALS,SPAIN,200,22,62,35.5,17,44,38.6,5,18,27.8,8,13,61.5,11,28,39,10,20,16,10,0,57,1
15470,360096,406_13_72,CROATIA,0,TOTALS,CROATIA,200,23,55,41.8,19,42,45.2,4,13,30.8,24,34,70.6,12,30,42,13,21,22,8,0,74,0
15471,360109,406_13_72,TURKEY,0,TOTALS,TURKEY,200,30,65,46.2,21,40,52.5,9,25,36.0,12,17,70.6,7,22,29,13,26,14,12,5,81,1
15472,360122,407_13_01,NORWAY,0,TOTALS,NORWAY,200,25,60,41.7,23,53,43.4,2,7,28.6,5,15,33.3,15,32,47,9,16,18,7,3,57,0
15473,360135,407_13_01,GERMANY,0,TOTALS,GERMANY,200,26,72,36.1,19,52,36.5,7,20,35.0,9,13,69.2,17,26,43,14,17,12,8,4,68,1
15474,360148,407_13_02,SCOTLAND,0,TOTALS,SCOTLAND,200,9,53,17.0,6,30,20.0,3,23,13.0,6,13,46.2,7,21,28,3,10,26,6,0,27,0
15475,360161,407_13_02,ISRAEL,0,TOTALS,ISRAEL,200,40,79,50.6,37,63,58.7,3,16,18.8,3,5,60.0,20,40,60,17,18,17,18,8,86,1
15476,360174,407_13_03,AUSTRIA,0,TOTALS,AUSTRIA,200,15,50,30.0,11,32,34.4,4,18,22.2,11,21,52.4,13,21,34,4,21,25,7,5,45,0
15477,360187,407_13_03,NETHERLANDS,0,TOTALS,NETHERLANDS,200,25,56,44.6,18,38,47.4,7,18,38.9,8,18,44.4,13,27,40,17,22,23,12,0,65,1
15478,360200,407_13_04,SLOVAK REPUBLIC,0,TOTALS,SLOVAK REPUBLIC,200,29,64,45.3,27,47,57.4,2,17,11.8,15,25,60.0,20,25,45,11,20,19,10,2,75,0
15479,360213,407_13_04,ROMANIA,0,TOTALS,ROMANIA,200,31,70,44.3,28,61,45.9,3,9,33.3,11,26,42.3,18,16,34,9,20,12,11,1,76,1
15480,360226,407_13_05,GEORGIA,0,TOTALS,GEORGIA,200,24,63,38.1,20,41,48.8,4,22,18.2,5,19,26.3,16,23,39,13,25,15,4,1,57,0
15481,360239,407_13_05,ESTONIA,0,TOTALS,ESTONIA,200,27,56,48.2,23,43,53.5,4,13,30.8,15,28,53.6,14,29,43,6,20,15,9,0,73,1
15482,360252,407_13_06,SWEDEN,0,TOTALS,SWEDEN,200,39,66,59.1,30,48,62.5,9,18,50.0,11,20,55.0,13,26,39,18,20,15,22,1,98,1
15483,360265,407_13_06,SWITZERLAND,0,TOTALS,SWITZERLAND,200,18,55,32.7,15,38,39.5,3,17,17.6,8,14,57.1,9,20,29,13,20,26,4,3,47,0
15484,360278,407_13_07,HUNGARY,0,TOTALS,HUNGARY,200,24,58,41.4,21,40,52.5,3,18,16.7,13,20,65.0,10,27,37,9,16,15,8,5,64,0
15485,360291,407_13_07,MKD,0,TOTALS,MKD,200,29,68,42.6,19,43,44.2,10,25,40.0,8,15,53.3,16,28,44,14,23,14,11,5,76,1
15486,360304,407_13_08,PORTUGAL,0,TOTALS,PORTUGAL,225,27,76,35.5,19,45,42.2,8,31,25.8,12,17,70.6,21,27,48,13,28,24,15,0,74,1
15487,360317,407_13_08,BELARUS,0,TOTALS,BELARUS,225,24,63,38.1,22,45,48.9,2,18,11.1,18,29,62.1,13,31,44,17,21,23,9,2,68,0
15488,360330,407_13_09,FINLAND,0,TOTALS,FINLAND,200,24,63,38.1,18,43,41.9,6,20,30.0,10,14,71.4,14,19,33,6,12,9,8,0,64,1
15489,360343,407_13_09,DENMARK,0,TOTALS,DENMARK,200,16,47,34.0,12,34,35.3,4,13,30.8,7,11,63.6,13,22,35,6,17,21,3,4,43,0
15490,360356,407_13_10,BELGIUM,0,TOTALS,BELGIUM,200,36,74,48.6,24,43,55.8,12,31,38.7,18,31,58.1,15,33,48,22,14,9,9,5,102,0
15491,360369,407_13_10,LUXEMBOURG,0,TOTALS,LUXEMBOURG,200,20,62,32.3,16,40,40.0,4,22,18.2,6,8,75.0,11,28,39,4,23,20,5,2,50,1
15492,360382,407_13_11,NETHERLANDS,0,TOTALS,NETHERLANDS,200,25,56,44.6,20,40,50.0,5,16,31.2,16,32,50.0,12,29,41,14,22,19,8,0,71,1
15493,360395,407_13_11,GEORGIA,0,TOTALS,GEORGIA,200,22,64,34.4,20,43,46.5,2,21,9.5,14,25,56.0,17,24,41,7,26,20,11,2,60,0
15494,360408,407_13_12,ROMANIA,0,TOTALS,ROMANIA,200,22,62,35.5,16,44,36.4,6,18,33.3,13,19,68.4,15,30,45,10,16,24,5,3,63,0
15495,360421,407_13_12,SWEDEN,0,TOTALS,SWEDEN,200,32,73,43.8,24,48,50.0,8,25,32.0,9,12,75.0,13,24,37,19,20,12,10,8,81,1
15496,360434,407_13_13,ESTONIA,0,TOTALS,ESTONIA,200,24,75,32.0,18,51,35.3,6,24,25.0,5,10,50.0,15,28,43,14,21,10,13,2,59,1
15497,360447,407_13_13,NORWAY,0,TOTALS,NORWAY,200,20,50,40.0,18,39,46.2,2,11,18.2,12,23,52.2,7,39,46,8,14,22,6,4,54,0
15498,360460,407_13_14,SWITZERLAND,0,TOTALS,SWITZERLAND,200,29,64,45.3,22,48,45.8,7,16,43.8,13,19,68.4,16,30,46,19,22,19,11,6,78,1
15499,360473,407_13_14,SCOTLAND,0,TOTALS,SCOTLAND,200,25,69,36.2,20,53,37.7,5,16,31.2,13,19,68.4,16,20,36,13,17,19,11,1,68,0
15500,360486,407_13_15,POLAND,0,TOTALS,POLAND,200,21,64,32.8,18,42,42.9,3,22,13.6,19,24,79.2,16,34,50,12,14,15,8,1,64,1
15501,360499,407_13_15,FINLAND,0,TOTALS,FINLAND,200,21,64,32.8,16,34,47.1,5,30,16.7,5,6,83.3,9,30,39,10,21,17,7,0,52,0
15502,360512,407_13_16,MONTENEGRO,0,TOTALS,MONTENEGRO,200,22,56,39.3,16,45,35.6,6,11,54.5,8,10,80.0,13,32,45,9,21,21,5,3,58,1
15503,360525,407_13_16,BELGIUM,0,TOTALS,BELGIUM,200,18,61,29.5,11,36,30.6,7,25,28.0,8,16,50.0,13,22,35,7,19,14,10,5,51,0
15504,360538,407_13_17,DENMARK,0,TOTALS,DENMARK,200,25,61,41.0,22,44,50.0,3,17,17.6,15,19,78.9,14,25,39,14,25,12,6,0,68,0
15505,360551,407_13_17,HUNGARY,0,TOTALS,HUNGARY,200,24,55,43.6,16,37,43.2,8,18,44.4,16,26,61.5,9,24,33,15,17,14,6,5,72,1
15506,360564,407_13_18,LUXEMBOURG,0,TOTALS,LUXEMBOURG,200,21,57,36.8,19,42,45.2,2,15,13.3,2,4,50.0,5,30,35,9,24,20,4,5,46,0
15507,360577,407_13_18,PORTUGAL,0,TOTALS,PORTUGAL,200,23,66,34.8,16,34,47.1,7,32,21.9,21,36,58.3,17,32,49,13,10,10,8,3,74,1
15508,360590,407_13_19,GERMANY,0,TOTALS,GERMANY,200,30,59,50.8,22,40,55.0,8,19,42.1,11,13,84.6,9,32,41,18,21,19,12,2,79,1
15509,360603,407_13_19,AUSTRIA,0,TOTALS,AUSTRIA,200,12,43,27.9,10,31,32.3,2,12,16.7,9,20,45.0,5,19,24,5,19,23,6,4,35,0
15510,360616,407_13_20,ISRAEL,0,TOTALS,ISRAEL,200,46,77,59.7,34,56,60.7,12,21,57.1,15,26,57.7,16,26,42,30,28,7,11,5,119,0
15511,360629,407_13_20,SLOVAK REPUBLIC,0,TOTALS,SLOVAK REPUBLIC,200,21,63,33.3,14,37,37.8,7,26,26.9,18,27,66.7,18,20,38,8,27,23,2,1,67,1
15512,360642,407_13_21,HUNGARY,0,TOTALS,HUNGARY,200,18,58,31.0,17,48,35.4,1,10,10.0,11,16,68.8,9,21,30,9,22,26,8,0,48,0
15513,360655,407_13_21,POLAND,0,TOTALS,POLAND,200,30,55,54.5,24,39,61.5,6,16,37.5,17,22,77.3,7,31,38,17,19,22,11,3,83,1
15514,360668,407_13_22,PORTUGAL,0,TOTALS,PORTUGAL,200,20,69,29.0,12,38,31.6,8,31,25.8,2,6,33.3,13,18,31,12,20,9,10,0,50,0
15515,360681,407_13_22,MONTENEGRO,0,TOTALS,MONTENEGRO,200,24,53,45.3,20,39,51.3,4,14,28.6,8,17,47.1,14,34,48,11,18,19,3,2,60,1
15516,360694,407_13_23,SWITZERLAND,0,TOTALS,SWITZERLAND,200,22,64,34.4,21,51,41.2,1,13,7.7,10,14,71.4,17,30,47,12,17,32,7,3,55,0
15517,360707,407_13_23,ISRAEL,0,TOTALS,ISRAEL,200,35,73,47.9,21,44,47.7,14,29,48.3,9,19,47.4,15,26,41,22,22,21,15,2,93,1
15518,360720,407_13_24,BELARUS,0,TOTALS,BELARUS,200,28,60,46.7,21,43,48.8,7,17,41.2,23,29,79.3,11,36,47,11,13,15,3,5,86,1
15519,360733,407_13_24,LUXEMBOURG,0,TOTALS,LUXEMBOURG,200,25,70,35.7,17,43,39.5,8,27,29.6,11,20,55.0,11,23,34,13,23,11,9,2,69,0
15520,360746,407_13_25,GEORGIA,0,TOTALS,GEORGIA,200,19,58,32.8,10,30,33.3,9,28,32.1,8,14,57.1,7,27,34,6,21,14,7,0,55,0
15521,360759,407_13_25,AUSTRIA,0,TOTALS,AUSTRIA,200,26,68,38.2,22,47,46.8,4,21,19.0,8,14,57.1,18,31,49,10,14,15,7,8,64,1
15522,360772,407_13_26,SWEDEN,0,TOTALS,SWEDEN,200,40,76,52.6,36,63,57.1,4,13,30.8,15,19,78.9,15,35,50,20,15,12,14,5,99,1
15523,360785,407_13_26,SLOVAK REPUBLIC,0,TOTALS,SLOVAK REPUBLIC,200,15,56,26.8,13,40,32.5,2,16,12.5,10,19,52.6,10,21,31,5,21,25,5,0,42,0
15524,360798,407_13_27,MKD,0,TOTALS,MKD,200,20,64,31.2,18,47,38.3,2,17,11.8,14,30,46.7,19,25,44,6,27,11,8,1,56,0
15525,360811,407_13_27,DENMARK,0,TOTALS,DENMARK,200,19,53,35.8,14,35,40.0,5,18,27.8,15,27,55.6,13,33,46,8,24,18,4,3,58,1
15526,360824,407_13_28,ESTONIA,0,TOTALS,ESTONIA,200,30,68,44.1,20,47,42.6,10,21,47.6,10,16,62.5,9,27,36,14,22,13,11,3,80,1
15527,360837,407_13_28,GERMANY,0,TOTALS,GERMANY,200,18,55,32.7,16,43,37.2,2,12,16.7,17,26,65.4,11,31,42,7,17,25,6,3,55,0
15528,360850,407_13_29,NORWAY,0,TOTALS,NORWAY,200,23,55,41.8,22,48,45.8,1,7,14.3,6,14,42.9,12,26,38,6,27,24,2,2,53,0
15529,360863,407_13_29,NETHERLANDS,0,TOTALS,NETHERLANDS,200,28,70,40.0,23,53,43.4,5,17,29.4,14,28,50.0,21,24,45,11,19,14,10,0,75,1
15530,360876,407_13_30,SCOTLAND,0,TOTALS,SCOTLAND,200,21,49,42.9,17,33,51.5,4,16,25.0,5,9,55.6,7,21,28,15,20,25,3,0,51,0
15531,360889,407_13_30,ROMANIA,0,TOTALS,ROMANIA,200,32,62,51.6,29,51,56.9,3,11,27.3,9,21,42.9,15,22,37,12,17,17,19,1,76,1
15532,360902,407_13_31,ISRAEL,0,TOTALS,ISRAEL,200,28,63,44.4,21,44,47.7,7,19,36.8,16,25,64.0,10,26,36,9,21,15,7,4,79,1
15533,360915,407_13_31,SWEDEN,0,TOTALS,SWEDEN,200,27,61,44.3,18,42,42.9,9,19,47.4,15,20,75.0,10,27,37,14,28,18,10,0,78,0
15534,360928,407_13_32,MONTENEGRO,0,TOTALS,MONTENEGRO,225,34,71,47.9,30,56,53.6,4,15,26.7,17,38,44.7,18,29,47,12,27,17,8,2,89,1
15535,360941,407_13_32,BELARUS,0,TOTALS,BELARUS,225,30,73,41.1,21,46,45.7,9,27,33.3,17,28,60.7,17,28,45,11,28,17,6,1,86,0
15536,360954,407_13_33,GERMANY,0,TOTALS,GERMANY,200,28,61,45.9,16,34,47.1,12,27,44.4,18,25,72.0,18,32,50,17,12,19,6,3,86,1
15537,360967,407_13_33,GEORGIA,0,TOTALS,GEORGIA,200,25,67,37.3,15,39,38.5,10,28,35.7,2,9,22.2,10,16,26,9,19,15,10,3,62,0
15538,360980,407_13_34,SLOVAK REPUBLIC,0,TOTALS,SLOVAK REPUBLIC,200,34,72,47.2,32,58,55.2,2,14,14.3,8,10,80.0,14,28,42,10,15,9,6,2,78,1
15539,360993,407_13_34,SCOTLAND,0,TOTALS,SCOTLAND,200,20,50,40.0,13,35,37.1,7,15,46.7,8,17,47.1,5,25,30,15,9,17,1,2,55,0
15540,361006,407_13_35,NETHERLANDS,0,TOTALS,NETHERLANDS,200,28,73,38.4,22,50,44.0,6,23,26.1,14,26,53.8,17,31,48,16,24,17,10,3,76,1
15541,361019,407_13_35,ESTONIA,0,TOTALS,ESTONIA,200,24,57,42.1,20,46,43.5,4,11,36.4,15,22,68.2,4,34,38,6,27,21,9,2,67,0
15542,361032,407_13_36,ROMANIA,0,TOTALS,ROMANIA,200,28,57,49.1,24,38,63.2,4,19,21.1,22,38,57.9,12,17,29,13,21,18,17,3,82,0
15543,361045,407_13_36,SWITZERLAND,0,TOTALS,SWITZERLAND,200,36,58,62.1,33,53,62.3,3,5,60.0,8,16,50.0,6,25,31,17,25,20,9,1,83,1
15544,361058,407_13_37,POLAND,0,TOTALS,POLAND,200,22,67,32.8,17,47,36.2,5,20,25.0,17,29,58.6,20,28,48,12,18,16,9,4,66,1
15545,361071,407_13_37,MKD,0,TOTALS,MKD,200,23,62,37.1,20,45,44.4,3,17,17.6,10,13,76.9,13,33,46,11,28,19,7,3,59,0
15546,361084,407_13_38,AUSTRIA,0,TOTALS,AUSTRIA,200,23,70,32.9,22,56,39.3,1,14,7.1,9,22,40.9,18,28,46,6,21,16,9,2,56,0
15547,361097,407_13_38,NORWAY,0,TOTALS,NORWAY,200,20,52,38.5,15,34,44.1,5,18,27.8,14,23,60.9,8,37,45,8,20,21,7,1,59,1
15548,361110,407_13_39,FINLAND,0,TOTALS,FINLAND,200,22,62,35.5,15,40,37.5,7,22,31.8,4,8,50.0,6,27,33,13,17,14,6,1,55,0
15549,361123,407_13_39,HUNGARY,0,TOTALS,HUNGARY,200,23,59,39.0,17,42,40.5,6,17,35.3,4,7,57.1,10,36,46,10,18,20,11,8,56,1
15550,361136,407_13_40,BELGIUM,0,TOTALS,BELGIUM,200,24,58,41.4,16,36,44.4,8,22,36.4,9,20,45.0,8,35,43,12,17,14,7,3,65,1
15551,361149,407_13_40,PORTUGAL,0,TOTALS,PORTUGAL,200,16,59,27.1,11,39,28.2,5,20,25.0,6,13,46.2,10,32,42,7,20,17,3,1,43,0
15552,361162,407_13_41,DENMARK,0,TOTALS,DENMARK,200,26,63,41.3,21,48,43.8,5,15,33.3,7,9,77.8,8,22,30,17,23,20,11,2,64,0
15553,361175,407_13_41,POLAND,0,TOTALS,POLAND,200,26,54,48.1,21,41,51.2,5,13,38.5,17,26,65.4,9,31,40,11,13,23,9,3,74,1
15554,361188,407_13_42,NETHERLANDS,0,TOTALS,NETHERLANDS,200,16,55,29.1,10,33,30.3,6,22,27.3,10,19,52.6,15,30,45,8,14,23,3,1,48,0
15555,361201,407_13_42,GERMANY,0,TOTALS,GERMANY,200,27,61,44.3,26,49,53.1,1,12,8.3,10,15,66.7,6,27,33,7,19,13,11,3,65,1
15556,361214,407_13_43,ESTONIA,0,TOTALS,ESTONIA,200,25,62,40.3,20,42,47.6,5,20,25.0,12,15,80.0,9,31,40,12,17,16,16,3,67,1
15557,361227,407_13_43,AUSTRIA,0,TOTALS,AUSTRIA,200,23,60,38.3,16,40,40.0,7,20,35.0,6,13,46.2,10,28,38,16,17,21,7,4,59,0
15558,361240,407_13_44,ROMANIA,0,TOTALS,ROMANIA,200,18,54,33.3,16,42,38.1,2,12,16.7,10,18,55.6,13,31,44,9,30,39,10,3,48,0
15559,361253,407_13_44,ISRAEL,0,TOTALS,ISRAEL,200,27,77,35.1,21,47,44.7,6,30,20.0,15,28,53.6,23,25,48,13,20,23,23,3,75,1
15560,361266,407_13_45,BELARUS,0,TOTALS,BELARUS,200,19,59,32.2,16,43,37.2,3,16,18.8,13,25,52.0,13,23,36,6,20,16,7,1,54,0
15561,361279,407_13_45,BELGIUM,0,TOTALS,BELGIUM,200,28,62,45.2,26,46,56.5,2,16,12.5,10,19,52.6,14,29,43,15,24,18,7,3,68,1
15562,361292,407_13_46,LUXEMBOURG,0,TOTALS,LUXEMBOURG,200,21,77,27.3,13,48,27.1,8,29,27.6,2,7,28.6,11,31,42,14,24,8,5,2,52,0
15563,361305,407_13_46,MONTENEGRO,0,TOTALS,MONTENEGRO,200,28,78,35.9,24,51,47.1,4,27,14.8,9,19,47.4,22,46,68,12,14,14,4,2,69,1
15564,361318,407_13_47,MKD,0,TOTALS,MKD,200,22,50,44.0,12,24,50.0,10,26,38.5,14,28,50.0,7,30,37,13,22,15,4,9,68,1
15565,361331,407_13_47,FINLAND,0,TOTALS,FINLAND,200,20,67,29.9,14,32,43.8,6,35,17.1,16,23,69.6,20,28,48,9,24,13,4,0,62,0
15566,361344,407_13_48,SCOTLAND,0,TOTALS,SCOTLAND,200,17,55,30.9,14,39,35.9,3,16,18.8,9,14,64.3,6,14,20,13,18,19,7,1,46,1
15567,361357,407_13_48,SWEDEN,0,TOTALS,SWEDEN,200,43,75,57.3,38,58,65.5,5,17,29.4,9,15,60.0,18,34,52,21,15,15,6,5,100,0
15568,361370,407_13_49,NORWAY,0,TOTALS,NORWAY,200,26,56,46.4,20,40,50.0,6,16,37.5,22,33,66.7,18,42,60,15,9,26,6,3,80,1
15569,361383,407_13_49,GEORGIA,0,TOTALS,GEORGIA,200,28,80,35.0,21,58,36.2,7,22,31.8,4,8,50.0,12,17,29,14,27,10,16,2,67,0
15570,361396,407_13_50,SWITZERLAND,0,TOTALS,SWITZERLAND,200,22,58,37.9,20,49,40.8,2,9,22.2,12,21,57.1,8,28,36,11,16,14,10,3,58,1
15571,361409,407_13_50,SLOVAK REPUBLIC,0,TOTALS,SLOVAK REPUBLIC,200,22,66,33.3,19,46,41.3,3,20,15.0,10,14,71.4,14,33,47,5,20,23,8,3,57,0
15572,361422,407_13_51,DENMARK,0,TOTALS,DENMARK,200,26,70,37.1,21,51,41.2,5,19,26.3,11,17,64.7,20,22,42,12,17,11,7,0,68,1
15573,361435,407_13_51,AUSTRIA,0,TOTALS,AUSTRIA,200,23,59,39.0,20,44,45.5,3,15,20.0,5,7,71.4,12,25,37,8,17,19,6,3,54,0
15574,361448,407_13_52,SCOTLAND,0,TOTALS,SCOTLAND,200,22,58,37.9,18,34,52.9,4,24,16.7,9,14,64.3,10,28,38,13,14,18,9,1,57,0
15575,361461,407_13_52,LUXEMBOURG,0,TOTALS,LUXEMBOURG,200,26,67,38.8,18,43,41.9,8,24,33.3,6,11,54.5,14,28,42,18,19,14,14,2,66,1
15576,361474,407_13_53,HUNGARY,0,TOTALS,HUNGARY,200,27,78,34.6,25,62,40.3,2,16,12.5,10,13,76.9,16,34,50,13,19,20,14,5,66,1
15577,361487,407_13_53,NORWAY,0,TOTALS,NORWAY,200,20,60,33.3,12,40,30.0,8,20,40.0,8,19,42.1,11,34,45,12,13,27,8,3,56,0
15578,361500,407_13_54,SWITZERLAND,0,TOTALS,SWITZERLAND,200,18,49,36.7,12,38,31.6,6,11,54.5,7,12,58.3,7,27,34,9,18,31,13,1,49,0
15579,361513,407_13_54,BELARUS,0,TOTALS,BELARUS,200,27,72,37.5,25,55,45.5,2,17,11.8,14,24,58.3,21,27,48,10,17,17,19,2,70,1
15580,361526,407_13_55,FINLAND,0,TOTALS,FINLAND,225,28,71,39.4,17,35,48.6,11,36,30.6,18,26,69.2,11,22,33,16,13,13,11,0,85,1
15581,361539,407_13_55,GERMANY,0,TOTALS,GERMANY,225,34,72,47.2,26,47,55.3,8,25,32.0,6,11,54.5,14,33,47,19,23,21,7,2,82,0
15582,361552,407_13_56,ROMANIA,0,TOTALS,ROMANIA,200,24,56,42.9,20,44,45.5,4,12,33.3,17,25,68.0,9,26,35,6,28,20,11,2,69,0
15583,361565,407_13_56,PORTUGAL,0,TOTALS,PORTUGAL,200,25,58,43.1,22,42,52.4,3,16,18.8,21,33,63.6,14,27,41,13,21,21,13,1,74,1
15584,361578,407_13_57,MKD,0,TOTALS,MKD,200,19,49,38.8,15,34,44.1,4,15,26.7,21,25,84.0,12,41,53,10,19,28,6,6,63,1
15585,361591,407_13_57,ESTONIA,0,TOTALS,ESTONIA,200,18,65,27.7,13,43,30.2,5,22,22.7,8,16,50.0,8,21,29,9,23,12,22,0,49,0
15586,361604,407_13_58,ISRAEL,0,TOTALS,ISRAEL,200,18,62,29.0,11,36,30.6,7,26,26.9,11,25,44.0,17,31,48,8,21,24,10,1,54,0
15587,361617,407_13_58,BELGIUM,0,TOTALS,BELGIUM,200,27,66,40.9,22,45,48.9,5,21,23.8,6,17,35.3,14,32,46,15,18,21,11,7,65,1
15588,361630,407_13_59,POLAND,0,TOTALS,POLAND,200,25,58,43.1,21,44,47.7,4,14,28.6,12,16,75.0,11,38,49,9,21,20,6,5,66,1
15589,361643,407_13_59,NETHERLANDS,0,TOTALS,NETHERLANDS,200,19,65,29.2,16,46,34.8,3,19,15.8,9,15,60.0,10,22,32,4,15,16,8,0,50,0
15590,361656,407_13_60,SWEDEN,0,TOTALS,SWEDEN,200,30,63,47.6,21,42,50.0,9,21,42.9,5,7,71.4,9,28,37,22,20,11,7,4,74,1
15591,361669,407_13_60,MONTENEGRO,0,TOTALS,MONTENEGRO,200,22,58,37.9,19,47,40.4,3,11,27.3,8,17,47.1,12,24,36,9,18,11,4,2,55,0
15592,361682,407_13_61,GEORGIA,0,TOTALS,GEORGIA,200,19,60,31.7,13,44,29.5,6,16,37.5,6,20,30.0,15,17,32,5,23,19,10,2,50,0
15593,361695,407_13_61,DENMARK,0,TOTALS,DENMARK,200,27,57,47.4,22,45,48.9,5,12,41.7,18,29,62.1,19,31,50,10,19,16,12,2,77,1
15594,361708,407_13_62,LUXEMBOURG,0,TOTALS,LUXEMBOURG,200,30,67,44.8,28,52,53.8,2,15,13.3,7,11,63.6,9,22,31,11,22,10,4,1,69,0
15595,361721,407_13_62,SLOVAK REPUBLIC,0,TOTALS,SLOVAK REPUBLIC,200,27,61,44.3,20,37,54.1,7,24,29.2,11,21,52.4,16,28,44,11,18,18,5,1,72,1
15596,361734,407_13_63,GERMANY,0,TOTALS,GERMANY,200,28,60,46.7,20,39,51.3,8,21,38.1,10,15,66.7,11,37,48,17,20,21,3,4,74,1
15597,361747,407_13_63,HUNGARY,0,TOTALS,HUNGARY,200,28,76,36.8,22,56,39.3,6,20,30.0,8,15,53.3,12,24,36,16,17,8,15,4,70,0
15598,361760,407_13_64,PORTUGAL,0,TOTALS,PORTUGAL,200,24,68,35.3,18,40,45.0,6,28,21.4,11,18,61.1,17,24,41,15,22,15,18,1,65,1
15599,361773,407_13_64,SWITZERLAND,0,TOTALS,SWITZERLAND,200,14,42,33.3,11,32,34.4,3,10,30.0,15,21,71.4,7,28,35,9,18,31,8,0,46,0
15600,361786,407_13_65,NORWAY,0,TOTALS,NORWAY,200,22,57,38.6,15,41,36.6,7,16,43.8,10,22,45.5,12,25,37,13,14,12,5,3,61,0
15601,361799,407_13_65,FINLAND,0,TOTALS,FINLAND,200,36,77,46.8,28,49,57.1,8,28,28.6,7,13,53.8,21,27,48,20,19,10,7,5,87,1
15602,361812,407_13_66,BELARUS,0,TOTALS,BELARUS,200,20,58,34.5,18,46,39.1,2,12,16.7,13,19,68.4,16,32,48,11,21,26,11,3,55,0
15603,361825,407_13_66,ROMANIA,0,TOTALS,ROMANIA,200,23,64,35.9,20,57,35.1,3,7,42.9,14,29,48.3,18,25,43,8,21,17,14,3,63,1
15604,361838,407_13_67,NETHERLANDS,0,TOTALS,NETHERLANDS,200,22,60,36.7,17,43,39.5,5,17,29.4,6,11,54.5,11,24,35,11,17,19,7,2,55,0
15605,361851,407_13_67,MKD,0,TOTALS,MKD,200,28,58,48.3,24,40,60.0,4,18,22.2,9,14,64.3,8,29,37,13,13,15,8,3,69,1
15606,361864,407_13_68,BELGIUM,0,TOTALS,BELGIUM,200,27,65,41.5,24,42,57.1,3,23,13.0,9,18,50.0,15,27,42,10,17,20,18,3,66,1
15607,361877,407_13_68,SWEDEN,0,TOTALS,SWEDEN,200,21,57,36.8,16,39,41.0,5,18,27.8,12,17,70.6,10,27,37,13,21,27,6,4,59,0
15608,361890,407_13_69,ESTONIA,0,TOTALS,ESTONIA,200,21,69,30.4,15,42,35.7,6,27,22.2,4,7,57.1,10,27,37,12,23,22,9,1,52,0
15609,361903,407_13_69,POLAND,0,TOTALS,POLAND,200,27,63,42.9,24,48,50.0,3,15,20.0,10,19,52.6,8,36,44,15,13,22,8,5,67,1
15610,361916,407_13_70,MONTENEGRO,0,TOTALS,MONTENEGRO,200,20,55,36.4,12,30,40.0,8,25,32.0,15,31,48.4,9,36,45,11,20,14,5,5,63,1
15611,361929,407_13_70,ISRAEL,0,TOTALS,ISRAEL,200,23,70,32.9,17,41,41.5,6,29,20.7,8,17,47.1,15,36,51,11,28,11,6,3,60,0
15612,361942,407_13_71,HUNGARY,0,TOTALS,HUNGARY,200,29,67,43.3,25,47,53.2,4,20,20.0,20,27,74.1,5,34,39,16,20,10,18,2,82,1
15613,361955,407_13_71,SWITZERLAND,0,TOTALS,SWITZERLAND,200,17,58,29.3,16,47,34.0,1,11,9.1,11,16,68.8,10,32,42,8,19,27,3,1,46,0
15614,361968,407_13_72,FINLAND,0,TOTALS,FINLAND,200,25,54,46.3,18,36,50.0,7,18,38.9,21,26,80.8,4,26,30,14,10,11,10,3,78,1
15615,361981,407_13_72,BELARUS,0,TOTALS,BELARUS,200,29,79,36.7,20,47,42.6,9,32,28.1,1,5,20.0,26,27,53,19,22,16,7,1,68,0
15616,361994,407_13_73,ROMANIA,0,TOTALS,ROMANIA,200,24,76,31.6,22,65,33.8,2,11,18.2,6,12,50.0,17,19,36,12,28,10,10,2,56,0
15617,362007,407_13_73,NORWAY,0,TOTALS,NORWAY,200,24,48,50.0,21,37,56.8,3,11,27.3,25,36,69.4,10,36,46,10,14,20,6,11,76,1
15618,362020,407_13_74,PORTUGAL,0,TOTALS,PORTUGAL,200,19,56,33.9,12,34,35.3,7,22,31.8,8,12,66.7,9,28,37,5,17,11,6,2,53,1
15619,362033,407_13_74,GERMANY,0,TOTALS,GERMANY,200,18,45,40.0,13,30,43.3,5,15,33.3,11,21,52.4,5,28,33,9,12,13,3,3,52,0
15620,362046,407_13_75,NETHERLANDS,0,TOTALS,NETHERLANDS,200,26,72,36.1,18,49,36.7,8,23,34.8,4,7,57.1,15,22,37,17,20,13,4,0,64,0
15621,362059,407_13_75,SWEDEN,0,TOTALS,SWEDEN,200,30,58,51.7,29,52,55.8,1,6,16.7,13,18,72.2,9,32,41,8,13,14,5,2,74,1
15622,362072,407_13_76,POLAND,0,TOTALS,POLAND,200,30,67,44.8,22,41,53.7,8,26,30.8,12,20,60.0,12,36,48,14,17,18,7,2,80,1
15623,362085,407_13_76,BELGIUM,0,TOTALS,BELGIUM,200,24,77,31.2,17,43,39.5,7,34,20.6,7,12,58.3,17,28,45,12,19,17,12,7,62,0
15624,362098,407_13_77,ISRAEL,0,TOTALS,ISRAEL,200,35,68,51.5,30,47,63.8,5,21,23.8,9,19,47.4,10,27,37,23,22,15,11,0,84,1
15625,362111,407_13_77,ESTONIA,0,TOTALS,ESTONIA,200,23,55,41.8,15,31,48.4,8,24,33.3,10,24,41.7,10,23,33,9,20,22,7,0,64,0
15626,362124,407_13_78,MONTENEGRO,0,TOTALS,MONTENEGRO,200,22,50,44.0,17,35,48.6,5,15,33.3,13,24,54.2,7,37,44,12,18,18,8,3,62,1
15627,362137,407_13_78,MKD,0,TOTALS,MKD,200,23,69,33.3,16,44,36.4,7,25,28.0,7,11,63.6,12,27,39,7,20,11,6,4,60,0
15628,362150,407_13_79,AUSTRIA,0,TOTALS,AUSTRIA,200,31,60,51.7,28,44,63.6,3,16,18.8,1,2,50.0,9,30,39,10,19,23,4,3,66,0
15629,362163,407_13_79,LUXEMBOURG,0,TOTALS,LUXEMBOURG,200,28,70,40.0,23,39,59.0,5,31,16.1,12,22,54.5,16,16,32,14,10,9,11,0,73,1
15630,362176,407_13_80,GEORGIA,0,TOTALS,GEORGIA,200,37,68,54.4,26,45,57.8,11,23,47.8,9,16,56.2,9,35,44,21,24,21,16,3,94,1
15631,362189,407_13_80,SCOTLAND,0,TOTALS,SCOTLAND,200,24,69,34.8,20,53,37.7,4,16,25.0,16,25,64.0,16,25,41,12,16,24,10,1,68,0
15632,362202,407_13_81,DENMARK,0,TOTALS,DENMARK,200,32,67,47.8,30,55,54.5,2,12,16.7,17,28,60.7,11,23,34,20,19,12,9,2,83,1
15633,362215,407_13_81,SLOVAK REPUBLIC,0,TOTALS,SLOVAK REPUBLIC,200,28,58,48.3,24,46,52.2,4,12,33.3,8,18,44.4,12,23,35,9,28,22,9,5,68,0
15634,362228,407_13_82,FINLAND,0,TOTALS,FINLAND,200,21,52,40.4,12,28,42.9,9,24,37.5,18,21,85.7,8,31,39,10,10,17,6,3,69,1
15635,362241,407_13_82,PORTUGAL,0,TOTALS,PORTUGAL,200,24,69,34.8,21,41,51.2,3,28,10.7,9,12,75.0,16,24,40,9,21,11,11,1,60,0
15636,362254,407_13_83,SWITZERLAND,0,TOTALS,SWITZERLAND,200,23,51,45.1,19,43,44.2,4,8,50.0,12,22,54.5,11,23,34,12,19,26,13,1,62,1
15637,362267,407_13_83,ROMANIA,0,TOTALS,ROMANIA,200,22,55,40.0,19,41,46.3,3,14,21.4,11,20,55.0,15,17,32,7,23,23,14,0,58,0
15638,362280,407_13_84,NETHERLANDS,0,TOTALS,NETHERLANDS,200,26,68,38.2,21,43,48.8,5,25,20.0,11,24,45.8,18,31,49,15,23,20,5,7,68,0
15639,362293,407_13_84,ESTONIA,0,TOTALS,ESTONIA,200,26,70,37.1,21,57,36.8,5,13,38.5,18,25,72.0,16,28,44,12,19,13,9,2,75,1
15640,362306,407_13_85,HUNGARY,0,TOTALS,HUNGARY,200,33,73,45.2,29,60,48.3,4,13,30.8,7,10,70.0,10,30,40,19,14,9,12,7,77,1
15641,362319,407_13_85,NORWAY,0,TOTALS,NORWAY,200,25,64,39.1,17,42,40.5,8,22,36.4,9,15,60.0,12,31,43,15,13,19,5,3,67,0
15642,362332,407_13_86,SWEDEN,0,TOTALS,SWEDEN,200,22,65,33.8,20,49,40.8,2,16,12.5,22,27,81.5,15,27,42,9,15,15,5,3,68,0
15643,362345,407_13_86,ISRAEL,0,TOTALS,ISRAEL,200,33,71,46.5,26,51,51.0,7,20,35.0,11,13,84.6,11,30,41,19,24,11,8,3,84,1
15644,362358,407_13_87,BELARUS,0,TOTALS,BELARUS,200,16,66,24.2,13,42,31.0,3,24,12.5,8,16,50.0,18,28,46,5,19,15,6,3,43,0
15645,362371,407_13_87,GERMANY,0,TOTALS,GERMANY,200,29,61,47.5,23,42,54.8,6,19,31.6,6,16,37.5,9,36,45,18,13,10,9,7,70,1
15646,362384,407_13_88,BELGIUM,0,TOTALS,BELGIUM,200,28,74,37.8,23,58,39.7,5,16,31.2,9,19,47.4,22,29,51,19,24,15,15,9,70,1
15647,362397,407_13_88,MKD,0,TOTALS,MKD,200,13,49,26.5,11,36,30.6,2,13,15.4,17,29,58.6,11,28,39,5,19,23,6,4,45,0
15648,362410,407_13_89,POLAND,0,TOTALS,POLAND,200,26,65,40.0,20,43,46.5,6,22,27.3,5,8,62.5,13,26,39,8,18,11,4,2,63,0
15649,362423,407_13_89,MONTENEGRO,0,TOTALS,MONTENEGRO,200,25,65,38.5,17,39,43.6,8,26,30.8,6,8,75.0,15,27,42,16,18,12,3,3,64,1
15650,362435,408_13_01,WALES,0,TOTALS,WALES,200,33,80,41.2,29,70,41.4,4,10,40.0,12,21,57.1,15,20,35,14,18,25,19,0,82,0
15651,362448,408_13_01,MOLDOVA,0,TOTALS,MOLDOVA,200,36,71,50.7,33,62,53.2,3,9,33.3,8,18,44.4,19,31,50,15,19,36,14,2,83,1
15652,362461,408_13_02,PRINCIPALITY OF MONACO,0,TOTALS,PRINCIPALITY OF MONACO,200,19,63,30.2,12,41,29.3,7,22,31.8,16,32,50.0,16,29,45,8,20,17,12,1,61,1
15653,362473,408_13_02,GIBRALTAR,0,TOTALS,GIBRALTAR,200,21,80,26.2,16,52,30.8,5,28,17.9,7,17,41.2,27,27,54,8,25,18,8,2,54,0
15654,362486,408_13_03,MOLDOVA,0,TOTALS,MOLDOVA,200,38,74,51.4,34,59,57.6,4,15,26.7,10,15,66.7,14,38,52,18,13,23,14,3,90,1
15655,362499,408_13_03,SAN MARINO,0,TOTALS,SAN MARINO,200,22,69,31.9,16,49,32.7,6,20,30.0,5,8,62.5,6,18,24,9,19,20,19,0,55,0
15656,362511,408_13_04,GIBRALTAR,0,TOTALS,GIBRALTAR,200,17,58,29.3,14,44,31.8,3,14,21.4,10,26,38.5,12,23,35,7,29,27,7,4,47,0
15657,362524,408_13_04,ANDORRA,0,TOTALS,ANDORRA,200,32,81,39.5,27,64,42.2,5,17,29.4,18,34,52.9,22,32,54,9,25,14,16,0,87,1
15658,362537,408_13_05,SAN MARINO,0,TOTALS,SAN MARINO,200,28,76,36.8,20,54,37.0,8,22,36.4,13,18,72.2,10,39,49,15,29,21,12,8,77,1
15659,362549,408_13_05,WALES,0,TOTALS,WALES,200,21,69,30.4,20,56,35.7,1,13,7.7,19,30,63.3,13,34,47,11,18,23,7,3,62,0
15660,362562,408_13_06,ANDORRA,0,TOTALS,ANDORRA,200,17,64,26.6,12,45,26.7,5,19,26.3,22,38,57.9,24,27,51,11,24,28,14,0,61,0
15661,362575,408_13_06,PRINCIPALITY OF MONACO,0,TOTALS,PRINCIPALITY OF MONACO,200,27,64,42.2,23,49,46.9,4,15,26.7,19,28,67.9,14,28,42,12,29,24,18,1,77,1
15662,362588,408_13_07,SAN MARINO,0,TOTALS,SAN MARINO,200,29,83,34.9,22,56,39.3,7,27,25.9,11,16,68.8,27,30,57,18,22,20,17,1,76,1
15663,362600,408_13_07,GIBRALTAR,0,TOTALS,GIBRALTAR,200,18,55,32.7,16,41,39.0,2,14,14.3,10,23,43.5,13,29,42,6,15,28,11,3,48,0
15664,362613,408_13_08,ANDORRA,0,TOTALS,ANDORRA,200,22,65,33.8,16,38,42.1,6,27,22.2,11,18,61.1,22,31,53,11,15,23,10,4,61,1
15665,362625,408_13_08,WALES,0,TOTALS,WALES,200,19,60,31.7,17,50,34.0,2,10,20.0,9,18,50.0,14,25,39,9,21,21,11,0,49,0
15666,362637,408_13_09,GIBRALTAR,0,TOTALS,GIBRALTAR,200,25,70,35.7,20,50,40.0,5,20,25.0,5,7,71.4,19,37,56,10,17,24,13,4,60,1
15667,362649,408_13_09,WALES,0,TOTALS,WALES,200,21,77,27.3,20,56,35.7,1,21,4.8,13,28,46.4,28,25,53,9,15,18,16,3,56,0
15668,362662,408_13_10,MOLDOVA,0,TOTALS,MOLDOVA,200,36,67,53.7,30,50,60.0,6,17,35.3,5,14,35.7,14,40,54,15,17,20,10,7,83,1
15669,362675,408_13_10,ANDORRA,0,TOTALS,ANDORRA,200,26,79,32.9,16,50,32.0,10,29,34.5,5,13,38.5,17,22,39,12,17,13,11,1,67,0
15670,362688,408_13_11,PRINCIPALITY OF MONACO,0,TOTALS,PRINCIPALITY OF MONACO,200,23,56,41.1,20,43,46.5,3,13,23.1,21,36,58.3,11,27,38,8,18,24,11,2,70,0
15671,362701,408_13_11,SAN MARINO,0,TOTALS,SAN MARINO,200,27,70,38.6,19,45,42.2,8,25,32.0,12,14,85.7,14,28,42,12,27,24,14,1,74,1
15672,362714,408_13_12,ANDORRA,0,TOTALS,ANDORRA,200,23,66,34.8,17,44,38.6,6,22,27.3,18,29,62.1,20,34,54,16,24,34,19,3,70,1
15673,362727,408_13_12,PRINCIPALITY OF MONACO,0,TOTALS,PRINCIPALITY OF MONACO,200,17,58,29.3,16,45,35.6,1,13,7.7,15,23,65.2,9,29,38,8,26,31,15,0,50,0
15674,362740,408_13_13,MOLDOVA,0,TOTALS,MOLDOVA,225,40,74,54.1,36,59,61.0,4,15,26.7,16,30,53.3,18,32,50,12,22,29,14,5,100,0
15675,362753,408_13_13,SAN MARINO,0,TOTALS,SAN MARINO,225,35,78,44.9,20,46,43.5,15,32,46.9,18,24,75.0,12,23,35,15,29,22,14,1,103,1
15676,366561,412_13_01,RUSSIA,0,TOTALS,RUSSIA,200,25,64,39.1,24,52,46.2,1,12,8.3,9,22,40.9,11,28,39,14,32,23,14,2,60,0
15677,366574,412_13_01,SPAIN,0,TOTALS,SPAIN,200,25,69,36.2,18,46,39.1,7,23,30.4,30,46,65.2,19,33,52,14,23,21,11,7,87,1
15678,366587,412_13_02,GERMANY,0,TOTALS,GERMANY,200,22,59,37.3,20,47,42.6,2,12,16.7,9,17,52.9,13,30,43,9,17,18,3,0,55,0
15679,366600,412_13_02,TURKEY,0,TOTALS,TURKEY,200,24,64,37.5,17,40,42.5,7,24,29.2,7,12,58.3,11,26,37,9,19,15,9,9,62,1
15680,366613,412_13_03,MONTENEGRO,0,TOTALS,MONTENEGRO,200,20,56,35.7,16,37,43.2,4,19,21.1,10,20,50.0,11,27,38,14,22,20,13,4,54,1
15681,366626,412_13_03,POLAND,0,TOTALS,POLAND,200,16,63,25.4,14,45,31.1,2,18,11.1,9,14,64.3,22,34,56,10,22,26,12,3,43,0
15682,366639,412_13_04,ITALY,0,TOTALS,ITALY,200,27,80,33.8,23,64,35.9,4,16,25.0,6,11,54.5,11,29,40,5,23,8,9,2,64,0
15683,366652,412_13_04,CROATIA,0,TOTALS,CROATIA,200,35,74,47.3,33,66,50.0,2,8,25.0,19,28,67.9,17,45,62,21,15,16,3,9,91,1
15684,366665,412_13_05,SWEDEN,0,TOTALS,SWEDEN,200,22,61,36.1,18,47,38.3,4,14,28.6,16,21,76.2,17,17,34,9,28,21,7,1,64,0
15685,366678,412_13_05,LITHUANIA,0,TOTALS,LITHUANIA,200,27,58,46.6,24,46,52.2,3,12,25.0,23,40,57.5,20,23,43,12,18,16,9,8,80,1
15686,366691,412_13_06,SERBIA,0,TOTALS,SERBIA,200,24,57,42.1,17,38,44.7,7,19,36.8,5,20,25.0,14,29,43,14,27,19,5,4,60,1
15687,366704,412_13_06,FRANCE,0,TOTALS,FRANCE,200,20,62,32.3,15,41,36.6,5,21,23.8,14,27,51.9,18,26,44,11,18,12,8,1,59,0
15688,366717,412_13_07,BELGIUM,0,TOTALS,BELGIUM,200,20,57,35.1,15,42,35.7,5,15,33.3,7,9,77.8,8,21,29,13,18,24,15,0,52,0
15689,366730,412_13_07,GREECE,0,TOTALS,GREECE,200,26,56,46.4,24,43,55.8,2,13,15.4,9,17,52.9,13,28,41,15,17,23,8,5,63,1
15690,366743,412_13_08,UKRAINE,0,TOTALS,UKRAINE,200,30,76,39.5,23,55,41.8,7,21,33.3,11,12,91.7,16,39,55,18,24,13,9,2,78,1
15691,366756,412_13_08,LATVIA,0,TOTALS,LATVIA,200,22,74,29.7,15,46,32.6,7,28,25.0,10,17,58.8,17,32,49,10,15,14,5,6,61,0
15692,366769,412_13_09,LITHUANIA,0,TOTALS,LITHUANIA,200,22,63,34.9,18,43,41.9,4,20,20.0,20,36,55.6,15,29,44,11,26,19,15,7,68,0
15693,366782,412_13_09,GERMANY,0,TOTALS,GERMANY,200,26,63,41.3,22,51,43.1,4,12,33.3,15,28,53.6,16,33,49,14,29,28,11,3,71,1
15694,366795,412_13_10,FRANCE,0,TOTALS,FRANCE,200,30,59,50.8,23,36,63.9,7,23,30.4,13,26,50.0,12,31,43,12,11,17,6,2,80,1
15695,366808,412_13_10,MONTENEGRO,0,TOTALS,MONTENEGRO,200,28,70,40.0,17,35,48.6,11,35,31.4,4,6,66.7,14,23,37,18,24,12,10,2,71,0
15696,366821,412_13_11,GREECE,0,TOTALS,GREECE,200,24,61,39.3,21,47,44.7,3,14,21.4,17,35,48.6,19,30,49,15,24,20,11,10,68,1
15697,366834,412_13_11,RUSSIA,0,TOTALS,RUSSIA,200,21,63,33.3,17,50,34.0,4,13,30.8,14,24,58.3,14,26,40,11,25,18,10,2,60,0
15698,366847,412_13_12,POLAND,0,TOTALS,POLAND,200,17,63,27.0,16,52,30.8,1,11,9.1,13,25,52.0,12,22,34,7,23,18,16,4,48,0
15699,366860,412_13_12,SERBIA,0,TOTALS,SERBIA,200,23,60,38.3,18,42,42.9,5,18,27.8,11,24,45.8,19,40,59,9,24,31,9,9,62,1
15700,366873,412_13_13,SPAIN,0,TOTALS,SPAIN,200,28,63,44.4,22,38,57.9,6,25,24.0,18,28,64.3,15,36,51,20,16,18,12,2,80,1
15701,366886,412_13_13,BELGIUM,0,TOTALS,BELGIUM,200,26,68,38.2,21,45,46.7,5,23,21.7,4,13,30.8,12,24,36,11,22,20,12,1,61,0
15702,366899,412_13_14,LATVIA,0,TOTALS,LATVIA,200,24,64,37.5,21,49,42.9,3,15,20.0,5,12,41.7,8,33,41,9,17,18,6,3,56,1
15703,366912,412_13_14,ITALY,0,TOTALS,ITALY,200,18,61,29.5,13,39,33.3,5,22,22.7,13,16,81.2,9,31,40,9,14,19,12,3,54,0
15704,366925,412_13_15,TURKEY,0,TOTALS,TURKEY,200,28,74,37.8,22,58,37.9,6,16,37.5,5,14,35.7,21,25,46,12,18,13,16,4,67,1
15705,366938,412_13_15,SWEDEN,0,TOTALS,SWEDEN,200,17,60,28.3,16,46,34.8,1,14,7.1,9,14,64.3,17,28,45,10,13,22,6,1,44,0
15706,366951,412_13_16,CROATIA,0,TOTALS,CROATIA,200,28,67,41.8,23,46,50.0,5,21,23.8,18,28,64.3,24,37,61,20,17,25,10,6,79,1
15707,366964,412_13_16,UKRAINE,0,TOTALS,UKRAINE,200,26,75,34.7,18,45,40.0,8,30,26.7,7,12,58.3,14,21,35,14,25,12,15,4,67,0
15708,366977,412_13_17,BELGIUM,0,TOTALS,BELGIUM,200,20,64,31.2,14,44,31.8,6,20,30.0,18,20,90.0,14,24,38,11,28,20,15,4,64,0
15709,366990,412_13_17,RUSSIA,0,TOTALS,RUSSIA,200,24,60,40.0,23,47,48.9,1,13,7.7,19,30,63.3,18,30,48,14,22,22,10,2,68,1
15710,367003,412_13_18,SPAIN,0,TOTALS,SPAIN,200,18,65,27.7,14,44,31.8,4,21,19.0,3,4,75.0,9,21,30,12,9,12,12,1,43,0
15711,367016,412_13_18,GREECE,0,TOTALS,GREECE,200,23,52,44.2,18,36,50.0,5,16,31.2,6,9,66.7,10,37,47,15,16,24,2,3,57,1
15712,367029,412_13_19,SWEDEN,0,TOTALS,SWEDEN,200,19,69,27.5,11,46,23.9,8,23,34.8,4,6,66.7,11,33,44,14,27,15,9,5,50,0
15713,367042,412_13_19,GERMANY,0,TOTALS,GERMANY,200,20,61,32.8,19,48,39.6,1,13,7.7,25,36,69.4,15,39,54,8,16,15,9,5,66,1
15714,367055,412_13_20,CROATIA,0,TOTALS,CROATIA,200,25,63,39.7,24,53,45.3,1,10,10.0,15,23,65.2,18,40,58,13,20,19,4,4,66,1
15715,367068,412_13_20,LATVIA,0,TOTALS,LATVIA,200,18,73,24.7,13,48,27.1,5,25,20.0,14,19,73.7,17,23,40,10,20,8,8,4,55,0
15716,367081,412_13_21,TURKEY,0,TOTALS,TURKEY,200,32,62,51.6,24,40,60.0,8,22,36.4,10,13,76.9,12,27,39,15,19,21,12,6,82,1
15717,367094,412_13_21,LITHUANIA,0,TOTALS,LITHUANIA,200,27,67,40.3,22,50,44.0,5,17,29.4,8,11,72.7,14,21,35,16,18,20,12,3,67,0
15718,367107,412_13_22,MONTENEGRO,0,TOTALS,MONTENEGRO,200,22,74,29.7,15,45,33.3,7,29,24.1,7,11,63.6,14,24,38,10,25,13,6,1,58,0
15719,367120,412_13_22,SERBIA,0,TOTALS,SERBIA,200,24,56,42.9,23,41,56.1,1,15,6.7,20,34,58.8,14,42,56,18,18,18,8,6,69,1
15720,367133,412_13_23,FRANCE,0,TOTALS,FRANCE,200,26,59,44.1,17,28,60.7,9,31,29.0,16,20,80.0,13,23,36,17,24,16,13,2,77,1
15721,367146,412_13_23,POLAND,0,TOTALS,POLAND,200,22,53,41.5,20,42,47.6,2,11,18.2,13,22,59.1,10,21,31,12,21,21,7,2,59,0
15722,367159,412_13_24,UKRAINE,0,TOTALS,UKRAINE,200,20,60,33.3,13,32,40.6,7,28,25.0,14,24,58.3,11,30,41,10,26,23,7,3,61,0
15723,367172,412_13_24,ITALY,0,TOTALS,ITALY,200,26,64,40.6,22,45,48.9,4,19,21.1,21,29,72.4,10,31,41,12,26,13,14,4,77,1
15724,367185,412_13_25,BELGIUM,0,TOTALS,BELGIUM,225,30,68,44.1,22,46,47.8,8,22,36.4,16,23,69.6,11,19,30,14,21,18,14,2,84,1
15725,367198,412_13_25,LATVIA,0,TOTALS,LATVIA,225,28,65,43.1,22,45,48.9,6,20,30.0,18,22,81.8,19,30,49,15,24,27,5,3,80,0
15726,367211,412_13_26,SWEDEN,0,TOTALS,SWEDEN,200,21,67,31.3,15,45,33.3,6,22,27.3,8,16,50.0,17,26,43,10,29,25,8,7,56,0
15727,367224,412_13_26,POLAND,0,TOTALS,POLAND,200,24,54,44.4,23,46,50.0,1,8,12.5,31,45,68.9,8,32,40,20,18,17,17,4,80,1
15728,367237,412_13_27,GERMANY,0,TOTALS,GERMANY,200,29,61,47.5,25,44,56.8,4,17,23.5,15,21,71.4,17,35,52,5,24,18,3,6,77,1
15729,367250,412_13_27,SPAIN,0,TOTALS,SPAIN,200,27,71,38.0,20,48,41.7,7,23,30.4,9,17,52.9,15,19,34,9,16,9,9,3,70,0
15730,367263,412_13_28,LITHUANIA,0,TOTALS,LITHUANIA,225,25,66,37.9,16,40,40.0,9,26,34.6,6,12,50.0,8,33,41,15,27,17,5,0,65,0
15731,367276,412_13_28,GREECE,0,TOTALS,GREECE,225,23,68,33.8,19,48,39.6,4,20,20.0,18,30,60.0,17,35,52,10,18,17,10,3,68,1
15732,367289,412_13_29,ITALY,0,TOTALS,ITALY,200,26,62,41.9,25,49,51.0,1,13,7.7,10,14,71.4,9,31,40,11,17,17,8,5,63,1
15733,367302,412_13_29,FRANCE,0,TOTALS,FRANCE,200,23,67,34.3,18,48,37.5,5,19,26.3,9,10,90.0,14,29,43,11,18,19,9,0,60,0
15734,367315,412_13_30,UKRAINE,0,TOTALS,UKRAINE,200,19,61,31.1,18,40,45.0,1,21,4.8,11,23,47.8,8,24,32,8,20,17,6,9,50,0
15735,367328,412_13_30,SERBIA,0,TOTALS,SERBIA,200,31,74,41.9,25,57,43.9,6,17,35.3,17,24,70.8,22,39,61,21,21,21,15,6,85,1
15736,367341,412_13_31,RUSSIA,0,TOTALS,RUSSIA,200,22,59,37.3,18,47,38.3,4,12,33.3,9,14,64.3,11,27,38,16,20,18,9,4,57,0
15737,367354,412_13_31,TURKEY,0,TOTALS,TURKEY,200,29,70,41.4,22,48,45.8,7,22,31.8,11,15,73.3,16,28,44,17,14,13,10,4,76,1
15738,367367,412_13_32,MONTENEGRO,0,TOTALS,MONTENEGRO,200,21,73,28.8,18,51,35.3,3,22,13.6,3,7,42.9,14,19,33,8,16,21,14,2,48,1
15739,367380,412_13_32,CROATIA,0,TOTALS,CROATIA,200,41,72,56.9,35,56,62.5,6,16,37.5,12,17,70.6,16,38,54,31,14,20,12,12,100,0
15740,367393,412_13_33,POLAND,0,TOTALS,POLAND,200,28,56,50.0,20,42,47.6,8,14,57.1,19,25,76.0,12,28,40,15,19,21,13,6,83,1
15741,367406,412_13_33,BELGIUM,0,TOTALS,BELGIUM,200,14,47,29.8,11,32,34.4,3,15,20.0,12,21,57.1,10,19,29,8,22,28,12,5,43,0
15742,367419,412_13_34,LATVIA,0,TOTALS,LATVIA,200,21,57,36.8,18,42,42.9,3,15,20.0,15,23,65.2,10,29,39,8,14,16,10,3,60,0
15743,367432,412_13_34,SWEDEN,0,TOTALS,SWEDEN,200,23,64,35.9,16,40,40.0,7,24,29.2,9,12,75.0,13,28,41,14,22,17,9,3,62,1
15744,367445,412_13_35,LITHUANIA,0,TOTALS,LITHUANIA,200,24,61,39.3,18,42,42.9,6,19,31.6,20,30,66.7,17,31,48,15,23,19,5,5,74,1
15745,367458,412_13_35,RUSSIA,0,TOTALS,RUSSIA,200,23,64,35.9,16,42,38.1,7,22,31.8,15,25,60.0,13,25,38,13,22,15,12,2,68,0
15746,367471,412_13_36,GREECE,0,TOTALS,GREECE,200,27,66,40.9,20,48,41.7,7,18,38.9,7,14,50.0,16,29,45,16,19,21,15,6,68,1
15747,367484,412_13_36,GERMANY,0,TOTALS,GERMANY,200,19,53,35.8,17,44,38.6,2,9,22.2,7,14,50.0,7,27,34,12,19,27,11,6,47,0
15748,367497,412_13_37,SPAIN,0,TOTALS,SPAIN,200,27,62,43.5,20,34,58.8,7,28,25.0,9,16,56.2,9,35,44,14,17,17,8,3,70,1
15749,367510,412_13_37,TURKEY,0,TOTALS,TURKEY,200,25,71,35.2,19,46,41.3,6,25,24.0,9,15,60.0,15,27,42,15,14,13,6,7,65,0
15750,367523,412_13_38,UKRAINE,0,TOTALS,UKRAINE,200,27,69,39.1,18,46,39.1,9,23,39.1,26,37,70.3,18,31,49,21,30,21,9,3,89,1
15751,367536,412_13_38,MONTENEGRO,0,TOTALS,MONTENEGRO,200,21,61,34.4,13,40,32.5,8,21,38.1,32,39,82.1,14,28,42,13,27,18,12,2,82,0
15752,367549,412_13_39,SERBIA,0,TOTALS,SERBIA,200,28,66,42.4,23,50,46.0,5,16,31.2,15,20,75.0,17,34,51,19,16,18,6,5,76,1
15753,367562,412_13_39,ITALY,0,TOTALS,ITALY,200,21,62,33.9,17,46,37.0,4,16,25.0,10,17,58.8,9,23,32,15,18,19,12,3,56,0
15754,367575,412_13_40,FRANCE,0,TOTALS,FRANCE,200,24,69,34.8,18,42,42.9,6,27,22.2,15,18,83.3,10,22,32,11,18,12,6,3,69,0
15755,367588,412_13_40,CROATIA,0,TOTALS,CROATIA,200,29,57,50.9,24,41,58.5,5,16,31.2,15,21,71.4,8,36,44,18,21,18,6,4,78,1
15756,367601,412_13_41,BELGIUM,0,TOTALS,BELGIUM,200,24,59,40.7,20,46,43.5,4,13,30.8,13,16,81.2,14,28,42,11,7,17,10,4,65,1
15757,367614,412_13_41,SWEDEN,0,TOTALS,SWEDEN,200,22,75,29.3,16,48,33.3,6,27,22.2,4,6,66.7,23,22,45,13,20,18,7,3,54,0
15758,367627,412_13_42,POLAND,0,TOTALS,POLAND,200,29,58,50.0,20,40,50.0,9,18,50.0,11,20,55.0,11,24,35,15,17,19,12,4,78,1
15759,367640,412_13_42,LATVIA,0,TOTALS,LATVIA,200,23,64,35.9,19,46,41.3,4,18,22.2,9,15,60.0,19,21,40,13,21,24,10,1,59,0
15760,367653,412_13_43,GERMANY,0,TOTALS,GERMANY,200,28,63,44.4,26,51,51.0,2,12,16.7,13,24,54.2,17,31,48,12,23,17,7,8,71,1
15761,367666,412_13_43,RUSSIA,0,TOTALS,RUSSIA,200,25,65,38.5,18,42,42.9,7,23,30.4,12,16,75.0,9,24,33,18,21,17,7,6,69,0
15762,367679,412_13_44,CROATIA,0,TOTALS,CROATIA,200,25,63,39.7,24,48,50.0,1,15,6.7,18,24,75.0,17,42,59,18,17,18,6,7,69,1
15763,367692,412_13_44,SERBIA,0,TOTALS,SERBIA,200,27,80,33.8,21,61,34.4,6,19,31.6,3,8,37.5,15,25,40,12,23,10,8,1,63,0
15764,367705,412_13_45,TURKEY,0,TOTALS,TURKEY,200,18,48,37.5,14,32,43.8,4,16,25.0,4,7,57.1,9,28,37,9,12,20,7,3,44,0
15765,367718,412_13_45,GREECE,0,TOTALS,GREECE,200,21,57,36.8,17,36,47.2,4,21,19.0,7,11,63.6,9,25,34,12,13,10,10,2,53,1
15766,367731,412_13_46,ITALY,0,TOTALS,ITALY,200,32,66,48.5,29,48,60.4,3,18,16.7,12,20,60.0,11,31,42,22,19,14,14,7,79,1
15767,367744,412_13_46,MONTENEGRO,0,TOTALS,MONTENEGRO,200,21,65,32.3,13,41,31.7,8,24,33.3,16,20,80.0,15,27,42,16,18,20,10,2,66,0
15768,367757,412_13_47,SPAIN,0,TOTALS,SPAIN,200,33,71,46.5,25,46,54.3,8,25,32.0,21,34,61.8,17,25,42,16,28,14,8,1,95,1
15769,367770,412_13_47,LITHUANIA,0,TOTALS,LITHUANIA,200,25,67,37.3,19,42,45.2,6,25,24.0,34,41,82.9,19,28,47,13,28,14,6,5,90,0
15770,367783,412_13_48,FRANCE,0,TOTALS,FRANCE,200,24,58,41.4,20,35,57.1,4,23,17.4,9,11,81.8,7,32,39,11,17,18,9,9,61,1
15771,367796,412_13_48,UKRAINE,0,TOTALS,UKRAINE,200,21,63,33.3,11,38,28.9,10,25,40.0,7,12,58.3,11,27,38,12,19,17,10,0,59,0
15772,367809,412_13_49,GREECE,0,TOTALS,GREECE,200,17,61,27.9,17,44,38.6,0,17,0.0,8,10,80.0,11,30,41,9,20,9,8,3,42,1
15773,367822,412_13_49,FRANCE,0,TOTALS,FRANCE,200,12,53,22.6,9,34,26.5,3,19,15.8,11,16,68.8,12,32,44,8,17,15,3,4,38,0
15774,367835,412_13_50,LITHUANIA,0,TOTALS,LITHUANIA,200,30,58,51.7,22,36,61.1,8,22,36.4,15,28,53.6,8,38,46,18,16,15,7,6,83,1
15775,367848,412_13_50,LATVIA,0,TOTALS,LATVIA,200,30,85,35.3,21,54,38.9,9,31,29.0,5,10,50.0,20,26,46,16,23,12,9,3,74,0
15776,367861,412_13_51,TURKEY,0,TOTALS,TURKEY,200,31,73,42.5,30,58,51.7,1,15,6.7,10,16,62.5,17,25,42,13,20,12,5,5,73,0
15777,367874,412_13_51,ITALY,0,TOTALS,ITALY,200,29,63,46.0,20,41,48.8,9,22,40.9,15,22,68.2,9,28,37,20,17,9,7,3,82,1
15778,367887,412_13_52,RUSSIA,0,TOTALS,RUSSIA,200,24,57,42.1,17,33,51.5,7,24,29.2,23,33,69.7,15,35,50,19,18,21,8,3,78,1
15779,367900,412_13_52,BELGIUM,0,TOTALS,BELGIUM,200,28,67,41.8,24,50,48.0,4,17,23.5,7,15,46.7,8,21,29,13,24,14,14,1,67,0
15780,367913,412_13_53,CROATIA,0,TOTALS,CROATIA,200,25,76,32.9,23,63,36.5,2,13,15.4,7,13,53.8,25,35,60,12,18,19,8,6,59,0
15781,367926,412_13_53,SPAIN,0,TOTALS,SPAIN,200,24,73,32.9,16,47,34.0,8,26,30.8,5,9,55.6,14,30,44,11,18,13,8,6,61,1
15782,367939,412_13_54,UKRAINE,0,TOTALS,UKRAINE,200,35,66,53.0,29,49,59.2,6,17,35.3,24,32,75.0,12,35,47,24,19,17,16,3,100,0
15783,367952,412_13_54,SWEDEN,0,TOTALS,SWEDEN,200,23,68,33.8,17,47,36.2,6,21,28.6,6,12,50.0,14,23,37,10,21,25,8,0,58,1
15784,367965,412_13_55,SERBIA,0,TOTALS,SERBIA,200,27,58,46.6,14,35,40.0,13,23,56.5,9,17,52.9,10,33,43,19,17,16,8,5,76,1
15785,367978,412_13_55,GERMANY,0,TOTALS,GERMANY,200,16,55,29.1,11,38,28.9,5,17,29.4,13,19,68.4,9,26,35,9,22,18,12,4,50,0
15786,367991,412_13_56,MONTENEGRO,0,TOTALS,MONTENEGRO,200,25,64,39.1,19,41,46.3,6,23,26.1,18,21,85.7,15,19,34,7,23,20,10,0,74,0
15787,368004,412_13_56,POLAND,0,TOTALS,POLAND,200,32,62,51.6,28,44,63.6,4,18,22.2,14,22,63.6,16,26,42,20,20,20,12,4,82,1
15788,368017,412_13_57,SWEDEN,0,TOTALS,SWEDEN,200,16,60,26.7,10,35,28.6,6,25,24.0,18,26,69.2,22,28,50,10,19,17,5,1,56,0
15789,368030,412_13_57,BELGIUM,0,TOTALS,BELGIUM,200,21,59,35.6,13,36,36.1,8,23,34.8,8,12,66.7,10,22,32,10,19,13,13,4,58,1
15790,368043,412_13_58,CROATIA,0,TOTALS,CROATIA,200,27,61,44.3,25,51,49.0,2,10,20.0,27,35,77.1,14,38,52,15,17,19,5,3,83,1
15791,368056,412_13_58,TURKEY,0,TOTALS,TURKEY,200,28,76,36.8,19,51,37.3,9,25,36.0,8,15,53.3,15,26,41,15,26,13,11,5,73,0
15792,368069,412_13_59,LATVIA,0,TOTALS,LATVIA,200,28,60,46.7,18,33,54.5,10,27,37.0,5,10,50.0,9,22,31,19,14,17,3,4,71,1
15793,368082,412_13_59,MONTENEGRO,0,TOTALS,MONTENEGRO,200,28,69,40.6,26,45,57.8,2,24,8.3,11,17,64.7,18,24,42,14,17,14,10,0,69,0
15794,368095,412_13_60,FRANCE,0,TOTALS,FRANCE,200,19,55,34.5,15,39,38.5,4,16,25.0,16,21,76.2,12,24,36,13,17,18,7,3,58,1
15795,368108,412_13_60,GERMANY,0,TOTALS,GERMANY,200,20,53,37.7,16,38,42.1,4,15,26.7,9,14,64.3,10,26,36,10,23,20,9,7,53,0
15796,368121,412_13_61,UKRAINE,0,TOTALS,UKRAINE,200,26,68,38.2,20,46,43.5,6,22,27.3,19,26,73.1,10,26,36,13,27,11,12,5,77,1
15797,368134,412_13_61,RUSSIA,0,TOTALS,RUSSIA,200,21,59,35.6,15,38,39.5,6,21,28.6,21,28,75.0,14,36,50,13,22,19,5,4,69,0
15798,368147,412_13_62,GREECE,0,TOTALS,GREECE,200,21,62,33.9,20,49,40.8,1,13,7.7,6,12,50.0,11,19,30,7,16,10,10,2,49,0
15799,368160,412_13_62,SERBIA,0,TOTALS,SERBIA,200,24,52,46.2,18,33,54.5,6,19,31.6,11,16,68.8,11,32,43,17,16,16,6,2,65,1
15800,368173,412_13_63,LITHUANIA,0,TOTALS,LITHUANIA,225,32,69,46.4,28,54,51.9,4,15,26.7,16,18,88.9,18,34,52,14,22,27,8,5,84,1
15801,368186,412_13_63,POLAND,0,TOTALS,POLAND,225,31,75,41.3,26,58,44.8,5,17,29.4,12,24,50.0,13,19,32,16,19,12,18,3,79,0
15802,368199,412_13_64,SPAIN,0,TOTALS,SPAIN,200,19,68,27.9,16,55,29.1,3,13,23.1,16,21,76.2,15,32,47,12,16,10,5,4,57,1
15803,368212,412_13_64,ITALY,0,TOTALS,ITALY,200,20,65,30.8,16,40,40.0,4,25,16.0,7,12,58.3,14,34,48,13,23,17,3,2,51,0
15804,368225,412_13_65,MONTENEGRO,0,TOTALS,MONTENEGRO,200,26,63,41.3,19,44,43.2,7,19,36.8,19,29,65.5,15,23,38,18,13,16,15,0,78,1
15805,368238,412_13_65,SWEDEN,0,TOTALS,SWEDEN,200,27,66,40.9,15,36,41.7,12,30,40.0,6,8,75.0,15,27,42,17,23,24,8,7,72,0
15806,368251,412_13_66,GERMANY,0,TOTALS,GERMANY,200,14,61,23.0,14,39,35.9,0,22,0.0,10,21,47.6,15,40,55,7,20,22,10,2,38,0
15807,368264,412_13_66,TURKEY,0,TOTALS,TURKEY,200,20,65,30.8,13,41,31.7,7,24,29.2,4,15,26.7,10,37,47,13,18,14,6,9,51,1
15808,368277,412_13_67,LATVIA,0,TOTALS,LATVIA,200,26,51,51.0,20,33,60.6,6,18,33.3,15,24,62.5,9,27,36,13,21,18,6,1,73,1
15809,368290,412_13_67,BELGIUM,0,TOTALS,BELGIUM,200,22,54,40.7,17,32,53.1,5,22,22.7,13,19,68.4,6,19,25,13,21,16,11,1,62,0
15810,368303,412_13_68,FRANCE,0,TOTALS,FRANCE,200,21,61,34.4,17,42,40.5,4,19,21.1,13,19,68.4,13,32,45,12,17,12,10,3,59,1
15811,368316,412_13_68,CROATIA,0,TOTALS,CROATIA,200,19,53,35.8,17,33,51.5,2,20,10.0,8,18,44.4,6,29,35,12,16,15,6,3,48,0
15812,368329,412_13_69,LITHUANIA,0,TOTALS,LITHUANIA,200,28,66,42.4,17,41,41.5,11,25,44.0,15,25,60.0,8,42,50,20,21,18,7,8,82,1
15813,368342,412_13_69,UKRAINE,0,TOTALS,UKRAINE,200,24,77,31.2,21,51,41.2,3,26,11.5,17,21,81.0,15,32,47,14,20,11,12,8,68,0
15814,368355,412_13_70,GREECE,0,TOTALS,GREECE,200,31,58,53.4,27,44,61.4,4,14,28.6,12,17,70.6,8,45,53,23,20,25,9,10,78,1
15815,368368,412_13_70,ITALY,0,TOTALS,ITALY,200,20,78,25.6,18,61,29.5,2,17,11.8,8,14,57.1,15,19,34,10,19,14,12,0,50,0
15816,368381,412_13_71,POLAND,0,TOTALS,POLAND,200,21,57,36.8,18,42,42.9,3,15,20.0,20,36,55.6,9,21,30,12,15,16,17,6,65,0
15817,368394,412_13_71,RUSSIA,0,TOTALS,RUSSIA,200,31,62,50.0,22,41,53.7,9,21,42.9,9,11,81.8,9,33,42,19,27,23,4,2,80,1
15818,368407,412_13_72,SERBIA,0,TOTALS,SERBIA,225,25,79,31.6,20,54,37.0,5,25,20.0,8,14,57.1,15,32,47,11,25,12,12,4,63,0
15819,368420,412_13_72,SPAIN,0,TOTALS,SPAIN,225,24,68,35.3,21,47,44.7,3,21,14.3,14,23,60.9,16,40,56,13,17,18,6,3,65,1
15820,368433,413_13_01,MKD,0,TOTALS,MKD,200,32,70,45.7,27,49,55.1,5,21,23.8,13,30,43.3,21,36,57,17,12,17,8,3,82,1
15821,368446,413_13_01,NORWAY,0,TOTALS,NORWAY,200,21,61,34.4,13,37,35.1,8,24,33.3,5,8,62.5,6,24,30,13,23,16,9,0,55,0
15822,368459,413_13_02,AUSTRIA,0,TOTALS,AUSTRIA,200,26,59,44.1,23,47,48.9,3,12,25.0,11,17,64.7,13,20,33,8,20,21,17,0,66,1
15823,368472,413_13_02,BELARUS,0,TOTALS,BELARUS,200,20,54,37.0,20,42,47.6,0,12,0.0,11,16,68.8,14,21,35,7,18,34,11,2,51,0
15824,368485,413_13_03,ENGLAND,0,TOTALS,ENGLAND,200,31,63,49.2,23,42,54.8,8,21,38.1,15,32,46.9,14,32,46,14,20,19,8,1,85,1
15825,368498,413_13_03,ROMANIA,0,TOTALS,ROMANIA,200,30,65,46.2,27,48,56.2,3,17,17.6,13,25,52.0,10,24,34,11,25,19,8,2,76,0
15826,368511,413_13_04,ESTONIA,0,TOTALS,ESTONIA,200,27,66,40.9,22,49,44.9,5,17,29.4,10,18,55.6,11,26,37,15,11,18,11,2,69,0
15827,368524,413_13_04,PORTUGAL,0,TOTALS,PORTUGAL,200,34,62,54.8,26,43,60.5,8,19,42.1,5,9,55.6,6,30,36,22,18,18,11,1,81,1
15828,368537,413_13_05,GEORGIA,0,TOTALS,GEORGIA,200,19,59,32.2,13,37,35.1,6,22,27.3,7,17,41.2,16,33,49,8,15,22,5,1,51,0
15829,368550,413_13_05,CZECH REPUBLIC,0,TOTALS,CZECH REPUBLIC,200,21,66,31.8,15,37,40.5,6,29,20.7,4,10,40.0,14,26,40,13,21,15,15,1,52,1
15830,368563,413_13_06,SLOVENIA,0,TOTALS,SLOVENIA,200,35,74,47.3,24,47,51.1,11,27,40.7,4,5,80.0,11,32,43,25,22,23,13,7,85,1
15831,368576,413_13_06,SWITZERLAND,0,TOTALS,SWITZERLAND,200,17,47,36.2,16,33,48.5,1,14,7.1,17,25,68.0,8,25,33,6,14,27,12,1,52,0
15832,368589,413_13_07,FINLAND,0,TOTALS,FINLAND,200,32,63,50.8,26,44,59.1,6,19,31.6,11,19,57.9,7,27,34,19,21,17,18,0,81,1
15833,368602,413_13_07,BULGARIA,0,TOTALS,BULGARIA,200,19,53,35.8,14,37,37.8,5,16,31.2,15,21,71.4,7,30,37,10,15,25,7,2,58,0
15834,368615,413_13_08,LUXEMBOURG,0,TOTALS,LUXEMBOURG,200,24,56,42.9,21,49,42.9,3,7,42.9,3,12,25.0,7,25,32,6,13,25,10,1,54,0
15835,368628,413_13_08,HUNGARY,0,TOTALS,HUNGARY,200,36,76,47.4,29,43,67.4,7,33,21.2,12,18,66.7,16,26,42,13,9,15,17,2,91,1
15836,368641,413_13_09,ISRAEL,0,TOTALS,ISRAEL,200,29,75,38.7,27,53,50.9,2,22,9.1,4,7,57.1,10,20,30,15,20,16,18,2,64,0
15837,368654,413_13_09,DENMARK,0,TOTALS,DENMARK,200,33,64,51.6,29,50,58.0,4,14,28.6,10,17,58.8,14,41,55,14,16,28,9,6,80,1
15838,368667,413_13_10,NETHERLANDS,0,TOTALS,NETHERLANDS,200,19,51,37.3,14,37,37.8,5,14,35.7,8,16,50.0,13,29,42,14,18,25,7,0,51,0
15839,368680,413_13_10,BOSNIA AND HERZEGOVINA,0,TOTALS,BOSNIA AND HERZEGOVINA,200,20,65,30.8,14,37,37.8,6,28,21.4,7,9,77.8,14,24,38,11,20,17,15,1,53,1
15840,368693,413_13_11,CZECH REPUBLIC,0,TOTALS,CZECH REPUBLIC,200,32,67,47.8,25,49,51.0,7,18,38.9,15,20,75.0,13,25,38,20,16,21,21,3,86,1
15841,368706,413_13_11,AUSTRIA,0,TOTALS,AUSTRIA,200,20,56,35.7,17,43,39.5,3,13,23.1,6,7,85.7,13,23,36,12,15,36,10,0,49,0
15842,368719,413_13_12,NORWAY,0,TOTALS,NORWAY,200,18,56,32.1,13,36,36.1,5,20,25.0,6,15,40.0,12,29,41,10,21,19,8,1,47,0
15843,368732,413_13_12,ESTONIA,0,TOTALS,ESTONIA,200,21,65,32.3,13,34,38.2,8,31,25.8,11,15,73.3,13,31,44,19,20,13,9,1,61,1
15844,368745,413_13_13,IRELAND,0,TOTALS,IRELAND,200,22,62,35.5,11,35,31.4,11,27,40.7,15,24,62.5,14,22,36,16,20,20,13,2,70,0
15845,368758,413_13_13,SLOVENIA,0,TOTALS,SLOVENIA,200,30,69,43.5,25,50,50.0,5,19,26.3,10,15,66.7,19,27,46,13,22,26,7,1,75,1
15846,368771,413_13_14,HUNGARY,0,TOTALS,HUNGARY,200,26,59,44.1,23,46,50.0,3,13,23.1,8,15,53.3,10,30,40,11,11,19,7,3,63,1
15847,368784,413_13_14,GEORGIA,0,TOTALS,GEORGIA,200,26,68,38.2,20,43,46.5,6,25,24.0,1,7,14.3,18,27,45,13,17,19,8,2,59,0
15848,368797,413_13_15,BULGARIA,0,TOTALS,BULGARIA,200,17,66,25.8,14,46,30.4,3,20,15.0,12,17,70.6,14,34,48,11,19,28,14,3,49,0
15849,368810,413_13_15,MKD,0,TOTALS,MKD,200,26,77,33.8,23,59,39.0,3,18,16.7,12,23,52.2,22,34,56,9,18,22,17,3,67,1
15850,368823,413_13_16,SWITZERLAND,0,TOTALS,SWITZERLAND,200,16,71,22.5,11,48,22.9,5,23,21.7,9,14,64.3,21,17,38,5,18,25,17,2,46,0
15851,368836,413_13_16,ENGLAND,0,TOTALS,ENGLAND,200,23,56,41.1,19,43,44.2,4,13,30.8,9,15,60.0,16,37,53,11,18,32,12,2,59,1
15852,368849,413_13_17,SLOVAK REPUBLIC,0,TOTALS,SLOVAK REPUBLIC,200,21,39,53.8,16,25,64.0,5,14,35.7,19,23,82.6,8,21,29,13,15,38,13,3,66,1
15853,368862,413_13_17,ISRAEL,0,TOTALS,ISRAEL,200,45,77,58.4,37,54,68.5,8,23,34.8,5,11,45.5,15,16,31,29,24,20,26,5,103,0
15854,368875,413_13_18,PORTUGAL,0,TOTALS,PORTUGAL,200,22,57,38.6,16,32,50.0,6,25,24.0,12,18,66.7,9,21,30,16,14,21,7,1,62,0
15855,368888,413_13_18,FINLAND,0,TOTALS,FINLAND,200,27,72,37.5,19,41,46.3,8,31,25.8,12,16,75.0,23,26,49,15,21,21,8,1,74,1
15856,368901,413_13_19,BELARUS,0,TOTALS,BELARUS,225,22,75,29.3,20,54,37.0,2,21,9.5,15,29,51.7,28,30,58,10,17,33,13,2,61,0
15857,368914,413_13_19,LUXEMBOURG,0,TOTALS,LUXEMBOURG,225,30,79,38.0,26,59,44.1,4,20,20.0,3,12,25.0,21,27,48,17,22,25,18,1,67,1
15858,368927,413_13_20,DENMARK,0,TOTALS,DENMARK,200,25,56,44.6,24,46,52.2,1,10,10.0,18,46,39.1,10,31,41,7,15,14,9,6,69,0
15859,368940,413_13_20,NETHERLANDS,0,TOTALS,NETHERLANDS,200,32,62,51.6,28,46,60.9,4,16,25.0,5,14,35.7,8,31,39,11,29,16,9,3,73,1
15860,368953,413_13_21,AUSTRIA,0,TOTALS,AUSTRIA,225,29,68,42.6,21,43,48.8,8,25,32.0,10,14,71.4,14,27,41,12,23,22,11,3,76,1
15861,368966,413_13_21,HUNGARY,0,TOTALS,HUNGARY,225,24,58,41.4,20,34,58.8,4,24,16.7,19,28,67.9,12,29,41,6,18,22,7,2,71,0
15862,368979,413_13_22,BULGARIA,0,TOTALS,BULGARIA,200,26,71,36.6,21,50,42.0,5,21,23.8,2,4,50.0,19,33,52,15,13,23,12,3,59,1
15863,368992,413_13_22,NORWAY,0,TOTALS,NORWAY,200,17,57,29.8,15,39,38.5,2,18,11.1,2,7,28.6,8,27,35,10,13,23,11,1,38,0
15864,369005,413_13_23,ROMANIA,0,TOTALS,ROMANIA,200,36,70,51.4,30,51,58.8,6,19,31.6,10,23,43.5,14,33,47,23,26,16,10,6,88,1
15865,369018,413_13_23,SWITZERLAND,0,TOTALS,SWITZERLAND,200,20,60,33.3,16,47,34.0,4,13,30.8,14,22,63.6,9,28,37,11,19,22,9,0,58,0
15866,369031,413_13_24,CZECH REPUBLIC,0,TOTALS,CZECH REPUBLIC,200,35,74,47.3,28,58,48.3,7,16,43.8,10,14,71.4,15,33,48,21,21,18,19,3,87,1
15867,369044,413_13_24,BELARUS,0,TOTALS,BELARUS,200,22,62,35.5,18,39,46.2,4,23,17.4,11,22,50.0,12,33,45,10,15,27,9,7,59,0
15868,369057,413_13_25,FINLAND,0,TOTALS,FINLAND,200,21,64,32.8,18,51,35.3,3,13,23.1,10,19,52.6,18,25,43,10,21,14,10,0,55,1
15869,369070,413_13_25,ESTONIA,0,TOTALS,ESTONIA,200,15,47,31.9,10,24,41.7,5,23,21.7,10,14,71.4,9,30,39,10,16,22,6,3,45,0
15870,369083,413_13_26,ENGLAND,0,TOTALS,ENGLAND,200,18,65,27.7,16,40,40.0,2,25,8.0,18,27,66.7,19,36,55,5,13,21,8,4,56,1
15871,369096,413_13_26,IRELAND,0,TOTALS,IRELAND,200,20,69,29.0,18,53,34.0,2,16,12.5,5,11,45.5,13,30,43,9,23,15,8,2,47,0
15872,369109,413_13_27,BOSNIA AND HERZEGOVINA,0,TOTALS,BOSNIA AND HERZEGOVINA,200,26,67,38.8,18,46,39.1,8,21,38.1,12,17,70.6,19,18,37,18,26,13,15,4,72,1
15873,369122,413_13_27,DENMARK,0,TOTALS,DENMARK,200,24,49,49.0,20,34,58.8,4,15,26.7,19,27,70.4,13,31,44,5,18,26,8,11,71,0
15874,369135,413_13_28,MKD,0,TOTALS,MKD,200,32,76,42.1,28,52,53.8,4,24,16.7,11,22,50.0,16,28,44,19,15,16,16,1,79,1
15875,369148,413_13_28,PORTUGAL,0,TOTALS,PORTUGAL,200,23,58,39.7,19,42,45.2,4,16,25.0,9,12,75.0,8,33,41,16,16,28,8,2,59,0
15876,369161,413_13_29,GEORGIA,0,TOTALS,GEORGIA,200,31,64,48.4,21,36,58.3,10,28,35.7,11,20,55.0,15,36,51,16,14,25,19,4,83,1
15877,369174,413_13_29,LUXEMBOURG,0,TOTALS,LUXEMBOURG,200,17,60,28.3,16,48,33.3,1,12,8.3,4,9,44.4,8,23,31,9,20,32,11,3,39,0
15878,369187,413_13_30,NETHERLANDS,0,TOTALS,NETHERLANDS,200,29,67,43.3,28,54,51.9,1,13,7.7,9,18,50.0,20,34,54,7,19,21,13,3,68,1
15879,369200,413_13_30,SLOVAK REPUBLIC,0,TOTALS,SLOVAK REPUBLIC,200,16,49,32.7,12,35,34.3,4,14,28.6,7,15,46.7,4,22,26,6,17,21,8,2,43,0
15880,369213,413_13_31,SLOVENIA,0,TOTALS,SLOVENIA,200,29,68,42.6,21,46,45.7,8,22,36.4,6,11,54.5,12,33,45,11,21,17,16,0,72,1
15881,369226,413_13_31,ENGLAND,0,TOTALS,ENGLAND,200,25,66,37.9,18,45,40.0,7,21,33.3,13,23,56.5,12,33,45,9,15,21,7,5,70,0
15882,369239,413_13_32,NORWAY,0,TOTALS,NORWAY,200,15,63,23.8,13,41,31.7,2,22,9.1,4,6,66.7,7,20,27,10,14,17,16,1,36,0
15883,369252,413_13_32,FINLAND,0,TOTALS,FINLAND,200,26,61,42.6,18,39,46.2,8,22,36.4,11,21,52.4,20,41,61,14,11,25,8,3,71,1
15884,369265,413_13_33,IRELAND,0,TOTALS,IRELAND,200,16,56,28.6,10,41,24.4,6,15,40.0,15,22,68.2,10,31,41,7,20,27,10,2,53,0
15885,369278,413_13_33,ROMANIA,0,TOTALS,ROMANIA,200,26,69,37.7,19,41,46.3,7,28,25.0,8,23,34.8,17,31,48,19,23,17,16,6,67,1
15886,369291,413_13_34,ISRAEL,0,TOTALS,ISRAEL,200,25,60,41.7,19,38,50.0,6,22,27.3,8,10,80.0,5,25,30,12,23,16,17,0,64,1
15887,369304,413_13_34,NETHERLANDS,0,TOTALS,NETHERLANDS,200,20,63,31.7,16,43,37.2,4,20,20.0,11,19,57.9,17,34,51,8,14,27,5,4,55,0
15888,369317,413_13_35,ESTONIA,0,TOTALS,ESTONIA,200,22,55,40.0,9,26,34.6,13,29,44.8,11,27,40.7,14,27,41,17,24,15,7,3,68,1
15889,369330,413_13_35,MKD,0,TOTALS,MKD,200,20,60,33.3,13,42,31.0,7,18,38.9,18,29,62.1,19,24,43,11,26,11,7,1,65,0
15890,369343,413_13_36,BELARUS,0,TOTALS,BELARUS,200,27,67,40.3,22,53,41.5,5,14,35.7,7,12,58.3,16,32,48,18,21,26,5,2,66,0
15891,369356,413_13_36,GEORGIA,0,TOTALS,GEORGIA,200,26,64,40.6,17,36,47.2,9,28,32.1,13,26,50.0,9,26,35,20,12,13,12,3,74,1
15892,369369,413_13_37,SLOVAK REPUBLIC,0,TOTALS,SLOVAK REPUBLIC,200,19,47,40.4,14,32,43.8,5,15,33.3,8,14,57.1,14,26,40,9,21,41,9,3,51,0
15893,369382,413_13_37,BOSNIA AND HERZEGOVINA,0,TOTALS,BOSNIA AND HERZEGOVINA,200,25,61,41.0,24,47,51.1,1,14,7.1,21,31,67.7,16,18,34,11,21,22,30,5,72,1
15894,369395,413_13_38,PORTUGAL,0,TOTALS,PORTUGAL,200,31,65,47.7,28,46,60.9,3,19,15.8,3,12,25.0,14,33,47,18,13,20,13,5,68,1
15895,369408,413_13_38,BULGARIA,0,TOTALS,BULGARIA,200,23,65,35.4,19,45,42.2,4,20,20.0,8,16,50.0,13,24,37,14,15,21,9,2,58,0
15896,369421,413_13_39,LUXEMBOURG,0,TOTALS,LUXEMBOURG,200,12,46,26.1,12,35,34.3,0,11,0.0,3,6,50.0,8,22,30,8,16,33,13,2,27,0
15897,369434,413_13_39,AUSTRIA,0,TOTALS,AUSTRIA,200,23,71,32.4,18,45,40.0,5,26,19.2,5,12,41.7,27,25,52,19,12,26,13,2,56,1
15898,369447,413_13_40,HUNGARY,0,TOTALS,HUNGARY,200,21,54,38.9,17,37,45.9,4,17,23.5,10,17,58.8,6,30,36,9,21,19,8,2,56,0
15899,369460,413_13_40,CZECH REPUBLIC,0,TOTALS,CZECH REPUBLIC,200,26,62,41.9,18,43,41.9,8,19,42.1,10,19,52.6,12,30,42,11,18,17,13,4,70,1
15900,369473,413_13_41,MKD,0,TOTALS,MKD,200,21,54,38.9,18,39,46.2,3,15,20.0,14,27,51.9,10,26,36,9,21,21,10,3,59,0
15901,369486,413_13_41,FINLAND,0,TOTALS,FINLAND,200,28,66,42.4,20,46,43.5,8,20,40.0,13,19,68.4,15,31,46,12,25,20,7,2,77,1
15902,369499,413_13_42,ROMANIA,0,TOTALS,ROMANIA,200,21,58,36.2,17,37,45.9,4,21,19.0,11,24,45.8,15,13,28,11,18,16,7,3,57,0
15903,369512,413_13_42,SLOVENIA,0,TOTALS,SLOVENIA,200,35,66,53.0,29,51,56.9,6,15,40.0,7,11,63.6,16,32,48,19,26,17,9,1,83,1
15904,369525,413_13_43,SWITZERLAND,0,TOTALS,SWITZERLAND,200,22,58,37.9,14,31,45.2,8,27,29.6,13,22,59.1,16,31,47,18,18,26,13,4,65,1
15905,369538,413_13_43,IRELAND,0,TOTALS,IRELAND,200,21,69,30.4,18,47,38.3,3,22,13.6,9,14,64.3,19,24,43,9,19,24,15,0,54,0
15906,369551,413_13_44,DENMARK,0,TOTALS,DENMARK,200,26,45,57.8,20,30,66.7,6,15,40.0,12,24,50.0,6,39,45,8,21,30,12,9,70,1
15907,369564,413_13_44,SLOVAK REPUBLIC,0,TOTALS,SLOVAK REPUBLIC,200,16,62,25.8,9,34,26.5,7,28,25.0,11,16,68.8,18,24,42,12,23,23,17,4,50,0
15908,369577,413_13_45,PORTUGAL,0,TOTALS,PORTUGAL,200,29,66,43.9,22,42,52.4,7,24,29.2,18,22,81.8,10,28,38,22,10,17,11,3,83,1
15909,369590,413_13_45,NORWAY,0,TOTALS,NORWAY,200,22,60,36.7,12,37,32.4,10,23,43.5,6,10,60.0,13,28,41,17,18,27,11,2,60,0
15910,369603,413_13_46,AUSTRIA,0,TOTALS,AUSTRIA,200,29,60,48.3,24,46,52.2,5,14,35.7,2,7,28.6,14,17,31,17,28,25,6,0,65,0
15911,369616,413_13_46,GEORGIA,0,TOTALS,GEORGIA,200,28,50,56.0,23,33,69.7,5,17,29.4,20,37,54.1,12,17,29,11,15,24,15,2,81,1
15912,369629,413_13_47,BOSNIA AND HERZEGOVINA,0,TOTALS,BOSNIA AND HERZEGOVINA,200,22,64,34.4,11,36,30.6,11,28,39.3,10,15,66.7,16,32,48,11,17,24,6,3,65,1
15913,369642,413_13_47,ISRAEL,0,TOTALS,ISRAEL,200,21,60,35.0,17,45,37.8,4,15,26.7,11,17,64.7,11,27,38,7,24,20,14,1,57,0
15914,369655,413_13_48,HUNGARY,0,TOTALS,HUNGARY,200,27,78,34.6,25,63,39.7,2,15,13.3,11,17,64.7,12,22,34,12,17,14,15,5,67,0
15915,369668,413_13_48,BELARUS,0,TOTALS,BELARUS,200,28,62,45.2,24,49,49.0,4,13,30.8,13,16,81.2,13,37,50,14,14,23,8,6,73,1
15916,369681,413_13_49,CZECH REPUBLIC,0,TOTALS,CZECH REPUBLIC,200,33,82,40.2,22,47,46.8,11,35,31.4,4,12,33.3,25,33,58,14,12,18,13,3,81,1
15917,369694,413_13_49,LUXEMBOURG,0,TOTALS,LUXEMBOURG,200,17,53,32.1,13,38,34.2,4,15,26.7,6,10,60.0,4,26,30,11,8,27,15,2,44,0
15918,369707,413_13_50,BULGARIA,0,TOTALS,BULGARIA,200,18,53,34.0,13,39,33.3,5,14,35.7,4,8,50.0,9,24,33,7,21,22,4,2,45,0
15919,369720,413_13_50,ESTONIA,0,TOTALS,ESTONIA,200,21,51,41.2,15,33,45.5,6,18,33.3,19,26,73.1,10,27,37,13,11,16,12,1,67,1
15920,369733,413_13_51,FINLAND,0,TOTALS,FINLAND,200,29,64,45.3,24,50,48.0,5,14,35.7,7,14,50.0,10,26,36,8,20,19,9,1,70,1
15921,369746,413_13_51,ENGLAND,0,TOTALS,ENGLAND,200,22,62,35.5,18,41,43.9,4,21,19.0,12,22,54.5,18,32,50,8,17,26,10,7,60,0
15922,369759,413_13_52,NORWAY,0,TOTALS,NORWAY,200,22,69,31.9,17,44,38.6,5,25,20.0,5,8,62.5,17,27,44,11,20,24,8,5,54,0
15923,369772,413_13_52,IRELAND,0,TOTALS,IRELAND,200,21,62,33.9,15,43,34.9,6,19,31.6,10,19,52.6,15,29,44,8,13,24,8,0,58,1
15924,369785,413_13_53,ESTONIA,0,TOTALS,ESTONIA,200,22,55,40.0,16,32,50.0,6,23,26.1,15,20,75.0,11,18,29,16,16,12,9,3,65,0
15925,369798,413_13_53,ROMANIA,0,TOTALS,ROMANIA,200,29,59,49.2,24,46,52.2,5,13,38.5,8,10,80.0,12,24,36,18,21,15,2,4,71,1
15926,369811,413_13_54,MKD,0,TOTALS,MKD,200,23,67,34.3,19,43,44.2,4,24,16.7,14,19,73.7,19,22,41,11,19,18,11,2,64,0
15927,369824,413_13_54,SLOVENIA,0,TOTALS,SLOVENIA,200,32,62,51.6,30,43,69.8,2,19,10.5,10,13,76.9,11,30,41,9,18,21,9,4,76,1
15928,369837,413_13_55,PORTUGAL,0,TOTALS,PORTUGAL,200,22,66,33.3,19,49,38.8,3,17,17.6,8,12,66.7,11,30,41,11,18,26,12,8,55,0
15929,369850,413_13_55,SWITZERLAND,0,TOTALS,SWITZERLAND,200,25,65,38.5,19,44,43.2,6,21,28.6,17,24,70.8,14,34,48,14,11,26,20,1,73,1
15930,369863,413_13_56,NETHERLANDS,0,TOTALS,NETHERLANDS,200,26,62,41.9,18,49,36.7,8,13,61.5,9,21,42.9,11,28,39,18,20,17,14,4,69,1
15931,369876,413_13_56,HUNGARY,0,TOTALS,HUNGARY,200,22,62,35.5,19,41,46.3,3,21,14.3,14,20,70.0,14,31,45,13,18,23,3,1,61,0
15932,369889,413_13_57,BOSNIA AND HERZEGOVINA,0,TOTALS,BOSNIA AND HERZEGOVINA,200,24,85,28.2,17,55,30.9,7,30,23.3,20,23,87.0,31,25,56,10,20,15,13,3,75,1
15933,369902,413_13_57,GEORGIA,0,TOTALS,GEORGIA,200,23,51,45.1,18,35,51.4,5,16,31.2,12,22,54.5,11,32,43,11,26,21,4,3,63,0
15934,369915,413_13_58,SLOVAK REPUBLIC,0,TOTALS,SLOVAK REPUBLIC,225,27,72,37.5,24,56,42.9,3,16,18.8,13,33,39.4,17,29,46,13,29,25,15,3,70,0
15935,369928,413_13_58,BELARUS,0,TOTALS,BELARUS,225,30,79,38.0,28,60,46.7,2,19,10.5,15,30,50.0,25,38,63,5,24,30,16,6,77,1
15936,369941,413_13_59,ISRAEL,0,TOTALS,ISRAEL,200,35,63,55.6,26,42,61.9,9,21,42.9,14,23,60.9,9,27,36,23,16,19,21,2,93,1
15937,369954,413_13_59,AUSTRIA,0,TOTALS,AUSTRIA,200,16,53,30.2,13,28,46.4,3,25,12.0,7,9,77.8,9,23,32,9,20,35,8,0,42,0
15938,369967,413_13_60,DENMARK,0,TOTALS,DENMARK,200,26,57,45.6,21,40,52.5,5,17,29.4,12,27,44.4,19,31,50,16,18,20,10,6,69,1
15939,369980,413_13_60,CZECH REPUBLIC,0,TOTALS,CZECH REPUBLIC,200,20,59,33.9,19,35,54.3,1,24,4.2,13,21,61.9,16,21,37,8,25,14,8,3,54,0
15940,369993,413_13_61,SLOVENIA,0,TOTALS,SLOVENIA,200,32,67,47.8,26,38,68.4,6,29,20.7,9,12,75.0,8,29,37,19,21,15,4,3,79,0
15941,370006,413_13_61,FINLAND,0,TOTALS,FINLAND,200,28,66,42.4,15,36,41.7,13,30,43.3,19,25,76.0,13,28,41,20,18,13,7,1,88,1
15942,370019,413_13_62,IRELAND,0,TOTALS,IRELAND,200,28,57,49.1,23,43,53.5,5,14,35.7,6,10,60.0,8,29,37,11,15,22,11,1,67,1
15943,370032,413_13_62,BULGARIA,0,TOTALS,BULGARIA,200,22,64,34.4,15,43,34.9,7,21,33.3,6,11,54.5,16,23,39,10,15,22,12,3,57,0
15944,370045,413_13_63,SWITZERLAND,0,TOTALS,SWITZERLAND,200,26,53,49.1,19,37,51.4,7,16,43.8,14,22,63.6,16,23,39,16,14,21,7,2,73,1
15945,370058,413_13_63,ESTONIA,0,TOTALS,ESTONIA,200,26,57,45.6,18,34,52.9,8,23,34.8,10,14,71.4,8,18,26,15,19,16,13,1,70,0
15946,370071,413_13_64,ENGLAND,0,TOTALS,ENGLAND,200,20,74,27.0,15,42,35.7,5,32,15.6,12,14,85.7,18,42,60,8,9,16,9,3,57,1
15947,370084,413_13_64,MKD,0,TOTALS,MKD,200,23,69,33.3,20,49,40.8,3,20,15.0,6,6,100.0,7,35,42,6,17,14,8,2,55,0
15948,370097,413_13_65,LUXEMBOURG,0,TOTALS,LUXEMBOURG,200,20,57,35.1,11,37,29.7,9,20,45.0,3,9,33.3,8,20,28,7,19,23,15,0,52,0
15949,370110,413_13_65,SLOVAK REPUBLIC,0,TOTALS,SLOVAK REPUBLIC,200,23,55,41.8,19,41,46.3,4,14,28.6,17,26,65.4,14,28,42,7,12,28,11,1,67,1
15950,370123,413_13_66,AUSTRIA,0,TOTALS,AUSTRIA,200,19,54,35.2,13,38,34.2,6,16,37.5,18,25,72.0,9,20,29,12,20,25,9,0,62,0
15951,370136,413_13_66,NETHERLANDS,0,TOTALS,NETHERLANDS,200,30,69,43.5,27,53,50.9,3,16,18.8,15,22,68.2,21,30,51,17,22,22,14,3,78,1
15952,370149,413_13_67,CZECH REPUBLIC,0,TOTALS,CZECH REPUBLIC,200,20,61,32.8,12,37,32.4,8,24,33.3,11,15,73.3,12,23,35,10,22,14,3,5,59,0
15953,370162,413_13_67,BOSNIA AND HERZEGOVINA,0,TOTALS,BOSNIA AND HERZEGOVINA,200,23,57,40.4,16,30,53.3,7,27,25.9,16,26,61.5,15,30,45,12,16,13,7,2,69,1
15954,370175,413_13_68,ROMANIA,0,TOTALS,ROMANIA,200,22,55,40.0,18,35,51.4,4,20,20.0,17,35,48.6,14,31,45,9,18,21,14,6,65,1
15955,370188,413_13_68,PORTUGAL,0,TOTALS,PORTUGAL,200,19,59,32.2,16,46,34.8,3,13,23.1,7,15,46.7,12,27,39,10,26,25,9,0,48,0
15956,370201,413_13_69,HUNGARY,0,TOTALS,HUNGARY,200,22,59,37.3,14,43,32.6,8,16,50.0,5,9,55.6,13,28,41,13,13,24,8,2,57,0
15957,370214,413_13_69,ISRAEL,0,TOTALS,ISRAEL,200,31,75,41.3,24,47,51.1,7,28,25.0,13,22,59.1,19,26,45,15,13,16,18,5,82,1
15958,370227,413_13_70,GEORGIA,0,TOTALS,GEORGIA,200,21,58,36.2,15,33,45.5,6,25,24.0,14,25,56.0,15,24,39,15,12,17,13,1,62,0
15959,370240,413_13_70,DENMARK,0,TOTALS,DENMARK,200,30,64,46.9,25,43,58.1,5,21,23.8,9,14,64.3,14,31,45,14,23,20,7,6,74,1
15960,370253,413_13_71,PORTUGAL,0,TOTALS,PORTUGAL,200,25,73,34.2,21,58,36.2,4,15,26.7,7,8,87.5,14,38,52,14,24,21,7,2,61,0
15961,370266,413_13_71,HUNGARY,0,TOTALS,HUNGARY,200,19,66,28.8,14,37,37.8,5,29,17.2,25,33,75.8,7,32,39,13,11,12,15,1,68,1
15962,370279,413_13_72,ENGLAND,0,TOTALS,ENGLAND,200,31,84,36.9,25,61,41.0,6,23,26.1,12,24,50.0,31,34,65,11,15,16,12,2,80,1
15963,370292,413_13_72,GEORGIA,0,TOTALS,GEORGIA,200,23,71,32.4,22,53,41.5,1,18,5.6,5,7,71.4,13,29,42,8,21,21,7,0,52,0
15964,370305,413_13_73,AUSTRIA,0,TOTALS,AUSTRIA,200,27,60,45.0,21,43,48.8,6,17,35.3,13,22,59.1,14,32,46,15,18,13,10,3,73,1
15965,370318,413_13_73,ESTONIA,0,TOTALS,ESTONIA,200,22,65,33.8,16,43,37.2,6,22,27.3,5,16,31.2,18,23,41,13,18,16,7,1,55,0
15966,370331,413_13_74,CZECH REPUBLIC,0,TOTALS,CZECH REPUBLIC,200,30,66,45.5,23,40,57.5,7,26,26.9,15,21,71.4,10,21,31,15,24,16,9,1,82,1
15967,370344,413_13_74,MKD,0,TOTALS,MKD,200,25,52,48.1,20,36,55.6,5,16,31.2,20,30,66.7,8,26,34,5,22,18,7,1,75,0
15968,370357,413_13_75,ROMANIA,0,TOTALS,ROMANIA,200,19,55,34.5,16,38,42.1,3,17,17.6,17,24,70.8,10,35,45,13,17,24,11,6,58,1
15969,370370,413_13_75,NETHERLANDS,0,TOTALS,NETHERLANDS,200,20,69,29.0,17,53,32.1,3,16,18.8,4,13,30.8,16,26,42,8,19,21,13,4,47,0
15970,370383,413_13_76,BOSNIA AND HERZEGOVINA,0,TOTALS,BOSNIA AND HERZEGOVINA,200,24,61,39.3,17,34,50.0,7,27,25.9,15,27,55.6,21,27,48,16,15,17,10,1,70,1
15971,370396,413_13_76,SLOVENIA,0,TOTALS,SLOVENIA,200,23,59,39.0,17,38,44.7,6,21,28.6,10,11,90.9,10,20,30,10,24,16,10,4,62,0
15972,370409,413_13_77,ISRAEL,0,TOTALS,ISRAEL,200,36,69,52.2,29,48,60.4,7,21,33.3,12,16,75.0,8,38,46,21,19,14,6,5,91,1
15973,370422,413_13_77,SWITZERLAND,0,TOTALS,SWITZERLAND,200,24,74,32.4,17,48,35.4,7,26,26.9,7,14,50.0,15,22,37,12,15,15,9,1,62,0
15974,370435,413_13_78,FINLAND,0,TOTALS,FINLAND,200,20,57,35.1,12,39,30.8,8,18,44.4,8,17,47.1,6,18,24,10,26,22,7,1,56,0
15975,370448,413_13_78,DENMARK,0,TOTALS,DENMARK,200,32,56,57.1,29,44,65.9,3,12,25.0,20,32,62.5,12,39,51,9,18,23,12,7,87,1
15976,370461,413_13_79,PORTUGAL,0,TOTALS,PORTUGAL,200,22,74,29.7,19,57,33.3,3,17,17.6,13,24,54.2,23,28,51,10,21,6,9,0,60,1
15977,370474,413_13_79,ESTONIA,0,TOTALS,ESTONIA,200,16,51,31.4,11,26,42.3,5,25,20.0,17,28,60.7,12,30,42,11,19,14,0,3,54,0
15978,370487,413_13_80,NORWAY,0,TOTALS,NORWAY,200,22,69,31.9,17,43,39.5,5,26,19.2,3,3,100.0,18,26,44,13,15,19,14,0,52,0
15979,370500,413_13_80,LUXEMBOURG,0,TOTALS,LUXEMBOURG,200,23,59,39.0,18,39,46.2,5,20,25.0,11,20,55.0,14,27,41,13,11,18,10,2,62,1
15980,370513,413_13_81,GEORGIA,0,TOTALS,GEORGIA,200,32,71,45.1,22,44,50.0,10,27,37.0,12,24,50.0,15,35,50,18,16,17,10,3,86,1
15981,370526,413_13_81,MKD,0,TOTALS,MKD,200,26,69,37.7,18,43,41.9,8,26,30.8,4,8,50.0,10,34,44,9,20,19,8,3,64,0
15982,370539,413_13_82,HUNGARY,0,TOTALS,HUNGARY,200,22,60,36.7,17,39,43.6,5,21,23.8,11,16,68.8,9,24,33,12,14,12,7,1,60,1
15983,370552,413_13_82,AUSTRIA,0,TOTALS,AUSTRIA,200,24,55,43.6,22,42,52.4,2,13,15.4,7,11,63.6,7,32,39,13,11,17,6,0,57,0
15984,370565,413_13_83,BULGARIA,0,TOTALS,BULGARIA,200,28,72,38.9,25,52,48.1,3,20,15.0,11,25,44.0,15,26,41,20,13,22,16,0,70,1
15985,370578,413_13_83,BELARUS,0,TOTALS,BELARUS,200,30,71,42.3,28,57,49.1,2,14,14.3,5,8,62.5,15,32,47,20,17,24,12,1,67,0
15986,370591,413_13_84,ENGLAND,0,TOTALS,ENGLAND,200,23,53,43.4,18,36,50.0,5,17,29.4,7,13,53.8,14,34,48,10,12,28,4,4,58,0
15987,370604,413_13_84,CZECH REPUBLIC,0,TOTALS,CZECH REPUBLIC,200,29,71,40.8,23,51,45.1,6,20,30.0,8,8,100.0,12,20,32,14,18,11,16,2,72,1
15988,370617,413_13_85,NETHERLANDS,0,TOTALS,NETHERLANDS,200,25,68,36.8,21,49,42.9,4,19,21.1,11,18,61.1,20,23,43,15,20,16,5,2,65,0
15989,370630,413_13_85,SWITZERLAND,0,TOTALS,SWITZERLAND,200,27,70,38.6,19,45,42.2,8,25,32.0,6,13,46.2,23,26,49,19,18,15,6,1,68,1
15990,370643,413_13_86,IRELAND,0,TOTALS,IRELAND,200,13,56,23.2,10,32,31.2,3,24,12.5,10,24,41.7,20,29,49,1,14,19,8,2,39,0
15991,370656,413_13_86,SLOVAK REPUBLIC,0,TOTALS,SLOVAK REPUBLIC,200,17,60,28.3,13,46,28.3,4,14,28.6,3,7,42.9,16,29,45,7,21,21,4,6,41,1
15992,370669,413_13_87,FINLAND,0,TOTALS,FINLAND,200,30,51,58.8,16,25,64.0,14,26,53.8,22,28,78.6,7,30,37,18,19,15,15,1,96,1
15993,370682,413_13_87,SLOVENIA,0,TOTALS,SLOVENIA,200,24,64,37.5,15,33,45.5,9,31,29.0,5,11,45.5,12,21,33,17,21,21,7,4,62,0
15994,370695,413_13_88,ROMANIA,0,TOTALS,ROMANIA,200,27,69,39.1,23,46,50.0,4,23,17.4,12,17,70.6,13,28,41,17,23,22,7,5,70,0
15995,370708,413_13_88,ISRAEL,0,TOTALS,ISRAEL,200,30,66,45.5,23,45,51.1,7,21,33.3,20,29,69.0,12,27,39,23,19,15,17,4,87,1
15996,370721,413_13_89,DENMARK,0,TOTALS,DENMARK,200,28,58,48.3,25,44,56.8,3,14,21.4,13,18,72.2,13,31,44,10,22,17,3,10,72,1
15997,370734,413_13_89,BOSNIA AND HERZEGOVINA,0,TOTALS,BOSNIA AND HERZEGOVINA,200,20,67,29.9,12,45,26.7,8,22,36.4,21,26,80.8,16,20,36,8,18,8,4,3,69,0
15998,370747,414_13_01,ANDORRA,0,TOTALS,ANDORRA,200,19,64,29.7,15,51,29.4,4,13,30.8,6,11,54.5,10,21,31,8,14,27,17,1,48,0
15999,370760,414_13_01,SCOTLAND,0,TOTALS,SCOTLAND,200,35,77,45.5,31,65,47.7,4,12,33.3,6,13,46.2,22,35,57,11,12,28,17,1,80,1
16000,370773,414_13_02,WALES,0,TOTALS,WALES,200,24,70,34.3,18,39,46.2,6,31,19.4,9,19,47.4,16,23,39,8,22,20,6,1,63,0
16001,370786,414_13_02,GIBRALTAR,0,TOTALS,GIBRALTAR,200,29,77,37.7,28,70,40.0,1,7,14.3,17,28,60.7,25,28,53,10,14,15,9,4,76,1
16002,370799,414_13_03,SAN MARINO,0,TOTALS,SAN MARINO,200,25,64,39.1,22,46,47.8,3,18,16.7,8,20,40.0,11,25,36,1,28,22,12,4,61,0
16003,370812,414_13_03,ANDORRA,0,TOTALS,ANDORRA,200,24,59,40.7,24,54,44.4,0,5,0.0,25,44,56.8,16,28,44,13,20,15,14,1,73,1
16004,370825,414_13_04,SCOTLAND,0,TOTALS,SCOTLAND,200,35,75,46.7,33,63,52.4,2,12,16.7,2,9,22.2,17,29,46,6,12,25,23,4,74,1
16005,370838,414_13_04,WALES,0,TOTALS,WALES,200,16,55,29.1,12,41,29.3,4,14,28.6,4,19,21.1,14,23,37,3,8,36,14,1,40,0
16006,370851,414_13_05,WALES,0,TOTALS,WALES,200,31,67,46.3,29,59,49.2,2,8,25.0,12,28,42.9,18,46,64,9,17,31,10,2,76,1
16007,370864,414_13_05,SAN MARINO,0,TOTALS,SAN MARINO,200,23,74,31.1,20,58,34.5,3,16,18.8,12,22,54.5,10,23,33,9,26,18,19,1,61,0
16008,370877,414_13_06,GIBRALTAR,0,TOTALS,GIBRALTAR,200,22,64,34.4,16,47,34.0,6,17,35.3,7,10,70.0,12,27,39,6,15,19,11,4,57,1
16009,370890,414_13_06,SCOTLAND,0,TOTALS,SCOTLAND,200,20,63,31.7,17,43,39.5,3,20,15.0,7,15,46.7,16,29,45,9,18,22,9,5,50,0
16010,370903,414_13_07,ANDORRA,0,TOTALS,ANDORRA,200,27,62,43.5,25,54,46.3,2,8,25.0,16,35,45.7,11,28,39,15,19,20,8,5,72,1
16011,370916,414_13_07,WALES,0,TOTALS,WALES,200,19,63,30.2,16,51,31.4,3,12,25.0,20,24,83.3,13,31,44,4,28,24,9,1,61,0
16012,370929,414_13_08,SAN MARINO,0,TOTALS,SAN MARINO,200,14,65,21.5,11,48,22.9,3,17,17.6,11,20,55.0,24,28,52,5,21,24,14,1,42,0
16013,370942,414_13_08,GIBRALTAR,0,TOTALS,GIBRALTAR,200,20,67,29.9,19,58,32.8,1,9,11.1,15,29,51.7,24,31,55,4,20,20,10,6,56,1
16014,370955,414_13_09,SCOTLAND,0,TOTALS,SCOTLAND,200,37,88,42.0,34,73,46.6,3,15,20.0,6,10,60.0,26,38,64,17,13,21,20,2,83,1
16015,370968,414_13_09,SAN MARINO,0,TOTALS,SAN MARINO,200,21,67,31.3,20,54,37.0,1,13,7.7,1,5,20.0,9,27,36,4,12,27,17,3,44,0
16016,370981,414_13_10,GIBRALTAR,0,TOTALS,GIBRALTAR,200,21,67,31.3,19,54,35.2,2,13,15.4,9,20,45.0,19,33,52,4,21,22,19,9,53,1
16017,370994,414_13_10,ANDORRA,0,TOTALS,ANDORRA,200,11,57,19.3,9,44,20.5,2,13,15.4,15,23,65.2,16,30,46,5,19,28,10,3,39,0
16018,374731,418_13_01,NEW ZEALAND,0,TOTALS,NEW ZEALAND,200,22,56,39.3,16,39,41.0,6,17,35.3,9,12,75.0,8,23,31,12,18,13,2,2,59,0
16019,374744,418_13_01,AUSTRALIA,0,TOTALS,AUSTRALIA,200,26,60,43.3,21,43,48.8,5,17,29.4,13,17,76.5,8,25,33,11,18,6,9,6,70,1
16020,374757,418_13_02,AUSTRALIA,0,TOTALS,AUSTRALIA,200,27,57,47.4,17,35,48.6,10,22,45.5,12,15,80.0,10,17,27,20,18,15,6,5,76,1
16021,374770,418_13_02,NEW ZEALAND,0,TOTALS,NEW ZEALAND,200,23,56,41.1,17,37,45.9,6,19,31.6,11,13,84.6,11,19,30,7,18,15,8,2,63,0
16022,374833,420_13_01,AUSTRALIA,0,TOTALS,AUSTRALIA,200,33,75,44.0,27,55,49.1,6,20,30.0,7,14,50.0,17,23,40,14,19,19,8,3,79,1
16023,374846,420_13_01,NEW ZEALAND,0,TOTALS,NEW ZEALAND,200,22,57,38.6,21,47,44.7,1,10,10.0,11,20,55.0,8,17,25,5,18,21,3,5,56,0
16024,374859,420_13_02,NEW ZEALAND,0,TOTALS,NEW ZEALAND,200,26,61,42.6,23,52,44.2,3,9,33.3,13,18,72.2,9,25,34,9,20,21,5,2,68,0
16025,374872,420_13_02,AUSTRALIA,0,TOTALS,AUSTRALIA,200,27,61,44.3,21,43,48.8,6,18,33.3,19,26,73.1,12,21,33,12,20,18,10,3,79,1
16026,374885,420_13_03,AUSTRALIA,0,TOTALS,AUSTRALIA,200,17,63,27.0,15,45,33.3,2,18,11.1,23,35,65.7,20,20,40,9,19,16,5,2,59,0
16027,374898,420_13_03,NEW ZEALAND,0,TOTALS,NEW ZEALAND,200,22,57,38.6,15,43,34.9,7,14,50.0,15,21,71.4,13,28,41,11,28,20,2,7,66,1
16028,374987,422_14_01,CROATIA,0,TOTALS,CROATIA,225,28,61,45.9,21,36,58.3,7,25,28.0,18,20,90.0,10,33,43,16,23,21,7,4,81,1
16029,375000,422_14_01,PHILIPPINES,0,TOTALS,PHILIPPINES,225,29,79,36.7,19,51,37.3,10,28,35.7,10,13,76.9,14,24,38,13,23,15,8,1,78,0
16030,375013,422_14_02,UKRAINE,0,TOTALS,UKRAINE,200,22,51,43.1,12,28,42.9,10,23,43.5,18,26,69.2,6,30,36,11,18,17,6,1,72,1
16031,375026,422_14_02,DOMINICAN REPUBLIC,0,TOTALS,DOMINICAN REPUBLIC,200,24,64,37.5,17,37,45.9,7,27,25.9,7,14,50.0,13,28,41,13,22,17,4,2,62,0
16032,375039,422_14_03,ANGOLA,0,TOTALS,ANGOLA,200,27,59,45.8,19,42,45.2,8,17,47.1,18,24,75.0,12,34,46,14,19,16,4,2,80,1
16033,375052,422_14_03,KOREA,0,TOTALS,KOREA,200,27,73,37.0,18,41,43.9,9,32,28.1,6,11,54.5,15,21,36,17,22,9,4,6,69,0
16034,375065,422_14_04,EGYPT,0,TOTALS,EGYPT,200,24,63,38.1,18,40,45.0,6,23,26.1,10,17,58.8,8,22,30,14,18,12,7,2,64,0
16035,375078,422_14_04,SERBIA,0,TOTALS,SERBIA,200,33,63,52.4,25,42,59.5,8,21,38.1,11,19,57.9,11,32,43,18,18,13,6,3,85,1
16036,375091,422_14_05,NEW ZEALAND,0,TOTALS,NEW ZEALAND,200,27,68,39.7,18,41,43.9,9,27,33.3,10,14,71.4,21,26,47,12,23,18,7,1,73,0
16037,375104,422_14_05,TURKEY,0,TOTALS,TURKEY,200,26,60,43.3,19,37,51.4,7,23,30.4,17,21,81.0,10,21,31,12,20,14,9,4,76,1
16038,375117,422_14_06,AUSTRALIA,0,TOTALS,AUSTRALIA,200,29,57,50.9,23,44,52.3,6,13,46.2,16,21,76.2,10,15,25,12,18,19,6,2,80,0
16039,375130,422_14_06,SLOVENIA,0,TOTALS,SLOVENIA,200,34,60,56.7,24,39,61.5,10,21,47.6,12,14,85.7,12,20,32,10,27,19,10,3,90,1
16040,375143,422_14_07,PUERTO RICO,0,TOTALS,PUERTO RICO,200,26,66,39.4,18,43,41.9,8,23,34.8,15,20,75.0,6,29,35,5,26,12,3,1,75,0
16041,375156,422_14_07,ARGENTINA,0,TOTALS,ARGENTINA,200,34,66,51.5,24,39,61.5,10,27,37.0,20,29,69.0,7,34,41,22,25,10,2,1,98,1
16042,375169,422_14_08,FRANCE,0,TOTALS,FRANCE,200,22,52,42.3,16,33,48.5,6,19,31.6,13,16,81.2,4,26,30,9,23,16,5,4,63,0
16043,375182,422_14_08,BRAZIL,0,TOTALS,BRAZIL,200,23,61,37.7,18,45,40.0,5,16,31.2,14,24,58.3,16,26,42,9,21,11,8,2,65,1
16044,375195,422_14_09,MEXICO,0,TOTALS,MEXICO,200,33,61,54.1,27,40,67.5,6,21,28.6,2,2,100.0,8,18,26,12,20,17,5,1,74,0
16045,375208,422_14_09,LITHUANIA,0,TOTALS,LITHUANIA,200,35,58,60.3,24,38,63.2,11,20,55.0,6,11,54.5,7,18,25,17,12,14,3,3,87,1
16046,375221,422_14_10,GREECE,0,TOTALS,GREECE,200,30,59,50.8,17,35,48.6,13,24,54.2,14,16,87.5,10,33,43,19,25,16,5,0,87,1
16047,375234,422_14_10,SENEGAL,0,TOTALS,SENEGAL,200,19,58,32.8,15,44,34.1,4,14,28.6,22,30,73.3,10,21,31,9,19,11,10,7,64,0
16048,375247,422_14_11,USA,0,TOTALS,USA,200,43,73,58.9,37,55,67.3,6,18,33.3,22,25,88.0,11,35,46,20,19,19,18,4,114,0
16049,375260,422_14_11,FINLAND,0,TOTALS,FINLAND,200,18,65,27.7,14,44,31.8,4,21,19.0,15,17,88.2,13,18,31,5,24,31,10,1,55,1
16050,375273,422_14_12,IRAN,0,TOTALS,IRAN,200,23,59,39.0,17,44,38.6,6,15,40.0,8,13,61.5,11,20,31,11,24,20,8,1,60,0
16051,375286,422_14_12,SPAIN,0,TOTALS,SPAIN,200,30,60,50.0,23,41,56.1,7,19,36.8,23,32,71.9,13,29,42,22,12,12,13,4,90,1
16052,375299,422_14_13,DOMINICAN REPUBLIC,0,TOTALS,DOMINICAN REPUBLIC,200,32,67,47.8,24,46,52.2,8,21,38.1,4,7,57.1,14,29,43,13,17,13,3,4,76,1
16053,375312,422_14_13,NEW ZEALAND,0,TOTALS,NEW ZEALAND,200,22,64,34.4,15,32,46.9,7,32,21.9,12,18,66.7,16,18,34,15,14,11,3,1,63,0
16054,375325,422_14_14,KOREA,0,TOTALS,KOREA,200,22,56,39.3,17,31,54.8,5,25,20.0,6,9,66.7,5,13,18,15,21,19,9,8,55,0
16055,375338,422_14_14,AUSTRALIA,0,TOTALS,AUSTRALIA,200,35,68,51.5,27,54,50.0,8,14,57.1,11,16,68.8,21,26,47,23,15,17,10,0,89,1
16056,375351,422_14_15,ARGENTINA,0,TOTALS,ARGENTINA,200,31,65,47.7,22,41,53.7,9,24,37.5,14,20,70.0,6,25,31,17,23,6,4,3,85,0
16057,375364,422_14_15,CROATIA,0,TOTALS,CROATIA,200,30,63,47.6,17,30,56.7,13,33,39.4,17,22,77.3,8,28,36,19,23,9,4,0,90,1
16058,375377,422_14_16,SERBIA,0,TOTALS,SERBIA,200,25,53,47.2,21,35,60.0,4,18,22.2,19,21,90.5,8,18,26,10,20,14,10,0,73,0
16059,375390,422_14_16,FRANCE,0,TOTALS,FRANCE,200,29,55,52.7,22,32,68.8,7,23,30.4,9,13,69.2,9,20,29,21,21,16,7,1,74,1
16060,375403,422_14_17,FINLAND,0,TOTALS,FINLAND,200,29,62,46.8,18,34,52.9,11,28,39.3,12,23,52.2,10,22,32,19,22,11,7,1,81,1
16061,375416,422_14_17,UKRAINE,0,TOTALS,UKRAINE,200,24,54,44.4,14,24,58.3,10,30,33.3,18,23,78.3,9,27,36,19,23,18,3,2,76,0
16062,375429,422_14_18,SLOVENIA,0,TOTALS,SLOVENIA,200,32,53,60.4,22,32,68.8,10,21,47.6,15,20,75.0,6,14,20,19,21,11,10,1,89,1
16063,375442,422_14_18,MEXICO,0,TOTALS,MEXICO,200,26,47,55.3,21,34,61.8,5,13,38.5,11,15,73.3,8,17,25,12,23,20,5,3,68,0
16064,375455,422_14_19,SENEGAL,0,TOTALS,SENEGAL,200,30,58,51.7,23,38,60.5,7,20,35.0,15,27,55.6,10,28,38,12,21,16,12,6,82,1
16065,375468,422_14_19,PUERTO RICO,0,TOTALS,PUERTO RICO,200,26,61,42.6,14,32,43.8,12,29,41.4,11,17,64.7,9,24,33,19,23,18,4,1,75,0
16066,375481,422_14_20,BRAZIL,0,TOTALS,BRAZIL,200,32,59,54.2,27,44,61.4,5,15,33.3,10,15,66.7,6,29,35,14,16,19,17,3,79,1
16067,375494,422_14_20,IRAN,0,TOTALS,IRAN,200,21,56,37.5,18,42,42.9,3,14,21.4,5,9,55.6,7,23,30,9,19,24,11,2,50,0
16068,375507,422_14_21,LITHUANIA,0,TOTALS,LITHUANIA,200,24,49,49.0,17,29,58.6,7,20,35.0,20,28,71.4,8,29,37,14,16,16,2,2,75,1
16069,375520,422_14_21,ANGOLA,0,TOTALS,ANGOLA,200,23,63,36.5,16,38,42.1,7,25,28.0,9,12,75.0,11,23,34,10,24,14,11,0,62,0
16070,375533,422_14_22,PHILIPPINES,0,TOTALS,PHILIPPINES,200,24,68,35.3,18,46,39.1,6,22,27.3,16,20,80.0,8,33,41,10,25,12,8,2,70,0
16071,375546,422_14_22,GREECE,0,TOTALS,GREECE,200,28,65,43.1,23,43,53.5,5,22,22.7,21,30,70.0,10,35,45,14,19,12,6,8,82,1
16072,375559,422_14_23,TURKEY,0,TOTALS,TURKEY,200,26,56,46.4,17,32,53.1,9,24,37.5,16,25,64.0,9,25,34,17,22,28,2,5,77,0
16073,375572,422_14_23,USA,0,TOTALS,USA,200,39,74,52.7,31,52,59.6,8,22,36.4,12,19,63.2,10,22,32,21,23,12,17,4,98,1
16074,375585,422_14_24,SPAIN,0,TOTALS,SPAIN,200,35,71,49.3,28,46,60.9,7,25,28.0,14,16,87.5,12,35,47,22,13,14,9,7,91,1
16075,375598,422_14_24,EGYPT,0,TOTALS,EGYPT,200,22,65,33.8,18,40,45.0,4,25,16.0,6,10,60.0,8,24,32,5,21,20,7,1,54,0
16076,375611,422_14_25,CROATIA,0,TOTALS,CROATIA,200,24,56,42.9,17,30,56.7,7,26,26.9,20,28,71.4,8,21,29,16,23,10,4,1,75,0
16077,375624,422_14_25,SENEGAL,0,TOTALS,SENEGAL,200,24,53,45.3,17,38,44.7,7,15,46.7,22,27,81.5,10,23,33,14,28,15,8,6,77,1
16078,375637,422_14_26,IRAN,0,TOTALS,IRAN,200,24,46,52.2,19,26,73.1,5,20,25.0,17,20,85.0,7,15,22,11,28,23,11,1,70,0
16079,375650,422_14_26,SERBIA,0,TOTALS,SERBIA,200,31,53,58.5,25,40,62.5,6,13,46.2,15,29,51.7,11,17,28,20,23,19,9,2,83,1
16080,375663,422_14_27,ARGENTINA,0,TOTALS,ARGENTINA,200,29,69,42.0,14,31,45.2,15,38,39.5,12,16,75.0,13,22,35,17,17,8,10,0,85,1
16081,375676,422_14_27,PHILIPPINES,0,TOTALS,PHILIPPINES,200,31,61,50.8,18,34,52.9,13,27,48.1,6,8,75.0,8,31,39,9,19,16,4,3,81,0
16082,375689,422_14_28,FRANCE,0,TOTALS,FRANCE,200,38,58,65.5,31,40,77.5,7,18,38.9,11,19,57.9,5,36,41,31,9,13,6,4,94,1
16083,375702,422_14_28,EGYPT,0,TOTALS,EGYPT,200,22,67,32.8,15,46,32.6,7,21,33.3,4,6,66.7,6,17,23,10,20,13,7,0,55,0
16084,375715,422_14_29,PUERTO RICO,0,TOTALS,PUERTO RICO,200,24,62,38.7,18,44,40.9,6,18,33.3,25,31,80.6,14,21,35,10,25,11,6,2,79,0
16085,375728,422_14_29,GREECE,0,TOTALS,GREECE,200,34,64,53.1,29,49,59.2,5,15,33.3,17,26,65.4,12,25,37,21,24,11,5,3,90,1
16086,375741,422_14_30,BRAZIL,0,TOTALS,BRAZIL,200,26,64,40.6,23,54,42.6,3,10,30.0,8,15,53.3,6,26,32,7,20,6,6,1,63,0
16087,375754,422_14_30,SPAIN,0,TOTALS,SPAIN,200,30,59,50.8,19,35,54.3,11,24,45.8,11,16,68.8,6,35,41,17,21,10,3,4,82,1
16088,375767,422_14_31,ANGOLA,0,TOTALS,ANGOLA,200,21,78,26.9,17,51,33.3,4,27,14.8,9,11,81.8,24,21,45,10,19,9,6,1,55,0
16089,375780,422_14_31,MEXICO,0,TOTALS,MEXICO,200,27,58,46.6,15,32,46.9,12,26,46.2,13,14,92.9,10,33,43,13,18,13,7,4,79,1
16090,375793,422_14_32,UKRAINE,0,TOTALS,UKRAINE,200,24,64,37.5,14,33,42.4,10,31,32.3,6,7,85.7,9,26,35,12,15,10,5,2,64,1
16091,375806,422_14_32,TURKEY,0,TOTALS,TURKEY,200,19,52,36.5,13,37,35.1,6,15,40.0,14,19,73.7,8,31,39,12,15,13,3,3,58,0
16092,375819,422_14_33,AUSTRALIA,0,TOTALS,AUSTRALIA,200,30,64,46.9,23,50,46.0,7,14,50.0,15,22,68.2,11,21,32,13,23,14,9,0,82,1
16093,375832,422_14_33,LITHUANIA,0,TOTALS,LITHUANIA,200,25,49,51.0,20,33,60.6,5,16,31.2,20,22,90.9,4,25,29,8,21,22,4,3,75,0
16094,375845,422_14_34,USA,0,TOTALS,USA,200,35,69,50.7,29,52,55.8,6,17,35.3,22,34,64.7,17,30,47,21,13,16,14,4,98,1
16095,375858,422_14_34,NEW ZEALAND,0,TOTALS,NEW ZEALAND,200,29,71,40.8,20,45,44.4,9,26,34.6,4,7,57.1,12,22,34,11,22,22,3,3,71,0
16096,375871,422_14_35,KOREA,0,TOTALS,KOREA,200,26,60,43.3,20,40,50.0,6,20,30.0,14,20,70.0,11,23,34,16,21,12,3,8,72,0
16097,375884,422_14_35,SLOVENIA,0,TOTALS,SLOVENIA,200,34,69,49.3,23,38,60.5,11,31,35.5,10,18,55.6,16,24,40,11,20,9,3,2,89,1
16098,375897,422_14_36,FINLAND,0,TOTALS,FINLAND,200,25,70,35.7,14,38,36.8,11,32,34.4,7,8,87.5,11,17,28,14,26,9,9,1,68,0
16099,375910,422_14_36,DOMINICAN REPUBLIC,0,TOTALS,DOMINICAN REPUBLIC,200,26,54,48.1,19,37,51.4,7,17,41.2,15,25,60.0,15,34,49,17,17,23,5,5,74,1
16100,375923,422_14_37,MEXICO,0,TOTALS,MEXICO,200,23,57,40.4,16,40,40.0,7,17,41.2,9,18,50.0,10,21,31,13,21,12,7,4,62,0
16101,375936,422_14_37,AUSTRALIA,0,TOTALS,AUSTRALIA,200,25,56,44.6,19,43,44.2,6,13,46.2,14,19,73.7,12,27,39,18,23,14,7,4,70,1
16102,375949,422_14_38,PHILIPPINES,0,TOTALS,PHILIPPINES,200,24,57,42.1,18,29,62.1,6,28,21.4,19,22,86.4,9,23,32,11,23,19,8,3,73,0
16103,375962,422_14_38,PUERTO RICO,0,TOTALS,PUERTO RICO,200,23,58,39.7,12,32,37.5,11,26,42.3,20,24,83.3,12,20,32,9,21,16,10,1,77,1
16104,375975,422_14_39,NEW ZEALAND,0,TOTALS,NEW ZEALAND,200,26,60,43.3,18,37,48.6,8,23,34.8,13,21,61.9,18,30,48,16,19,19,4,1,73,1
16105,375988,422_14_39,UKRAINE,0,TOTALS,UKRAINE,200,24,62,38.7,18,45,40.0,6,17,35.3,7,9,77.8,8,17,25,12,20,14,10,0,61,0
16106,376001,422_14_40,EGYPT,0,TOTALS,EGYPT,200,25,60,41.7,18,38,47.4,7,22,31.8,16,22,72.7,13,19,32,11,17,17,5,3,73,0
16107,376014,422_14_40,IRAN,0,TOTALS,IRAN,200,35,70,50.0,25,47,53.2,10,23,43.5,8,11,72.7,16,25,41,19,22,14,10,2,88,1
16108,376027,422_14_41,SLOVENIA,0,TOTALS,SLOVENIA,200,31,61,50.8,17,28,60.7,14,33,42.4,17,21,81.0,11,19,30,19,24,15,9,0,93,1
16109,376040,422_14_41,ANGOLA,0,TOTALS,ANGOLA,200,30,64,46.9,23,48,47.9,7,16,43.8,20,24,83.3,15,20,35,17,20,17,5,2,87,0
16110,376053,422_14_42,SENEGAL,0,TOTALS,SENEGAL,200,18,55,32.7,17,43,39.5,1,12,8.3,9,12,75.0,9,20,29,7,17,21,8,4,46,0
16111,376066,422_14_42,ARGENTINA,0,TOTALS,ARGENTINA,200,29,64,45.3,17,36,47.2,12,28,42.9,11,12,91.7,14,27,41,20,17,15,10,3,81,1
16112,376079,422_14_43,TURKEY,0,TOTALS,TURKEY,225,21,54,38.9,15,30,50.0,6,24,25.0,29,45,64.4,10,30,40,23,19,13,10,2,77,1
16113,376092,422_14_43,FINLAND,0,TOTALS,FINLAND,225,26,58,44.8,11,30,36.7,15,28,53.6,6,10,60.0,3,26,29,14,31,19,3,4,73,0
16114,376105,422_14_44,SERBIA,0,TOTALS,SERBIA,200,24,57,42.1,16,37,43.2,8,20,40.0,17,29,58.6,12,22,34,13,24,8,5,0,73,0
16115,376118,422_14_44,BRAZIL,0,TOTALS,BRAZIL,200,31,62,50.0,20,39,51.3,11,23,47.8,8,15,53.3,12,26,38,16,27,10,4,3,81,1
16116,376131,422_14_45,LITHUANIA,0,TOTALS,LITHUANIA,200,35,72,48.6,26,51,51.0,9,21,42.9,0,0,0.0,17,25,42,15,17,12,6,3,79,1
16117,376144,422_14_45,KOREA,0,TOTALS,KOREA,200,18,48,37.5,14,31,45.2,4,17,23.5,9,10,90.0,4,18,22,14,14,18,1,5,49,0
16118,376157,422_14_46,GREECE,0,TOTALS,GREECE,200,33,66,50.0,28,43,65.1,5,23,21.7,5,9,55.6,7,30,37,23,22,10,8,4,76,1
16119,376170,422_14_46,CROATIA,0,TOTALS,CROATIA,200,24,61,39.3,16,41,39.0,8,20,40.0,9,17,52.9,7,26,33,9,16,13,6,4,65,0
16120,376183,422_14_47,DOMINICAN REPUBLIC,0,TOTALS,DOMINICAN REPUBLIC,200,28,71,39.4,21,53,39.6,7,18,38.9,8,10,80.0,12,28,40,16,23,26,5,1,71,1
16121,376196,422_14_47,USA,0,TOTALS,USA,200,44,78,56.4,38,57,66.7,6,21,28.6,12,19,63.2,11,32,43,28,18,16,17,8,106,0
16122,376209,422_14_48,SPAIN,0,TOTALS,SPAIN,200,32,63,50.8,26,40,65.0,6,23,26.1,18,22,81.8,7,30,37,19,16,8,11,5,88,1
16123,376222,422_14_48,FRANCE,0,TOTALS,FRANCE,200,27,69,39.1,22,44,50.0,5,25,20.0,5,8,62.5,13,23,36,10,22,15,4,0,64,0
16124,376235,422_14_49,AUSTRALIA,0,TOTALS,AUSTRALIA,200,31,61,50.8,17,36,47.2,14,25,56.0,7,9,77.8,9,23,32,21,19,18,3,1,83,0
16125,376248,422_14_49,ANGOLA,0,TOTALS,ANGOLA,200,37,77,48.1,30,53,56.6,7,24,29.2,10,19,52.6,21,21,42,16,15,9,14,2,91,1
16126,376261,422_14_50,SENEGAL,0,TOTALS,SENEGAL,225,29,71,40.8,21,37,56.8,8,34,23.5,13,17,76.5,10,28,38,21,23,16,11,5,79,0
16127,376274,422_14_50,PHILIPPINES,0,TOTALS,PHILIPPINES,225,25,68,36.8,17,41,41.5,8,27,29.6,23,30,76.7,15,30,45,11,17,18,9,0,81,1
16128,376287,422_14_51,FINLAND,0,TOTALS,FINLAND,200,22,55,40.0,19,40,47.5,3,15,20.0,18,20,90.0,6,22,28,13,20,9,8,3,65,0
16129,376300,422_14_51,NEW ZEALAND,0,TOTALS,NEW ZEALAND,200,26,60,43.3,19,41,46.3,7,19,36.8,8,12,66.7,12,26,38,15,19,14,1,1,67,1
16130,376313,422_14_52,BRAZIL,0,TOTALS,BRAZIL,200,50,67,74.6,40,47,85.1,10,20,50.0,18,26,69.2,9,36,45,35,13,11,11,3,128,0
16131,376326,422_14_52,EGYPT,0,TOTALS,EGYPT,200,27,73,37.0,16,39,41.0,11,34,32.4,0,4,0.0,13,12,25,11,23,18,8,1,65,1
16132,376339,422_14_53,KOREA,0,TOTALS,KOREA,200,23,49,46.9,17,30,56.7,6,19,31.6,19,23,82.6,4,15,19,17,14,13,6,6,71,0
16133,376352,422_14_53,MEXICO,0,TOTALS,MEXICO,200,37,72,51.4,27,50,54.0,10,22,45.5,3,5,60.0,20,24,44,16,19,14,3,1,87,1
16134,376365,422_14_54,UKRAINE,0,TOTALS,UKRAINE,200,25,62,40.3,17,38,44.7,8,24,33.3,13,19,68.4,10,24,34,8,21,19,5,2,71,0
16135,376378,422_14_54,USA,0,TOTALS,USA,200,37,73,50.7,32,61,52.5,5,12,41.7,16,21,76.2,14,28,42,25,19,10,12,6,95,1
16136,376391,422_14_55,IRAN,0,TOTALS,IRAN,200,27,59,45.8,22,42,52.4,5,17,29.4,17,24,70.8,13,19,32,11,18,15,8,1,76,0
16137,376404,422_14_55,FRANCE,0,TOTALS,FRANCE,200,30,53,56.6,19,29,65.5,11,24,45.8,10,15,66.7,4,24,28,15,23,14,6,3,81,1
16138,376417,422_14_56,CROATIA,0,TOTALS,CROATIA,200,33,57,57.9,22,33,66.7,11,24,45.8,26,34,76.5,11,23,34,26,30,22,5,0,103,0
16139,376430,422_14_56,PUERTO RICO,0,TOTALS,PUERTO RICO,200,29,63,46.0,18,37,48.6,11,26,42.3,13,20,65.0,12,13,25,12,29,18,10,1,82,1
16140,376443,422_14_57,LITHUANIA,0,TOTALS,LITHUANIA,200,24,56,42.9,18,40,45.0,6,16,37.5,13,17,76.5,9,29,38,9,17,14,4,4,67,1
16141,376456,422_14_57,SLOVENIA,0,TOTALS,SLOVENIA,200,26,65,40.0,20,40,50.0,6,25,24.0,6,10,60.0,11,23,34,12,22,11,6,3,64,0
16142,376469,422_14_58,TURKEY,0,TOTALS,TURKEY,200,31,67,46.3,25,48,52.1,6,19,31.6,9,15,60.0,12,31,43,22,17,12,8,2,77,1
16143,376482,422_14_58,DOMINICAN REPUBLIC,0,TOTALS,DOMINICAN REPUBLIC,200,27,63,42.9,19,42,45.2,8,21,38.1,2,4,50.0,5,27,32,16,18,13,8,1,64,0
16144,376495,422_14_59,SERBIA,0,TOTALS,SERBIA,200,26,64,40.6,19,45,42.2,7,19,36.8,14,20,70.0,10,22,32,15,28,18,8,1,73,0
16145,376508,422_14_59,SPAIN,0,TOTALS,SPAIN,200,28,59,47.5,20,36,55.6,8,23,34.8,25,28,89.3,8,30,38,16,26,18,10,3,89,1
16146,376521,422_14_60,ARGENTINA,0,TOTALS,ARGENTINA,200,24,63,38.1,17,43,39.5,7,20,35.0,16,19,84.2,5,20,25,13,21,6,10,0,71,0
16147,376534,422_14_60,GREECE,0,TOTALS,GREECE,200,29,58,50.0,23,43,53.5,6,15,40.0,15,16,93.8,8,33,41,13,22,14,3,8,79,1
16148,376547,422_14_61,USA,0,TOTALS,USA,200,34,73,46.6,21,44,47.7,13,29,44.8,5,5,100.0,14,31,45,18,12,15,6,6,86,1
16149,376560,422_14_61,MEXICO,0,TOTALS,MEXICO,200,28,73,38.4,24,57,42.1,4,16,25.0,3,8,37.5,17,25,42,10,12,16,7,2,63,0
16150,376573,422_14_62,FRANCE,0,TOTALS,FRANCE,200,25,56,44.6,18,34,52.9,7,22,31.8,12,18,66.7,5,31,36,15,16,15,5,5,69,1
16151,376586,422_14_62,CROATIA,0,TOTALS,CROATIA,200,25,67,37.3,19,42,45.2,6,25,24.0,8,12,66.7,9,28,37,10,21,11,6,2,64,0
16152,376599,422_14_63,DOMINICAN REPUBLIC,0,TOTALS,DOMINICAN REPUBLIC,200,22,54,40.7,20,42,47.6,2,12,16.7,15,21,71.4,6,27,33,6,21,16,9,5,61,0
16153,376612,422_14_63,SLOVENIA,0,TOTALS,SLOVENIA,200,28,64,43.8,22,38,57.9,6,26,23.1,9,12,75.0,11,27,38,12,24,16,7,1,71,1
16154,376625,422_14_64,SPAIN,0,TOTALS,SPAIN,200,34,59,57.6,27,36,75.0,7,23,30.4,14,24,58.3,9,24,33,21,21,11,9,13,89,1
16155,376638,422_14_64,SENEGAL,0,TOTALS,SENEGAL,200,21,59,35.6,19,48,39.6,2,11,18.2,12,19,63.2,15,22,37,9,24,21,4,0,56,0
16156,376651,422_14_65,NEW ZEALAND,0,TOTALS,NEW ZEALAND,200,26,62,41.9,20,40,50.0,6,22,27.3,13,17,76.5,12,25,37,12,28,14,7,1,71,0
16157,376664,422_14_65,LITHUANIA,0,TOTALS,LITHUANIA,200,25,60,41.7,19,37,51.4,6,23,26.1,20,28,71.4,11,26,37,13,20,10,6,3,76,1
16158,376677,422_14_66,SERBIA,0,TOTALS,SERBIA,200,32,59,54.2,23,42,54.8,9,17,52.9,17,20,85.0,6,23,29,17,22,10,6,0,90,1
16159,376690,422_14_66,GREECE,0,TOTALS,GREECE,200,24,55,43.6,15,31,48.4,9,24,37.5,15,18,83.3,6,23,29,16,25,14,8,2,72,0
16160,376703,422_14_67,TURKEY,0,TOTALS,TURKEY,200,23,57,40.4,14,35,40.0,9,22,40.9,10,14,71.4,7,23,30,9,19,10,7,3,65,1
16161,376716,422_14_67,AUSTRALIA,0,TOTALS,AUSTRALIA,200,25,58,43.1,21,43,48.8,4,15,26.7,10,19,52.6,13,31,44,15,22,16,3,2,64,0
16162,376729,422_14_68,BRAZIL,0,TOTALS,BRAZIL,200,32,60,53.3,27,41,65.9,5,19,26.3,16,21,76.2,9,30,39,16,22,8,5,2,85,1
16163,376742,422_14_68,ARGENTINA,0,TOTALS,ARGENTINA,200,22,56,39.3,12,27,44.4,10,29,34.5,11,18,61.1,4,22,26,10,22,10,3,0,65,0
16164,376755,422_14_69,LITHUANIA,0,TOTALS,LITHUANIA,200,27,58,46.6,17,39,43.6,10,19,52.6,9,11,81.8,9,27,36,13,20,15,3,5,73,1
16165,376768,422_14_69,TURKEY,0,TOTALS,TURKEY,200,23,58,39.7,20,40,50.0,3,18,16.7,12,17,70.6,10,22,32,13,21,11,8,5,61,0
16166,376781,422_14_70,SLOVENIA,0,TOTALS,SLOVENIA,200,29,66,43.9,21,39,53.8,8,27,29.6,10,17,58.8,12,26,38,12,26,25,1,5,76,1
16167,376794,422_14_70,USA,0,TOTALS,USA,200,46,92,50.0,37,73,50.7,9,19,47.4,18,27,66.7,24,30,54,21,22,11,12,7,119,0
16168,376807,422_14_71,SERBIA,0,TOTALS,SERBIA,200,31,62,50.0,22,37,59.5,9,25,36.0,13,16,81.2,6,31,37,19,21,6,3,5,84,1
16169,376820,422_14_71,BRAZIL,0,TOTALS,BRAZIL,200,22,65,33.8,17,50,34.0,5,15,33.3,7,15,46.7,14,26,40,13,18,7,4,3,56,0
16170,376833,422_14_72,FRANCE,0,TOTALS,FRANCE,200,22,56,39.3,16,32,50.0,6,24,25.0,15,20,75.0,16,34,50,14,22,16,4,2,65,1
16171,376846,422_14_72,SPAIN,0,TOTALS,SPAIN,200,20,62,32.3,18,40,45.0,2,22,9.1,10,13,76.9,8,20,28,9,18,8,5,5,52,0
16172,376859,422_14_73,USA,0,TOTALS,USA,200,38,80,47.5,29,56,51.8,9,24,37.5,11,20,55.0,18,32,50,14,27,16,9,4,96,1
16173,376872,422_14_73,LITHUANIA,0,TOTALS,LITHUANIA,200,17,56,30.4,15,38,39.5,2,18,11.1,32,42,76.2,10,28,38,10,20,21,5,6,68,0
16174,376885,422_14_74,FRANCE,0,TOTALS,FRANCE,200,29,63,46.0,14,30,46.7,15,33,45.5,12,14,85.7,9,23,32,17,20,12,6,2,85,0
16175,376898,422_14_74,SERBIA,0,TOTALS,SERBIA,200,32,56,57.1,24,41,58.5,8,15,53.3,18,25,72.0,3,25,28,19,18,9,6,2,90,1
16176,376911,422_14_75,LITHUANIA,0,TOTALS,LITHUANIA,200,31,67,46.3,24,50,48.0,7,17,41.2,24,28,85.7,15,21,36,12,28,7,3,1,93,0
16177,376924,422_14_75,FRANCE,0,TOTALS,FRANCE,200,32,57,56.1,25,37,67.6,7,20,35.0,24,33,72.7,10,21,31,12,25,7,4,2,95,1
16178,376937,422_14_76,USA,0,TOTALS,USA,200,45,78,57.7,30,48,62.5,15,30,50.0,24,29,82.8,16,28,44,16,25,8,4,7,129,0
16179,376950,422_14_76,SERBIA,0,TOTALS,SERBIA,200,36,75,48.0,31,50,62.0,5,25,20.0,15,21,71.4,12,20,32,20,27,10,3,1,92,1
16180,378003,424_14_01,JAPAN,0,TOTALS,JAPAN,225,34,92,37.0,20,58,34.5,14,34,41.2,2,4,50.0,16,26,42,14,27,10,8,5,84,0
16181,378016,424_14_01,AUSTRALIA,0,TOTALS,AUSTRALIA,225,32,80,40.0,26,61,42.6,6,19,31.6,27,34,79.4,25,40,65,8,7,17,5,7,97,1
16182,378029,424_14_02,PUERTO RICO,0,TOTALS,PUERTO RICO,200,23,65,35.4,19,51,37.3,4,14,28.6,17,20,85.0,14,31,45,12,16,9,4,3,67,1
16183,378042,424_14_02,SPAIN,0,TOTALS,SPAIN,200,25,68,36.8,15,36,41.7,10,32,31.2,5,8,62.5,11,29,40,12,17,9,3,3,65,0
16184,378055,424_14_03,ANGOLA,0,TOTALS,ANGOLA,200,30,72,41.7,20,33,60.6,10,39,25.6,12,38,31.6,20,50,70,14,13,22,2,7,82,1
16185,378068,424_14_03,PHILIPPINES,0,TOTALS,PHILIPPINES,200,29,88,33.0,24,53,45.3,5,35,14.3,9,11,81.8,11,35,46,6,28,9,10,1,72,0
16186,378081,424_14_04,SERBIA,0,TOTALS,SERBIA,200,30,63,47.6,22,39,56.4,8,24,33.3,12,21,57.1,9,30,39,14,23,16,6,2,80,1
16187,378094,424_14_04,CHINA,0,TOTALS,CHINA,200,24,62,38.7,23,52,44.2,1,10,10.0,19,30,63.3,11,29,40,9,22,14,5,2,68,0
16188,378107,424_14_05,FRANCE,0,TOTALS,FRANCE,200,30,61,49.2,24,40,60.0,6,21,28.6,10,14,71.4,13,31,44,13,19,17,5,5,76,1
16189,378120,424_14_05,CANADA,0,TOTALS,CANADA,200,24,63,38.1,19,40,47.5,5,23,21.7,13,27,48.1,15,20,35,7,21,11,8,2,66,0
16190,378133,424_14_06,UNITED ARAB EMIRATES,0,TOTALS,UNITED ARAB EMIRATES,200,10,51,19.6,9,40,22.5,1,11,9.1,11,22,50.0,9,18,27,2,14,27,3,0,32,1
16191,378146,424_14_06,ITALY,0,TOTALS,ITALY,200,53,92,57.6,45,66,68.2,8,26,30.8,7,13,53.8,23,38,61,23,13,7,17,9,121,0
16192,378159,424_14_07,GREECE,0,TOTALS,GREECE,200,23,70,32.9,17,41,41.5,6,29,20.7,21,26,80.8,20,18,38,8,21,11,7,1,73,0
16193,378172,424_14_07,USA,0,TOTALS,USA,200,31,62,50.0,27,46,58.7,4,16,25.0,17,21,81.0,14,29,43,17,25,16,9,5,83,1
16194,378185,424_14_08,ARGENTINA,0,TOTALS,ARGENTINA,200,28,64,43.8,20,40,50.0,8,24,33.3,10,13,76.9,21,42,63,18,21,28,11,6,74,1
16195,378198,424_14_08,EGYPT,0,TOTALS,EGYPT,200,13,61,21.3,12,45,26.7,1,16,6.2,12,21,57.1,10,16,26,4,15,17,15,6,39,0
16196,378211,424_14_09,CANADA,0,TOTALS,CANADA,200,37,72,51.4,33,57,57.9,4,15,26.7,18,27,66.7,17,45,62,17,18,19,10,8,96,1
16197,378224,424_14_09,JAPAN,0,TOTALS,JAPAN,200,18,78,23.1,14,50,28.0,4,28,14.3,12,12,100.0,14,24,38,7,20,18,2,1,52,0
16198,378237,424_14_10,ITALY,0,TOTALS,ITALY,200,19,59,32.2,15,36,41.7,4,23,17.4,9,16,56.2,12,27,39,10,16,8,5,5,51,0
16199,378250,424_14_10,PUERTO RICO,0,TOTALS,PUERTO RICO,200,22,64,34.4,20,50,40.0,2,14,14.3,12,17,70.6,18,30,48,3,18,10,3,0,58,1
16200,378263,424_14_11,USA,0,TOTALS,USA,200,36,79,45.6,30,65,46.2,6,14,42.9,21,31,67.7,21,33,54,18,17,19,22,6,99,1
16201,378276,424_14_11,ANGOLA,0,TOTALS,ANGOLA,200,21,71,29.6,16,42,38.1,5,29,17.2,9,20,45.0,21,25,46,5,20,28,7,7,56,0
16202,378289,424_14_12,AUSTRALIA,0,TOTALS,AUSTRALIA,200,30,69,43.5,25,54,46.3,5,15,33.3,19,26,73.1,15,26,41,13,18,16,10,4,84,1
16203,378302,424_14_12,FRANCE,0,TOTALS,FRANCE,200,30,65,46.2,24,44,54.5,6,21,28.6,15,21,71.4,13,26,39,6,23,17,8,5,81,0
16204,378315,424_14_13,EGYPT,0,TOTALS,EGYPT,200,23,57,40.4,16,36,44.4,7,21,33.3,10,15,66.7,6,22,28,9,20,18,11,5,63,0
16205,378328,424_14_13,SERBIA,0,TOTALS,SERBIA,200,31,74,41.9,23,51,45.1,8,23,34.8,11,18,61.1,27,29,56,15,19,21,12,6,81,1
16206,378341,424_14_14,PHILIPPINES,0,TOTALS,PHILIPPINES,200,25,68,36.8,19,49,38.8,6,19,31.6,9,18,50.0,13,31,44,8,23,15,7,2,65,0
16207,378354,424_14_14,GREECE,0,TOTALS,GREECE,200,28,76,36.8,15,33,45.5,13,43,30.2,16,26,61.5,24,33,57,21,23,14,9,3,85,1
16208,378367,424_14_15,SPAIN,0,TOTALS,SPAIN,200,55,90,61.1,48,69,69.6,7,21,33.3,21,30,70.0,28,39,67,27,13,9,18,10,138,0
16209,378380,424_14_15,UNITED ARAB EMIRATES,0,TOTALS,UNITED ARAB EMIRATES,200,9,55,16.4,7,44,15.9,2,11,18.2,7,13,53.8,8,11,19,3,25,29,3,0,27,1
16210,378393,424_14_16,CHINA,0,TOTALS,CHINA,200,20,62,32.3,12,44,27.3,8,18,44.4,22,32,68.8,16,32,48,12,14,19,4,3,70,0
16211,378406,424_14_16,ARGENTINA,0,TOTALS,ARGENTINA,200,29,69,42.0,20,45,44.4,9,24,37.5,8,12,66.7,10,27,37,11,27,14,13,1,75,1
16212,378419,424_14_17,JAPAN,0,TOTALS,JAPAN,200,22,68,32.4,21,54,38.9,1,14,7.1,6,12,50.0,15,12,27,5,22,14,7,1,51,0
16213,378432,424_14_17,FRANCE,0,TOTALS,FRANCE,200,34,63,54.0,26,45,57.8,8,18,44.4,20,26,76.9,19,33,52,13,13,16,7,6,96,1
16214,378445,424_14_18,CHINA,0,TOTALS,CHINA,200,35,71,49.3,32,60,53.3,3,11,27.3,11,16,68.8,19,30,49,10,19,24,16,3,84,1
16215,378458,424_14_18,EGYPT,0,TOTALS,EGYPT,200,20,58,34.5,18,45,40.0,2,13,15.4,16,21,76.2,11,19,30,9,18,28,10,3,58,0
16216,378471,424_14_19,ANGOLA,0,TOTALS,ANGOLA,200,22,56,39.3,18,41,43.9,4,15,26.7,3,18,16.7,12,35,47,5,21,24,5,6,51,0
16217,378484,424_14_19,GREECE,0,TOTALS,GREECE,200,25,78,32.1,23,49,46.9,2,29,6.9,10,16,62.5,20,29,49,9,24,10,14,1,62,1
16218,378497,424_14_20,CANADA,0,TOTALS,CANADA,200,30,73,41.1,21,49,42.9,9,24,37.5,16,23,69.6,11,28,39,14,22,13,7,2,85,1
16219,378510,424_14_20,AUSTRALIA,0,TOTALS,AUSTRALIA,200,29,74,39.2,28,55,50.9,1,19,5.3,15,23,65.2,20,34,54,15,17,20,4,7,74,0
16220,378523,424_14_21,USA,0,TOTALS,USA,200,50,90,55.6,41,67,61.2,9,23,39.1,15,20,75.0,25,41,66,21,13,16,12,10,124,0
16221,378536,424_14_21,PHILIPPINES,0,TOTALS,PHILIPPINES,200,27,77,35.1,22,56,39.3,5,21,23.8,5,9,55.6,10,16,26,13,18,18,5,0,64,1
16222,378549,424_14_22,ITALY,0,TOTALS,ITALY,200,22,50,44.0,18,32,56.2,4,18,22.2,16,22,72.7,7,24,31,9,23,19,7,3,64,1
16223,378562,424_14_22,SPAIN,0,TOTALS,SPAIN,200,13,44,29.5,6,23,26.1,7,21,33.3,17,22,77.3,9,25,34,6,23,25,11,1,50,0
16224,378575,424_14_23,PUERTO RICO,0,TOTALS,PUERTO RICO,200,44,81,54.3,34,51,66.7,10,30,33.3,12,15,80.0,21,40,61,24,7,13,10,8,110,0
16225,378588,424_14_23,UNITED ARAB EMIRATES,0,TOTALS,UNITED ARAB EMIRATES,200,21,64,32.8,17,50,34.0,4,14,28.6,7,12,58.3,5,16,21,5,13,16,7,0,53,1
16226,378601,424_14_24,ARGENTINA,0,TOTALS,ARGENTINA,200,23,53,43.4,20,36,55.6,3,17,17.6,8,20,40.0,9,33,42,7,27,15,4,2,57,0
16227,378614,424_14_24,SERBIA,0,TOTALS,SERBIA,200,18,51,35.3,12,32,37.5,6,19,31.6,18,34,52.9,10,27,37,6,22,10,8,2,60,1
16228,378627,424_14_25,USA,0,TOTALS,USA,200,55,83,66.3,49,62,79.0,6,21,28.6,6,13,46.2,19,46,65,19,15,16,15,10,122,0
16229,378640,424_14_25,JAPAN,0,TOTALS,JAPAN,200,16,74,21.6,15,56,26.8,1,18,5.6,5,15,33.3,16,12,28,5,19,17,7,2,38,1
16230,378653,424_14_26,ANGOLA,0,TOTALS,ANGOLA,200,22,84,26.2,15,52,28.8,7,32,21.9,8,18,44.4,28,16,44,8,21,17,8,2,59,1
16231,378666,424_14_26,CANADA,0,TOTALS,CANADA,200,38,70,54.3,28,43,65.1,10,27,37.0,20,24,83.3,16,38,54,11,19,16,7,5,106,0
16232,378679,424_14_27,PHILIPPINES,0,TOTALS,PHILIPPINES,200,24,75,32.0,22,61,36.1,2,14,14.3,7,10,70.0,10,23,33,9,23,11,7,2,57,0
16233,378692,424_14_27,FRANCE,0,TOTALS,FRANCE,200,33,68,48.5,23,45,51.1,10,23,43.5,10,23,43.5,19,41,60,18,13,19,9,6,86,1
16234,378705,424_14_28,ITALY,0,TOTALS,ITALY,200,28,68,41.2,28,57,49.1,0,11,0.0,11,21,52.4,17,13,30,5,22,13,15,0,67,0
16235,378718,424_14_28,CHINA,0,TOTALS,CHINA,200,28,51,54.9,21,37,56.8,7,14,50.0,16,23,69.6,12,30,42,8,17,25,9,2,79,1
16236,378731,424_14_29,PUERTO RICO,0,TOTALS,PUERTO RICO,225,29,76,38.2,21,49,42.9,8,27,29.6,20,31,64.5,23,30,53,11,20,20,12,6,86,1
16237,378744,424_14_29,EGYPT,0,TOTALS,EGYPT,225,30,76,39.5,24,53,45.3,6,23,26.1,13,17,76.5,18,29,47,16,27,19,12,9,79,0
16238,378757,424_14_30,UNITED ARAB EMIRATES,0,TOTALS,UNITED ARAB EMIRATES,200,11,56,19.6,7,42,16.7,4,14,28.6,5,10,50.0,7,13,20,5,10,22,7,0,31,1
16239,378770,424_14_30,SERBIA,0,TOTALS,SERBIA,200,48,84,57.1,35,51,68.6,13,33,39.4,7,9,77.8,24,40,64,16,13,14,15,9,116,0
16240,378783,424_14_31,GREECE,0,TOTALS,GREECE,200,30,74,40.5,21,43,48.8,9,31,29.0,7,11,63.6,8,21,29,12,26,11,11,2,76,0
16241,378796,424_14_31,AUSTRALIA,0,TOTALS,AUSTRALIA,200,27,60,45.0,24,48,50.0,3,12,25.0,27,30,90.0,14,37,51,6,17,22,6,3,84,1
16242,378809,424_14_32,SPAIN,0,TOTALS,SPAIN,200,21,52,40.4,15,23,65.2,6,29,20.7,16,23,69.6,9,28,37,11,21,20,5,9,64,1
16243,378822,424_14_32,ARGENTINA,0,TOTALS,ARGENTINA,200,19,58,32.8,13,39,33.3,6,19,31.6,13,16,81.2,12,25,37,15,24,19,14,0,57,0
16244,378835,424_14_33,JAPAN,0,TOTALS,JAPAN,200,19,63,30.2,14,44,31.8,5,19,26.3,13,19,68.4,8,25,33,10,22,15,4,3,56,0
16245,378848,424_14_33,ITALY,0,TOTALS,ITALY,200,31,66,47.0,24,44,54.5,7,22,31.8,14,23,60.9,15,38,53,15,18,16,10,3,83,1
16246,378861,424_14_34,ANGOLA,0,TOTALS,ANGOLA,200,37,87,42.5,27,44,61.4,10,43,23.3,5,17,29.4,23,36,59,16,13,13,17,9,89,1
16247,378874,424_14_34,UNITED ARAB EMIRATES,0,TOTALS,UNITED ARAB EMIRATES,200,20,64,31.2,17,52,32.7,3,12,25.0,4,7,57.1,9,32,41,5,16,28,6,0,47,0
16248,378887,424_14_35,USA,0,TOTALS,USA,200,50,88,56.8,47,76,61.8,3,12,25.0,10,17,58.8,22,33,55,18,22,22,16,11,113,0
16249,378900,424_14_35,CHINA,0,TOTALS,CHINA,200,22,67,32.8,17,46,37.0,5,21,23.8,22,27,81.5,13,19,32,8,14,26,12,2,71,1
16250,378913,424_14_36,PHILIPPINES,0,TOTALS,PHILIPPINES,200,25,75,33.3,12,45,26.7,13,30,43.3,8,11,72.7,13,27,40,9,19,16,5,4,71,0
16251,378926,424_14_36,ARGENTINA,0,TOTALS,ARGENTINA,200,28,82,34.1,17,48,35.4,11,34,32.4,17,24,70.8,29,33,62,12,15,14,9,11,84,1
16252,378939,424_14_37,CANADA,0,TOTALS,CANADA,200,23,63,36.5,15,38,39.5,8,25,32.0,10,12,83.3,15,23,38,9,22,22,13,0,64,0
16253,378952,424_14_37,SERBIA,0,TOTALS,SERBIA,200,24,59,40.7,16,34,47.1,8,25,32.0,15,23,65.2,16,26,42,11,17,24,14,2,71,1
16254,378965,424_14_38,GREECE,0,TOTALS,GREECE,200,24,69,34.8,15,41,36.6,9,28,32.1,10,11,90.9,16,32,48,18,24,22,14,9,67,1
16255,378978,424_14_38,EGYPT,0,TOTALS,EGYPT,200,18,58,31.0,18,45,40.0,0,13,0.0,14,28,50.0,15,29,44,5,18,24,14,6,50,0
16256,378991,424_14_39,AUSTRALIA,0,TOTALS,AUSTRALIA,200,26,57,45.6,15,33,45.5,11,24,45.8,13,14,92.9,9,42,51,13,12,21,5,3,76,1
16257,379004,424_14_39,PUERTO RICO,0,TOTALS,PUERTO RICO,200,23,83,27.7,21,61,34.4,2,22,9.1,4,5,80.0,18,20,38,4,12,8,13,3,52,0
16258,379017,424_14_40,FRANCE,0,TOTALS,FRANCE,200,26,58,44.8,25,44,56.8,1,14,7.1,14,24,58.3,13,25,38,10,22,17,8,3,67,0
16259,379030,424_14_40,SPAIN,0,TOTALS,SPAIN,200,22,57,38.6,15,36,41.7,7,21,33.3,20,24,83.3,12,22,34,9,24,16,6,4,71,1
16260,379043,424_14_41,ITALY,0,TOTALS,ITALY,200,25,69,36.2,17,44,38.6,8,25,32.0,19,25,76.0,11,19,30,12,29,7,20,3,77,1
16261,379056,424_14_41,ANGOLA,0,TOTALS,ANGOLA,200,21,51,41.2,12,32,37.5,9,19,47.4,20,37,54.1,17,34,51,12,22,28,4,4,71,0
16262,379069,424_14_42,JAPAN,0,TOTALS,JAPAN,200,37,77,48.1,24,47,51.1,13,30,43.3,4,9,44.4,20,33,53,22,19,14,9,6,91,1
16263,379082,424_14_42,UNITED ARAB EMIRATES,0,TOTALS,UNITED ARAB EMIRATES,200,19,54,35.2,17,47,36.2,2,7,28.6,9,17,52.9,6,22,28,1,14,18,7,3,49,0
16264,379095,424_14_43,CHINA,0,TOTALS,CHINA,200,27,60,45.0,19,42,45.2,8,18,44.4,19,24,79.2,16,17,33,11,14,24,9,3,81,0
16265,379108,424_14_43,CANADA,0,TOTALS,CANADA,200,41,72,56.9,39,65,60.0,2,7,28.6,8,12,66.7,15,19,34,18,22,17,12,4,92,1
16266,379121,424_14_44,EGYPT,0,TOTALS,EGYPT,200,34,67,50.7,25,41,61.0,9,26,34.6,15,24,62.5,20,41,61,18,15,31,10,6,92,1
16267,379134,424_14_44,PHILIPPINES,0,TOTALS,PHILIPPINES,200,24,78,30.8,17,50,34.0,7,28,25.0,12,18,66.7,15,16,31,12,21,16,19,2,67,0
16268,379147,424_14_45,PUERTO RICO,0,TOTALS,PUERTO RICO,200,23,63,36.5,18,45,40.0,5,18,27.8,19,30,63.3,14,26,40,5,22,12,7,3,70,1
16269,379160,424_14_45,FRANCE,0,TOTALS,FRANCE,200,23,55,41.8,18,37,48.6,5,18,27.8,12,20,60.0,9,31,40,8,20,19,6,3,63,0
16270,379173,424_14_46,GREECE,0,TOTALS,GREECE,200,18,62,29.0,12,34,35.3,6,28,21.4,12,19,63.2,11,23,34,8,21,9,6,2,54,0
16271,379186,424_14_46,ARGENTINA,0,TOTALS,ARGENTINA,200,23,52,44.2,17,31,54.8,6,21,28.6,13,25,52.0,10,34,44,10,23,15,7,0,65,1
16272,379199,424_14_47,USA,0,TOTALS,USA,200,30,78,38.5,25,61,41.0,5,17,29.4,24,34,70.6,22,36,58,10,23,18,8,2,89,1
16273,379212,424_14_47,SERBIA,0,TOTALS,SERBIA,200,21,68,30.9,13,44,29.5,8,24,33.3,18,22,81.8,11,28,39,13,27,16,9,2,68,0
16274,379225,424_14_48,AUSTRALIA,0,TOTALS,AUSTRALIA,225,30,68,44.1,23,45,51.1,7,23,30.4,13,17,76.5,10,36,46,16,13,18,8,7,80,1
16275,379238,424_14_48,SPAIN,0,TOTALS,SPAIN,225,31,85,36.5,24,52,46.2,7,33,21.2,5,10,50.0,17,28,45,7,17,12,6,3,74,0
16276,379251,424_14_49,JAPAN,0,TOTALS,JAPAN,200,21,70,30.0,18,46,39.1,3,24,12.5,8,13,61.5,12,24,36,10,26,17,10,1,53,0
16277,379264,424_14_49,EGYPT,0,TOTALS,EGYPT,200,24,58,41.4,21,49,42.9,3,9,33.3,17,33,51.5,16,38,54,3,18,21,8,7,68,1
16278,379277,424_14_50,ANGOLA,0,TOTALS,ANGOLA,200,21,60,35.0,17,40,42.5,4,20,20.0,13,20,65.0,20,32,52,5,14,20,9,3,59,1
16279,379290,424_14_50,GREECE,0,TOTALS,GREECE,200,21,63,33.3,16,34,47.1,5,29,17.2,4,5,80.0,11,19,30,9,23,17,11,5,51,0
16280,379303,424_14_51,ITALY,0,TOTALS,ITALY,200,18,59,30.5,10,41,24.4,8,18,44.4,22,27,81.5,11,25,36,7,24,15,8,4,66,1
16281,379316,424_14_51,ARGENTINA,0,TOTALS,ARGENTINA,200,21,54,38.9,16,34,47.1,5,20,25.0,15,24,62.5,10,29,39,6,24,17,9,0,62,0
16282,379329,424_14_52,CHINA,0,TOTALS,CHINA,200,33,61,54.1,29,51,56.9,4,10,40.0,17,24,70.8,9,14,23,22,16,13,17,3,87,1
16283,379342,424_14_52,FRANCE,0,TOTALS,FRANCE,200,37,67,55.2,33,59,55.9,4,8,50.0,1,5,20.0,17,22,39,12,20,24,4,3,79,0
16284,379355,424_14_53,UNITED ARAB EMIRATES,0,TOTALS,UNITED ARAB EMIRATES,200,16,58,27.6,14,43,32.6,2,15,13.3,17,29,58.6,13,27,40,0,25,33,3,1,51,1
16285,379368,424_14_53,PHILIPPINES,0,TOTALS,PHILIPPINES,200,45,104,43.3,36,77,46.8,9,27,33.3,16,27,59.3,37,30,67,16,24,18,19,5,115,0
16286,379381,424_14_54,CANADA,0,TOTALS,CANADA,200,25,67,37.3,19,44,43.2,6,23,26.1,7,13,53.8,13,32,45,8,14,10,6,0,63,0
16287,379394,424_14_54,PUERTO RICO,0,TOTALS,PUERTO RICO,200,26,76,34.2,20,54,37.0,6,22,27.3,7,14,50.0,20,30,50,9,14,10,5,7,65,1
16288,379407,424_14_55,SERBIA,0,TOTALS,SERBIA,200,18,57,31.6,14,42,33.3,4,15,26.7,22,30,73.3,14,36,50,6,26,18,9,5,62,1
16289,379420,424_14_55,SPAIN,0,TOTALS,SPAIN,200,20,68,29.4,18,48,37.5,2,20,10.0,17,20,85.0,15,27,42,5,21,13,10,4,59,0
16290,379433,424_14_56,USA,0,TOTALS,USA,200,41,89,46.1,39,74,52.7,2,15,13.3,15,25,60.0,26,31,57,6,21,16,9,6,99,1
16291,379446,424_14_56,AUSTRALIA,0,TOTALS,AUSTRALIA,200,31,70,44.3,20,45,44.4,11,25,44.0,19,26,73.1,8,23,31,13,21,16,6,1,92,0
16292,380915,426_14_01,CHINESE TAIPEI,0,TOTALS,CHINESE TAIPEI,200,34,81,42.0,33,61,54.1,1,20,5.0,16,22,72.7,26,32,58,11,21,12,7,0,85,1
16293,380928,426_14_01,JORDAN,0,TOTALS,JORDAN,200,21,62,33.9,16,41,39.0,5,21,23.8,16,26,61.5,10,25,35,9,19,16,6,1,63,0
16294,380941,426_14_02,JAPAN,0,TOTALS,JAPAN,200,18,57,31.6,12,31,38.7,6,26,23.1,14,20,70.0,10,22,32,11,20,10,7,2,56,0
16295,380954,426_14_02,IRAN,0,TOTALS,IRAN,200,26,56,46.4,22,39,56.4,4,17,23.5,10,20,50.0,10,29,39,13,20,14,5,1,66,1
16296,380967,426_14_03,CHINA,0,TOTALS,CHINA,200,40,75,53.3,28,46,60.9,12,29,41.4,13,19,68.4,19,42,61,15,12,18,15,4,105,0
16297,380980,426_14_03,INDONESIA,0,TOTALS,INDONESIA,200,17,71,23.9,15,48,31.2,2,23,8.7,1,2,50.0,11,19,30,5,18,22,7,1,37,1
16298,380993,426_14_04,PHILIPPINES,0,TOTALS,PHILIPPINES,200,28,72,38.9,18,42,42.9,10,30,33.3,12,17,70.6,14,40,54,21,21,26,6,6,78,1
16299,381006,426_14_04,CHINESE TAIPEI,0,TOTALS,CHINESE TAIPEI,200,23,75,30.7,15,50,30.0,8,25,32.0,10,18,55.6,16,30,46,17,20,23,10,4,64,0
16300,381019,426_14_05,INDIA,0,TOTALS,INDIA,200,20,53,37.7,16,37,43.2,4,16,25.0,8,14,57.1,12,27,39,8,17,24,7,1,52,0
16301,381032,426_14_05,JAPAN,0,TOTALS,JAPAN,200,29,62,46.8,21,42,50.0,8,20,40.0,9,14,64.3,10,23,33,15,21,13,14,2,75,1
16302,381045,426_14_06,IRAN,0,TOTALS,IRAN,200,18,59,30.5,17,37,45.9,1,22,4.5,14,22,63.6,14,23,37,7,25,16,9,3,51,0
16303,381058,426_14_06,CHINA,0,TOTALS,CHINA,200,21,61,34.4,18,38,47.4,3,23,13.0,19,24,79.2,16,28,44,9,19,14,9,3,64,1
16304,381071,426_14_07,SINGAPORE,0,TOTALS,SINGAPORE,200,17,64,26.6,11,36,30.6,6,28,21.4,13,14,92.9,12,31,43,6,16,15,4,8,53,0
16305,381084,426_14_07,JORDAN,0,TOTALS,JORDAN,200,27,75,36.0,25,56,44.6,2,19,10.5,14,19,73.7,16,38,54,9,19,9,8,1,70,1
16306,381097,426_14_08,INDONESIA,0,TOTALS,INDONESIA,200,17,62,27.4,10,32,31.2,7,30,23.3,6,11,54.5,9,34,43,6,15,21,5,2,47,0
16307,381110,426_14_08,IRAN,0,TOTALS,IRAN,200,31,77,40.3,25,48,52.1,6,29,20.7,9,16,56.2,16,39,55,11,16,11,16,2,77,1
16308,381123,426_14_09,CHINA,0,TOTALS,CHINA,200,21,52,40.4,17,33,51.5,4,19,21.1,12,22,54.5,15,26,41,6,26,24,9,3,58,0
16309,381136,426_14_09,INDIA,0,TOTALS,INDIA,200,24,71,33.8,19,48,39.6,5,23,21.7,12,24,50.0,23,19,42,11,19,17,9,4,65,1
16310,381149,426_14_10,PHILIPPINES,0,TOTALS,PHILIPPINES,200,31,66,47.0,27,51,52.9,4,15,26.7,8,13,61.5,6,41,47,13,20,12,4,4,74,1
16311,381162,426_14_10,SINGAPORE,0,TOTALS,SINGAPORE,200,18,76,23.7,10,43,23.3,8,33,24.2,13,16,81.2,13,33,46,5,12,9,5,4,57,0
16312,381175,426_14_11,INDIA,0,TOTALS,INDIA,200,38,76,50.0,29,50,58.0,9,26,34.6,6,13,46.2,13,39,52,19,9,12,12,5,91,1
16313,381188,426_14_11,INDONESIA,0,TOTALS,INDONESIA,200,22,74,29.7,14,54,25.9,8,20,40.0,3,4,75.0,15,29,44,8,12,19,6,1,55,0
16314,381201,426_14_12,JAPAN,0,TOTALS,JAPAN,200,27,66,40.9,21,47,44.7,6,19,31.6,6,9,66.7,7,24,31,12,26,11,7,1,66,0
16315,381214,426_14_12,CHINA,0,TOTALS,CHINA,200,27,59,45.8,20,40,50.0,7,19,36.8,18,27,66.7,13,34,47,9,17,16,5,8,79,1
16316,381227,426_14_13,IRAN,0,TOTALS,IRAN,200,24,53,45.3,23,40,57.5,1,13,7.7,13,23,56.5,12,32,44,14,16,21,11,4,62,1
16317,381240,426_14_13,INDIA,0,TOTALS,INDIA,200,20,53,37.7,14,27,51.9,6,26,23.1,3,7,42.9,4,21,25,10,24,22,11,1,49,0
16318,381253,426_14_14,INDONESIA,0,TOTALS,INDONESIA,200,22,64,34.4,17,36,47.2,5,28,17.9,10,11,90.9,7,31,38,13,20,16,5,5,59,0
16319,381266,426_14_14,JAPAN,0,TOTALS,JAPAN,200,34,74,45.9,25,51,49.0,9,23,39.1,19,26,73.1,13,36,49,24,10,7,11,2,96,1
16320,381279,426_14_15,JORDAN,0,TOTALS,JORDAN,200,25,70,35.7,20,49,40.8,5,21,23.8,15,22,68.2,15,32,47,8,15,12,8,2,70,0
16321,381292,426_14_15,PHILIPPINES,0,TOTALS,PHILIPPINES,200,26,67,38.8,19,47,40.4,7,20,35.0,12,17,70.6,11,30,41,6,22,14,6,1,71,1
16322,381305,426_14_16,SINGAPORE,0,TOTALS,SINGAPORE,200,20,65,30.8,9,35,25.7,11,30,36.7,14,16,87.5,16,24,40,7,20,21,5,2,65,0
16323,381318,426_14_16,CHINESE TAIPEI,0,TOTALS,CHINESE TAIPEI,200,34,70,48.6,30,58,51.7,4,12,33.3,14,22,63.6,15,29,44,15,17,12,14,1,86,1
16324,381331,426_14_17,CHINESE TAIPEI,0,TOTALS,CHINESE TAIPEI,200,32,61,52.5,28,49,57.1,4,12,33.3,8,15,53.3,14,32,46,12,14,21,10,4,76,1
16325,381344,426_14_17,JAPAN,0,TOTALS,JAPAN,200,25,68,36.8,21,46,45.7,4,22,18.2,8,12,66.7,11,18,29,8,18,15,10,3,62,0
16326,381357,426_14_18,IRAN,0,TOTALS,IRAN,200,29,54,53.7,26,46,56.5,3,8,37.5,14,18,77.8,10,26,36,11,26,22,6,1,75,1
16327,381370,426_14_18,JORDAN,0,TOTALS,JORDAN,200,17,55,30.9,13,38,34.2,4,17,23.5,22,31,71.0,13,15,28,4,21,14,12,0,60,0
16328,381383,426_14_19,PHILIPPINES,0,TOTALS,PHILIPPINES,200,26,63,41.3,20,43,46.5,6,20,30.0,12,16,75.0,17,31,48,8,19,22,11,3,70,1
16329,381396,426_14_19,INDIA,0,TOTALS,INDIA,200,21,59,35.6,12,29,41.4,9,30,30.0,15,24,62.5,11,21,32,13,18,16,12,2,66,0
16330,381409,426_14_20,CHINA,0,TOTALS,CHINA,200,35,66,53.0,25,43,58.1,10,23,43.5,4,9,44.4,15,37,52,19,13,13,5,3,84,1
16331,381422,426_14_20,SINGAPORE,0,TOTALS,SINGAPORE,200,13,57,22.8,9,36,25.0,4,21,19.0,7,8,87.5,8,18,26,3,11,15,8,4,37,0
16332,381435,426_14_21,INDIA,0,TOTALS,INDIA,200,22,55,40.0,17,41,41.5,5,14,35.7,16,22,72.7,12,26,38,11,20,18,9,0,65,0
16333,381448,426_14_21,JORDAN,0,TOTALS,JORDAN,200,28,68,41.2,26,52,50.0,2,16,12.5,11,18,61.1,17,22,39,15,18,13,8,1,69,1
16334,381461,426_14_22,SINGAPORE,0,TOTALS,SINGAPORE,200,16,53,30.2,16,34,47.1,0,19,0.0,16,26,61.5,8,18,26,3,17,18,12,0,48,0
16335,381474,426_14_22,JAPAN,0,TOTALS,JAPAN,200,31,57,54.4,23,39,59.0,8,18,44.4,12,18,66.7,10,32,42,16,20,16,7,2,82,1
16336,381487,426_14_23,PHILIPPINES,0,TOTALS,PHILIPPINES,200,22,67,32.8,19,46,41.3,3,21,14.3,8,10,80.0,12,27,39,7,22,9,0,3,55,0
16337,381500,426_14_23,IRAN,0,TOTALS,IRAN,200,27,64,42.2,20,44,45.5,7,20,35.0,15,22,68.2,12,34,46,14,16,7,6,5,76,1
16338,381513,426_14_24,CHINA,0,TOTALS,CHINA,200,23,62,37.1,18,45,40.0,5,17,29.4,22,34,64.7,24,24,48,7,22,29,9,6,73,0
16339,381526,426_14_24,CHINESE TAIPEI,0,TOTALS,CHINESE TAIPEI,200,30,58,51.7,25,46,54.3,5,12,41.7,19,32,59.4,11,24,35,11,28,20,17,4,84,1
16340,381539,426_14_25,INDIA,0,TOTALS,INDIA,200,32,68,47.1,30,51,58.8,2,17,11.8,19,25,76.0,16,37,53,12,12,12,15,6,85,1
16341,381552,426_14_25,SINGAPORE,0,TOTALS,SINGAPORE,200,12,54,22.2,9,36,25.0,3,18,16.7,9,13,69.2,7,20,27,4,20,23,10,0,36,0
16342,381565,426_14_26,JORDAN,0,TOTALS,JORDAN,200,31,73,42.5,23,45,51.1,8,28,28.6,9,21,42.9,16,29,45,10,16,11,8,5,79,1
16343,381578,426_14_26,JAPAN,0,TOTALS,JAPAN,200,28,65,43.1,24,53,45.3,4,12,33.3,12,16,75.0,11,30,41,21,20,13,3,2,72,0
16344,381591,426_14_27,PHILIPPINES,0,TOTALS,PHILIPPINES,200,31,68,45.6,24,50,48.0,7,18,38.9,11,12,91.7,10,33,43,21,25,15,8,2,80,1
16345,381604,426_14_27,CHINA,0,TOTALS,CHINA,200,28,64,43.8,19,44,43.2,9,20,45.0,14,23,60.9,7,26,33,10,15,11,7,2,79,0
16346,381617,426_14_28,IRAN,0,TOTALS,IRAN,200,30,64,46.9,29,57,50.9,1,7,14.3,28,39,71.8,18,25,43,7,26,14,13,5,89,1
16347,381630,426_14_28,CHINESE TAIPEI,0,TOTALS,CHINESE TAIPEI,200,28,61,45.9,23,42,54.8,5,19,26.3,18,26,69.2,10,21,31,14,29,17,11,1,79,0
16348,382564,428_14_01,URUGUAY,0,TOTALS,URUGUAY,200,34,67,50.7,24,45,53.3,10,22,45.5,14,21,66.7,13,31,44,16,16,10,12,1,92,1
16349,382577,428_14_01,CHILE,0,TOTALS,CHILE,200,20,56,35.7,14,37,37.8,6,19,31.6,6,14,42.9,9,24,33,2,19,18,4,2,52,0
16350,382590,428_14_02,ECUADOR,0,TOTALS,ECUADOR,200,16,47,34.0,12,27,44.4,4,20,20.0,8,14,57.1,8,18,26,3,19,26,7,2,44,1
16351,382603,428_14_02,ARGENTINA,0,TOTALS,ARGENTINA,200,36,70,51.4,25,40,62.5,11,30,36.7,17,24,70.8,6,19,25,19,19,12,21,0,100,0
16352,382616,428_14_03,BRAZIL,0,TOTALS,BRAZIL,200,25,59,42.4,19,32,59.4,6,27,22.2,17,26,65.4,19,26,45,10,21,17,12,0,73,1
16353,382629,428_14_03,PARAGUAY,0,TOTALS,PARAGUAY,200,20,55,36.4,15,32,46.9,5,23,21.7,11,13,84.6,7,17,24,13,21,17,9,0,56,0
16354,382642,428_14_04,PERU,0,TOTALS,PERU,200,21,53,39.6,16,32,50.0,5,21,23.8,2,4,50.0,4,18,22,11,17,16,6,0,49,0
16355,382655,428_14_04,VENEZUELA,0,TOTALS,VENEZUELA,200,28,57,49.1,16,27,59.3,12,30,40.0,18,26,69.2,12,29,41,20,6,14,11,0,86,1
16356,382668,428_14_05,ECUADOR,0,TOTALS,ECUADOR,200,14,49,28.6,11,29,37.9,3,20,15.0,23,33,69.7,9,19,28,6,31,24,8,2,54,1
16357,382681,428_14_05,BRAZIL,0,TOTALS,BRAZIL,200,34,59,57.6,25,39,64.1,9,20,45.0,29,38,76.3,11,28,39,20,24,17,11,2,106,0
16358,382694,428_14_06,PERU,0,TOTALS,PERU,200,17,66,25.8,8,41,19.5,9,25,36.0,2,4,50.0,10,19,29,10,19,17,3,1,45,1
16359,382707,428_14_06,URUGUAY,0,TOTALS,URUGUAY,200,37,59,62.7,28,41,68.3,9,18,50.0,20,27,74.1,7,40,47,22,7,11,13,4,103,0
16360,382720,428_14_07,ARGENTINA,0,TOTALS,ARGENTINA,200,23,50,46.0,15,27,55.6,8,23,34.8,21,31,67.7,10,26,36,17,20,13,9,2,75,1
16361,382733,428_14_07,PARAGUAY,0,TOTALS,PARAGUAY,200,25,57,43.9,18,34,52.9,7,23,30.4,8,15,53.3,9,20,29,10,27,16,7,0,65,0
16362,382746,428_14_08,VENEZUELA,0,TOTALS,VENEZUELA,200,27,51,52.9,17,33,51.5,10,18,55.6,12,21,57.1,5,31,36,16,12,12,7,4,76,1
16363,382759,428_14_08,CHILE,0,TOTALS,CHILE,200,23,67,34.3,18,49,36.7,5,18,27.8,4,4,100.0,11,20,31,10,14,12,6,0,55,0
16364,382772,428_14_09,PARAGUAY,0,TOTALS,PARAGUAY,200,31,62,50.0,26,43,60.5,5,19,26.3,16,24,66.7,11,31,42,17,22,18,9,3,83,1
16365,382785,428_14_09,ECUADOR,0,TOTALS,ECUADOR,200,28,64,43.8,22,40,55.0,6,24,25.0,11,26,42.3,11,20,31,7,25,16,10,1,73,0
16366,382798,428_14_10,CHILE,0,TOTALS,CHILE,200,26,55,47.3,19,31,61.3,7,24,29.2,26,36,72.2,11,20,31,8,21,14,8,2,85,1
16367,382811,428_14_10,PERU,0,TOTALS,PERU,200,25,51,49.0,15,32,46.9,10,19,52.6,10,15,66.7,9,18,27,14,28,17,5,1,70,0
16368,382824,428_14_11,BRAZIL,0,TOTALS,BRAZIL,200,18,58,31.0,12,29,41.4,6,29,20.7,17,22,77.3,14,27,41,5,25,17,8,1,59,0
16369,382837,428_14_11,ARGENTINA,0,TOTALS,ARGENTINA,200,21,51,41.2,16,28,57.1,5,23,21.7,17,26,65.4,6,29,35,9,23,14,4,1,64,1
16370,382850,428_14_12,VENEZUELA,0,TOTALS,VENEZUELA,200,25,55,45.5,17,29,58.6,8,26,30.8,9,18,50.0,7,23,30,14,18,9,7,2,67,1
16371,382863,428_14_12,URUGUAY,0,TOTALS,URUGUAY,200,21,53,39.6,13,33,39.4,8,20,40.0,13,16,81.2,9,26,35,9,21,17,4,1,63,0
16372,382876,428_14_13,PARAGUAY,0,TOTALS,PARAGUAY,200,30,57,52.6,24,36,66.7,6,21,28.6,14,27,51.9,12,29,41,13,10,12,14,0,80,1
16373,382889,428_14_13,PERU,0,TOTALS,PERU,200,21,55,38.2,11,28,39.3,10,27,37.0,4,4,100.0,5,19,24,15,21,16,7,1,56,0
16374,382902,428_14_14,CHILE,0,TOTALS,CHILE,200,24,65,36.9,19,43,44.2,5,22,22.7,21,29,72.4,15,31,46,10,25,15,7,3,74,1
16375,382915,428_14_14,ECUADOR,0,TOTALS,ECUADOR,200,19,57,33.3,15,37,40.5,4,20,20.0,15,25,60.0,13,29,42,5,27,20,6,2,57,0
16376,382928,428_14_15,ARGENTINA,0,TOTALS,ARGENTINA,200,27,63,42.9,21,40,52.5,6,23,26.1,19,26,73.1,13,23,36,14,23,9,11,0,79,1
16377,382941,428_14_15,URUGUAY,0,TOTALS,URUGUAY,200,24,60,40.0,20,42,47.6,4,18,22.2,16,23,69.6,13,24,37,6,22,18,7,1,68,0
16378,382954,428_14_16,VENEZUELA,0,TOTALS,VENEZUELA,200,23,55,41.8,20,41,48.8,3,14,21.4,17,22,77.3,15,20,35,7,18,9,4,1,66,1
16379,382967,428_14_16,BRAZIL,0,TOTALS,BRAZIL,200,28,65,43.1,25,47,53.2,3,18,16.7,6,14,42.9,18,19,37,9,19,10,8,1,65,0
16380,382980,428_14_17,PERU,0,TOTALS,PERU,200,27,62,43.5,22,38,57.9,5,24,20.8,4,10,40.0,6,26,32,19,24,14,3,0,63,0
16381,382993,428_14_17,ECUADOR,0,TOTALS,ECUADOR,200,29,66,43.9,19,42,45.2,10,24,41.7,22,31,71.0,12,34,46,10,13,10,9,0,90,1
16382,383006,428_14_18,PARAGUAY,0,TOTALS,PARAGUAY,200,29,57,50.9,23,37,62.2,6,20,30.0,11,17,64.7,4,27,31,16,23,9,11,3,75,1
16383,383019,428_14_18,CHILE,0,TOTALS,CHILE,200,16,52,30.8,12,34,35.3,4,18,22.2,13,20,65.0,12,29,41,8,20,17,5,1,49,0
16384,383032,428_14_19,URUGUAY,0,TOTALS,URUGUAY,200,21,60,35.0,11,33,33.3,10,27,37.0,9,17,52.9,8,24,32,8,21,9,7,0,61,0
16385,383045,428_14_19,BRAZIL,0,TOTALS,BRAZIL,200,24,53,45.3,18,25,72.0,6,28,21.4,12,20,60.0,8,34,42,10,23,11,2,2,66,1
16386,383058,428_14_20,ARGENTINA,0,TOTALS,ARGENTINA,200,23,58,39.7,14,36,38.9,9,22,40.9,10,14,71.4,14,28,42,9,21,16,2,2,65,0
16387,383071,428_14_20,VENEZUELA,0,TOTALS,VENEZUELA,200,26,64,40.6,21,42,50.0,5,22,22.7,17,24,70.8,13,25,38,12,19,9,12,3,74,1
16388,383603,430_14_01,ECUADOR,0,TOTALS,ECUADOR,200,13,57,22.8,7,32,21.9,6,25,24.0,3,12,25.0,7,16,23,5,18,18,7,5,35,1
16389,383616,430_14_01,ARGENTINA,0,TOTALS,ARGENTINA,200,42,63,66.7,28,39,71.8,14,24,58.3,10,13,76.9,5,35,40,31,16,12,4,3,108,0
16390,383629,430_14_02,CHILE,0,TOTALS,CHILE,200,33,67,49.3,27,45,60.0,6,22,27.3,4,10,40.0,10,17,27,17,14,17,22,0,76,1
16391,383640,430_14_02,BOLIVIA,0,TOTALS,BOLIVIA,200,19,45,42.2,14,31,45.2,5,14,35.7,4,10,40.0,8,25,33,7,14,39,8,2,47,0
16392,383653,430_14_03,ARGENTINA,0,TOTALS,ARGENTINA,200,27,59,45.8,19,37,51.4,8,22,36.4,12,19,63.2,5,33,38,16,14,13,11,2,74,1
16393,383666,430_14_03,COLOMBIA,0,TOTALS,COLOMBIA,200,16,54,29.6,12,35,34.3,4,19,21.1,7,19,36.8,7,28,35,5,21,19,6,2,43,0
16394,383680,430_14_04,CHILE,0,TOTALS,CHILE,200,26,73,35.6,18,44,40.9,8,29,27.6,10,22,45.5,27,27,54,18,15,18,9,1,70,1
16395,383692,430_14_04,ECUADOR,0,TOTALS,ECUADOR,200,18,51,35.3,9,30,30.0,9,21,42.9,5,9,55.6,6,22,28,9,16,26,3,2,50,0
16396,383703,430_14_05,BOLIVIA,0,TOTALS,BOLIVIA,200,14,51,27.5,6,30,20.0,8,21,38.1,1,2,50.0,5,20,25,7,17,24,8,0,37,0
16397,383716,430_14_05,ARGENTINA,0,TOTALS,ARGENTINA,200,29,49,59.2,17,27,63.0,12,22,54.5,12,18,66.7,3,26,29,19,6,18,6,6,82,1
16398,383729,430_14_06,COLOMBIA,0,TOTALS,COLOMBIA,200,32,75,42.7,25,48,52.1,7,27,25.9,21,35,60.0,21,29,50,15,8,13,12,6,92,1
16399,383741,430_14_06,ECUADOR,0,TOTALS,ECUADOR,200,21,66,31.8,16,44,36.4,5,22,22.7,5,8,62.5,7,25,32,5,23,22,4,4,52,0
16400,383752,430_14_07,BOLIVIA,0,TOTALS,BOLIVIA,200,23,55,41.8,16,32,50.0,7,23,30.4,18,25,72.0,5,33,38,12,25,28,9,4,71,1
16401,383764,430_14_07,ECUADOR,0,TOTALS,ECUADOR,200,14,53,26.4,10,28,35.7,4,25,16.0,28,39,71.8,7,25,32,3,22,19,10,3,60,0
16402,383777,430_14_08,CHILE,0,TOTALS,CHILE,200,21,56,37.5,15,34,44.1,6,22,27.3,20,24,83.3,8,18,26,7,20,11,9,0,68,1
16403,383790,430_14_08,COLOMBIA,0,TOTALS,COLOMBIA,200,19,49,38.8,12,22,54.5,7,27,25.9,13,24,54.2,9,28,37,10,25,18,7,3,58,0
16404,383801,430_14_09,BOLIVIA,0,TOTALS,BOLIVIA,200,15,64,23.4,10,40,25.0,5,24,20.8,7,12,58.3,10,25,35,6,15,20,8,1,42,0
16405,383814,430_14_09,COLOMBIA,0,TOTALS,COLOMBIA,200,31,70,44.3,16,30,53.3,15,40,37.5,11,14,78.6,12,33,45,13,13,14,10,4,88,1
16406,383827,430_14_10,CHILE,0,TOTALS,CHILE,200,17,56,30.4,9,35,25.7,8,21,38.1,12,17,70.6,4,15,19,5,17,9,9,1,54,0
16407,383840,430_14_10,ARGENTINA,0,TOTALS,ARGENTINA,200,30,56,53.6,18,30,60.0,12,26,46.2,7,11,63.6,9,34,43,14,19,16,4,4,79,1
16408,383853,430_14_11,COLOMBIA,0,TOTALS,COLOMBIA,200,30,59,50.8,19,32,59.4,11,27,40.7,9,19,47.4,10,28,38,15,10,18,13,4,80,1
16409,383864,430_14_11,BOLIVIA,0,TOTALS,BOLIVIA,200,29,68,42.6,20,42,47.6,9,26,34.6,5,7,71.4,9,21,30,17,17,13,9,2,72,0
16410,383877,430_14_12,ARGENTINA,0,TOTALS,ARGENTINA,200,31,58,53.4,22,37,59.5,9,21,42.9,14,21,66.7,7,33,40,21,19,19,6,4,85,1
16411,383890,430_14_12,CHILE,0,TOTALS,CHILE,200,18,63,28.6,15,40,37.5,3,23,13.0,15,19,78.9,5,21,26,5,20,13,11,0,54,0
16412,384321,432_14_01,CUBA,0,TOTALS,CUBA,200,25,62,40.3,20,43,46.5,5,19,26.3,16,27,59.3,11,26,37,10,24,8,7,2,71,1
16413,384334,432_14_01,PANAMA,0,TOTALS,PANAMA,200,20,60,33.3,12,39,30.8,8,21,38.1,15,23,65.2,14,29,43,6,20,14,2,5,63,0
16414,384347,432_14_02,COSTA RICA,0,TOTALS,COSTA RICA,200,19,60,31.7,17,41,41.5,2,19,10.5,7,9,77.8,6,23,29,7,22,18,8,4,47,0
16415,384360,432_14_02,DOMINICAN REPUBLIC,0,TOTALS,DOMINICAN REPUBLIC,200,30,65,46.2,24,46,52.2,6,19,31.6,19,27,70.4,14,35,49,14,9,19,6,2,85,1
16416,384373,432_14_03,PUERTO RICO,0,TOTALS,PUERTO RICO,200,35,74,47.3,28,57,49.1,7,17,41.2,11,19,57.9,14,27,41,14,22,8,3,2,88,1
16417,384386,432_14_03,BAHAMAS,0,TOTALS,BAHAMAS,200,23,63,36.5,15,43,34.9,8,20,40.0,18,24,75.0,9,26,35,11,18,7,4,3,72,0
16418,384399,432_14_04,MEXICO,0,TOTALS,MEXICO,200,26,66,39.4,22,48,45.8,4,18,22.2,18,30,60.0,18,31,49,15,23,18,11,1,74,1
16419,384412,432_14_04,VIRGIN ISLANDS,0,TOTALS,VIRGIN ISLANDS,200,20,61,32.8,13,42,31.0,7,19,36.8,17,30,56.7,15,27,42,8,25,18,7,2,64,0
16420,384425,432_14_05,BAHAMAS,0,TOTALS,BAHAMAS,200,36,73,49.3,27,52,51.9,9,21,42.9,15,24,62.5,14,41,55,14,16,10,0,3,96,1
16421,384438,432_14_05,EL SALVADOR,0,TOTALS,EL SALVADOR,200,18,71,25.4,13,44,29.5,5,27,18.5,6,16,37.5,11,15,26,7,21,6,6,2,47,0
16422,384451,432_14_06,JAMAICA,0,TOTALS,JAMAICA,200,25,66,37.9,24,53,45.3,1,13,7.7,7,20,35.0,11,22,33,5,21,13,8,2,58,0
16423,384462,432_14_06,CUBA,0,TOTALS,CUBA,200,24,60,40.0,21,41,51.2,3,19,15.8,19,28,67.9,19,35,54,11,26,18,7,5,70,1
16424,384475,432_14_07,PANAMA,0,TOTALS,PANAMA,200,34,68,50.0,24,45,53.3,10,23,43.5,6,17,35.3,11,42,53,18,12,11,9,1,84,1
16425,384488,432_14_07,COSTA RICA,0,TOTALS,COSTA RICA,200,16,64,25.0,13,45,28.9,3,19,15.8,5,11,45.5,9,29,38,7,19,12,8,0,40,0
16426,384501,432_14_08,VIRGIN ISLANDS,0,TOTALS,VIRGIN ISLANDS,200,23,67,34.3,17,47,36.2,6,20,30.0,12,21,57.1,11,27,38,15,22,12,5,1,64,0
16427,384514,432_14_08,PUERTO RICO,0,TOTALS,PUERTO RICO,200,33,65,50.8,25,44,56.8,8,21,38.1,23,30,76.7,9,38,47,18,19,9,8,1,97,1
16428,384527,432_14_09,COSTA RICA,0,TOTALS,COSTA RICA,200,21,69,30.4,17,50,34.0,4,19,21.1,10,20,50.0,15,32,47,12,19,13,7,6,56,0
16429,384540,432_14_09,JAMAICA,0,TOTALS,JAMAICA,200,25,80,31.2,22,55,40.0,3,25,12.0,11,19,57.9,27,35,62,8,16,13,2,6,64,1
16430,384553,432_14_10,DOMINICAN REPUBLIC,0,TOTALS,DOMINICAN REPUBLIC,200,26,63,41.3,23,53,43.4,3,10,30.0,16,17,94.1,8,28,36,15,18,13,11,8,71,1
16431,384566,432_14_10,PANAMA,0,TOTALS,PANAMA,200,22,67,32.8,16,50,32.0,6,17,35.3,6,12,50.0,20,29,49,12,21,20,8,3,56,0
16432,384579,432_14_11,EL SALVADOR,0,TOTALS,EL SALVADOR,200,23,52,44.2,21,41,51.2,2,11,18.2,10,12,83.3,9,21,30,7,19,24,5,2,58,0
16433,384592,432_14_11,PUERTO RICO,0,TOTALS,PUERTO RICO,200,36,69,52.2,27,48,56.2,9,21,42.9,12,23,52.2,14,22,36,21,16,13,13,2,93,1
16434,384604,432_14_12,BAHAMAS,0,TOTALS,BAHAMAS,200,17,57,29.8,13,42,31.0,4,15,26.7,19,30,63.3,13,20,33,7,18,21,11,2,57,0
16435,384617,432_14_12,MEXICO,0,TOTALS,MEXICO,200,30,57,52.6,16,31,51.6,14,26,53.8,16,21,76.2,8,33,41,19,27,22,13,3,90,1
16436,384628,432_14_13,CUBA,0,TOTALS,CUBA,200,29,65,44.6,23,44,52.3,6,21,28.6,8,12,66.7,9,38,47,21,23,22,7,2,72,1
16437,384641,432_14_13,COSTA RICA,0,TOTALS,COSTA RICA,200,24,70,34.3,22,55,40.0,2,15,13.3,17,25,68.0,11,26,37,12,17,13,12,2,67,0
16438,384654,432_14_14,VIRGIN ISLANDS,0,TOTALS,VIRGIN ISLANDS,200,29,70,41.4,23,45,51.1,6,25,24.0,16,27,59.3,13,34,47,18,22,19,7,1,80,1
16439,384666,432_14_14,BAHAMAS,0,TOTALS,BAHAMAS,200,26,70,37.1,20,49,40.8,6,21,28.6,21,30,70.0,10,31,41,18,26,13,12,4,79,0
16440,384679,432_14_15,JAMAICA,0,TOTALS,JAMAICA,200,28,65,43.1,24,51,47.1,4,14,28.6,8,12,66.7,13,30,43,7,22,15,6,1,68,0
16441,384692,432_14_15,DOMINICAN REPUBLIC,0,TOTALS,DOMINICAN REPUBLIC,200,26,64,40.6,19,40,47.5,7,24,29.2,14,21,66.7,9,25,34,19,16,9,9,4,73,1
16442,384705,432_14_16,MEXICO,0,TOTALS,MEXICO,200,40,70,57.1,30,45,66.7,10,25,40.0,17,23,73.9,12,26,38,25,13,14,20,4,107,0
16443,384718,432_14_16,EL SALVADOR,0,TOTALS,EL SALVADOR,200,25,55,45.5,17,36,47.2,8,19,42.1,6,10,60.0,4,19,23,20,14,26,5,0,64,1
16444,384731,432_14_17,PANAMA,0,TOTALS,PANAMA,200,21,71,29.6,15,44,34.1,6,27,22.2,14,16,87.5,19,38,57,13,17,12,6,9,62,1
16445,384744,432_14_17,JAMAICA,0,TOTALS,JAMAICA,200,21,72,29.2,19,57,33.3,2,15,13.3,11,19,57.9,16,33,49,5,17,11,6,3,55,0
16446,384757,432_14_18,EL SALVADOR,0,TOTALS,EL SALVADOR,200,28,73,38.4,21,46,45.7,7,27,25.9,7,10,70.0,7,34,41,13,16,19,7,4,70,1
16447,384770,432_14_18,VIRGIN ISLANDS,0,TOTALS,VIRGIN ISLANDS,200,37,91,40.7,20,44,45.5,17,47,36.2,14,25,56.0,22,38,60,25,13,13,9,1,105,0
16448,384783,432_14_19,DOMINICAN REPUBLIC,0,TOTALS,DOMINICAN REPUBLIC,200,27,55,49.1,22,42,52.4,5,13,38.5,17,20,85.0,4,28,32,15,13,14,8,5,76,1
16449,384794,432_14_19,CUBA,0,TOTALS,CUBA,200,30,70,42.9,23,55,41.8,7,15,46.7,5,8,62.5,13,24,37,16,20,16,5,4,72,0
16450,384807,432_14_20,PUERTO RICO,0,TOTALS,PUERTO RICO,200,20,55,36.4,13,37,35.1,7,18,38.9,18,29,62.1,13,23,36,12,32,22,9,2,65,0
16451,384820,432_14_20,MEXICO,0,TOTALS,MEXICO,200,23,51,45.1,20,36,55.6,3,15,20.0,26,33,78.8,8,24,32,17,28,19,12,4,75,1
16452,384833,432_14_21,DOMINICAN REPUBLIC,0,TOTALS,DOMINICAN REPUBLIC,200,26,63,41.3,22,46,47.8,4,17,23.5,17,19,89.5,10,22,32,17,18,10,5,3,73,0
16453,384846,432_14_21,PUERTO RICO,0,TOTALS,PUERTO RICO,200,30,63,47.6,23,46,50.0,7,17,41.2,11,17,64.7,14,26,40,20,22,13,4,5,78,1
16454,384859,432_14_22,MEXICO,0,TOTALS,MEXICO,200,36,65,55.4,30,47,63.8,6,18,33.3,7,11,63.6,8,27,35,26,20,16,8,7,85,1
16455,384870,432_14_22,CUBA,0,TOTALS,CUBA,200,26,63,41.3,22,52,42.3,4,11,36.4,14,20,70.0,10,23,33,9,13,15,8,2,70,0
16456,384883,432_14_23,DOMINICAN REPUBLIC,0,TOTALS,DOMINICAN REPUBLIC,200,28,58,48.3,21,43,48.8,7,15,46.7,12,17,70.6,5,26,31,21,14,14,10,2,75,1
16457,384894,432_14_23,CUBA,0,TOTALS,CUBA,200,27,56,48.2,18,38,47.4,9,18,50.0,3,9,33.3,6,29,35,12,18,21,5,1,66,0
16458,384907,432_14_24,PUERTO RICO,0,TOTALS,PUERTO RICO,200,23,67,34.3,15,46,32.6,8,21,38.1,6,10,60.0,12,20,32,13,24,16,10,0,60,0
16459,384920,432_14_24,MEXICO,0,TOTALS,MEXICO,200,23,56,41.1,16,37,43.2,7,19,36.8,21,24,87.5,13,34,47,13,19,20,8,4,74,1
16460,385443,434_14_01,ST.VINCENT AND THE GRENADINES,0,TOTALS,ST.VINCENT AND THE GRENADINES,200,19,56,33.9,15,45,33.3,4,11,36.4,11,21,52.4,12,25,37,18,22,22,1,2,53,0
16461,385456,434_14_01,BAHAMAS,0,TOTALS,BAHAMAS,200,32,75,42.7,31,67,46.3,1,8,12.5,19,30,63.3,16,29,45,23,14,17,15,5,84,1
16462,385469,434_14_02,CUBA,0,TOTALS,CUBA,200,34,75,45.3,24,54,44.4,10,21,47.6,4,7,57.1,11,34,45,21,20,12,8,2,82,1
16463,385482,434_14_02,ANTIGUA,0,TOTALS,ANTIGUA,200,18,57,31.6,14,42,33.3,4,15,26.7,16,21,76.2,7,26,33,9,12,13,10,5,56,0
16464,385495,434_14_03,BARBADOS,0,TOTALS,BARBADOS,200,16,56,28.6,14,46,30.4,2,10,20.0,19,30,63.3,5,31,36,9,14,16,10,2,53,0
16465,385508,434_14_03,VIRGIN ISLANDS,0,TOTALS,VIRGIN ISLANDS,200,28,71,39.4,27,55,49.1,1,16,6.2,9,15,60.0,13,31,44,21,19,17,9,2,66,1
16466,385521,434_14_04,BRITISH VIRGIN ISLANDS,0,TOTALS,BRITISH VIRGIN ISLANDS,200,39,75,52.0,25,48,52.1,14,27,51.9,7,18,38.9,9,26,35,30,22,9,3,1,99,1
16467,385532,434_14_04,GUYANA,0,TOTALS,GUYANA,200,20,60,33.3,10,32,31.2,10,28,35.7,13,23,56.5,11,26,37,13,13,16,6,4,63,0
16468,385545,434_14_05,CUBA,0,TOTALS,CUBA,200,30,81,37.0,22,56,39.3,8,25,32.0,18,19,94.7,10,22,32,23,25,11,19,6,86,1
16469,385558,434_14_05,ST.VINCENT AND THE GRENADINES,0,TOTALS,ST.VINCENT AND THE GRENADINES,200,20,54,37.0,19,45,42.2,1,9,11.1,17,33,51.5,10,31,41,17,13,26,6,2,58,0
16470,385571,434_14_06,VIRGIN ISLANDS,0,TOTALS,VIRGIN ISLANDS,200,37,77,48.1,26,47,55.3,11,30,36.7,10,14,71.4,12,26,38,30,25,14,13,4,95,1
16471,385582,434_14_06,GUYANA,0,TOTALS,GUYANA,200,25,74,33.8,17,49,34.7,8,25,32.0,17,32,53.1,18,24,42,12,16,17,8,2,75,0
16472,385595,434_14_07,BAHAMAS,0,TOTALS,BAHAMAS,200,24,67,35.8,19,46,41.3,5,21,23.8,15,23,65.2,13,27,40,12,22,12,7,4,68,0
16473,385608,434_14_07,ANTIGUA,0,TOTALS,ANTIGUA,200,32,76,42.1,21,45,46.7,11,31,35.5,15,27,55.6,14,27,41,19,19,12,7,1,90,1
16474,385621,434_14_08,BRITISH VIRGIN ISLANDS,0,TOTALS,BRITISH VIRGIN ISLANDS,200,32,63,50.8,26,50,52.0,6,13,46.2,11,16,68.8,10,22,32,20,19,19,15,6,81,1
16475,385634,434_14_08,BARBADOS,0,TOTALS,BARBADOS,200,28,66,42.4,19,39,48.7,9,27,33.3,12,20,60.0,17,19,36,19,18,19,10,0,77,0
16476,385647,434_14_09,ST.VINCENT AND THE GRENADINES,0,TOTALS,ST.VINCENT AND THE GRENADINES,200,27,63,42.9,20,43,46.5,7,20,35.0,32,36,88.9,8,30,38,18,13,11,7,11,93,1
16477,385660,434_14_09,ANTIGUA,0,TOTALS,ANTIGUA,200,34,84,40.5,22,50,44.0,12,34,35.3,12,17,70.6,17,23,40,28,25,12,6,4,92,0
16478,385673,434_14_10,BARBADOS,0,TOTALS,BARBADOS,200,26,58,44.8,17,39,43.6,9,19,47.4,19,26,73.1,11,29,40,17,19,14,1,6,80,1
16479,385684,434_14_10,GUYANA,0,TOTALS,GUYANA,200,27,72,37.5,21,48,43.8,6,24,25.0,9,14,64.3,12,18,30,16,23,6,5,3,69,0
16480,385697,434_14_11,CUBA,0,TOTALS,CUBA,200,25,57,43.9,19,41,46.3,6,16,37.5,15,18,83.3,12,18,30,16,25,15,8,4,71,0
16481,385710,434_14_11,BAHAMAS,0,TOTALS,BAHAMAS,200,25,65,38.5,20,52,38.5,5,13,38.5,22,33,66.7,17,20,37,19,18,12,7,3,77,1
16482,385723,434_14_12,VIRGIN ISLANDS,0,TOTALS,VIRGIN ISLANDS,200,32,64,50.0,23,42,54.8,9,22,40.9,16,20,80.0,11,27,38,24,22,10,7,1,89,1
16483,385736,434_14_12,BRITISH VIRGIN ISLANDS,0,TOTALS,BRITISH VIRGIN ISLANDS,200,20,70,28.6,13,46,28.3,7,24,29.2,13,19,68.4,15,19,34,14,17,12,5,5,60,0
16484,385749,434_14_13,ANTIGUA,0,TOTALS,ANTIGUA,200,25,63,39.7,19,39,48.7,6,24,25.0,14,23,60.9,8,22,30,13,17,16,13,3,70,0
16485,385762,434_14_13,BARBADOS,0,TOTALS,BARBADOS,200,29,64,45.3,21,37,56.8,8,27,29.6,17,23,73.9,15,22,37,20,23,19,8,1,83,1
16486,385775,434_14_14,ST.VINCENT AND THE GRENADINES,0,TOTALS,ST.VINCENT AND THE GRENADINES,200,28,63,44.4,25,50,50.0,3,13,23.1,13,23,56.5,11,14,25,15,16,13,5,5,72,0
16487,385786,434_14_14,GUYANA,0,TOTALS,GUYANA,200,33,74,44.6,24,50,48.0,9,24,37.5,11,18,61.1,12,21,33,21,20,10,11,2,86,1
16488,385799,434_14_15,CUBA,0,TOTALS,CUBA,200,24,64,37.5,21,51,41.2,3,13,23.1,11,20,55.0,18,19,37,15,22,16,9,2,62,1
16489,385812,434_14_15,VIRGIN ISLANDS,0,TOTALS,VIRGIN ISLANDS,200,17,51,33.3,11,29,37.9,6,22,27.3,20,32,62.5,14,19,33,8,18,11,7,4,60,0
16490,385825,434_14_16,BRITISH VIRGIN ISLANDS,0,TOTALS,BRITISH VIRGIN ISLANDS,200,22,61,36.1,14,36,38.9,8,25,32.0,13,20,65.0,16,16,32,12,19,13,2,5,65,0
16491,385838,434_14_16,BAHAMAS,0,TOTALS,BAHAMAS,200,33,61,54.1,27,50,54.0,6,11,54.5,12,20,60.0,8,23,31,16,16,14,10,3,84,1
16492,385851,434_14_17,ANTIGUA,0,TOTALS,ANTIGUA,200,41,87,47.1,26,56,46.4,15,31,48.4,12,20,60.0,14,28,42,29,28,15,8,3,109,0
16493,385864,434_14_17,ST.VINCENT AND THE GRENADINES,0,TOTALS,ST.VINCENT AND THE GRENADINES,200,26,71,36.6,24,55,43.6,2,16,12.5,27,44,61.4,13,23,36,18,15,19,7,7,81,1
16494,385877,434_14_18,BARBADOS,0,TOTALS,BARBADOS,200,22,62,35.5,18,38,47.4,4,24,16.7,10,14,71.4,10,22,32,11,17,15,8,3,58,0
16495,385888,434_14_18,GUYANA,0,TOTALS,GUYANA,200,29,68,42.6,20,46,43.5,9,22,40.9,12,19,63.2,16,24,40,20,15,13,8,3,79,1
16496,385901,434_14_19,VIRGIN ISLANDS,0,TOTALS,VIRGIN ISLANDS,200,43,75,57.3,34,51,66.7,9,24,37.5,7,15,46.7,7,16,23,23,12,4,8,3,102,0
16497,385914,434_14_19,BRITISH VIRGIN ISLANDS,0,TOTALS,BRITISH VIRGIN ISLANDS,200,27,69,39.1,23,49,46.9,4,20,20.0,10,14,71.4,15,23,38,9,15,15,2,3,68,1
16498,385927,434_14_20,CUBA,0,TOTALS,CUBA,200,25,64,39.1,21,47,44.7,4,17,23.5,10,16,62.5,14,23,37,15,15,15,7,3,64,0
16499,385940,434_14_20,BAHAMAS,0,TOTALS,BAHAMAS,200,26,66,39.4,21,51,41.2,5,15,33.3,18,24,75.0,12,21,33,14,18,12,6,6,75,1
16500,386471,436_14_01,PANAMA,0,TOTALS,PANAMA,200,32,72,44.4,21,45,46.7,11,27,40.7,18,25,72.0,12,17,29,17,23,16,11,6,93,1
16501,386484,436_14_01,DOMINICAN REPUBLIC,0,TOTALS,DOMINICAN REPUBLIC,200,28,68,41.2,26,58,44.8,2,10,20.0,29,33,87.9,13,24,37,10,20,20,8,2,87,0
16502,386497,436_14_02,PUERTO RICO,0,TOTALS,PUERTO RICO,200,33,79,41.8,18,47,38.3,15,32,46.9,15,22,68.2,16,31,47,18,14,16,13,3,96,1
16503,386510,436_14_02,JAMAICA,0,TOTALS,JAMAICA,200,24,78,30.8,20,56,35.7,4,22,18.2,12,20,60.0,12,27,39,8,21,21,6,3,64,0
16504,386523,436_14_03,MEXICO,0,TOTALS,MEXICO,200,31,55,56.4,25,43,58.1,6,12,50.0,14,20,70.0,7,33,40,20,27,21,9,6,82,1
16505,386536,436_14_03,COSTA RICA,0,TOTALS,COSTA RICA,200,18,70,25.7,16,52,30.8,2,18,11.1,15,29,51.7,9,16,25,9,24,13,12,2,53,0
16506,386549,436_14_04,JAMAICA,0,TOTALS,JAMAICA,200,17,50,34.0,10,34,29.4,7,16,43.8,25,37,67.6,4,23,27,8,27,20,6,3,66,0
16507,386562,436_14_04,CUBA,0,TOTALS,CUBA,200,25,69,36.2,18,51,35.3,7,18,38.9,22,37,59.5,18,31,49,14,27,16,12,1,79,1
16508,386575,436_14_05,DOMINICAN REPUBLIC,0,TOTALS,DOMINICAN REPUBLIC,200,30,63,47.6,22,41,53.7,8,22,36.4,15,20,75.0,14,31,45,17,17,29,9,5,83,1
16509,386588,436_14_05,COSTA RICA,0,TOTALS,COSTA RICA,200,30,83,36.1,27,62,43.5,3,21,14.3,10,18,55.6,15,19,34,18,21,17,18,1,73,0
16510,386601,436_14_06,PANAMA,0,TOTALS,PANAMA,200,30,72,41.7,23,47,48.9,7,25,28.0,12,19,63.2,16,20,36,9,14,13,9,3,79,1
16511,386614,436_14_06,MEXICO,0,TOTALS,MEXICO,200,27,62,43.5,21,47,44.7,6,15,40.0,13,16,81.2,13,20,33,24,19,18,9,6,73,0
16512,386627,436_14_07,COSTA RICA,0,TOTALS,COSTA RICA,200,21,61,34.4,17,44,38.6,4,17,23.5,6,18,33.3,17,27,44,9,22,18,9,3,52,0
16513,386640,436_14_07,PANAMA,0,TOTALS,PANAMA,200,27,64,42.2,19,39,48.7,8,25,32.0,11,16,68.8,6,31,37,11,14,15,7,1,73,1
16514,386653,436_14_08,PUERTO RICO,0,TOTALS,PUERTO RICO,200,29,61,47.5,23,44,52.3,6,17,35.3,19,31,61.3,8,26,34,12,23,14,6,3,83,1
16515,386666,436_14_08,CUBA,0,TOTALS,CUBA,200,25,64,39.1,15,36,41.7,10,28,35.7,12,17,70.6,6,21,27,9,26,13,4,3,72,0
16516,386679,436_14_09,MEXICO,0,TOTALS,MEXICO,200,28,78,35.9,23,59,39.0,5,19,26.3,11,15,73.3,17,25,42,12,24,13,8,2,72,0
16517,386692,436_14_09,DOMINICAN REPUBLIC,0,TOTALS,DOMINICAN REPUBLIC,200,25,61,41.0,22,47,46.8,3,14,21.4,24,33,72.7,10,29,39,6,18,13,4,4,77,1
16518,386705,436_14_10,JAMAICA,0,TOTALS,JAMAICA,200,24,71,33.8,17,39,43.6,7,32,21.9,10,15,66.7,16,21,37,7,18,13,5,2,65,0
16519,386718,436_14_10,COSTA RICA,0,TOTALS,COSTA RICA,200,23,60,38.3,16,40,40.0,7,20,35.0,22,34,64.7,15,24,39,13,17,14,4,1,75,1
16520,386731,436_14_11,PUERTO RICO,0,TOTALS,PUERTO RICO,200,28,82,34.1,22,57,38.6,6,25,24.0,9,12,75.0,16,27,43,12,25,10,5,5,71,0
16521,386744,436_14_11,DOMINICAN REPUBLIC,0,TOTALS,DOMINICAN REPUBLIC,200,22,64,34.4,17,47,36.2,5,17,29.4,23,32,71.9,11,31,42,8,15,14,4,2,72,1
16522,386757,436_14_12,PANAMA,0,TOTALS,PANAMA,200,23,69,33.3,17,50,34.0,6,19,31.6,9,14,64.3,15,18,33,9,14,15,10,3,64,1
16523,386770,436_14_12,CUBA,0,TOTALS,CUBA,200,22,65,33.8,18,51,35.3,4,14,28.6,9,13,69.2,13,29,42,4,15,20,11,7,59,0
16524,386783,436_14_13,MEXICO,0,TOTALS,MEXICO,200,29,62,46.8,26,47,55.3,3,15,20.0,13,19,68.4,8,25,33,14,19,26,13,2,74,1
16525,386796,436_14_13,COSTA RICA,0,TOTALS,COSTA RICA,200,22,56,39.3,18,45,40.0,4,11,36.4,17,22,77.3,5,14,19,24,22,20,11,2,65,0
16526,386809,436_14_14,PUERTO RICO,0,TOTALS,PUERTO RICO,225,32,78,41.0,25,56,44.6,7,22,31.8,36,46,78.3,19,18,37,9,32,10,8,7,107,0
16527,386822,436_14_14,CUBA,0,TOTALS,CUBA,225,31,78,39.7,28,62,45.2,3,16,18.8,32,47,68.1,24,28,52,7,38,18,4,1,97,1
16528,386835,436_14_15,DOMINICAN REPUBLIC,0,TOTALS,DOMINICAN REPUBLIC,200,35,80,43.8,27,53,50.9,8,27,29.6,5,10,50.0,11,28,39,16,17,7,10,2,83,1
16529,386848,436_14_15,PANAMA,0,TOTALS,PANAMA,200,24,69,34.8,18,43,41.9,6,26,23.1,15,19,78.9,13,64,77,11,14,18,7,2,69,0
16530,387366,438_14_01,MEXICO,0,TOTALS,MEXICO,200,25,75,33.3,13,39,33.3,12,36,33.3,10,24,41.7,19,26,45,10,29,18,11,5,72,0
16531,387379,438_14_01,ARGENTINA,0,TOTALS,ARGENTINA,200,28,67,41.8,21,42,50.0,7,25,28.0,24,33,72.7,15,37,52,11,25,18,8,1,87,1
16532,387392,438_14_02,CANADA,0,TOTALS,CANADA,200,38,71,53.5,28,53,52.8,10,18,55.6,15,19,78.9,11,29,40,25,19,11,11,4,101,0
16533,387405,438_14_02,BRAZIL,0,TOTALS,BRAZIL,200,18,57,31.6,10,30,33.3,8,27,29.6,15,21,71.4,12,21,33,10,20,23,6,5,59,1
16534,387418,438_14_03,PUERTO RICO,0,TOTALS,PUERTO RICO,200,28,75,37.3,23,56,41.1,5,19,26.3,11,20,55.0,12,28,40,11,23,14,8,2,72,0
16535,387431,438_14_03,DOMINICAN REPUBLIC,0,TOTALS,DOMINICAN REPUBLIC,200,25,58,43.1,21,43,48.8,4,15,26.7,20,30,66.7,10,39,49,10,21,24,9,3,74,1
16536,387444,438_14_04,URUGUAY,0,TOTALS,URUGUAY,200,21,63,33.3,10,39,25.6,11,24,45.8,5,13,38.5,5,21,26,9,21,32,4,1,58,1
16537,387457,438_14_04,USA,0,TOTALS,USA,200,59,94,62.8,46,68,67.6,13,26,50.0,25,37,67.6,19,38,57,40,16,10,21,8,156,0
16538,387470,438_14_05,BRAZIL,0,TOTALS,BRAZIL,200,27,62,43.5,23,45,51.1,4,17,23.5,17,21,81.0,12,24,36,13,22,16,10,4,75,0
16539,387483,438_14_05,PUERTO RICO,0,TOTALS,PUERTO RICO,200,30,66,45.5,23,51,45.1,7,15,46.7,13,21,61.9,15,25,40,20,18,20,5,2,80,1
16540,387496,438_14_06,DOMINICAN REPUBLIC,0,TOTALS,DOMINICAN REPUBLIC,200,23,64,35.9,17,45,37.8,6,19,31.6,15,23,65.2,15,19,34,12,22,22,16,3,67,0
16541,387509,438_14_06,CANADA,0,TOTALS,CANADA,200,28,58,48.3,21,37,56.8,7,21,33.3,16,22,72.7,12,32,44,15,22,27,7,4,79,1
16542,387522,438_14_07,URUGUAY,0,TOTALS,URUGUAY,200,15,61,24.6,13,43,30.2,2,18,11.1,23,40,57.5,16,28,44,5,24,16,7,2,55,0
16543,387535,438_14_07,ARGENTINA,0,TOTALS,ARGENTINA,200,23,57,40.4,13,35,37.1,10,22,45.5,11,28,39.3,13,37,50,13,25,21,11,4,67,1
16544,387548,438_14_08,USA,0,TOTALS,USA,200,41,73,56.2,35,53,66.0,6,20,30.0,12,21,57.1,16,37,53,19,17,15,12,8,100,0
16545,387561,438_14_08,MEXICO,0,TOTALS,MEXICO,200,14,62,22.6,11,41,26.8,3,21,14.3,15,19,78.9,12,20,32,5,20,22,5,2,46,1
16546,387574,438_14_09,PUERTO RICO,0,TOTALS,PUERTO RICO,200,24,67,35.8,15,44,34.1,9,23,39.1,13,22,59.1,13,18,31,15,22,21,13,3,70,0
16547,387587,438_14_09,CANADA,0,TOTALS,CANADA,200,34,69,49.3,29,52,55.8,5,17,29.4,18,28,64.3,21,37,58,19,18,24,14,7,91,1
16548,387600,438_14_10,MEXICO,0,TOTALS,MEXICO,200,21,68,30.9,15,46,32.6,6,22,27.3,22,34,64.7,14,20,34,9,30,18,8,10,70,0
16549,387613,438_14_10,URUGUAY,0,TOTALS,URUGUAY,200,32,65,49.2,26,52,50.0,6,13,46.2,19,27,70.4,15,35,50,19,31,22,10,3,89,1
16550,387626,438_14_11,BRAZIL,0,TOTALS,BRAZIL,200,26,61,42.6,19,41,46.3,7,20,35.0,10,12,83.3,11,23,34,16,24,16,7,4,69,0
16551,387639,438_14_11,DOMINICAN REPUBLIC,0,TOTALS,DOMINICAN REPUBLIC,200,27,63,42.9,21,50,42.0,6,13,46.2,12,24,50.0,19,26,45,9,15,21,9,4,72,1
16552,387652,438_14_12,ARGENTINA,0,TOTALS,ARGENTINA,200,24,71,33.8,21,49,42.9,3,22,13.6,13,22,59.1,14,26,40,7,27,16,3,2,64,1
16553,387665,438_14_12,USA,0,TOTALS,USA,200,45,83,54.2,36,57,63.2,9,26,34.6,19,32,59.4,21,34,55,21,21,8,9,10,118,0
16554,387678,438_14_13,PUERTO RICO,0,TOTALS,PUERTO RICO,200,25,63,39.7,20,50,40.0,5,13,38.5,15,25,60.0,10,37,47,17,21,20,6,5,70,1
16555,387691,438_14_13,MEXICO,0,TOTALS,MEXICO,200,26,83,31.3,19,56,33.9,7,27,25.9,10,17,58.8,20,32,52,13,25,15,10,2,69,0
16556,387704,438_14_14,URUGUAY,0,TOTALS,URUGUAY,200,18,68,26.5,15,40,37.5,3,28,10.7,16,25,64.0,18,22,40,5,28,19,6,2,55,0
16557,387717,438_14_14,BRAZIL,0,TOTALS,BRAZIL,200,33,64,51.6,27,47,57.4,6,17,35.3,25,37,67.6,16,34,50,12,23,16,12,4,97,1
16558,387730,438_14_15,CANADA,0,TOTALS,CANADA,225,27,60,45.0,23,40,57.5,4,20,20.0,33,40,82.5,12,33,45,7,28,16,6,2,91,1
16559,387743,438_14_15,ARGENTINA,0,TOTALS,ARGENTINA,225,26,64,40.6,20,38,52.6,6,26,23.1,24,34,70.6,11,22,33,7,29,16,4,1,82,0
16560,387756,438_14_16,USA,0,TOTALS,USA,200,31,63,49.2,27,49,55.1,4,14,28.6,24,36,66.7,11,34,45,16,15,13,15,8,90,1
16561,387769,438_14_16,DOMINICAN REPUBLIC,0,TOTALS,DOMINICAN REPUBLIC,200,22,70,31.4,20,53,37.7,2,17,11.8,10,14,71.4,15,26,41,9,24,24,4,2,56,0
16562,387782,438_14_17,MEXICO,0,TOTALS,MEXICO,200,30,69,43.5,24,49,49.0,6,20,30.0,13,22,59.1,18,29,47,14,16,19,8,2,79,1
16563,387795,438_14_17,URUGUAY,0,TOTALS,URUGUAY,200,20,52,38.5,14,33,42.4,6,19,31.6,19,23,82.6,4,24,28,9,20,20,11,5,65,0
16564,387808,438_14_18,PUERTO RICO,0,TOTALS,PUERTO RICO,225,31,62,50.0,25,49,51.0,6,13,46.2,20,32,62.5,9,30,39,9,25,20,9,2,88,1
16565,387821,438_14_18,BRAZIL,0,TOTALS,BRAZIL,225,30,78,38.5,19,48,39.6,11,30,36.7,13,28,46.4,22,28,50,16,26,19,6,7,84,0
16566,387834,438_14_19,ARGENTINA,0,TOTALS,ARGENTINA,200,19,59,32.2,15,36,41.7,4,23,17.4,11,15,73.3,12,22,34,7,20,7,5,1,53,0
16567,387847,438_14_19,DOMINICAN REPUBLIC,0,TOTALS,DOMINICAN REPUBLIC,200,24,61,39.3,22,47,46.8,2,14,14.3,14,18,77.8,18,28,46,11,16,12,4,2,64,1
16568,387860,438_14_20,CANADA,0,TOTALS,CANADA,200,22,60,36.7,18,47,38.3,4,13,30.8,31,44,70.5,15,21,36,5,32,25,6,5,79,1
16569,387873,438_14_20,USA,0,TOTALS,USA,200,38,85,44.7,31,68,45.6,7,17,41.2,30,41,73.2,28,29,57,18,32,20,11,6,113,0
16570,388406,440_14_01,URUGUAY,0,TOTALS,URUGUAY,200,21,63,33.3,17,44,38.6,4,19,21.1,15,28,53.6,19,25,44,10,23,16,9,2,61,0
16571,388419,440_14_01,CHILE,0,TOTALS,CHILE,200,19,55,34.5,15,25,60.0,4,30,13.3,21,31,67.7,13,30,43,12,22,16,9,2,63,1
16572,388432,440_14_02,BRAZIL,0,TOTALS,BRAZIL,200,27,71,38.0,23,57,40.4,4,14,28.6,16,33,48.5,25,30,55,17,19,19,11,3,74,1
16573,388445,440_14_02,ECUADOR,0,TOTALS,ECUADOR,200,16,60,26.7,15,47,31.9,1,13,7.7,8,20,40.0,18,26,44,7,25,24,10,1,41,0
16574,388458,440_14_03,VENEZUELA,0,TOTALS,VENEZUELA,200,25,66,37.9,21,51,41.2,4,15,26.7,11,29,37.9,22,39,61,16,13,21,13,2,65,1
16575,388471,440_14_03,PERU,0,TOTALS,PERU,200,20,69,29.0,16,44,36.4,4,25,16.0,5,9,55.6,12,25,37,9,18,19,13,4,49,0
16576,388484,440_14_04,ARGENTINA,0,TOTALS,ARGENTINA,200,30,75,40.0,27,55,49.1,3,20,15.0,14,32,43.8,25,41,66,14,26,19,3,3,77,1
16577,388497,440_14_04,COLOMBIA,0,TOTALS,COLOMBIA,200,16,63,25.4,12,43,27.9,4,20,20.0,16,43,37.2,16,24,40,5,21,13,11,4,52,0
16578,388510,440_14_05,PERU,0,TOTALS,PERU,200,13,58,22.4,11,38,28.9,2,20,10.0,17,26,65.4,12,25,37,10,23,16,7,3,45,0
16579,388523,440_14_05,BRAZIL,0,TOTALS,BRAZIL,200,23,66,34.8,18,48,37.5,5,18,27.8,19,32,59.4,22,31,53,14,18,16,12,2,70,1
16580,388536,440_14_06,CHILE,0,TOTALS,CHILE,200,16,51,31.4,8,26,30.8,8,25,32.0,15,37,40.5,13,22,35,10,17,22,10,4,55,0
16581,388549,440_14_06,ARGENTINA,0,TOTALS,ARGENTINA,200,29,63,46.0,25,44,56.8,4,19,21.1,8,15,53.3,16,28,44,17,26,19,13,4,70,1
16582,388562,440_14_07,COLOMBIA,0,TOTALS,COLOMBIA,200,19,66,28.8,17,54,31.5,2,12,16.7,6,23,26.1,17,29,46,9,0,23,14,2,46,0
16583,388575,440_14_07,URUGUAY,0,TOTALS,URUGUAY,200,26,67,38.8,18,47,38.3,8,20,40.0,14,30,46.7,19,39,58,15,17,29,12,2,74,1
16584,388588,440_14_08,VENEZUELA,0,TOTALS,VENEZUELA,200,33,81,40.7,32,65,49.2,1,16,6.2,11,25,44.0,27,28,55,18,13,18,19,6,78,1
16585,388601,440_14_08,ECUADOR,0,TOTALS,ECUADOR,200,12,61,19.7,11,49,22.4,1,12,8.3,3,7,42.9,13,23,36,3,20,17,12,1,28,0
16586,388614,440_14_09,CHILE,0,TOTALS,CHILE,200,30,66,45.5,26,48,54.2,4,18,22.2,8,18,44.4,12,27,39,10,12,24,12,0,72,1
16587,388627,440_14_09,COLOMBIA,0,TOTALS,COLOMBIA,200,22,70,31.4,17,42,40.5,5,28,17.9,9,18,50.0,24,28,52,10,17,19,14,2,58,0
16588,388640,440_14_10,ECUADOR,0,TOTALS,ECUADOR,200,20,62,32.3,17,43,39.5,3,19,15.8,11,25,44.0,15,30,45,7,18,14,14,0,54,0
16589,388653,440_14_10,PERU,0,TOTALS,PERU,200,23,68,33.8,15,42,35.7,8,26,30.8,9,21,42.9,18,30,48,9,22,20,8,1,63,1
16590,388666,440_14_11,ARGENTINA,0,TOTALS,ARGENTINA,200,26,63,41.3,18,42,42.9,8,21,38.1,10,15,66.7,13,35,48,15,24,17,5,1,70,1
16591,388679,440_14_11,URUGUAY,0,TOTALS,URUGUAY,200,19,59,32.2,11,33,33.3,8,26,30.8,14,30,46.7,12,27,39,9,22,12,8,2,60,0
16592,388692,440_14_12,VENEZUELA,0,TOTALS,VENEZUELA,200,22,61,36.1,18,47,38.3,4,14,28.6,18,40,45.0,20,29,49,10,20,23,13,7,66,0
16593,388705,440_14_12,BRAZIL,0,TOTALS,BRAZIL,200,23,61,37.7,17,42,40.5,6,19,31.6,18,25,72.0,14,28,42,12,30,17,13,2,70,1
16594,388718,440_14_13,URUGUAY,0,TOTALS,URUGUAY,200,30,68,44.1,26,50,52.0,4,18,22.2,11,28,39.3,17,31,48,14,18,14,10,2,75,1
16595,388731,440_14_13,ECUADOR,0,TOTALS,ECUADOR,200,21,61,34.4,19,51,37.3,2,10,20.0,9,33,27.3,12,23,35,11,23,16,7,1,53,0
16596,388744,440_14_14,PERU,0,TOTALS,PERU,200,29,72,40.3,21,49,42.9,8,23,34.8,11,18,61.1,11,34,45,17,27,15,7,2,77,1
16597,388757,440_14_14,COLOMBIA,0,TOTALS,COLOMBIA,200,21,66,31.8,13,43,30.2,8,23,34.8,23,39,59.0,16,33,49,12,17,13,10,2,73,0
16598,388770,440_14_15,BRAZIL,0,TOTALS,BRAZIL,200,37,68,54.4,29,50,58.0,8,18,44.4,8,14,57.1,16,31,47,21,17,9,9,1,90,1
16599,388783,440_14_15,CHILE,0,TOTALS,CHILE,200,16,53,30.2,13,39,33.3,3,14,21.4,10,17,58.8,7,16,23,12,12,11,6,3,45,0
16600,388796,440_14_16,ARGENTINA,0,TOTALS,ARGENTINA,200,23,59,39.0,14,36,38.9,9,23,39.1,11,17,64.7,16,30,46,16,25,18,12,6,66,1
16601,388809,440_14_16,VENEZUELA,0,TOTALS,VENEZUELA,200,15,55,27.3,14,45,31.1,1,10,10.0,18,31,58.1,14,26,40,10,21,21,10,4,49,0
16602,388822,440_14_17,ECUADOR,0,TOTALS,ECUADOR,275,32,89,36.0,27,71,38.0,5,18,27.8,11,23,47.8,21,46,67,14,30,30,10,3,80,1
16603,388835,440_14_17,COLOMBIA,0,TOTALS,COLOMBIA,275,27,99,27.3,19,70,27.1,8,29,27.6,17,47,36.2,35,36,71,12,21,24,17,2,79,0
16604,388848,440_14_18,URUGUAY,0,TOTALS,URUGUAY,200,29,65,44.6,24,48,50.0,5,17,29.4,10,22,45.5,13,42,55,17,16,12,1,0,73,1
16605,388861,440_14_18,PERU,0,TOTALS,PERU,200,19,72,26.4,12,44,27.3,7,28,25.0,9,19,47.4,16,26,42,11,15,4,6,3,54,0
16606,388874,440_14_19,VENEZUELA,0,TOTALS,VENEZUELA,200,29,66,43.9,23,49,46.9,6,17,35.3,4,11,36.4,21,29,50,8,20,17,11,3,68,1
16607,388887,440_14_19,CHILE,0,TOTALS,CHILE,200,15,49,30.6,12,32,37.5,3,17,17.6,11,18,61.1,8,19,27,2,12,19,9,4,44,0
16608,388900,440_14_20,ARGENTINA,0,TOTALS,ARGENTINA,200,20,51,39.2,19,37,51.4,1,14,7.1,14,23,60.9,9,24,33,1,24,17,5,1,55,0
16609,388913,440_14_20,BRAZIL,0,TOTALS,BRAZIL,200,24,60,40.0,19,48,39.6,5,12,41.7,13,22,59.1,13,25,38,10,26,16,7,1,66,1
16610,389448,442_14_01,MEXICO,0,TOTALS,MEXICO,200,32,72,44.4,23,49,46.9,9,23,39.1,7,10,70.0,10,23,33,20,20,26,23,7,80,1
16611,389461,442_14_01,DOMINICAN REPUBLIC,0,TOTALS,DOMINICAN REPUBLIC,200,25,68,36.8,23,59,39.0,2,9,22.2,15,26,57.7,21,30,51,17,10,31,12,2,67,0
16612,389473,442_14_02,COSTA RICA,0,TOTALS,COSTA RICA,200,14,45,31.1,12,31,38.7,2,14,14.3,13,19,68.4,8,22,30,8,10,34,16,1,43,0
16613,389486,442_14_02,VIRGIN ISLANDS,0,TOTALS,VIRGIN ISLANDS,200,30,76,39.5,20,53,37.7,10,23,43.5,3,13,23.1,25,24,49,19,17,31,20,2,73,1
16614,389499,442_14_03,BAHAMAS,0,TOTALS,BAHAMAS,200,17,53,32.1,13,36,36.1,4,17,23.5,2,5,40.0,15,28,43,7,15,24,4,5,40,0
16615,389512,442_14_03,PUERTO RICO,0,TOTALS,PUERTO RICO,200,29,81,35.8,24,73,32.9,5,8,62.5,15,25,60.0,21,21,42,23,5,8,13,4,78,1
16616,389525,442_14_04,PANAMA,0,TOTALS,PANAMA,200,30,67,44.8,30,58,51.7,0,9,0.0,10,28,35.7,25,38,63,13,15,27,10,4,70,1
16617,389537,442_14_04,GUATEMALA,0,TOTALS,GUATEMALA,200,20,68,29.4,13,43,30.2,7,25,28.0,6,13,46.2,10,19,29,11,20,17,12,1,53,0
16618,389550,442_14_05,VIRGIN ISLANDS,0,TOTALS,VIRGIN ISLANDS,200,18,68,26.5,11,32,34.4,7,36,19.4,8,13,61.5,15,32,47,14,12,13,6,8,51,0
16619,389563,442_14_05,MEXICO,0,TOTALS,MEXICO,200,27,82,32.9,21,65,32.3,6,17,35.3,1,4,25.0,19,36,55,21,16,13,6,1,61,1
16620,389576,442_14_06,DOMINICAN REPUBLIC,0,TOTALS,DOMINICAN REPUBLIC,200,34,84,40.5,30,55,54.5,4,29,13.8,8,11,72.7,31,32,63,21,4,17,11,3,80,1
16621,389588,442_14_06,COSTA RICA,0,TOTALS,COSTA RICA,200,13,55,23.6,7,33,21.2,6,22,27.3,1,2,50.0,6,15,21,9,8,18,4,0,33,0
16622,389601,442_14_07,PUERTO RICO,0,TOTALS,PUERTO RICO,200,34,77,44.2,33,67,49.3,1,10,10.0,12,19,63.2,18,20,38,16,13,17,20,3,81,1
16623,389613,442_14_07,GUATEMALA,0,TOTALS,GUATEMALA,200,14,34,41.2,13,29,44.8,1,5,20.0,10,19,52.6,4,26,30,9,12,32,7,7,39,0
16624,389626,442_14_08,BAHAMAS,0,TOTALS,BAHAMAS,200,25,80,31.2,21,50,42.0,4,30,13.3,9,14,64.3,21,22,43,9,37,19,15,0,63,0
16625,389639,442_14_08,PANAMA,0,TOTALS,PANAMA,200,20,55,36.4,17,40,42.5,3,15,20.0,27,54,50.0,18,32,50,13,12,29,5,9,70,1
16626,389652,442_14_09,MEXICO,0,TOTALS,MEXICO,200,38,93,40.9,34,71,47.9,4,22,18.2,13,18,72.2,32,26,58,22,16,19,28,6,93,1
16627,389664,442_14_09,COSTA RICA,0,TOTALS,COSTA RICA,200,10,45,22.2,10,32,31.2,0,13,0.0,8,16,50.0,10,22,32,4,15,44,9,3,28,0
16628,389677,442_14_10,VIRGIN ISLANDS,0,TOTALS,VIRGIN ISLANDS,200,16,61,26.2,10,41,24.4,6,20,30.0,7,18,38.9,11,25,36,14,22,23,10,4,45,0
16629,389690,442_14_10,DOMINICAN REPUBLIC,0,TOTALS,DOMINICAN REPUBLIC,200,27,65,41.5,21,48,43.8,6,17,35.3,15,25,60.0,14,36,50,15,18,24,11,6,75,1
16630,389702,442_14_11,GUATEMALA,0,TOTALS,GUATEMALA,200,19,53,35.8,17,40,42.5,2,13,15.4,5,16,31.2,7,30,37,11,17,19,6,4,45,0
16631,389715,442_14_11,BAHAMAS,0,TOTALS,BAHAMAS,200,21,76,27.6,20,61,32.8,1,15,6.7,17,30,56.7,23,29,52,14,14,18,13,2,60,1
16632,389728,442_14_12,PUERTO RICO,0,TOTALS,PUERTO RICO,200,29,64,45.3,20,45,44.4,9,19,47.4,9,13,69.2,10,20,30,17,26,17,15,0,76,1
16633,389741,442_14_12,PANAMA,0,TOTALS,PANAMA,200,18,42,42.9,18,34,52.9,0,8,0.0,15,33,45.5,8,24,32,7,13,26,9,2,51,0
16634,389754,442_14_13,VIRGIN ISLANDS,0,TOTALS,VIRGIN ISLANDS,200,38,95,40.0,35,76,46.1,3,19,15.8,7,16,43.8,35,38,73,22,18,21,13,7,86,1
16635,389766,442_14_13,GUATEMALA,0,TOTALS,GUATEMALA,200,22,72,30.6,19,57,33.3,3,15,20.0,13,23,56.5,12,18,30,18,13,22,11,2,60,0
16636,389779,442_14_14,BAHAMAS,0,TOTALS,BAHAMAS,200,19,63,30.2,18,55,32.7,1,8,12.5,9,28,32.1,23,35,58,7,12,25,12,1,48,1
16637,389791,442_14_14,COSTA RICA,0,TOTALS,COSTA RICA,200,13,57,22.8,12,42,28.6,1,15,6.7,4,9,44.4,9,18,27,6,14,18,10,0,31,0
16638,389804,442_14_15,PUERTO RICO,0,TOTALS,PUERTO RICO,200,25,54,46.3,18,42,42.9,7,12,58.3,8,14,57.1,9,18,27,14,20,21,7,3,65,1
16639,389817,442_14_15,DOMINICAN REPUBLIC,0,TOTALS,DOMINICAN REPUBLIC,200,24,51,47.1,22,47,46.8,2,4,50.0,12,25,48.0,11,22,33,14,15,15,13,3,62,0
16640,389830,442_14_16,MEXICO,0,TOTALS,MEXICO,200,29,71,40.8,26,50,52.0,3,21,14.3,17,28,60.7,14,25,39,8,24,17,11,3,78,1
16641,389843,442_14_16,PANAMA,0,TOTALS,PANAMA,200,14,48,29.2,11,30,36.7,3,18,16.7,14,35,40.0,13,32,45,6,20,27,5,1,45,0
16642,389855,442_14_17,GUATEMALA,0,TOTALS,GUATEMALA,200,23,52,44.2,17,34,50.0,6,18,33.3,10,17,58.8,8,21,29,11,21,18,8,3,62,0
16643,389867,442_14_17,COSTA RICA,0,TOTALS,COSTA RICA,200,23,53,43.4,13,28,46.4,10,25,40.0,11,21,52.4,5,19,24,20,12,16,11,2,67,1
16644,389880,442_14_18,VIRGIN ISLANDS,0,TOTALS,VIRGIN ISLANDS,200,22,60,36.7,16,43,37.2,6,17,35.3,9,20,45.0,12,25,37,15,13,13,9,3,59,1
16645,389893,442_14_18,BAHAMAS,0,TOTALS,BAHAMAS,200,19,60,31.7,16,50,32.0,3,10,30.0,11,22,50.0,15,26,41,11,14,18,6,2,52,0
16646,389906,442_14_19,PANAMA,0,TOTALS,PANAMA,200,14,52,26.9,13,37,35.1,1,15,6.7,16,20,80.0,12,15,27,7,10,25,16,4,45,0
16647,389919,442_14_19,DOMINICAN REPUBLIC,0,TOTALS,DOMINICAN REPUBLIC,200,33,62,53.2,27,45,60.0,6,17,35.3,6,9,66.7,13,26,39,19,19,27,11,2,78,1
16648,389932,442_14_20,MEXICO,0,TOTALS,MEXICO,200,24,73,32.9,21,61,34.4,3,12,25.0,10,19,52.6,15,35,50,12,13,18,5,6,61,1
16649,389945,442_14_20,PUERTO RICO,0,TOTALS,PUERTO RICO,200,27,71,38.0,26,63,41.3,1,8,12.5,3,10,30.0,8,31,39,14,16,14,9,5,58,0
16650,390444,444_14_01,PANAMA,0,TOTALS,PANAMA,200,32,91,35.2,26,71,36.6,6,20,30.0,7,21,33.3,30,33,63,16,24,22,10,10,77,1
16651,390457,444_14_01,EL SALVADOR,0,TOTALS,EL SALVADOR,200,19,66,28.8,18,55,32.7,1,11,9.1,12,21,57.1,8,22,30,14,17,28,4,5,51,0
16652,390470,444_14_02,COSTA RICA,0,TOTALS,COSTA RICA,200,27,69,39.1,22,56,39.3,5,13,38.5,7,15,46.7,19,41,60,12,26,30,17,3,66,1
16653,390483,444_14_02,GUATEMALA,0,TOTALS,GUATEMALA,200,15,60,25.0,12,50,24.0,3,10,30.0,9,33,27.3,12,26,38,5,19,27,16,0,42,0
16654,390496,444_14_03,HONDURAS,0,TOTALS,HONDURAS,200,57,115,49.6,54,103,52.4,3,12,25.0,12,18,66.7,30,30,60,23,16,17,37,5,129,0
16655,390507,444_14_03,NICARAGUA,0,TOTALS,NICARAGUA,200,12,51,23.5,12,47,25.5,0,4,0.0,8,26,30.8,16,24,40,4,11,54,5,3,32,1
16656,390520,444_14_04,PANAMA,0,TOTALS,PANAMA,200,24,65,36.9,23,53,43.4,1,12,8.3,21,49,42.9,20,40,60,9,20,32,6,4,70,1
16657,390533,444_14_04,COSTA RICA,0,TOTALS,COSTA RICA,200,25,76,32.9,18,50,36.0,7,26,26.9,10,21,47.6,13,27,40,19,34,24,11,3,67,0
16658,390544,444_14_05,NICARAGUA,0,TOTALS,NICARAGUA,200,17,57,29.8,16,55,29.1,1,2,50.0,12,30,40.0,9,32,41,8,9,35,8,2,47,1
16659,390557,444_14_05,EL SALVADOR,0,TOTALS,EL SALVADOR,200,49,116,42.2,46,99,46.5,3,17,17.6,4,13,30.8,34,34,68,29,22,15,26,3,105,0
16660,390570,444_14_06,GUATEMALA,0,TOTALS,GUATEMALA,200,17,69,24.6,15,58,25.9,2,11,18.2,23,41,56.1,16,32,48,8,22,33,17,2,59,1
16661,390583,444_14_06,HONDURAS,0,TOTALS,HONDURAS,200,24,65,36.9,24,59,40.7,0,6,0.0,10,31,32.3,17,38,55,8,27,37,20,2,58,0
16662,390596,444_14_07,GUATEMALA,0,TOTALS,GUATEMALA,200,49,114,43.0,46,104,44.2,3,10,30.0,6,15,40.0,29,25,54,25,16,23,37,6,107,0
16663,390607,444_14_07,NICARAGUA,0,TOTALS,NICARAGUA,200,19,51,37.3,19,49,38.8,0,2,0.0,9,18,50.0,5,37,42,12,14,58,14,3,47,1
16664,390620,444_14_08,EL SALVADOR,0,TOTALS,EL SALVADOR,200,15,67,22.4,14,62,22.6,1,5,20.0,6,15,40.0,12,17,29,13,11,31,11,1,37,0
16665,390633,444_14_08,COSTA RICA,0,TOTALS,COSTA RICA,200,42,72,58.3,35,56,62.5,7,16,43.8,7,15,46.7,14,38,52,28,15,21,17,8,98,1
16666,390646,444_14_09,HONDURAS,0,TOTALS,HONDURAS,200,19,74,25.7,17,63,27.0,2,11,18.2,17,36,47.2,16,24,40,10,21,23,13,0,57,0
16667,390659,444_14_09,PANAMA,0,TOTALS,PANAMA,200,31,78,39.7,30,62,48.4,1,16,6.2,8,28,28.6,26,40,66,12,24,28,9,10,71,1
16668,390672,444_14_10,EL SALVADOR,0,TOTALS,EL SALVADOR,200,22,68,32.4,20,57,35.1,2,11,18.2,15,41,36.6,23,37,60,11,17,29,9,1,61,0
16669,390685,444_14_10,GUATEMALA,0,TOTALS,GUATEMALA,200,27,79,34.2,25,67,37.3,2,12,16.7,12,21,57.1,14,28,42,13,24,18,17,2,68,1
16670,390696,444_14_11,NICARAGUA,0,TOTALS,NICARAGUA,200,16,72,22.2,14,62,22.6,2,10,20.0,6,10,60.0,6,25,31,4,5,21,6,0,40,1
16671,390709,444_14_11,PANAMA,0,TOTALS,PANAMA,200,51,112,45.5,43,83,51.8,8,29,27.6,2,8,25.0,35,45,80,25,10,9,12,9,112,0
16672,390722,444_14_12,COSTA RICA,0,TOTALS,COSTA RICA,200,32,85,37.6,25,60,41.7,7,25,28.0,3,8,37.5,13,40,53,18,22,28,14,8,74,1
16673,390735,444_14_12,HONDURAS,0,TOTALS,HONDURAS,200,19,62,30.6,19,60,31.7,0,2,0.0,10,25,40.0,10,36,46,8,21,36,11,3,48,0
16674,390746,444_14_13,NICARAGUA,0,TOTALS,NICARAGUA,200,7,48,14.6,7,46,15.2,0,2,0.0,6,9,66.7,4,23,27,6,4,44,4,3,20,1
16675,390759,444_14_13,COSTA RICA,0,TOTALS,COSTA RICA,200,58,117,49.6,48,94,51.1,10,23,43.5,2,4,50.0,31,31,62,37,12,10,34,5,128,0
16676,390772,444_14_14,PANAMA,0,TOTALS,PANAMA,200,32,61,52.5,26,49,53.1,6,12,50.0,15,35,42.9,12,53,65,18,16,28,7,6,85,1
16677,390785,444_14_14,GUATEMALA,0,TOTALS,GUATEMALA,200,20,87,23.0,18,63,28.6,2,24,8.3,9,15,60.0,16,21,37,7,24,11,13,3,51,0
16678,390798,444_14_15,HONDURAS,0,TOTALS,HONDURAS,200,37,72,51.4,29,54,53.7,8,18,44.4,5,10,50.0,13,33,46,17,19,26,13,8,87,1
16679,390811,444_14_15,EL SALVADOR,0,TOTALS,EL SALVADOR,200,20,69,29.0,20,58,34.5,0,11,0.0,11,19,57.9,16,24,40,13,10,26,14,1,51,0
16680,390823,445_14_01,EL SALVADOR,0,TOTALS,EL SALVADOR,200,27,69,39.1,26,62,41.9,1,7,14.3,15,34,44.1,14,26,40,8,8,28,17,2,70,0
16681,390836,445_14_01,NICARAGUA,0,TOTALS,NICARAGUA,200,32,88,36.4,31,81,38.3,1,7,14.3,7,12,58.3,25,32,57,19,20,31,18,5,72,1
16682,390849,445_14_02,MEXICO,0,TOTALS,MEXICO,200,28,74,37.8,23,55,41.8,5,19,26.3,13,24,54.2,17,38,55,19,18,21,13,5,74,1
16683,390862,445_14_02,GUATEMALA,0,TOTALS,GUATEMALA,200,17,65,26.2,15,44,34.1,2,21,9.5,12,22,54.5,8,30,38,8,17,19,8,8,48,0
16684,390875,445_14_03,COSTA RICA,0,TOTALS,COSTA RICA,200,21,77,27.3,19,53,35.8,2,24,8.3,15,32,46.9,17,23,40,8,24,29,20,4,59,0
16685,390888,445_14_03,BELIZE,0,TOTALS,BELIZE,200,23,66,34.8,18,53,34.0,5,13,38.5,21,31,67.7,18,33,51,11,25,35,20,9,72,1
16686,390901,445_14_04,PANAMA,0,TOTALS,PANAMA,200,30,98,30.6,25,77,32.5,5,21,23.8,1,8,12.5,29,38,67,17,13,9,12,6,66,1
16687,390914,445_14_04,HONDURAS,0,TOTALS,HONDURAS,200,17,61,27.9,14,49,28.6,3,12,25.0,6,12,50.0,7,38,45,11,10,19,4,4,43,0
16688,390927,445_14_05,NICARAGUA,0,TOTALS,NICARAGUA,200,23,87,26.4,21,69,30.4,2,18,11.1,1,2,50.0,16,15,31,12,14,24,7,4,49,1
16689,390940,445_14_05,MEXICO,0,TOTALS,MEXICO,200,54,86,62.8,49,76,64.5,5,10,50.0,14,20,70.0,20,36,56,37,4,17,14,3,127,0
16690,390953,445_14_06,GUATEMALA,0,TOTALS,GUATEMALA,200,31,85,36.5,23,63,36.5,8,22,36.4,3,6,50.0,22,24,46,20,17,18,20,3,73,1
16691,390965,445_14_06,EL SALVADOR,0,TOTALS,EL SALVADOR,200,14,49,28.6,13,38,34.2,1,11,9.1,11,21,52.4,11,31,42,8,6,35,10,2,40,0
16692,390978,445_14_07,HONDURAS,0,TOTALS,HONDURAS,200,17,59,28.8,16,52,30.8,1,7,14.3,14,26,53.8,14,28,42,8,18,39,14,3,49,0
16693,390991,445_14_07,COSTA RICA,0,TOTALS,COSTA RICA,200,26,78,33.3,22,65,33.8,4,13,30.8,12,22,54.5,24,29,53,14,21,30,30,5,68,1
16694,391004,445_14_08,BELIZE,0,TOTALS,BELIZE,200,25,77,32.5,21,60,35.0,4,17,23.5,11,28,39.3,26,35,61,11,30,26,8,12,65,0
16695,391017,445_14_08,PANAMA,0,TOTALS,PANAMA,200,22,84,26.2,16,61,26.2,6,23,26.1,22,46,47.8,31,24,55,13,20,15,14,8,72,1
16696,391030,445_14_09,NICARAGUA,0,TOTALS,NICARAGUA,200,17,66,25.8,15,57,26.3,2,9,22.2,15,26,57.7,14,23,37,14,16,32,14,8,51,0
16697,391043,445_14_09,GUATEMALA,0,TOTALS,GUATEMALA,200,34,75,45.3,32,67,47.8,2,8,25.0,17,24,70.8,13,35,48,21,16,23,22,3,87,1
16698,391056,445_14_10,MEXICO,0,TOTALS,MEXICO,200,32,80,40.0,20,49,40.8,12,31,38.7,4,7,57.1,16,29,45,26,10,17,22,2,80,1
16699,391068,445_14_10,EL SALVADOR,0,TOTALS,EL SALVADOR,200,12,49,24.5,9,40,22.5,3,9,33.3,7,14,50.0,9,25,34,9,3,31,3,3,34,0
16700,391081,445_14_11,HONDURAS,0,TOTALS,HONDURAS,200,22,70,31.4,18,53,34.0,4,17,23.5,13,24,54.2,12,29,41,13,12,24,14,4,61,0
16701,391094,445_14_11,BELIZE,0,TOTALS,BELIZE,200,27,85,31.8,23,57,40.4,4,28,14.3,8,13,61.5,24,36,60,9,21,26,15,3,66,1
16702,391107,445_14_12,PANAMA,0,TOTALS,PANAMA,200,18,69,26.1,15,54,27.8,3,15,20.0,9,21,42.9,20,29,49,10,21,38,13,5,48,0
16703,391120,445_14_12,COSTA RICA,0,TOTALS,COSTA RICA,200,28,64,43.8,22,53,41.5,6,11,54.5,8,23,34.8,8,26,34,24,23,25,25,4,70,1
16704,391133,445_14_13,NICARAGUA,0,TOTALS,NICARAGUA,200,25,86,29.1,20,71,28.2,5,15,33.3,10,15,66.7,23,24,47,13,29,23,8,7,65,0
16705,391146,445_14_13,HONDURAS,0,TOTALS,HONDURAS,200,33,61,54.1,33,61,54.1,0,0,0.0,21,44,47.7,8,36,44,14,16,17,11,5,87,1
16706,391159,445_14_14,PANAMA,0,TOTALS,PANAMA,200,24,61,39.3,19,45,42.2,5,16,31.2,12,25,48.0,20,34,54,10,16,29,19,5,65,1
16707,391171,445_14_14,EL SALVADOR,0,TOTALS,EL SALVADOR,200,11,58,19.0,9,44,20.5,2,14,14.3,7,15,46.7,8,20,28,7,18,32,15,2,31,0
16708,391184,445_14_15,MEXICO,0,TOTALS,MEXICO,200,37,79,46.8,26,56,46.4,11,23,47.8,13,18,72.2,13,39,52,28,10,16,18,1,98,1
16709,391197,445_14_15,BELIZE,0,TOTALS,BELIZE,200,17,78,21.8,15,57,26.3,2,21,9.5,6,11,54.5,18,30,48,9,16,23,6,5,42,0
16710,391210,445_14_16,COSTA RICA,0,TOTALS,COSTA RICA,200,17,51,33.3,15,42,35.7,2,9,22.2,15,28,53.6,10,42,52,12,16,33,9,7,51,1
16711,391223,445_14_16,GUATEMALA,0,TOTALS,GUATEMALA,200,18,65,27.7,15,49,30.6,3,16,18.8,4,14,28.6,5,21,26,11,22,15,17,4,43,0
16712,391236,445_14_17,NICARAGUA,0,TOTALS,NICARAGUA,200,23,83,27.7,21,70,30.0,2,13,15.4,7,11,63.6,24,34,58,16,20,30,18,4,55,0
16713,391248,445_14_17,EL SALVADOR,0,TOTALS,EL SALVADOR,200,26,69,37.7,25,61,41.0,1,8,12.5,21,35,60.0,10,31,41,20,8,23,19,5,74,1
16714,391261,445_14_18,HONDURAS,0,TOTALS,HONDURAS,200,13,71,18.3,11,57,19.3,2,14,14.3,12,24,50.0,15,34,49,7,20,17,9,2,40,0
16715,391274,445_14_18,PANAMA,0,TOTALS,PANAMA,200,23,68,33.8,19,53,35.8,4,15,26.7,13,30,43.3,16,42,58,9,17,15,12,5,63,1
16716,391287,445_14_19,BELIZE,0,TOTALS,BELIZE,200,28,67,41.8,26,51,51.0,2,16,12.5,6,11,54.5,17,28,45,10,16,23,7,6,64,0
16717,391300,445_14_19,GUATEMALA,0,TOTALS,GUATEMALA,200,23,75,30.7,15,53,28.3,8,22,36.4,18,26,69.2,19,24,43,15,14,12,16,1,72,1
16718,391313,445_14_20,MEXICO,0,TOTALS,MEXICO,200,33,74,44.6,25,53,47.2,8,21,38.1,15,25,60.0,18,30,48,27,12,18,21,6,89,1
16719,391326,445_14_20,COSTA RICA,0,TOTALS,COSTA RICA,194,19,67,28.4,13,47,27.7,6,20,30.0,7,11,63.6,13,26,39,12,18,28,11,2,51,0
16720,392102,448_14_01,MALTA,0,TOTALS,MALTA,225,27,63,42.9,23,46,50.0,4,17,23.5,29,34,85.3,9,31,40,8,24,19,7,2,87,1
16721,392115,448_14_01,SCOTLAND,0,TOTALS,SCOTLAND,225,32,76,42.1,30,63,47.6,2,13,15.4,16,23,69.6,13,25,38,12,29,17,7,0,82,0
16722,392128,448_14_02,ANDORRA,0,TOTALS,ANDORRA,200,34,76,44.7,30,57,52.6,4,19,21.1,11,24,45.8,18,42,60,15,10,17,14,4,83,1
16723,392141,448_14_02,GIBRALTAR,0,TOTALS,GIBRALTAR,200,20,77,26.0,17,50,34.0,3,27,11.1,5,5,100.0,13,31,44,7,24,18,7,1,48,0
16724,392154,448_14_03,SCOTLAND,0,TOTALS,SCOTLAND,200,33,67,49.3,22,45,48.9,11,22,50.0,13,24,54.2,13,29,42,15,20,22,16,5,90,1
16725,392167,448_14_03,WALES,0,TOTALS,WALES,200,23,64,35.9,19,42,45.2,4,22,18.2,12,21,57.1,14,26,40,5,23,25,8,2,62,0
16726,392180,448_14_04,GIBRALTAR,0,TOTALS,GIBRALTAR,200,16,62,25.8,11,38,28.9,5,24,20.8,2,8,25.0,16,25,41,4,25,21,7,2,39,0
16727,392193,448_14_04,SAN MARINO,0,TOTALS,SAN MARINO,200,29,64,45.3,20,39,51.3,9,25,36.0,13,21,61.9,14,32,46,12,14,10,9,2,80,1
16728,392206,448_14_05,WALES,0,TOTALS,WALES,200,30,68,44.1,25,53,47.2,5,15,33.3,10,16,62.5,12,21,33,11,25,14,5,2,75,0
16729,392219,448_14_05,MALTA,0,TOTALS,MALTA,200,31,68,45.6,19,35,54.3,12,33,36.4,19,26,73.1,21,26,47,12,18,17,7,7,93,1
16730,392232,448_14_06,SAN MARINO,0,TOTALS,SAN MARINO,200,17,61,27.9,12,32,37.5,5,29,17.2,8,9,88.9,9,28,37,5,24,23,1,1,47,0
16731,392245,448_14_06,ANDORRA,0,TOTALS,ANDORRA,200,32,68,47.1,30,56,53.6,2,12,16.7,17,23,73.9,12,33,45,13,12,12,14,4,83,1
16732,392258,448_14_07,SAN MARINO,0,TOTALS,SAN MARINO,200,19,56,33.9,12,25,48.0,7,31,22.6,17,22,77.3,10,31,41,8,20,15,8,2,62,1
16733,392271,448_14_07,WALES,0,TOTALS,WALES,200,19,57,33.3,17,37,45.9,2,20,10.0,15,23,65.2,11,30,41,9,25,14,6,0,55,0
16734,392284,448_14_08,SCOTLAND,0,TOTALS,SCOTLAND,200,20,60,33.3,16,41,39.0,4,19,21.1,11,13,84.6,14,34,48,7,14,18,10,0,55,1
16735,392297,448_14_08,GIBRALTAR,0,TOTALS,GIBRALTAR,200,10,55,18.2,6,23,26.1,4,32,12.5,8,12,66.7,13,26,39,1,18,23,6,3,32,0
16736,392310,448_14_09,MALTA,0,TOTALS,MALTA,200,35,61,57.4,29,45,64.4,6,16,37.5,13,20,65.0,12,33,45,14,16,13,4,2,89,1
16737,392323,448_14_09,SAN MARINO,0,TOTALS,SAN MARINO,200,23,64,35.9,15,37,40.5,8,27,29.6,14,20,70.0,9,18,27,5,18,10,6,0,68,0
16738,392336,448_14_10,ANDORRA,0,TOTALS,ANDORRA,200,34,70,48.6,27,51,52.9,7,19,36.8,9,11,81.8,13,32,45,15,17,22,12,3,84,1
16739,392349,448_14_10,SCOTLAND,0,TOTALS,SCOTLAND,200,24,69,34.8,17,45,37.8,7,24,29.2,8,12,66.7,14,23,37,6,18,21,10,3,63,0
16740,392362,448_14_11,WALES,0,TOTALS,WALES,200,25,59,42.4,23,48,47.9,2,11,18.2,14,21,66.7,17,39,56,15,18,22,6,2,66,1
16741,392375,448_14_11,GIBRALTAR,0,TOTALS,GIBRALTAR,200,19,76,25.0,9,26,34.6,10,50,20.0,11,17,64.7,19,21,40,9,22,14,11,3,59,0
16742,392388,448_14_12,SCOTLAND,0,TOTALS,SCOTLAND,200,26,66,39.4,20,50,40.0,6,16,37.5,9,16,56.2,19,38,57,9,14,24,5,1,67,1
16743,392401,448_14_12,SAN MARINO,0,TOTALS,SAN MARINO,200,20,69,29.0,15,36,41.7,5,33,15.2,10,16,62.5,13,23,36,9,19,14,12,2,55,0
16744,392414,448_14_13,ANDORRA,0,TOTALS,ANDORRA,200,21,60,35.0,13,37,35.1,8,23,34.8,16,30,53.3,16,29,45,7,23,13,8,3,66,1
16745,392427,448_14_13,MALTA,0,TOTALS,MALTA,200,24,60,40.0,19,34,55.9,5,26,19.2,10,20,50.0,12,29,41,6,22,14,9,4,63,0
16746,392830,450_14_01,TURKEY,0,TOTALS,TURKEY,225,21,70,30.0,16,48,33.3,5,22,22.7,23,34,67.6,20,39,59,16,23,20,7,3,70,1
16747,392843,450_14_01,CROATIA,0,TOTALS,CROATIA,225,22,74,29.7,12,38,31.6,10,36,27.8,12,23,52.2,18,33,51,16,27,19,9,3,66,0
16748,392856,450_14_02,CZECH REPUBLIC,0,TOTALS,CZECH REPUBLIC,200,22,55,40.0,20,44,45.5,2,11,18.2,14,18,77.8,11,26,37,13,19,26,6,1,60,0
16749,392869,450_14_02,ITALY,0,TOTALS,ITALY,200,35,70,50.0,28,49,57.1,7,21,33.3,7,10,70.0,12,22,34,18,22,14,13,1,84,1
16750,392882,450_14_03,SLOVENIA,0,TOTALS,SLOVENIA,200,24,53,45.3,22,37,59.5,2,16,12.5,11,15,73.3,8,18,26,16,22,13,4,2,61,0
16751,392895,450_14_03,SERBIA,0,TOTALS,SERBIA,200,27,48,56.2,23,36,63.9,4,12,33.3,15,21,71.4,7,22,29,13,23,11,10,1,73,1
16752,392908,450_14_04,POLAND,0,TOTALS,POLAND,200,27,70,38.6,21,48,43.8,6,22,27.3,25,34,73.5,17,27,44,10,23,11,7,1,85,1
16753,392921,450_14_04,BULGARIA,0,TOTALS,BULGARIA,200,30,63,47.6,26,45,57.8,4,18,22.2,14,20,70.0,6,26,32,12,26,14,7,3,78,0
16754,392934,450_14_05,GREECE,0,TOTALS,GREECE,200,20,63,31.7,14,39,35.9,6,24,25.0,19,23,82.6,18,22,40,12,24,13,6,2,65,0
16755,392947,450_14_05,LITHUANIA,0,TOTALS,LITHUANIA,200,25,55,45.5,18,37,48.6,7,18,38.9,16,22,72.7,10,28,38,14,25,15,3,5,73,1
16756,392960,450_14_06,GERMANY,0,TOTALS,GERMANY,200,17,48,35.4,14,30,46.7,3,18,16.7,16,29,55.2,12,21,33,10,20,17,8,0,53,0
16757,392973,450_14_06,SPAIN,0,TOTALS,SPAIN,200,23,54,42.6,17,31,54.8,6,23,26.1,13,17,76.5,12,26,38,14,24,16,13,2,65,1
16758,392986,450_14_07,FRANCE,0,TOTALS,FRANCE,200,25,63,39.7,18,45,40.0,7,18,38.9,8,17,47.1,17,18,35,11,21,18,10,0,65,0
16759,392999,450_14_07,RUSSIA,0,TOTALS,RUSSIA,200,24,47,51.1,15,24,62.5,9,23,39.1,9,16,56.2,5,22,27,16,20,16,13,3,66,1
16760,393012,450_14_08,GREAT BRITAIN,0,TOTALS,GREAT BRITAIN,200,21,56,37.5,14,37,37.8,7,19,36.8,15,21,71.4,7,24,31,15,21,20,11,4,64,1
16761,393025,450_14_08,LATVIA,0,TOTALS,LATVIA,200,24,62,38.7,21,43,48.8,3,19,15.8,11,24,45.8,17,29,46,12,20,23,7,4,62,0
16762,393038,450_14_09,MONTENEGRO,0,TOTALS,MONTENEGRO,200,31,54,57.4,27,43,62.8,4,11,36.4,18,40,45.0,13,33,46,25,24,27,6,3,84,1
16763,393051,450_14_09,CZECH REPUBLIC,0,TOTALS,CZECH REPUBLIC,200,23,63,36.5,17,45,37.8,6,18,33.3,18,25,72.0,12,19,31,16,32,21,14,1,70,0
16764,393064,450_14_10,ITALY,0,TOTALS,ITALY,200,22,63,34.9,13,32,40.6,9,31,29.0,13,16,81.2,7,20,27,17,27,9,2,1,66,0
16765,393077,450_14_10,TURKEY,0,TOTALS,TURKEY,200,30,61,49.2,23,39,59.0,7,22,31.8,23,30,76.7,15,34,49,14,22,10,3,1,90,1
16766,393090,450_14_11,SWEDEN,0,TOTALS,SWEDEN,200,18,59,30.5,17,44,38.6,1,15,6.7,10,11,90.9,6,26,32,9,27,16,3,8,47,0
16767,393103,450_14_11,GERMANY,0,TOTALS,GERMANY,200,26,65,40.0,19,47,40.4,7,18,38.9,23,29,79.3,15,35,50,11,19,11,10,1,82,1
16768,393116,450_14_12,ISRAEL,0,TOTALS,ISRAEL,200,28,57,49.1,20,37,54.1,8,20,40.0,10,17,58.8,10,31,41,14,23,18,12,1,74,1
16769,393129,450_14_12,POLAND,0,TOTALS,POLAND,200,14,54,25.9,11,34,32.4,3,20,15.0,18,23,78.3,11,21,32,7,19,17,9,2,49,0
16770,393142,450_14_13,LATVIA,0,TOTALS,LATVIA,200,25,63,39.7,15,36,41.7,10,27,37.0,17,24,70.8,11,24,35,14,25,12,4,3,77,0
16771,393155,450_14_13,GREECE,0,TOTALS,GREECE,200,29,62,46.8,23,41,56.1,6,21,28.6,15,24,62.5,12,31,43,13,25,15,6,2,79,1
16772,393168,450_14_14,SPAIN,0,TOTALS,SPAIN,200,26,69,37.7,23,49,46.9,3,20,15.0,8,17,47.1,19,15,34,15,19,5,5,1,63,0
16773,393181,450_14_14,SLOVENIA,0,TOTALS,SLOVENIA,200,24,53,45.3,11,23,47.8,13,30,43.3,10,11,90.9,11,28,39,15,24,12,0,2,71,1
16774,393194,450_14_15,BULGARIA,0,TOTALS,BULGARIA,200,28,63,44.4,24,42,57.1,4,21,19.0,16,19,84.2,12,24,36,16,22,11,2,0,76,0
16775,393207,450_14_15,FRANCE,0,TOTALS,FRANCE,200,27,59,45.8,20,38,52.6,7,21,33.3,16,21,76.2,7,22,29,14,19,7,9,5,77,1
16776,393220,450_14_16,HUNGARY,0,TOTALS,HUNGARY,200,18,63,28.6,11,35,31.4,7,28,25.0,10,16,62.5,21,24,45,14,17,19,8,3,53,1
16777,393233,450_14_16,GREAT BRITAIN,0,TOTALS,GREAT BRITAIN,200,19,52,36.5,15,35,42.9,4,17,23.5,2,6,33.3,10,27,37,14,19,24,7,5,44,0
16778,393246,450_14_17,CROATIA,0,TOTALS,CROATIA,200,30,74,40.5,25,53,47.2,5,21,23.8,15,20,75.0,20,31,51,18,20,13,6,5,80,1
16779,393259,450_14_17,ITALY,0,TOTALS,ITALY,200,27,69,39.1,21,43,48.8,6,26,23.1,7,11,63.6,13,26,39,15,27,15,6,7,67,0
16780,393272,450_14_18,TURKEY,0,TOTALS,TURKEY,200,33,66,50.0,24,39,61.5,9,27,33.3,11,20,55.0,14,23,37,17,23,13,8,8,86,1
16781,393285,450_14_18,MONTENEGRO,0,TOTALS,MONTENEGRO,200,31,65,47.7,21,46,45.7,10,19,52.6,11,23,47.8,18,23,41,19,23,16,4,1,83,0
16782,393298,450_14_19,SERBIA,0,TOTALS,SERBIA,200,29,60,48.3,25,47,53.2,4,13,30.8,8,17,47.1,12,31,43,16,13,17,7,5,70,1
16783,393311,450_14_19,SPAIN,0,TOTALS,SPAIN,200,25,59,42.4,19,44,43.2,6,15,40.0,5,7,71.4,5,22,27,13,18,14,10,1,61,0
16784,393324,450_14_20,RUSSIA,0,TOTALS,RUSSIA,200,26,67,38.8,16,41,39.0,10,26,38.5,15,24,62.5,15,29,44,12,20,9,6,5,77,1
16785,393337,450_14_20,BULGARIA,0,TOTALS,BULGARIA,200,27,61,44.3,22,38,57.9,5,23,21.7,5,8,62.5,7,30,37,15,25,13,5,3,64,0
16786,393350,450_14_21,GREECE,0,TOTALS,GREECE,200,22,59,37.3,20,42,47.6,2,17,11.8,21,31,67.7,20,21,41,11,19,13,8,3,67,1
16787,393363,450_14_21,HUNGARY,0,TOTALS,HUNGARY,200,24,62,38.7,19,40,47.5,5,22,22.7,12,22,54.5,16,24,40,11,26,12,6,2,65,0
16788,393376,450_14_22,SLOVENIA,0,TOTALS,SLOVENIA,200,24,52,46.2,18,33,54.5,6,19,31.6,16,20,80.0,10,29,39,15,15,13,8,1,70,1
16789,393389,450_14_22,SWEDEN,0,TOTALS,SWEDEN,200,22,58,37.9,15,35,42.9,7,23,30.4,7,11,63.6,9,20,29,19,23,10,7,2,58,0
16790,393402,450_14_23,FRANCE,0,TOTALS,FRANCE,200,32,66,48.5,27,47,57.4,5,19,26.3,6,12,50.0,14,26,40,14,20,8,4,3,75,1
16791,393415,450_14_23,ISRAEL,0,TOTALS,ISRAEL,200,21,57,36.8,17,42,40.5,4,15,26.7,17,25,68.0,10,21,31,10,22,11,3,1,63,0
16792,393428,450_14_24,LITHUANIA,0,TOTALS,LITHUANIA,200,27,58,46.6,24,39,61.5,3,19,15.8,17,29,58.6,11,31,42,11,21,12,5,2,74,1
16793,393441,450_14_24,LATVIA,0,TOTALS,LATVIA,200,13,52,25.0,10,33,30.3,3,19,15.8,14,26,53.8,14,23,37,9,29,17,2,2,43,0
16794,393454,450_14_25,CZECH REPUBLIC,0,TOTALS,CZECH REPUBLIC,200,23,63,36.5,16,44,36.4,7,19,36.8,11,21,52.4,11,27,38,13,18,12,7,0,64,0
16795,393467,450_14_25,TURKEY,0,TOTALS,TURKEY,200,29,67,43.3,20,45,44.4,9,22,40.9,14,15,93.3,11,32,43,18,21,13,7,7,81,1
16796,393480,450_14_26,MONTENEGRO,0,TOTALS,MONTENEGRO,200,19,54,35.2,12,29,41.4,7,25,28.0,17,28,60.7,9,29,38,15,26,13,4,4,62,0
16797,393493,450_14_26,CROATIA,0,TOTALS,CROATIA,200,23,65,35.4,19,40,47.5,4,25,16.0,22,29,75.9,17,28,45,18,24,12,4,3,72,1
16798,393506,450_14_27,GERMANY,0,TOTALS,GERMANY,200,21,51,41.2,14,29,48.3,7,22,31.8,14,17,82.4,6,24,30,12,18,16,12,2,63,1
16799,393519,450_14_27,SLOVENIA,0,TOTALS,SLOVENIA,200,24,53,45.3,18,31,58.1,6,22,27.3,6,10,60.0,6,24,30,18,22,19,8,3,60,0
16800,393532,450_14_28,POLAND,0,TOTALS,POLAND,200,21,68,30.9,18,48,37.5,3,20,15.0,15,20,75.0,15,21,36,10,17,7,10,2,60,0
16801,393545,450_14_28,FRANCE,0,TOTALS,FRANCE,200,23,52,44.2,17,36,47.2,6,16,37.5,15,16,93.8,7,33,40,12,20,19,6,2,67,1
16802,393558,450_14_29,GREAT BRITAIN,0,TOTALS,GREAT BRITAIN,200,26,60,43.3,20,33,60.6,6,27,22.2,11,19,57.9,9,29,38,17,21,15,8,5,69,1
16803,393571,450_14_29,GREECE,0,TOTALS,GREECE,200,20,65,30.8,9,29,31.0,11,36,30.6,15,21,71.4,18,27,45,13,17,15,5,2,66,0
16804,393584,450_14_30,SWEDEN,0,TOTALS,SWEDEN,200,18,54,33.3,13,38,34.2,5,16,31.2,8,13,61.5,10,18,28,10,21,15,4,4,49,0
16805,393597,450_14_30,SERBIA,0,TOTALS,SERBIA,200,26,58,44.8,17,39,43.6,9,19,47.4,14,18,77.8,16,28,44,18,20,16,9,0,75,1
16806,393610,450_14_31,ISRAEL,0,TOTALS,ISRAEL,200,21,57,36.8,16,43,37.2,5,14,35.7,11,14,78.6,7,26,33,8,17,11,10,0,58,1
16807,393623,450_14_31,RUSSIA,0,TOTALS,RUSSIA,200,21,57,36.8,16,39,41.0,5,18,27.8,9,10,90.0,9,29,38,11,16,18,6,6,56,0
16808,393636,450_14_32,HUNGARY,0,TOTALS,HUNGARY,200,23,64,35.9,18,40,45.0,5,24,20.8,11,17,64.7,12,14,26,15,22,12,6,4,62,0
16809,393649,450_14_32,LITHUANIA,0,TOTALS,LITHUANIA,200,28,49,57.1,26,41,63.4,2,8,25.0,18,23,78.3,9,29,38,20,16,20,7,5,76,1
16810,393662,450_14_33,ITALY,0,TOTALS,ITALY,225,32,83,38.6,25,50,50.0,7,33,21.2,17,25,68.0,28,27,55,21,21,11,6,4,88,1
16811,393675,450_14_33,MONTENEGRO,0,TOTALS,MONTENEGRO,225,30,68,44.1,20,46,43.5,10,22,45.5,14,19,73.7,10,26,36,22,26,15,3,1,84,0
16812,393688,450_14_34,CROATIA,0,TOTALS,CROATIA,200,24,58,41.4,17,39,43.6,7,19,36.8,17,24,70.8,15,31,46,18,20,15,6,4,72,1
16813,393701,450_14_34,CZECH REPUBLIC,0,TOTALS,CZECH REPUBLIC,200,20,64,31.2,18,48,37.5,2,16,12.5,4,8,50.0,14,25,39,6,23,17,5,3,46,0
16814,393714,450_14_35,SPAIN,0,TOTALS,SPAIN,200,28,70,40.0,25,48,52.1,3,22,13.6,9,10,90.0,14,23,37,18,16,14,14,3,68,1
16815,393727,450_14_35,SWEDEN,0,TOTALS,SWEDEN,200,23,60,38.3,15,36,41.7,8,24,33.3,5,6,83.3,15,29,44,16,19,25,5,2,59,0
16816,393740,450_14_36,BULGARIA,0,TOTALS,BULGARIA,200,26,67,38.8,22,41,53.7,4,26,15.4,12,18,66.7,13,25,38,15,13,14,6,2,68,0
16817,393753,450_14_36,ISRAEL,0,TOTALS,ISRAEL,200,34,75,45.3,25,53,47.2,9,22,40.9,5,8,62.5,16,28,44,27,19,12,6,1,82,1
16818,393766,450_14_37,LATVIA,0,TOTALS,LATVIA,200,33,66,50.0,23,46,50.0,10,20,50.0,8,16,50.0,19,27,46,20,22,14,6,5,84,1
16819,393779,450_14_37,HUNGARY,0,TOTALS,HUNGARY,200,23,63,36.5,17,45,37.8,6,18,33.3,15,19,78.9,13,18,31,19,15,12,5,2,67,0
16820,393792,450_14_38,SERBIA,0,TOTALS,SERBIA,225,23,62,37.1,11,21,52.4,12,41,29.3,18,27,66.7,12,25,37,18,19,11,6,7,76,1
16821,393805,450_14_38,GERMANY,0,TOTALS,GERMANY,225,24,66,36.4,15,41,36.6,9,25,36.0,11,16,68.8,16,27,43,20,23,17,7,2,68,0
16822,393818,450_14_39,RUSSIA,0,TOTALS,RUSSIA,200,28,63,44.4,24,44,54.5,4,19,21.1,11,19,57.9,9,25,34,11,20,14,6,3,71,0
16823,393831,450_14_39,POLAND,0,TOTALS,POLAND,200,27,56,48.2,20,43,46.5,7,13,53.8,14,21,66.7,7,24,31,17,21,16,4,0,75,1
16824,393844,450_14_40,LITHUANIA,0,TOTALS,LITHUANIA,200,26,62,41.9,14,35,40.0,12,27,44.4,17,25,68.0,13,25,38,19,17,12,5,1,81,1
16825,393857,450_14_40,GREAT BRITAIN,0,TOTALS,GREAT BRITAIN,200,29,67,43.3,20,48,41.7,9,19,47.4,6,8,75.0,12,25,37,21,21,12,1,6,73,0
16826,393870,450_14_41,LATVIA,0,TOTALS,LATVIA,200,27,66,40.9,23,48,47.9,4,18,22.2,11,15,73.3,11,30,41,19,20,12,9,4,69,1
16827,393883,450_14_41,BULGARIA,0,TOTALS,BULGARIA,200,22,62,35.5,14,33,42.4,8,29,27.6,11,15,73.3,10,30,40,13,19,17,3,0,63,0
16828,393896,450_14_42,SWEDEN,0,TOTALS,SWEDEN,200,27,64,42.2,22,43,51.2,5,21,23.8,6,9,66.7,10,25,35,15,18,9,10,3,65,1
16829,393909,450_14_42,MONTENEGRO,0,TOTALS,MONTENEGRO,200,17,53,32.1,13,35,37.1,4,18,22.2,9,18,50.0,11,28,39,14,15,17,3,4,47,0
16830,393922,450_14_43,HUNGARY,0,TOTALS,HUNGARY,200,16,48,33.3,11,33,33.3,5,15,33.3,22,24,91.7,7,23,30,11,19,21,11,6,59,1
16831,393935,450_14_43,RUSSIA,0,TOTALS,RUSSIA,200,21,57,36.8,15,42,35.7,6,15,40.0,10,16,62.5,16,25,41,16,22,23,8,3,58,0
16832,393948,450_14_44,GERMANY,0,TOTALS,GERMANY,200,28,57,49.1,22,45,48.9,6,12,50.0,16,22,72.7,9,37,46,15,14,14,8,5,78,1
16833,393961,450_14_44,CZECH REPUBLIC,0,TOTALS,CZECH REPUBLIC,200,14,57,24.6,8,36,22.2,6,21,28.6,8,12,66.7,8,22,30,8,23,14,4,0,42,0
16834,393974,450_14_45,POLAND,0,TOTALS,POLAND,200,19,70,27.1,15,50,30.0,4,20,20.0,9,15,60.0,17,30,47,8,10,13,7,4,51,0
16835,393987,450_14_45,TURKEY,0,TOTALS,TURKEY,200,27,65,41.5,24,46,52.2,3,19,15.8,2,5,40.0,10,36,46,16,20,14,5,6,59,1
16836,394000,450_14_46,SLOVENIA,0,TOTALS,SLOVENIA,200,31,61,50.8,22,34,64.7,9,27,33.3,4,5,80.0,13,22,35,24,19,12,8,1,75,1
16837,394013,450_14_46,GREAT BRITAIN,0,TOTALS,GREAT BRITAIN,200,17,41,41.5,13,26,50.0,4,15,26.7,14,19,73.7,4,18,22,16,12,16,7,2,52,0
16838,394026,450_14_47,ISRAEL,0,TOTALS,ISRAEL,225,26,71,36.6,15,48,31.2,11,23,47.8,13,20,65.0,10,27,37,15,23,14,10,0,76,0
16839,394039,450_14_47,CROATIA,0,TOTALS,CROATIA,225,28,71,39.4,21,48,43.8,7,23,30.4,17,21,81.0,17,38,55,19,22,18,6,6,80,1
16840,394052,450_14_48,GREECE,0,TOTALS,GREECE,200,28,62,45.2,23,44,52.3,5,18,27.8,9,18,50.0,12,22,34,10,19,15,5,3,70,1
16841,394065,450_14_48,SERBIA,0,TOTALS,SERBIA,200,24,56,42.9,19,40,47.5,5,16,31.2,16,23,69.6,10,26,36,18,20,16,4,3,69,0
16842,394078,450_14_49,SPAIN,0,TOTALS,SPAIN,200,23,60,38.3,16,37,43.2,7,23,30.4,12,21,57.1,17,21,38,19,17,11,8,5,65,1
16843,394091,450_14_49,LITHUANIA,0,TOTALS,LITHUANIA,200,25,68,36.8,20,46,43.5,5,22,22.7,7,9,77.8,19,24,43,11,18,11,3,7,62,0
16844,394104,450_14_50,ITALY,0,TOTALS,ITALY,200,23,56,41.1,16,34,47.1,7,22,31.8,12,17,70.6,8,19,27,10,22,14,6,3,65,0
16845,394117,450_14_50,FRANCE,0,TOTALS,FRANCE,200,23,51,45.1,18,37,48.6,5,14,35.7,15,20,75.0,9,27,36,14,23,19,3,4,66,1
16846,394130,450_14_51,MONTENEGRO,0,TOTALS,MONTENEGRO,200,24,60,40.0,19,40,47.5,5,20,25.0,7,12,58.3,10,39,49,10,22,26,11,3,60,1
16847,394143,450_14_51,LATVIA,0,TOTALS,LATVIA,200,24,76,31.6,22,60,36.7,2,16,12.5,9,18,50.0,16,28,44,12,18,18,12,6,59,0
16848,394156,450_14_52,CZECH REPUBLIC,0,TOTALS,CZECH REPUBLIC,200,22,63,34.9,18,43,41.9,4,20,20.0,16,20,80.0,13,30,43,15,18,13,4,1,64,0
16849,394169,450_14_52,HUNGARY,0,TOTALS,HUNGARY,200,28,72,38.9,25,56,44.6,3,16,18.8,14,17,82.4,16,29,45,15,15,9,7,2,73,1
16850,394182,450_14_53,BULGARIA,0,TOTALS,BULGARIA,200,32,66,48.5,28,49,57.1,4,17,23.5,10,12,83.3,11,32,43,20,24,19,14,1,78,1
16851,394195,450_14_53,SWEDEN,0,TOTALS,SWEDEN,200,20,68,29.4,14,46,30.4,6,22,27.3,11,17,64.7,17,23,40,7,21,24,10,1,57,0
16852,394208,450_14_54,RUSSIA,0,TOTALS,RUSSIA,200,25,53,47.2,14,27,51.9,11,26,42.3,9,16,56.2,11,22,33,16,17,17,9,5,70,1
16853,394221,450_14_54,GERMANY,0,TOTALS,GERMANY,200,22,56,39.3,19,38,50.0,3,18,16.7,11,17,64.7,13,19,32,10,20,17,9,2,58,0
16854,394234,450_14_55,TURKEY,0,TOTALS,TURKEY,200,27,65,41.5,21,44,47.7,6,21,28.6,19,23,82.6,16,31,47,17,13,16,6,5,79,1
16855,394247,450_14_55,ISRAEL,0,TOTALS,ISRAEL,200,27,70,38.6,21,48,43.8,6,22,27.3,6,12,50.0,14,24,38,12,21,16,3,2,66,0
16856,394260,450_14_56,POLAND,0,TOTALS,POLAND,200,21,53,39.6,20,40,50.0,1,13,7.7,9,22,40.9,10,29,39,11,19,23,6,2,52,0
16857,394273,450_14_56,ITALY,0,TOTALS,ITALY,200,23,56,41.1,19,36,52.8,4,20,20.0,11,13,84.6,5,30,35,10,18,17,6,2,61,1
16858,394286,450_14_57,GREAT BRITAIN,0,TOTALS,GREAT BRITAIN,200,23,69,33.3,18,43,41.9,5,26,19.2,6,11,54.5,19,16,35,11,19,14,9,1,57,0
16859,394299,450_14_57,SERBIA,0,TOTALS,SERBIA,200,30,67,44.8,24,42,57.1,6,25,24.0,8,14,57.1,22,27,49,15,17,22,5,3,74,1
16860,394312,450_14_58,SPAIN,0,TOTALS,SPAIN,200,20,53,37.7,15,37,40.5,5,16,31.2,15,31,48.4,17,22,39,14,28,17,15,4,60,1
16861,394325,450_14_58,GREECE,0,TOTALS,GREECE,200,20,61,32.8,18,45,40.0,2,16,12.5,16,22,72.7,22,24,46,10,24,19,7,1,58,0
16862,394338,450_14_59,LITHUANIA,0,TOTALS,LITHUANIA,200,22,53,41.5,17,33,51.5,5,20,25.0,14,22,63.6,11,21,32,10,18,16,6,3,63,1
16863,394351,450_14_59,SLOVENIA,0,TOTALS,SLOVENIA,200,20,55,36.4,16,33,48.5,4,22,18.2,18,18,100.0,14,22,36,15,22,19,7,2,62,0
16864,394364,450_14_60,CROATIA,0,TOTALS,CROATIA,200,23,56,41.1,17,39,43.6,6,17,35.3,11,15,73.3,12,27,39,8,13,15,5,3,63,1
16865,394377,450_14_60,FRANCE,0,TOTALS,FRANCE,200,21,68,30.9,12,40,30.0,9,28,32.1,4,5,80.0,16,22,38,11,16,13,4,4,55,0
16866,394390,450_14_61,MONTENEGRO,0,TOTALS,MONTENEGRO,225,31,71,43.7,25,43,58.1,6,28,21.4,13,21,61.9,15,29,44,15,20,18,8,2,81,0
16867,394403,450_14_61,BULGARIA,0,TOTALS,BULGARIA,225,30,79,38.0,26,50,52.0,4,29,13.8,18,21,85.7,18,27,45,21,19,13,5,0,82,1
16868,394416,450_14_62,CZECH REPUBLIC,0,TOTALS,CZECH REPUBLIC,200,22,59,37.3,19,44,43.2,3,15,20.0,10,11,90.9,11,17,28,16,19,17,5,0,57,0
16869,394429,450_14_62,RUSSIA,0,TOTALS,RUSSIA,200,29,60,48.3,22,40,55.0,7,20,35.0,11,16,68.8,16,25,41,16,19,16,9,4,76,1
16870,394442,450_14_63,LATVIA,0,TOTALS,LATVIA,200,29,63,46.0,25,44,56.8,4,19,21.1,13,19,68.4,15,29,44,20,17,13,3,7,75,1
16871,394455,450_14_63,SWEDEN,0,TOTALS,SWEDEN,200,27,74,36.5,25,56,44.6,2,18,11.1,8,11,72.7,20,22,42,10,22,11,6,4,64,0
16872,394468,450_14_64,HUNGARY,0,TOTALS,HUNGARY,200,21,63,33.3,18,45,40.0,3,18,16.7,8,13,61.5,11,21,32,15,18,10,4,1,53,0
16873,394481,450_14_64,GERMANY,0,TOTALS,GERMANY,200,24,51,47.1,20,35,57.1,4,16,25.0,11,18,61.1,9,32,41,11,23,20,7,1,63,1
16874,394494,450_14_65,ISRAEL,0,TOTALS,ISRAEL,200,27,55,49.1,22,41,53.7,5,14,35.7,20,26,76.9,8,31,39,20,15,10,4,1,79,1
16875,394507,450_14_65,ITALY,0,TOTALS,ITALY,200,28,65,43.1,20,36,55.6,8,29,27.6,3,4,75.0,5,19,24,11,20,8,6,4,67,0
16876,394520,450_14_66,GREAT BRITAIN,0,TOTALS,GREAT BRITAIN,200,20,68,29.4,16,44,36.4,4,24,16.7,15,21,71.4,16,23,39,14,17,14,7,2,59,0
16877,394533,450_14_66,SPAIN,0,TOTALS,SPAIN,200,25,55,45.5,18,38,47.4,7,17,41.2,19,26,73.1,8,33,41,20,19,18,3,3,76,1
16878,394546,450_14_67,SERBIA,0,TOTALS,SERBIA,200,26,51,51.0,18,32,56.2,8,19,42.1,13,18,72.2,8,23,31,13,16,18,8,4,73,1
16879,394559,450_14_67,LITHUANIA,0,TOTALS,LITHUANIA,200,21,56,37.5,17,40,42.5,4,16,25.0,8,12,66.7,14,16,30,11,20,20,7,2,54,0
16880,394572,450_14_68,SLOVENIA,0,TOTALS,SLOVENIA,200,22,64,34.4,10,32,31.2,12,32,37.5,11,13,84.6,14,18,32,11,26,11,6,1,67,0
16881,394585,450_14_68,GREECE,0,TOTALS,GREECE,200,28,56,50.0,19,38,50.0,9,18,50.0,19,26,73.1,11,29,40,18,18,17,2,4,84,1
16882,394598,450_14_69,FRANCE,0,TOTALS,FRANCE,200,22,61,36.1,16,43,37.2,6,18,33.3,18,22,81.8,13,34,47,17,20,16,3,3,68,1
16883,394611,450_14_69,TURKEY,0,TOTALS,TURKEY,200,23,65,35.4,20,45,44.4,3,20,15.0,15,21,71.4,10,25,35,15,20,10,7,5,64,0
16884,394624,450_14_70,CROATIA,0,TOTALS,CROATIA,200,32,74,43.2,27,53,50.9,5,21,23.8,6,10,60.0,16,32,48,22,22,13,5,5,75,1
16885,394637,450_14_70,POLAND,0,TOTALS,POLAND,200,19,64,29.7,15,37,40.5,4,27,14.8,14,18,77.8,11,28,39,10,13,14,7,3,56,0
16886,394650,450_14_71,SWEDEN,0,TOTALS,SWEDEN,200,24,67,35.8,22,45,48.9,2,22,9.1,8,15,53.3,14,23,37,13,23,12,4,2,58,0
16887,394663,450_14_71,CZECH REPUBLIC,0,TOTALS,CZECH REPUBLIC,200,27,54,50.0,18,35,51.4,9,19,47.4,18,24,75.0,5,32,37,15,17,12,6,1,81,1
16888,394676,450_14_72,HUNGARY,0,TOTALS,HUNGARY,200,23,60,38.3,19,47,40.4,4,13,30.8,9,13,69.2,10,20,30,17,17,11,5,4,59,0
16889,394689,450_14_72,MONTENEGRO,0,TOTALS,MONTENEGRO,200,27,59,45.8,20,39,51.3,7,20,35.0,9,15,60.0,14,27,41,14,20,13,7,4,70,1
16890,394702,450_14_73,TURKEY,0,TOTALS,TURKEY,200,30,64,46.9,23,42,54.8,7,22,31.8,12,16,75.0,13,22,35,19,22,18,8,2,79,1
16891,394715,450_14_73,LITHUANIA,0,TOTALS,LITHUANIA,200,21,54,38.9,16,32,50.0,5,22,22.7,18,23,78.3,12,23,35,13,17,22,7,2,65,0
16892,394728,450_14_74,LATVIA,0,TOTALS,LATVIA,200,27,69,39.1,22,44,50.0,5,25,20.0,3,5,60.0,10,31,41,15,24,20,6,2,62,0
16893,394741,450_14_74,GERMANY,0,TOTALS,GERMANY,200,22,66,33.3,16,45,35.6,6,21,28.6,17,24,70.8,14,32,46,12,17,14,8,0,67,1
16894,394754,450_14_75,RUSSIA,0,TOTALS,RUSSIA,200,28,60,46.7,21,42,50.0,7,18,38.9,4,8,50.0,16,27,43,17,11,26,3,1,67,1
16895,394767,450_14_75,BULGARIA,0,TOTALS,BULGARIA,200,24,65,36.9,20,41,48.8,4,24,16.7,11,15,73.3,13,18,31,11,15,17,8,2,63,0
16896,394780,450_14_76,SERBIA,0,TOTALS,SERBIA,250,31,70,44.3,22,45,48.9,9,25,36.0,19,31,61.3,18,30,48,16,20,16,7,1,90,1
16897,394793,450_14_76,ISRAEL,0,TOTALS,ISRAEL,250,34,72,47.2,28,48,58.3,6,24,25.0,12,16,75.0,8,28,36,13,28,12,7,1,86,0
16898,394806,450_14_77,SLOVENIA,0,TOTALS,SLOVENIA,200,24,60,40.0,20,40,50.0,4,20,20.0,8,14,57.1,11,24,35,21,18,19,4,1,60,0
16899,394819,450_14_77,POLAND,0,TOTALS,POLAND,200,27,58,46.6,17,37,45.9,10,21,47.6,15,19,78.9,9,29,38,18,17,15,9,1,79,1
16900,394832,450_14_78,SPAIN,0,TOTALS,SPAIN,200,19,45,42.2,13,28,46.4,6,17,35.3,6,14,42.9,8,22,30,10,15,22,5,1,50,1
16901,394845,450_14_78,FRANCE,0,TOTALS,FRANCE,200,17,52,32.7,12,31,38.7,5,21,23.8,7,13,53.8,14,20,34,8,19,20,11,3,46,0
16902,394858,450_14_79,CROATIA,0,TOTALS,CROATIA,200,28,56,50.0,16,28,57.1,12,28,42.9,14,17,82.4,6,36,42,12,23,11,0,4,82,1
16903,394871,450_14_79,GREECE,0,TOTALS,GREECE,200,22,69,31.9,15,42,35.7,7,27,25.9,17,23,73.9,13,24,37,11,23,6,4,5,68,0
16904,394884,450_14_80,ITALY,0,TOTALS,ITALY,200,25,67,37.3,17,40,42.5,8,27,29.6,18,25,72.0,16,31,47,15,22,12,7,0,76,1
16905,394897,450_14_80,GREAT BRITAIN,0,TOTALS,GREAT BRITAIN,200,24,69,34.8,19,47,40.4,5,22,22.7,14,18,77.8,14,28,42,16,23,18,4,3,67,0
16906,394910,450_14_81,ISRAEL,0,TOTALS,ISRAEL,200,30,65,46.2,21,49,42.9,9,16,56.2,6,8,75.0,9,11,20,17,23,17,8,2,75,0
16907,394923,450_14_81,LITHUANIA,0,TOTALS,LITHUANIA,200,30,52,57.7,22,36,61.1,8,16,50.0,13,24,54.2,15,25,40,20,18,25,10,6,81,1
16908,394936,450_14_82,SWEDEN,0,TOTALS,SWEDEN,200,21,59,35.6,18,46,39.1,3,13,23.1,13,16,81.2,19,23,42,13,15,19,7,5,58,1
16909,394949,450_14_82,HUNGARY,0,TOTALS,HUNGARY,200,20,60,33.3,14,44,31.8,6,16,37.5,8,12,66.7,16,21,37,16,14,19,8,4,54,0
16910,394962,450_14_83,GREECE,0,TOTALS,GREECE,200,26,57,45.6,20,35,57.1,6,22,27.3,23,27,85.2,12,23,35,16,17,18,6,4,81,1
16911,394975,450_14_83,FRANCE,0,TOTALS,FRANCE,200,26,56,46.4,19,34,55.9,7,22,31.8,13,13,100.0,7,20,27,14,25,21,10,4,72,0
16912,394988,450_14_84,LATVIA,0,TOTALS,LATVIA,200,24,74,32.4,14,45,31.1,10,29,34.5,14,18,77.8,18,34,52,14,22,15,2,3,72,0
16913,395001,450_14_84,BULGARIA,0,TOTALS,BULGARIA,200,24,64,37.5,15,41,36.6,9,23,39.1,17,24,70.8,10,34,44,15,23,13,9,0,74,1
16914,395014,450_14_85,SERBIA,0,TOTALS,SERBIA,200,20,70,28.6,16,44,36.4,4,26,15.4,9,18,50.0,20,28,48,5,16,16,7,3,53,0
16915,395027,450_14_85,TURKEY,0,TOTALS,TURKEY,200,28,62,45.2,24,43,55.8,4,19,21.1,6,7,85.7,7,33,40,14,20,16,5,8,66,1
16916,395040,450_14_86,GERMANY,0,TOTALS,GERMANY,200,16,54,29.6,13,35,37.1,3,19,15.8,12,14,85.7,10,27,37,8,21,13,5,1,47,0
16917,395053,450_14_86,RUSSIA,0,TOTALS,RUSSIA,200,17,55,30.9,12,32,37.5,5,23,21.7,13,22,59.1,13,28,41,11,15,12,4,2,52,1
16918,395066,450_14_87,CROATIA,0,TOTALS,CROATIA,200,22,57,38.6,10,24,41.7,12,33,36.4,5,8,62.5,9,29,38,18,19,16,3,1,61,0
16919,395079,450_14_87,SPAIN,0,TOTALS,SPAIN,200,26,65,40.0,22,45,48.9,4,20,20.0,7,12,58.3,13,26,39,14,19,12,7,1,63,1
16920,395092,450_14_88,SLOVENIA,0,TOTALS,SLOVENIA,200,29,55,52.7,17,26,65.4,12,29,41.4,12,16,75.0,5,25,30,25,19,15,6,2,82,0
16921,395105,450_14_88,GREAT BRITAIN,0,TOTALS,GREAT BRITAIN,200,30,65,46.2,18,37,48.6,12,28,42.9,13,18,72.2,12,22,34,21,16,15,10,2,85,1
16922,395118,450_14_89,POLAND,0,TOTALS,POLAND,200,28,66,42.4,25,50,50.0,3,16,18.8,20,27,74.1,16,25,41,19,22,16,10,3,79,1
16923,395131,450_14_89,ITALY,0,TOTALS,ITALY,200,28,59,47.5,24,43,55.8,4,16,25.0,15,20,75.0,9,25,34,15,25,21,4,2,75,0
16924,395144,450_14_90,ISRAEL,0,TOTALS,ISRAEL,200,31,64,48.4,29,53,54.7,2,11,18.2,4,5,80.0,12,29,41,18,14,15,5,2,68,1
16925,395157,450_14_90,FRANCE,0,TOTALS,FRANCE,200,21,58,36.2,16,36,44.4,5,22,22.7,8,12,66.7,10,20,30,13,13,14,5,1,55,0
16926,395170,450_14_91,CZECH REPUBLIC,0,TOTALS,CZECH REPUBLIC,200,35,69,50.7,31,50,62.0,4,19,21.1,9,12,75.0,13,31,44,22,17,7,4,1,83,1
16927,395183,450_14_91,MONTENEGRO,0,TOTALS,MONTENEGRO,200,22,60,36.7,18,43,41.9,4,17,23.5,7,13,53.8,11,21,32,7,15,14,1,4,55,0
16928,395196,450_14_92,LITHUANIA,0,TOTALS,LITHUANIA,200,30,54,55.6,22,37,59.5,8,17,47.1,9,13,69.2,9,22,31,16,24,19,5,4,77,1
16929,395209,450_14_92,GREECE,0,TOTALS,GREECE,200,27,59,45.8,23,41,56.1,4,18,22.2,15,21,71.4,14,18,32,12,15,13,10,3,73,0
16930,395222,450_14_93,SERBIA,0,TOTALS,SERBIA,200,30,58,51.7,21,38,55.3,9,20,45.0,10,17,58.8,12,21,33,14,21,12,2,1,79,1
16931,395235,450_14_93,CROATIA,0,TOTALS,CROATIA,200,24,55,43.6,17,31,54.8,7,24,29.2,11,12,91.7,9,19,28,14,20,16,3,1,66,0
16932,395248,450_14_94,TURKEY,0,TOTALS,TURKEY,200,22,62,35.5,16,35,45.7,6,27,22.2,15,19,78.9,12,33,45,12,18,15,4,2,65,1
16933,395261,450_14_94,SPAIN,0,TOTALS,SPAIN,200,21,66,31.8,15,39,38.5,6,27,22.2,9,15,60.0,14,29,43,11,16,13,6,4,57,0
16934,395274,451_14_01,GEORGIA,0,TOTALS,GEORGIA,200,20,66,30.3,16,39,41.0,4,27,14.8,12,16,75.0,15,30,45,8,20,23,6,1,56,0
16935,395287,451_14_01,FINLAND,0,TOTALS,FINLAND,200,27,66,40.9,18,44,40.9,9,22,40.9,12,18,66.7,11,30,41,18,18,16,10,0,75,1
16936,395300,451_14_02,ROMANIA,0,TOTALS,ROMANIA,200,24,61,39.3,21,47,44.7,3,14,21.4,19,31,61.3,14,35,49,12,22,21,10,3,70,1
16937,395313,451_14_02,ESTONIA,0,TOTALS,ESTONIA,200,21,58,36.2,13,34,38.2,8,24,33.3,8,21,38.1,10,29,39,16,24,27,16,1,58,0
16938,395326,451_14_03,NETHERLANDS,0,TOTALS,NETHERLANDS,200,23,59,39.0,20,45,44.4,3,14,21.4,8,19,42.1,9,26,35,9,17,21,6,4,57,1
16939,395339,451_14_03,UKRAINE,0,TOTALS,UKRAINE,200,19,52,36.5,16,38,42.1,3,14,21.4,13,17,76.5,8,29,37,8,22,22,11,1,54,0
16940,395352,451_14_04,CYPRUS,0,TOTALS,CYPRUS,200,10,40,25.0,8,24,33.3,2,16,12.5,26,38,68.4,6,19,25,5,22,16,0,2,48,0
16941,395365,451_14_04,PORTUGAL,0,TOTALS,PORTUGAL,200,31,63,49.2,18,40,45.0,13,23,56.5,14,20,70.0,14,27,41,16,29,8,12,2,89,1
16942,395378,451_14_05,SWITZERLAND,0,TOTALS,SWITZERLAND,200,14,66,21.2,10,41,24.4,4,25,16.0,9,18,50.0,18,29,47,8,17,19,11,1,41,0
16943,395391,451_14_05,AUSTRIA,0,TOTALS,AUSTRIA,200,23,59,39.0,17,41,41.5,6,18,33.3,13,22,59.1,13,36,49,9,17,19,11,3,65,1
16944,395404,451_14_06,BELGIUM,0,TOTALS,BELGIUM,200,18,64,28.1,13,33,39.4,5,31,16.1,9,16,56.2,18,21,39,10,22,18,11,5,50,0
16945,395417,451_14_06,BOSNIA AND HERZEGOVINA,0,TOTALS,BOSNIA AND HERZEGOVINA,200,29,58,50.0,24,38,63.2,5,20,25.0,8,16,50.0,13,30,43,16,21,20,9,3,71,1
16946,395430,451_14_07,UKRAINE,0,TOTALS,UKRAINE,200,32,61,52.5,29,49,59.2,3,12,25.0,8,13,61.5,15,28,43,15,24,20,12,0,75,1
16947,395443,451_14_07,SWITZERLAND,0,TOTALS,SWITZERLAND,200,18,61,29.5,15,40,37.5,3,21,14.3,19,25,76.0,16,19,35,8,21,17,9,2,58,0
16948,395456,451_14_08,BELARUS,0,TOTALS,BELARUS,200,34,63,54.0,24,39,61.5,10,24,41.7,11,15,73.3,21,32,53,21,19,18,6,4,89,1
16949,395469,451_14_08,NETHERLANDS,0,TOTALS,NETHERLANDS,200,23,63,36.5,15,40,37.5,8,23,34.8,10,17,58.8,15,17,32,14,23,9,2,5,64,0
16950,395482,451_14_09,PORTUGAL,0,TOTALS,PORTUGAL,200,24,61,39.3,13,31,41.9,11,30,36.7,23,26,88.5,13,19,32,13,20,8,12,0,82,1
16951,395495,451_14_09,ROMANIA,0,TOTALS,ROMANIA,200,26,58,44.8,24,46,52.2,2,12,16.7,10,19,52.6,17,22,39,7,23,22,4,1,64,0
16952,395508,451_14_10,LUXEMBOURG,0,TOTALS,LUXEMBOURG,200,23,60,38.3,17,48,35.4,6,12,50.0,6,12,50.0,7,29,36,12,20,19,4,0,58,1
16953,395521,451_14_10,BELGIUM,0,TOTALS,BELGIUM,200,35,74,47.3,23,40,57.5,12,34,35.3,18,24,75.0,12,34,46,21,13,8,10,5,100,0
16954,395534,451_14_11,AUSTRIA,0,TOTALS,AUSTRIA,200,24,67,35.8,19,47,40.4,5,20,25.0,2,5,40.0,12,27,39,16,13,17,8,0,55,0
16955,395547,451_14_11,GEORGIA,0,TOTALS,GEORGIA,200,28,60,46.7,19,35,54.3,9,25,36.0,7,14,50.0,7,31,38,16,13,17,8,3,72,1
16956,395560,451_14_12,BOSNIA AND HERZEGOVINA,0,TOTALS,BOSNIA AND HERZEGOVINA,200,40,71,56.3,27,45,60.0,13,26,50.0,11,17,64.7,19,29,48,27,24,16,4,11,104,0
16957,395573,451_14_12,CYPRUS,0,TOTALS,CYPRUS,200,20,66,30.3,18,46,39.1,2,20,10.0,14,22,63.6,16,15,31,10,24,16,10,0,56,1
16958,395586,451_14_13,CYPRUS,0,TOTALS,CYPRUS,200,20,71,28.2,13,50,26.0,7,21,33.3,1,4,25.0,14,25,39,8,21,20,7,0,48,0
16959,395599,451_14_13,LUXEMBOURG,0,TOTALS,LUXEMBOURG,200,27,62,43.5,25,47,53.2,2,15,13.3,16,21,76.2,10,35,45,11,16,18,11,4,72,1
16960,395612,451_14_14,ESTONIA,0,TOTALS,ESTONIA,200,23,57,40.4,16,35,45.7,7,22,31.8,11,17,64.7,5,24,29,16,22,10,6,2,64,0
16961,395625,451_14_14,PORTUGAL,0,TOTALS,PORTUGAL,200,25,63,39.7,15,38,39.5,10,25,40.0,16,19,84.2,14,32,46,14,16,10,3,4,76,1
16962,395638,451_14_15,GEORGIA,0,TOTALS,GEORGIA,200,23,60,38.3,15,30,50.0,8,30,26.7,15,20,75.0,9,24,33,9,20,14,7,2,69,0
16963,395651,451_14_15,UKRAINE,0,TOTALS,UKRAINE,200,30,65,46.2,27,53,50.9,3,12,25.0,8,12,66.7,13,29,42,20,21,15,11,1,71,1
16964,395664,451_14_16,FINLAND,0,TOTALS,FINLAND,200,31,69,44.9,26,47,55.3,5,22,22.7,15,19,78.9,16,31,47,22,15,20,13,2,82,1
16965,395677,451_14_16,AUSTRIA,0,TOTALS,AUSTRIA,200,18,52,34.6,16,32,50.0,2,20,10.0,8,13,61.5,8,25,33,9,21,33,11,1,46,0
16966,395690,451_14_17,SWITZERLAND,0,TOTALS,SWITZERLAND,200,23,70,32.9,19,48,39.6,4,22,18.2,4,7,57.1,11,22,33,12,21,12,10,3,54,0
16967,395703,451_14_17,BELARUS,0,TOTALS,BELARUS,200,32,70,45.7,30,57,52.6,2,13,15.4,18,27,66.7,20,36,56,18,13,14,6,3,84,1
16968,395716,451_14_18,ROMANIA,0,TOTALS,ROMANIA,200,16,46,34.8,13,31,41.9,3,15,20.0,5,10,50.0,5,22,27,7,27,31,3,3,40,0
16969,395729,451_14_18,BOSNIA AND HERZEGOVINA,0,TOTALS,BOSNIA AND HERZEGOVINA,200,35,78,44.9,31,54,57.4,4,24,16.7,22,33,66.7,25,27,52,23,18,12,17,1,96,1
16970,395742,451_14_19,BELGIUM,0,TOTALS,BELGIUM,200,18,55,32.7,12,26,46.2,6,29,20.7,16,21,76.2,14,28,42,13,18,16,5,5,58,1
16971,395755,451_14_19,CYPRUS,0,TOTALS,CYPRUS,200,12,43,27.9,12,33,36.4,0,10,0.0,17,20,85.0,5,22,27,2,17,16,3,0,41,0
16972,395768,451_14_20,BELARUS,0,TOTALS,BELARUS,200,32,62,51.6,26,47,55.3,6,15,40.0,12,15,80.0,11,35,46,19,13,16,10,3,82,1
16973,395781,451_14_20,GEORGIA,0,TOTALS,GEORGIA,200,23,71,32.4,13,38,34.2,10,33,30.3,7,12,58.3,14,22,36,14,22,13,5,2,63,0
16974,395794,451_14_21,LUXEMBOURG,0,TOTALS,LUXEMBOURG,200,22,65,33.8,18,43,41.9,4,22,18.2,20,31,64.5,14,26,40,9,18,16,8,0,68,0
16975,395807,451_14_21,ROMANIA,0,TOTALS,ROMANIA,200,29,62,46.8,21,36,58.3,8,26,30.8,13,18,72.2,8,30,38,14,27,17,10,3,79,1
16976,395820,451_14_22,UKRAINE,0,TOTALS,UKRAINE,200,33,64,51.6,29,50,58.0,4,14,28.6,9,13,69.2,12,34,46,25,22,24,8,6,79,1
16977,395833,451_14_22,FINLAND,0,TOTALS,FINLAND,200,23,60,38.3,18,33,54.5,5,27,18.5,8,16,50.0,9,18,27,11,16,14,9,0,59,0
16978,395846,451_14_23,NETHERLANDS,0,TOTALS,NETHERLANDS,200,21,60,35.0,17,43,39.5,4,17,23.5,6,13,46.2,13,21,34,12,18,15,13,1,52,1
16979,395859,451_14_23,SWITZERLAND,0,TOTALS,SWITZERLAND,200,20,50,40.0,15,31,48.4,5,19,26.3,4,7,57.1,9,27,36,11,20,24,5,0,49,0
16980,395872,451_14_24,BOSNIA AND HERZEGOVINA,0,TOTALS,BOSNIA AND HERZEGOVINA,200,35,64,54.7,29,48,60.4,6,16,37.5,19,38,50.0,17,38,55,23,22,23,10,5,95,1
16981,395885,451_14_24,ESTONIA,0,TOTALS,ESTONIA,200,20,63,31.7,14,37,37.8,6,26,23.1,11,15,73.3,9,20,29,8,33,17,11,2,57,0
16982,395898,451_14_25,FINLAND,0,TOTALS,FINLAND,200,25,67,37.3,18,39,46.2,7,28,25.0,16,19,84.2,12,17,29,12,17,16,11,5,73,0
16983,395911,451_14_25,BELARUS,0,TOTALS,BELARUS,200,35,67,52.2,28,47,59.6,7,20,35.0,8,12,66.7,18,30,48,18,21,23,11,2,85,1
16984,395924,451_14_26,AUSTRIA,0,TOTALS,AUSTRIA,200,21,61,34.4,15,38,39.5,6,23,26.1,6,8,75.0,13,19,32,14,14,16,12,0,54,0
16985,395937,451_14_26,UKRAINE,0,TOTALS,UKRAINE,200,27,56,48.2,22,32,68.8,5,24,20.8,4,10,40.0,12,28,40,21,14,17,11,3,63,1
16986,395950,451_14_27,ROMANIA,0,TOTALS,ROMANIA,200,11,51,21.6,9,34,26.5,2,17,11.8,13,20,65.0,7,23,30,6,12,19,6,0,37,0
16987,395963,451_14_27,BELGIUM,0,TOTALS,BELGIUM,200,29,65,44.6,19,37,51.4,10,28,35.7,7,13,53.8,14,33,47,15,19,12,5,4,75,1
16988,395976,451_14_28,GEORGIA,0,TOTALS,GEORGIA,200,19,59,32.2,12,30,40.0,7,29,24.1,6,7,85.7,12,20,32,10,17,24,10,0,51,0
16989,395989,451_14_28,NETHERLANDS,0,TOTALS,NETHERLANDS,200,30,63,47.6,26,42,61.9,4,21,19.0,9,14,64.3,12,30,42,18,14,21,10,2,73,1
16990,396002,451_14_29,ESTONIA,0,TOTALS,ESTONIA,200,28,62,45.2,14,27,51.9,14,35,40.0,5,8,62.5,4,31,35,15,24,8,8,3,75,1
16991,396015,451_14_29,LUXEMBOURG,0,TOTALS,LUXEMBOURG,200,21,59,35.6,14,37,37.8,7,22,31.8,19,27,70.4,10,30,40,7,12,15,5,2,68,0
16992,396028,451_14_30,PORTUGAL,0,TOTALS,PORTUGAL,200,25,71,35.2,18,42,42.9,7,29,24.1,7,8,87.5,17,20,37,15,23,18,11,2,64,0
16993,396041,451_14_30,BOSNIA AND HERZEGOVINA,0,TOTALS,BOSNIA AND HERZEGOVINA,200,28,52,53.8,25,41,61.0,3,11,27.3,14,21,66.7,6,31,37,20,17,20,11,1,73,1
16994,396054,451_14_31,CYPRUS,0,TOTALS,CYPRUS,200,18,55,32.7,7,23,30.4,11,32,34.4,14,16,87.5,13,35,48,12,19,19,7,2,61,1
16995,396067,451_14_31,ROMANIA,0,TOTALS,ROMANIA,200,19,57,33.3,14,40,35.0,5,17,29.4,2,15,13.3,10,23,33,6,20,15,10,2,45,0
16996,396080,451_14_32,SWITZERLAND,0,TOTALS,SWITZERLAND,200,26,58,44.8,11,25,44.0,15,33,45.5,9,14,64.3,10,25,35,19,14,21,7,3,76,0
16997,396093,451_14_32,GEORGIA,0,TOTALS,GEORGIA,200,29,60,48.3,17,35,48.6,12,25,48.0,9,13,69.2,8,24,32,22,17,14,10,2,79,1
16998,396106,451_14_33,BELARUS,0,TOTALS,BELARUS,200,30,63,47.6,22,43,51.2,8,20,40.0,10,18,55.6,18,28,46,18,17,16,10,2,78,1
16999,396119,451_14_33,AUSTRIA,0,TOTALS,AUSTRIA,200,23,55,41.8,13,30,43.3,10,25,40.0,7,14,50.0,9,20,29,13,21,16,9,0,63,0
17000,396132,451_14_34,LUXEMBOURG,0,TOTALS,LUXEMBOURG,200,25,63,39.7,20,48,41.7,5,15,33.3,11,11,100.0,12,24,36,12,16,13,5,0,66,0
17001,396145,451_14_34,PORTUGAL,0,TOTALS,PORTUGAL,200,27,65,41.5,17,36,47.2,10,29,34.5,10,14,71.4,15,27,42,19,17,14,4,1,74,1
17002,396158,451_14_35,BELGIUM,0,TOTALS,BELGIUM,200,33,67,49.3,21,38,55.3,12,29,41.4,14,28,50.0,18,28,46,19,13,14,13,5,92,1
17003,396171,451_14_35,ESTONIA,0,TOTALS,ESTONIA,200,14,50,28.0,8,28,28.6,6,22,27.3,5,8,62.5,8,20,28,10,27,24,9,1,39,0
17004,396184,451_14_36,NETHERLANDS,0,TOTALS,NETHERLANDS,200,25,57,43.9,24,46,52.2,1,11,9.1,17,24,70.8,12,36,48,11,18,21,4,3,68,1
17005,396197,451_14_36,FINLAND,0,TOTALS,FINLAND,200,25,69,36.2,17,39,43.6,8,30,26.7,8,12,66.7,10,23,33,11,23,14,6,1,66,0
17006,396210,451_14_37,UKRAINE,0,TOTALS,UKRAINE,200,30,53,56.6,22,35,62.9,8,18,44.4,9,14,64.3,9,20,29,21,23,19,10,1,77,1
17007,396223,451_14_37,BELARUS,0,TOTALS,BELARUS,200,27,57,47.4,19,39,48.7,8,18,44.4,9,10,90.0,10,14,24,16,20,16,7,1,71,0
17008,396236,451_14_38,AUSTRIA,0,TOTALS,AUSTRIA,200,19,54,35.2,11,28,39.3,8,26,30.8,1,6,16.7,9,20,29,10,16,19,4,1,47,0
17009,396249,451_14_38,NETHERLANDS,0,TOTALS,NETHERLANDS,200,27,62,43.5,18,40,45.0,9,22,40.9,14,17,82.4,15,29,44,18,10,13,11,1,77,1
17010,396262,451_14_39,ESTONIA,0,TOTALS,ESTONIA,200,22,57,38.6,13,32,40.6,9,25,36.0,8,14,57.1,3,24,27,12,27,19,7,3,61,0
17011,396275,451_14_39,CYPRUS,0,TOTALS,CYPRUS,200,20,54,37.0,13,31,41.9,7,23,30.4,25,32,78.1,8,30,38,9,21,21,11,0,72,1
17012,396288,451_14_40,FINLAND,0,TOTALS,FINLAND,200,27,63,42.9,22,46,47.8,5,17,29.4,19,28,67.9,12,16,28,13,25,20,13,0,78,0
17013,396301,451_14_40,SWITZERLAND,0,TOTALS,SWITZERLAND,200,31,57,54.4,28,40,70.0,3,17,17.6,22,26,84.6,11,29,40,14,21,24,9,2,87,1
17014,396314,451_14_41,PORTUGAL,0,TOTALS,PORTUGAL,200,19,70,27.1,11,42,26.2,8,28,28.6,7,14,50.0,19,16,35,7,15,9,3,1,53,0
17015,396327,451_14_41,BELGIUM,0,TOTALS,BELGIUM,200,35,57,61.4,26,41,63.4,9,16,56.2,13,18,72.2,7,36,43,21,13,8,7,6,92,1
17016,396340,451_14_42,BOSNIA AND HERZEGOVINA,0,TOTALS,BOSNIA AND HERZEGOVINA,200,36,62,58.1,29,41,70.7,7,21,33.3,20,27,74.1,11,37,48,29,14,19,14,5,99,1
17017,396353,451_14_42,LUXEMBOURG,0,TOTALS,LUXEMBOURG,200,23,70,32.9,20,46,43.5,3,24,12.5,3,6,50.0,11,20,31,12,19,21,10,2,52,0
17018,396366,451_14_43,NETHERLANDS,0,TOTALS,NETHERLANDS,200,25,56,44.6,19,38,50.0,6,18,33.3,13,16,81.2,16,20,36,11,19,12,4,3,69,1
17019,396379,451_14_43,CYPRUS,0,TOTALS,CYPRUS,200,15,41,36.6,11,22,50.0,4,19,21.1,11,15,73.3,7,14,21,6,16,16,6,2,45,0
17020,396392,451_14_44,PORTUGAL,0,TOTALS,PORTUGAL,200,31,77,40.3,24,54,44.4,7,23,30.4,6,8,75.0,18,28,46,13,18,16,9,1,75,1
17021,396405,451_14_44,FINLAND,0,TOTALS,FINLAND,200,29,70,41.4,27,51,52.9,2,19,10.5,5,11,45.5,14,26,40,9,13,16,6,3,65,0
17022,396418,451_14_45,ROMANIA,0,TOTALS,ROMANIA,200,24,65,36.9,14,40,35.0,10,25,40.0,12,19,63.2,17,24,41,13,20,15,11,2,70,1
17023,396431,451_14_45,AUSTRIA,0,TOTALS,AUSTRIA,200,25,56,44.6,14,32,43.8,11,24,45.8,7,17,41.2,12,23,35,19,18,18,8,1,68,0
17024,396444,451_14_46,BELARUS,0,TOTALS,BELARUS,200,24,63,38.1,18,43,41.9,6,20,30.0,16,26,61.5,10,28,38,12,20,12,3,1,70,0
17025,396457,451_14_46,BELGIUM,0,TOTALS,BELGIUM,200,34,71,47.9,26,45,57.8,8,26,30.8,15,21,71.4,12,32,44,16,24,12,5,5,91,1
17026,396470,451_14_47,GEORGIA,0,TOTALS,GEORGIA,200,18,56,32.1,10,38,26.3,8,18,44.4,16,19,84.2,16,36,52,10,16,21,5,2,60,1
17027,396483,451_14_47,ESTONIA,0,TOTALS,ESTONIA,200,22,69,31.9,17,42,40.5,5,27,18.5,3,7,42.9,11,23,34,12,21,12,11,1,52,0
17028,396496,451_14_48,BOSNIA AND HERZEGOVINA,0,TOTALS,BOSNIA AND HERZEGOVINA,200,34,72,47.2,28,50,56.0,6,22,27.3,15,25,60.0,17,26,43,23,15,10,11,6,89,1
17029,396509,451_14_48,UKRAINE,0,TOTALS,UKRAINE,200,29,61,47.5,22,45,48.9,7,16,43.8,6,9,66.7,9,23,32,13,25,18,4,3,71,0
17030,396522,451_14_49,LUXEMBOURG,0,TOTALS,LUXEMBOURG,200,24,65,36.9,18,47,38.3,6,18,33.3,11,13,84.6,12,29,41,7,16,12,6,0,65,1
17031,396535,451_14_49,SWITZERLAND,0,TOTALS,SWITZERLAND,200,22,66,33.3,18,37,48.6,4,29,13.8,12,16,75.0,16,26,42,8,19,14,10,1,60,0
17032,396548,451_14_50,FINLAND,0,TOTALS,FINLAND,200,33,63,52.4,26,45,57.8,7,18,38.9,15,22,68.2,11,30,41,17,10,7,8,3,88,1
17033,396561,451_14_50,CYPRUS,0,TOTALS,CYPRUS,200,22,59,37.3,19,43,44.2,3,16,18.8,5,10,50.0,10,23,33,12,18,15,3,1,52,0
17034,396574,451_14_51,AUSTRIA,0,TOTALS,AUSTRIA,200,18,54,33.3,15,31,48.4,3,23,13.0,13,23,56.5,12,26,38,7,19,14,11,1,52,1
17035,396587,451_14_51,ESTONIA,0,TOTALS,ESTONIA,200,17,47,36.2,9,26,34.6,8,21,38.1,9,18,50.0,8,30,38,5,25,21,5,0,51,0
17036,396600,451_14_52,PORTUGAL,0,TOTALS,PORTUGAL,200,21,57,36.8,17,35,48.6,4,22,18.2,19,22,86.4,7,21,28,5,21,13,10,0,65,0
17037,396613,451_14_52,NETHERLANDS,0,TOTALS,NETHERLANDS,200,27,51,52.9,24,40,60.0,3,11,27.3,17,25,68.0,8,27,35,13,23,18,7,3,74,1
17038,396626,451_14_53,ROMANIA,0,TOTALS,ROMANIA,200,24,46,52.2,15,28,53.6,9,18,50.0,9,13,69.2,12,18,30,13,21,20,9,3,66,1
17039,396639,451_14_53,GEORGIA,0,TOTALS,GEORGIA,200,17,40,42.5,13,26,50.0,4,14,28.6,12,20,60.0,7,11,18,5,15,18,11,4,50,0
17040,396652,451_14_54,UKRAINE,0,TOTALS,UKRAINE,200,29,67,43.3,23,47,48.9,6,20,30.0,13,17,76.5,12,32,44,14,21,12,6,4,77,1
17041,396665,451_14_54,BELARUS,0,TOTALS,BELARUS,200,23,62,37.1,18,38,47.4,5,24,20.8,11,16,68.8,10,26,36,11,20,14,1,8,62,0
17042,396678,451_14_55,BOSNIA AND HERZEGOVINA,0,TOTALS,BOSNIA AND HERZEGOVINA,200,24,49,49.0,20,40,50.0,4,9,44.4,24,31,77.4,9,35,44,10,20,22,3,4,76,1
17043,396691,451_14_55,BELGIUM,0,TOTALS,BELGIUM,200,25,81,30.9,11,40,27.5,14,41,34.1,6,12,50.0,22,17,39,9,23,13,10,4,70,0
17044,399739,454_14_01,ITALY,0,TOTALS,ITALY,200,24,63,38.1,20,40,50.0,4,23,17.4,20,28,71.4,13,35,48,14,22,12,14,3,72,1
17045,399752,454_14_01,LATVIA,0,TOTALS,LATVIA,200,21,67,31.3,16,42,38.1,5,25,20.0,8,13,61.5,12,30,42,12,26,19,4,3,55,0
17046,399765,454_14_02,GREECE,0,TOTALS,GREECE,200,30,61,49.2,23,46,50.0,7,15,46.7,11,14,78.6,15,23,38,19,16,15,5,10,78,1
17047,399778,454_14_02,BOSNIA AND HERZEGOVINA,0,TOTALS,BOSNIA AND HERZEGOVINA,200,23,54,42.6,15,36,41.7,8,18,44.4,15,23,65.2,12,14,26,12,18,15,2,5,69,0
17048,399791,454_14_03,FRANCE,0,TOTALS,FRANCE,200,30,58,51.7,25,44,56.8,5,14,35.7,7,15,46.7,7,19,26,13,16,18,9,3,72,0
17049,399804,454_14_03,LITHUANIA,0,TOTALS,LITHUANIA,200,27,59,45.8,19,37,51.4,8,22,36.4,13,19,68.4,13,25,38,19,18,22,6,3,75,1
17050,399817,454_14_04,SERBIA,0,TOTALS,SERBIA,200,28,55,50.9,26,45,57.8,2,10,20.0,21,24,87.5,9,35,44,21,16,16,8,4,79,1
17051,399830,454_14_04,RUSSIA,0,TOTALS,RUSSIA,200,20,69,29.0,16,51,31.4,4,18,22.2,9,15,60.0,16,18,34,6,20,14,5,5,53,0
17052,399843,454_14_05,POLAND,0,TOTALS,POLAND,200,21,56,37.5,13,32,40.6,8,24,33.3,17,25,68.0,17,28,45,12,13,22,8,4,67,1
17053,399856,454_14_05,BELGIUM,0,TOTALS,BELGIUM,200,26,62,41.9,23,44,52.3,3,18,16.7,8,12,66.7,8,20,28,17,26,16,11,5,63,0
17054,399869,454_14_06,SPAIN,0,TOTALS,SPAIN,200,28,74,37.8,24,49,49.0,4,25,16.0,13,17,76.5,17,22,39,9,20,12,6,1,73,1
17055,399882,454_14_06,MONTENEGRO,0,TOTALS,MONTENEGRO,200,25,60,41.7,21,42,50.0,4,18,22.2,18,20,90.0,14,29,43,12,20,17,5,4,72,0
17056,399895,454_14_07,CROATIA,0,TOTALS,CROATIA,200,34,74,45.9,27,51,52.9,7,23,30.4,13,19,68.4,18,37,55,28,21,19,10,10,88,1
17057,399908,454_14_07,ENGLAND,0,TOTALS,ENGLAND,200,16,70,22.9,12,52,23.1,4,18,22.2,11,17,64.7,18,26,44,8,20,24,6,1,47,0
17058,399921,454_14_08,TURKEY,0,TOTALS,TURKEY,200,41,72,56.9,33,54,61.1,8,18,44.4,11,22,50.0,14,30,44,30,18,10,15,2,101,0
17059,399934,454_14_08,CZECH REPUBLIC,0,TOTALS,CZECH REPUBLIC,200,23,64,35.9,21,49,42.9,2,15,13.3,3,10,30.0,13,23,36,8,19,24,3,5,51,1
17060,399947,454_14_09,BELGIUM,0,TOTALS,BELGIUM,200,23,58,39.7,16,36,44.4,7,22,31.8,26,33,78.8,15,28,43,16,23,14,6,2,79,1
17061,399960,454_14_09,ITALY,0,TOTALS,ITALY,200,27,68,39.7,20,49,40.8,7,19,36.8,14,26,53.8,19,21,40,12,26,10,6,2,75,0
17062,399973,454_14_10,MONTENEGRO,0,TOTALS,MONTENEGRO,200,32,69,46.4,27,50,54.0,5,19,26.3,9,17,52.9,14,29,43,9,20,10,2,7,78,1
17063,399986,454_14_10,SERBIA,0,TOTALS,SERBIA,200,30,75,40.0,26,53,49.1,4,22,18.2,9,14,64.3,17,29,46,10,19,4,4,3,73,0
17064,399999,454_14_11,ENGLAND,0,TOTALS,ENGLAND,200,17,51,33.3,14,34,41.2,3,17,17.6,8,15,53.3,11,20,31,7,21,21,6,1,45,0
17065,400012,454_14_11,FRANCE,0,TOTALS,FRANCE,200,25,59,42.4,14,36,38.9,11,23,47.8,12,18,66.7,16,26,42,19,19,19,8,3,73,1
17066,400025,454_14_12,CZECH REPUBLIC,0,TOTALS,CZECH REPUBLIC,200,22,55,40.0,17,41,41.5,5,14,35.7,8,11,72.7,8,23,31,9,17,20,4,3,57,0
17067,400038,454_14_12,GREECE,0,TOTALS,GREECE,200,29,62,46.8,23,44,52.3,6,18,33.3,11,13,84.6,12,25,37,14,19,16,11,4,75,1
17068,400051,454_14_13,LITHUANIA,0,TOTALS,LITHUANIA,200,23,66,34.8,12,33,36.4,11,33,33.3,9,16,56.2,18,24,42,14,19,22,8,3,66,0
17069,400064,454_14_13,CROATIA,0,TOTALS,CROATIA,200,34,73,46.6,31,63,49.2,3,10,30.0,18,26,69.2,19,28,47,11,22,15,18,3,89,1
17070,400077,454_14_14,RUSSIA,0,TOTALS,RUSSIA,200,25,77,32.5,23,56,41.1,2,21,9.5,8,11,72.7,21,25,46,8,20,15,11,2,60,0
17071,400090,454_14_14,SPAIN,0,TOTALS,SPAIN,200,28,67,41.8,22,49,44.9,6,18,33.3,5,15,33.3,19,31,50,13,19,21,6,7,67,1
17072,400103,454_14_15,LATVIA,0,TOTALS,LATVIA,200,25,59,42.4,16,34,47.1,9,25,36.0,13,24,54.2,12,26,38,15,20,22,11,5,72,1
17073,400116,454_14_15,POLAND,0,TOTALS,POLAND,200,26,68,38.2,21,51,41.2,5,17,29.4,11,15,73.3,18,29,47,14,27,22,6,4,68,0
17074,400129,454_14_16,BOSNIA AND HERZEGOVINA,0,TOTALS,BOSNIA AND HERZEGOVINA,200,25,54,46.3,19,39,48.7,6,15,40.0,17,20,85.0,14,25,39,12,24,21,7,1,73,1
17075,400142,454_14_16,TURKEY,0,TOTALS,TURKEY,200,22,57,38.6,15,33,45.5,7,24,29.2,15,25,60.0,12,17,29,15,19,17,12,1,66,0
17076,400155,454_14_17,FRANCE,0,TOTALS,FRANCE,200,21,66,31.8,17,43,39.5,4,23,17.4,16,31,51.6,13,27,40,12,19,12,10,1,62,0
17077,400168,454_14_17,CROATIA,0,TOTALS,CROATIA,200,28,68,41.2,23,46,50.0,5,22,22.7,18,24,75.0,15,39,54,21,22,16,4,4,79,1
17078,400181,454_14_18,SERBIA,0,TOTALS,SERBIA,200,25,71,35.2,20,50,40.0,5,21,23.8,16,20,80.0,26,30,56,14,22,22,8,3,71,1
17079,400194,454_14_18,SPAIN,0,TOTALS,SPAIN,200,24,63,38.1,18,43,41.9,6,20,30.0,9,12,75.0,10,22,32,13,23,16,12,6,63,0
17080,400207,454_14_19,ITALY,0,TOTALS,ITALY,200,32,77,41.6,27,57,47.4,5,20,25.0,9,15,60.0,19,26,45,10,25,15,9,3,78,1
17081,400220,454_14_19,POLAND,0,TOTALS,POLAND,200,24,64,37.5,21,44,47.7,3,20,15.0,17,26,65.4,19,28,47,18,17,20,8,6,68,0
17082,400233,454_14_20,MONTENEGRO,0,TOTALS,MONTENEGRO,200,22,54,40.7,20,40,50.0,2,14,14.3,23,30,76.7,15,34,49,15,13,21,5,6,69,1
17083,400246,454_14_20,RUSSIA,0,TOTALS,RUSSIA,200,29,78,37.2,26,55,47.3,3,23,13.0,2,5,40.0,14,22,36,11,24,9,9,2,63,0
17084,400259,454_14_21,BELGIUM,0,TOTALS,BELGIUM,200,17,69,24.6,14,50,28.0,3,19,15.8,15,20,75.0,16,27,43,8,19,17,12,3,52,0
17085,400272,454_14_21,LATVIA,0,TOTALS,LATVIA,200,23,64,35.9,20,50,40.0,3,14,21.4,14,21,66.7,17,40,57,13,21,25,9,4,63,1
17086,400285,454_14_22,BOSNIA AND HERZEGOVINA,0,TOTALS,BOSNIA AND HERZEGOVINA,200,25,63,39.7,21,47,44.7,4,16,25.0,18,23,78.3,15,26,41,12,19,13,8,2,72,1
17087,400298,454_14_22,CZECH REPUBLIC,0,TOTALS,CZECH REPUBLIC,200,22,56,39.3,14,33,42.4,8,23,34.8,13,20,65.0,10,25,35,11,18,16,8,6,65,0
17088,400311,454_14_23,ENGLAND,0,TOTALS,ENGLAND,200,23,66,34.8,21,53,39.6,2,13,15.4,13,24,54.2,15,17,32,9,22,13,11,1,61,0
17089,400324,454_14_23,LITHUANIA,0,TOTALS,LITHUANIA,200,25,52,48.1,16,29,55.2,9,23,39.1,18,23,78.3,11,32,43,20,20,19,5,6,77,1
17090,400337,454_14_24,TURKEY,0,TOTALS,TURKEY,200,24,60,40.0,18,44,40.9,6,16,37.5,14,22,63.6,14,25,39,12,20,9,4,3,68,1
17091,400350,454_14_24,GREECE,0,TOTALS,GREECE,200,25,60,41.7,21,42,50.0,4,18,22.2,10,18,55.6,13,26,39,12,23,10,5,5,64,0
17092,400363,454_14_25,BELGIUM,0,TOTALS,BELGIUM,200,26,64,40.6,23,53,43.4,3,11,27.3,10,14,71.4,9,15,24,17,21,10,10,4,65,0
17093,400376,454_14_25,RUSSIA,0,TOTALS,RUSSIA,200,28,55,50.9,23,44,52.3,5,11,45.5,23,28,82.1,16,30,46,12,14,16,4,6,84,1
17094,400389,454_14_26,ENGLAND,0,TOTALS,ENGLAND,200,20,63,31.7,16,46,34.8,4,17,23.5,6,13,46.2,16,33,49,8,17,19,6,3,50,0
17095,400402,454_14_26,CZECH REPUBLIC,0,TOTALS,CZECH REPUBLIC,200,22,77,28.6,16,53,30.2,6,24,25.0,5,11,45.5,20,30,50,14,16,12,13,8,55,1
17096,400415,454_14_27,FRANCE,0,TOTALS,FRANCE,200,25,60,41.7,23,47,48.9,2,13,15.4,13,17,76.5,10,28,38,14,26,16,4,4,65,0
17097,400428,454_14_27,ITALY,0,TOTALS,ITALY,200,21,63,33.3,11,31,35.5,10,32,31.2,16,21,76.2,15,26,41,13,18,13,6,3,68,1
17098,400441,454_14_28,SPAIN,0,TOTALS,SPAIN,250,24,75,32.0,19,55,34.5,5,20,25.0,32,38,84.2,12,43,55,11,29,12,6,3,85,0
17099,400454,454_14_28,GREECE,0,TOTALS,GREECE,250,29,85,34.1,19,49,38.8,10,36,27.8,21,36,58.3,22,41,63,18,30,16,6,10,89,1
17100,400467,454_14_29,LITHUANIA,0,TOTALS,LITHUANIA,200,30,67,44.8,20,41,48.8,10,26,38.5,6,10,60.0,20,26,46,23,22,24,9,4,76,0
17101,400480,454_14_29,LATVIA,0,TOTALS,LATVIA,200,25,56,44.6,14,34,41.2,11,22,50.0,17,22,77.3,6,19,25,11,21,16,15,2,78,1
17102,400493,454_14_30,SERBIA,0,TOTALS,SERBIA,200,27,53,50.9,20,37,54.1,7,16,43.8,16,19,84.2,11,26,37,13,19,22,5,2,77,1
17103,400506,454_14_30,BOSNIA AND HERZEGOVINA,0,TOTALS,BOSNIA AND HERZEGOVINA,200,25,59,42.4,13,36,36.1,12,23,52.2,9,17,52.9,11,16,27,17,21,14,11,1,71,0
17104,400519,454_14_31,POLAND,0,TOTALS,POLAND,200,31,70,44.3,21,42,50.0,10,28,35.7,9,18,50.0,11,27,38,17,24,17,11,3,81,1
17105,400532,454_14_31,CROATIA,0,TOTALS,CROATIA,200,38,69,55.1,31,48,64.6,7,21,33.3,18,29,62.1,11,32,43,27,22,12,11,8,101,0
17106,400545,454_14_32,TURKEY,0,TOTALS,TURKEY,200,34,75,45.3,28,56,50.0,6,19,31.6,4,6,66.7,18,17,35,17,22,12,12,6,78,1
17107,400558,454_14_32,MONTENEGRO,0,TOTALS,MONTENEGRO,200,21,53,39.6,19,40,47.5,2,13,15.4,19,27,70.4,17,22,39,14,17,23,5,2,63,0
17108,400571,454_14_33,CZECH REPUBLIC,0,TOTALS,CZECH REPUBLIC,200,32,64,50.0,23,45,51.1,9,19,47.4,13,21,61.9,14,29,43,19,15,15,6,4,86,1
17109,400584,454_14_33,BELGIUM,0,TOTALS,BELGIUM,200,29,66,43.9,25,46,54.3,4,20,20.0,12,13,92.3,6,22,28,16,20,11,9,1,74,0
17110,400597,454_14_34,RUSSIA,0,TOTALS,RUSSIA,200,26,62,41.9,20,45,44.4,6,17,35.3,7,14,50.0,11,30,41,13,13,11,7,7,65,1
17111,400610,454_14_34,ENGLAND,0,TOTALS,ENGLAND,200,19,67,28.4,13,49,26.5,6,18,33.3,6,13,46.2,20,29,49,9,15,17,3,2,50,0
17112,400623,454_14_35,ITALY,0,TOTALS,ITALY,200,22,55,40.0,17,39,43.6,5,16,31.2,15,21,71.4,8,28,36,9,18,14,10,0,64,1
17113,400636,454_14_35,LITHUANIA,0,TOTALS,LITHUANIA,200,22,58,37.9,17,36,47.2,5,22,22.7,12,18,66.7,10,26,36,15,21,16,5,9,61,0
17114,400649,454_14_36,BOSNIA AND HERZEGOVINA,0,TOTALS,BOSNIA AND HERZEGOVINA,200,25,64,39.1,19,48,39.6,6,16,37.5,8,10,80.0,10,18,28,15,16,15,11,1,64,0
17115,400662,454_14_36,MONTENEGRO,0,TOTALS,MONTENEGRO,200,27,56,48.2,19,37,51.4,8,19,42.1,11,14,78.6,10,29,39,19,16,22,10,7,73,1
17116,400675,454_14_37,FRANCE,0,TOTALS,FRANCE,200,31,68,45.6,27,54,50.0,4,14,28.6,7,12,58.3,13,35,48,23,15,14,8,2,73,1
17117,400688,454_14_37,POLAND,0,TOTALS,POLAND,200,13,55,23.6,10,27,37.0,3,28,10.7,8,10,80.0,6,24,30,7,15,20,5,5,37,0
17118,400701,454_14_38,GREECE,0,TOTALS,GREECE,200,23,58,39.7,19,39,48.7,4,19,21.1,19,23,82.6,11,23,34,17,23,18,7,4,69,0
17119,400714,454_14_38,SERBIA,0,TOTALS,SERBIA,200,24,59,40.7,18,41,43.9,6,18,33.3,20,23,87.0,12,25,37,11,22,19,8,1,74,1
17120,400727,454_14_39,LATVIA,0,TOTALS,LATVIA,200,27,71,38.0,19,45,42.2,8,26,30.8,10,15,66.7,13,16,29,14,23,19,13,5,72,0
17121,400740,454_14_39,CROATIA,0,TOTALS,CROATIA,200,34,64,53.1,25,43,58.1,9,21,42.9,15,23,65.2,16,32,48,22,23,22,12,6,92,1
17122,400753,454_14_40,SPAIN,0,TOTALS,SPAIN,200,19,62,30.6,13,45,28.9,6,17,35.3,27,33,81.8,12,26,38,9,16,16,4,5,71,0
17123,400766,454_14_40,TURKEY,0,TOTALS,TURKEY,200,36,71,50.7,33,56,58.9,3,15,20.0,9,15,60.0,11,34,45,18,26,13,6,6,84,1
17124,400779,454_14_41,BELGIUM,0,TOTALS,BELGIUM,200,25,60,41.7,17,40,42.5,8,20,40.0,9,18,50.0,8,24,32,10,19,8,7,1,67,1
17125,400792,454_14_41,ENGLAND,0,TOTALS,ENGLAND,200,22,59,37.3,18,49,36.7,4,10,40.0,16,25,64.0,16,32,48,12,19,15,6,4,64,0
17126,400805,454_14_42,CZECH REPUBLIC,0,TOTALS,CZECH REPUBLIC,200,23,56,41.1,20,42,47.6,3,14,21.4,4,9,44.4,11,24,35,9,17,17,0,3,53,0
17127,400818,454_14_42,RUSSIA,0,TOTALS,RUSSIA,200,22,55,40.0,20,40,50.0,2,15,13.3,16,21,76.2,10,22,32,6,13,10,6,2,62,1
17128,400831,454_14_43,CROATIA,0,TOTALS,CROATIA,200,25,64,39.1,18,41,43.9,7,23,30.4,24,32,75.0,16,33,49,20,21,18,9,5,81,1
17129,400844,454_14_43,ITALY,0,TOTALS,ITALY,200,24,73,32.9,19,52,36.5,5,21,23.8,12,19,63.2,19,25,44,5,24,18,8,4,65,0
17130,400857,454_14_44,MONTENEGRO,0,TOTALS,MONTENEGRO,200,19,56,33.9,14,39,35.9,5,17,29.4,14,26,53.8,13,25,38,10,15,15,4,10,57,0
17131,400870,454_14_44,GREECE,0,TOTALS,GREECE,200,29,65,44.6,21,46,45.7,8,19,42.1,6,7,85.7,11,28,39,17,20,12,9,2,72,1
17132,400883,454_14_45,LATVIA,0,TOTALS,LATVIA,200,17,54,31.5,10,27,37.0,7,27,25.9,22,27,81.5,17,33,50,13,18,19,6,3,63,1
17133,400896,454_14_45,FRANCE,0,TOTALS,FRANCE,200,21,62,33.9,15,37,40.5,6,25,24.0,11,20,55.0,14,22,36,12,26,12,11,4,59,0
17134,400909,454_14_46,BOSNIA AND HERZEGOVINA,0,TOTALS,BOSNIA AND HERZEGOVINA,200,23,73,31.5,18,48,37.5,5,25,20.0,16,20,80.0,19,29,48,14,26,10,5,2,67,0
17135,400922,454_14_46,SPAIN,0,TOTALS,SPAIN,200,27,59,45.8,18,32,56.2,9,27,33.3,21,27,77.8,5,32,37,16,18,11,7,4,84,1
17136,400935,454_14_47,LITHUANIA,0,TOTALS,LITHUANIA,200,29,62,46.8,25,42,59.5,4,20,20.0,20,31,64.5,12,29,41,20,15,16,5,3,82,1
17137,400948,454_14_47,POLAND,0,TOTALS,POLAND,200,31,75,41.3,26,59,44.1,5,16,31.2,4,7,57.1,16,26,42,16,29,16,4,1,71,0
17138,400961,454_14_48,SERBIA,0,TOTALS,SERBIA,200,31,65,47.7,25,51,49.0,6,14,42.9,14,18,77.8,14,37,51,19,21,14,5,2,82,1
17139,400974,454_14_48,TURKEY,0,TOTALS,TURKEY,200,21,65,32.3,15,42,35.7,6,23,26.1,14,20,70.0,10,22,32,8,18,12,6,7,62,0
17140,400987,454_14_49,ITALY,0,TOTALS,ITALY,200,22,64,34.4,17,40,42.5,5,24,20.8,19,23,82.6,9,21,30,9,20,10,8,1,68,0
17141,401000,454_14_49,GREECE,0,TOTALS,GREECE,200,33,57,57.9,24,40,60.0,9,17,52.9,10,18,55.6,9,33,42,12,19,18,5,8,85,1
17142,401013,454_14_50,MONTENEGRO,0,TOTALS,MONTENEGRO,200,35,59,59.3,29,45,64.4,6,14,42.9,9,17,52.9,6,29,35,20,15,14,5,7,85,1
17143,401026,454_14_50,ENGLAND,0,TOTALS,ENGLAND,200,25,66,37.9,17,44,38.6,8,22,36.4,9,12,75.0,11,23,34,16,17,16,7,2,67,0
17144,401039,454_14_51,SERBIA,0,TOTALS,SERBIA,200,33,76,43.4,27,55,49.1,6,21,28.6,11,13,84.6,16,25,41,20,14,10,9,2,83,1
17145,401052,454_14_51,LITHUANIA,0,TOTALS,LITHUANIA,200,28,57,49.1,19,41,46.3,9,16,56.2,2,6,33.3,7,27,34,18,15,21,8,3,67,0
17146,401065,454_14_52,POLAND,0,TOTALS,POLAND,200,28,68,41.2,23,51,45.1,5,17,29.4,13,18,72.2,14,23,37,14,20,14,8,3,74,0
17147,401078,454_14_52,RUSSIA,0,TOTALS,RUSSIA,200,30,64,46.9,21,38,55.3,9,26,34.6,16,26,61.5,16,29,45,18,21,15,6,1,85,1
17148,401091,454_14_53,CROATIA,0,TOTALS,CROATIA,200,27,73,37.0,20,47,42.6,7,26,26.9,19,27,70.4,22,40,62,19,23,18,2,7,80,1
17149,401104,454_14_53,SPAIN,0,TOTALS,SPAIN,200,21,70,30.0,20,52,38.5,1,18,5.6,12,19,63.2,12,26,38,9,23,12,8,5,55,0
17150,401117,454_14_54,BOSNIA AND HERZEGOVINA,0,TOTALS,BOSNIA AND HERZEGOVINA,200,31,60,51.7,22,41,53.7,9,19,47.4,16,19,84.2,10,20,30,13,18,12,3,4,87,1
17151,401130,454_14_54,CZECH REPUBLIC,0,TOTALS,CZECH REPUBLIC,200,29,64,45.3,24,45,53.3,5,19,26.3,14,16,87.5,16,18,34,15,16,13,7,6,77,0
17152,401143,454_14_55,TURKEY,0,TOTALS,TURKEY,200,31,71,43.7,24,50,48.0,7,21,33.3,9,16,56.2,20,35,55,15,20,13,10,10,78,1
17153,401156,454_14_55,LATVIA,0,TOTALS,LATVIA,200,20,65,30.8,14,42,33.3,6,23,26.1,7,16,43.8,14,21,35,10,16,14,8,3,53,0
17154,401169,454_14_56,FRANCE,0,TOTALS,FRANCE,200,30,60,50.0,25,42,59.5,5,18,27.8,10,13,76.9,8,30,38,17,12,15,6,3,75,1
17155,401182,454_14_56,BELGIUM,0,TOTALS,BELGIUM,200,24,68,35.3,15,38,39.5,9,30,30.0,3,3,100.0,14,23,37,13,18,16,9,1,60,0
17156,401195,454_14_57,LITHUANIA,0,TOTALS,LITHUANIA,200,21,62,33.9,16,38,42.1,5,24,20.8,10,20,50.0,16,24,40,11,14,20,5,3,57,0
17157,401208,454_14_57,ITALY,0,TOTALS,ITALY,200,31,69,44.9,19,46,41.3,12,23,52.2,6,8,75.0,12,30,42,16,19,16,12,2,80,1
17158,401221,454_14_58,ENGLAND,0,TOTALS,ENGLAND,200,28,55,50.9,21,40,52.5,7,15,46.7,20,30,66.7,13,33,46,18,20,24,6,5,83,1
17159,401234,454_14_58,POLAND,0,TOTALS,POLAND,200,26,61,42.6,20,42,47.6,6,19,31.6,16,24,66.7,5,20,25,21,23,15,11,1,74,0
17160,401247,454_14_59,SPAIN,0,TOTALS,SPAIN,200,26,65,40.0,17,46,37.0,9,19,47.4,22,26,84.6,12,30,42,18,20,12,8,4,83,1
17161,401260,454_14_59,LATVIA,0,TOTALS,LATVIA,200,28,69,40.6,18,37,48.6,10,32,31.2,12,17,70.6,13,29,42,17,29,15,5,5,78,0
17162,401273,454_14_60,BELGIUM,0,TOTALS,BELGIUM,200,25,67,37.3,23,55,41.8,2,12,16.7,9,10,90.0,15,28,43,8,20,19,7,2,61,0
17163,401286,454_14_60,CZECH REPUBLIC,0,TOTALS,CZECH REPUBLIC,200,24,61,39.3,20,43,46.5,4,18,22.2,17,20,85.0,11,26,37,11,14,16,6,7,69,1
17164,401299,454_14_61,MONTENEGRO,0,TOTALS,MONTENEGRO,200,26,66,39.4,23,57,40.4,3,9,33.3,7,13,53.8,17,26,43,11,17,19,7,1,62,0
17165,401312,454_14_61,RUSSIA,0,TOTALS,RUSSIA,200,28,64,43.8,21,39,53.8,7,25,28.0,9,12,75.0,11,27,38,12,16,14,12,2,72,1
17166,401325,454_14_62,SERBIA,0,TOTALS,SERBIA,200,22,64,34.4,19,47,40.4,3,17,17.6,13,20,65.0,17,29,46,10,19,19,10,2,60,1
17167,401338,454_14_62,GREECE,0,TOTALS,GREECE,200,19,60,31.7,18,42,42.9,1,18,5.6,16,23,69.6,11,27,38,13,19,17,7,8,55,0
17168,401351,454_14_63,FRANCE,0,TOTALS,FRANCE,200,26,59,44.1,22,40,55.0,4,19,21.1,12,15,80.0,12,26,38,16,11,17,8,1,68,1
17169,401364,454_14_63,BOSNIA AND HERZEGOVINA,0,TOTALS,BOSNIA AND HERZEGOVINA,200,17,43,39.5,10,25,40.0,7,18,38.9,11,16,68.8,3,20,23,13,19,22,8,1,52,0
17170,401377,454_14_64,CROATIA,0,TOTALS,CROATIA,200,23,64,35.9,18,43,41.9,5,21,23.8,16,20,80.0,15,29,44,13,17,15,6,3,67,0
17171,401390,454_14_64,TURKEY,0,TOTALS,TURKEY,200,28,63,44.4,18,45,40.0,10,18,55.6,8,13,61.5,10,29,39,18,17,10,7,8,74,1
17172,401403,454_14_65,POLAND,0,TOTALS,POLAND,200,30,66,45.5,25,51,49.0,5,15,33.3,14,21,66.7,17,23,40,20,19,18,10,1,79,0
17173,401416,454_14_65,BELGIUM,0,TOTALS,BELGIUM,200,33,65,50.8,29,50,58.0,4,15,26.7,13,19,68.4,11,23,34,17,16,18,11,3,83,1
17174,401429,454_14_66,LATVIA,0,TOTALS,LATVIA,200,23,66,34.8,17,42,40.5,6,24,25.0,4,7,57.1,12,16,28,15,15,18,4,1,56,0
17175,401442,454_14_66,LITHUANIA,0,TOTALS,LITHUANIA,200,36,68,52.9,25,44,56.8,11,24,45.8,7,11,63.6,16,33,49,23,16,20,11,2,90,1
17176,401455,454_14_67,ENGLAND,0,TOTALS,ENGLAND,200,22,62,35.5,18,50,36.0,4,12,33.3,11,18,61.1,11,22,33,13,14,13,9,3,59,0
17177,401468,454_14_67,CZECH REPUBLIC,0,TOTALS,CZECH REPUBLIC,200,29,59,49.2,20,41,48.8,9,18,50.0,6,7,85.7,8,30,38,19,20,16,6,4,73,1
17178,401481,454_14_68,SPAIN,0,TOTALS,SPAIN,200,28,57,49.1,20,40,50.0,8,17,47.1,4,12,33.3,9,37,46,12,18,22,2,4,68,1
17179,401494,454_14_68,ITALY,0,TOTALS,ITALY,200,26,70,37.1,20,49,40.8,6,21,28.6,7,13,53.8,10,25,35,14,17,8,11,0,65,0
17180,401507,454_14_69,MONTENEGRO,0,TOTALS,MONTENEGRO,200,34,64,53.1,26,42,61.9,8,22,36.4,9,12,75.0,12,36,48,22,18,16,4,6,85,1
17181,401520,454_14_69,BOSNIA AND HERZEGOVINA,0,TOTALS,BOSNIA AND HERZEGOVINA,200,22,65,33.8,14,39,35.9,8,26,30.8,12,18,66.7,10,16,26,12,15,8,3,1,64,0
17182,401533,454_14_70,CROATIA,0,TOTALS,CROATIA,200,25,70,35.7,19,48,39.6,6,22,27.3,19,23,82.6,20,32,52,19,23,16,4,5,75,1
17183,401546,454_14_70,GREECE,0,TOTALS,GREECE,200,23,66,34.8,14,38,36.8,9,28,32.1,16,19,84.2,13,26,39,13,20,14,6,7,71,0
17184,401559,454_14_71,RUSSIA,0,TOTALS,RUSSIA,200,18,58,31.0,8,30,26.7,10,28,35.7,6,10,60.0,10,16,26,12,10,15,3,2,52,0
17185,401572,454_14_71,FRANCE,0,TOTALS,FRANCE,200,32,61,52.5,25,47,53.2,7,14,50.0,6,10,60.0,13,32,45,21,13,12,12,3,77,1
17186,401585,454_14_72,TURKEY,0,TOTALS,TURKEY,200,32,69,46.4,22,46,47.8,10,23,43.5,11,19,57.9,18,24,42,21,22,11,6,9,85,1
17187,401598,454_14_72,SERBIA,0,TOTALS,SERBIA,200,21,61,34.4,18,45,40.0,3,16,18.8,23,29,79.3,18,21,39,7,18,16,7,2,68,0
17188,401611,455_14_01,DENMARK,0,TOTALS,DENMARK,200,19,51,37.3,17,36,47.2,2,15,13.3,21,34,61.8,7,32,39,9,22,18,5,4,61,0
17189,401624,455_14_01,IRELAND,0,TOTALS,IRELAND,200,27,66,40.9,22,49,44.9,5,17,29.4,7,16,43.8,10,32,42,15,28,13,7,1,66,1
17190,401637,455_14_02,NORWAY,0,TOTALS,NORWAY,200,22,53,41.5,15,35,42.9,7,18,38.9,13,22,59.1,12,23,35,14,19,32,11,0,64,0
17191,401650,455_14_02,FINLAND,0,TOTALS,FINLAND,200,33,72,45.8,23,37,62.2,10,35,28.6,9,15,60.0,17,22,39,23,24,20,21,1,85,1
17192,401663,455_14_03,PORTUGAL,0,TOTALS,PORTUGAL,200,21,60,35.0,14,41,34.1,7,19,36.8,12,15,80.0,9,23,32,12,22,16,4,2,61,0
17193,401676,455_14_03,UKRAINE,0,TOTALS,UKRAINE,200,27,61,44.3,19,42,45.2,8,19,42.1,20,27,74.1,14,30,44,15,20,14,10,1,82,1
17194,401689,455_14_04,GEORGIA,0,TOTALS,GEORGIA,200,21,62,33.9,15,35,42.9,6,27,22.2,6,11,54.5,5,24,29,11,15,15,11,3,54,0
17195,401700,455_14_04,AUSTRIA,0,TOTALS,AUSTRIA,200,25,57,43.9,21,43,48.8,4,14,28.6,3,8,37.5,9,37,46,12,12,24,8,3,57,1
17196,401713,455_14_05,LUXEMBOURG,0,TOTALS,LUXEMBOURG,200,31,56,55.4,26,43,60.5,5,13,38.5,8,11,72.7,7,25,32,15,20,24,12,1,75,1
17197,401726,455_14_05,NETHERLANDS,0,TOTALS,NETHERLANDS,200,22,55,40.0,17,36,47.2,5,19,26.3,9,15,60.0,9,20,29,11,13,23,9,3,58,0
17198,401739,455_14_06,ICELAND,0,TOTALS,ICELAND,200,30,68,44.1,26,49,53.1,4,19,21.1,8,12,66.7,6,38,44,19,17,13,17,5,72,1
17199,401752,455_14_06,ESTONIA,0,TOTALS,ESTONIA,200,15,69,21.7,9,44,20.5,6,25,24.0,9,14,64.3,17,33,50,8,18,22,9,4,45,0
17200,401765,455_14_07,SCOTLAND,0,TOTALS,SCOTLAND,200,18,62,29.0,13,36,36.1,5,26,19.2,4,10,40.0,10,26,36,9,18,20,8,0,45,0
17201,401778,455_14_07,BULGARIA,0,TOTALS,BULGARIA,200,29,64,45.3,21,40,52.5,8,24,33.3,8,14,57.1,10,36,46,15,17,17,14,5,74,1
17202,401791,455_14_08,SLOVENIA,0,TOTALS,SLOVENIA,200,27,55,49.1,20,32,62.5,7,23,30.4,16,24,66.7,8,28,36,11,21,19,8,4,77,1
17203,401804,455_14_08,MKD,0,TOTALS,MKD,200,16,49,32.7,14,35,40.0,2,14,14.3,15,26,57.7,9,22,31,11,23,19,5,1,49,0
17204,401817,455_14_09,SWEDEN,0,TOTALS,SWEDEN,200,29,67,43.3,26,54,48.1,3,13,23.1,1,5,20.0,17,24,41,10,15,13,11,2,62,1
17205,401830,455_14_09,HUNGARY,0,TOTALS,HUNGARY,200,18,53,34.0,12,40,30.0,6,13,46.2,8,10,80.0,12,22,34,8,13,17,5,3,50,0
17206,401843,455_14_10,ISRAEL,0,TOTALS,ISRAEL,200,21,58,36.2,21,44,47.7,0,14,0.0,3,3,100.0,9,22,31,12,20,18,4,4,45,0
17207,401856,455_14_10,GERMANY,0,TOTALS,GERMANY,200,31,71,43.7,22,45,48.9,9,26,34.6,10,14,71.4,21,28,49,18,12,12,12,2,81,1
17208,401869,455_14_11,IRELAND,0,TOTALS,IRELAND,200,13,61,21.3,11,45,24.4,2,16,12.5,5,10,50.0,14,33,47,6,23,25,10,2,33,0
17209,401882,455_14_11,PORTUGAL,0,TOTALS,PORTUGAL,200,24,68,35.3,22,48,45.8,2,20,10.0,15,25,60.0,17,35,52,15,15,17,13,6,65,1
17210,401895,455_14_12,ESTONIA,0,TOTALS,ESTONIA,200,32,69,46.4,17,35,48.6,15,34,44.1,10,19,52.6,16,32,48,23,17,16,6,5,89,1
17211,401908,455_14_12,GEORGIA,0,TOTALS,GEORGIA,200,27,68,39.7,23,48,47.9,4,20,20.0,1,2,50.0,8,24,32,12,21,16,6,4,59,0
17212,401921,455_14_13,UKRAINE,0,TOTALS,UKRAINE,200,28,70,40.0,25,50,50.0,3,20,15.0,22,35,62.9,22,46,68,22,16,19,9,7,81,1
17213,401934,455_14_13,SCOTLAND,0,TOTALS,SCOTLAND,200,12,63,19.0,11,38,28.9,1,25,4.0,9,14,64.3,7,27,34,5,22,21,8,3,34,0
17214,401947,455_14_14,MKD,0,TOTALS,MKD,200,25,63,39.7,19,44,43.2,6,19,31.6,17,27,63.0,12,28,40,11,30,20,6,5,73,0
17215,401960,455_14_14,NORWAY,0,TOTALS,NORWAY,200,26,68,38.2,22,45,48.9,4,23,17.4,23,30,76.7,17,30,47,12,20,20,11,1,79,1
17216,401973,455_14_15,HUNGARY,0,TOTALS,HUNGARY,200,20,58,34.5,9,25,36.0,11,33,33.3,9,14,64.3,17,24,41,17,12,24,10,4,60,1
17217,401986,455_14_15,LUXEMBOURG,0,TOTALS,LUXEMBOURG,200,22,58,37.9,17,40,42.5,5,18,27.8,8,15,53.3,14,21,35,12,17,17,17,0,57,0
17218,401999,455_14_16,SWITZERLAND,0,TOTALS,SWITZERLAND,200,14,52,26.9,12,35,34.3,2,17,11.8,2,2,100.0,5,19,24,8,21,27,12,2,32,0
17219,402012,455_14_16,SLOVENIA,0,TOTALS,SLOVENIA,200,28,57,49.1,23,43,53.5,5,14,35.7,13,21,61.9,13,32,45,15,12,24,16,3,74,1
17220,402025,455_14_17,BULGARIA,0,TOTALS,BULGARIA,200,23,64,35.9,17,43,39.5,6,21,28.6,5,6,83.3,11,26,37,13,18,19,12,8,57,0
17221,402038,455_14_17,DENMARK,0,TOTALS,DENMARK,200,24,66,36.4,19,44,43.2,5,22,22.7,12,19,63.2,16,29,45,15,12,20,10,7,65,1
17222,402051,455_14_18,GERMANY,0,TOTALS,GERMANY,200,22,57,38.6,13,33,39.4,9,24,37.5,7,12,58.3,9,35,44,13,20,21,7,0,60,1
17223,402064,455_14_18,ICELAND,0,TOTALS,ICELAND,200,21,64,32.8,15,32,46.9,6,32,18.8,10,18,55.6,13,27,40,9,18,17,9,5,58,0
17224,402077,455_14_19,ROMANIA,0,TOTALS,ROMANIA,225,27,59,45.8,24,49,49.0,3,10,30.0,22,32,68.8,12,28,40,12,27,17,9,7,79,1
17225,402090,455_14_19,SWEDEN,0,TOTALS,SWEDEN,225,28,69,40.6,23,50,46.0,5,19,26.3,15,29,51.7,20,22,42,17,28,17,8,2,76,0
17226,402101,455_14_20,AUSTRIA,0,TOTALS,AUSTRIA,200,18,52,34.6,16,41,39.0,2,11,18.2,9,13,69.2,8,34,42,10,15,26,6,3,47,0
17227,402114,455_14_20,ISRAEL,0,TOTALS,ISRAEL,200,27,70,38.6,21,44,47.7,6,26,23.1,9,12,75.0,11,27,38,16,15,12,13,3,69,1
17228,402127,455_14_21,NETHERLANDS,0,TOTALS,NETHERLANDS,200,25,55,45.5,21,41,51.2,4,14,28.6,8,11,72.7,12,24,36,10,19,21,9,1,62,0
17229,402140,455_14_21,HUNGARY,0,TOTALS,HUNGARY,200,24,52,46.2,19,35,54.3,5,17,29.4,13,17,76.5,5,19,24,14,18,16,11,4,66,1
17230,402153,455_14_22,FINLAND,0,TOTALS,FINLAND,200,23,61,37.7,17,28,60.7,6,33,18.2,12,19,63.2,13,31,44,14,27,20,9,2,64,1
17231,402166,455_14_22,MKD,0,TOTALS,MKD,200,19,55,34.5,14,39,35.9,5,16,31.2,13,21,61.9,10,28,38,11,23,20,8,1,56,0
17232,402179,455_14_23,PORTUGAL,0,TOTALS,PORTUGAL,200,23,51,45.1,14,30,46.7,9,21,42.9,10,16,62.5,11,31,42,13,21,25,13,6,65,1
17233,402192,455_14_23,DENMARK,0,TOTALS,DENMARK,200,18,63,28.6,15,49,30.6,3,14,21.4,8,17,47.1,18,20,38,9,17,20,9,1,47,0
17234,402205,455_14_24,NORWAY,0,TOTALS,NORWAY,200,27,56,48.2,19,37,51.4,8,19,42.1,13,19,68.4,10,32,42,18,14,17,5,1,75,1
17235,402218,455_14_24,SWITZERLAND,0,TOTALS,SWITZERLAND,200,22,67,32.8,18,43,41.9,4,24,16.7,14,17,82.4,15,22,37,10,21,14,8,4,62,0
17236,402231,455_14_25,LUXEMBOURG,0,TOTALS,LUXEMBOURG,200,24,73,32.9,17,61,27.9,7,12,58.3,7,10,70.0,15,25,40,4,17,15,15,2,62,1
17237,402244,455_14_25,ROMANIA,0,TOTALS,ROMANIA,200,20,56,35.7,18,44,40.9,2,12,16.7,11,14,78.6,11,33,44,9,17,25,8,13,53,0
17238,402257,455_14_26,GERMANY,0,TOTALS,GERMANY,200,25,57,43.9,19,36,52.8,6,21,28.6,18,27,66.7,13,30,43,16,16,17,10,5,74,1
17239,402270,455_14_26,ESTONIA,0,TOTALS,ESTONIA,200,19,63,30.2,12,35,34.3,7,28,25.0,6,10,60.0,15,23,38,7,23,18,8,4,51,0
17240,402283,455_14_27,UKRAINE,0,TOTALS,UKRAINE,200,23,60,38.3,20,39,51.3,3,21,14.3,18,29,62.1,14,27,41,15,24,18,12,3,67,1
17241,402296,455_14_27,BULGARIA,0,TOTALS,BULGARIA,200,21,55,38.2,15,33,45.5,6,22,27.3,10,15,66.7,7,29,36,14,28,20,9,1,58,0
17242,402309,455_14_28,ISRAEL,0,TOTALS,ISRAEL,200,36,71,50.7,28,50,56.0,8,21,38.1,14,19,73.7,10,31,41,20,21,14,12,1,94,1
17243,402322,455_14_28,GEORGIA,0,TOTALS,GEORGIA,200,27,68,39.7,18,42,42.9,9,26,34.6,10,15,66.7,12,28,40,17,18,19,8,2,73,0
17244,402335,455_14_29,SCOTLAND,0,TOTALS,SCOTLAND,200,25,60,41.7,17,38,44.7,8,22,36.4,12,16,75.0,10,26,36,12,11,14,10,4,70,1
17245,402348,455_14_29,IRELAND,0,TOTALS,IRELAND,200,24,62,38.7,18,43,41.9,6,19,31.6,5,6,83.3,11,26,37,12,21,17,8,7,59,0
17246,402361,455_14_30,ICELAND,0,TOTALS,ICELAND,200,30,65,46.2,24,40,60.0,6,25,24.0,14,19,73.7,10,24,34,18,18,19,16,7,80,1
17247,402372,455_14_30,AUSTRIA,0,TOTALS,AUSTRIA,200,24,63,38.1,19,46,41.3,5,17,29.4,9,14,64.3,17,26,43,13,21,27,11,2,62,0
17248,402385,455_14_31,SWEDEN,0,TOTALS,SWEDEN,200,22,61,36.1,18,45,40.0,4,16,25.0,11,19,57.9,22,34,56,13,19,26,4,1,59,1
17249,402398,455_14_31,LUXEMBOURG,0,TOTALS,LUXEMBOURG,200,16,54,29.6,14,46,30.4,2,8,25.0,13,20,65.0,5,20,25,8,18,17,14,4,47,0
17250,402411,455_14_32,SWITZERLAND,0,TOTALS,SWITZERLAND,200,26,52,50.0,19,37,51.4,7,15,46.7,5,10,50.0,6,22,28,16,22,30,9,0,64,0
17251,402424,455_14_32,FINLAND,0,TOTALS,FINLAND,200,35,67,52.2,29,42,69.0,6,25,24.0,13,19,68.4,13,22,35,23,16,17,14,0,89,1
17252,402437,455_14_33,ROMANIA,0,TOTALS,ROMANIA,200,19,45,42.2,15,31,48.4,4,14,28.6,14,20,70.0,8,22,30,6,34,32,10,3,56,0
17253,402450,455_14_33,NETHERLANDS,0,TOTALS,NETHERLANDS,200,22,53,41.5,17,38,44.7,5,15,33.3,32,46,69.6,14,21,35,13,22,17,16,2,81,1
17254,402463,455_14_34,ESTONIA,0,TOTALS,ESTONIA,225,35,78,44.9,27,48,56.2,8,30,26.7,15,20,75.0,8,26,34,10,30,14,10,5,93,1
17255,402476,455_14_34,ISRAEL,0,TOTALS,ISRAEL,225,38,79,48.1,31,56,55.4,7,23,30.4,24,35,68.6,19,39,58,24,25,18,11,3,107,0
17256,402489,455_14_35,IRELAND,0,TOTALS,IRELAND,200,19,70,27.1,11,50,22.0,8,20,40.0,9,10,90.0,10,28,38,9,23,20,13,2,55,0
17257,402502,455_14_35,UKRAINE,0,TOTALS,UKRAINE,200,31,77,40.3,20,44,45.5,11,33,33.3,14,27,51.9,24,41,65,17,12,18,13,5,87,1
17258,402513,455_14_36,AUSTRIA,0,TOTALS,AUSTRIA,200,19,53,35.8,15,35,42.9,4,18,22.2,8,18,44.4,10,23,33,13,21,24,6,2,50,1
17259,402526,455_14_36,GERMANY,0,TOTALS,GERMANY,200,37,66,56.1,24,41,58.5,13,25,52.0,14,22,63.6,11,31,42,23,20,13,13,1,101,0
17260,402539,455_14_37,BULGARIA,0,TOTALS,BULGARIA,200,19,53,35.8,16,37,43.2,3,16,18.8,10,13,76.9,9,22,31,10,18,17,12,1,51,0
17261,402552,455_14_37,PORTUGAL,0,TOTALS,PORTUGAL,200,20,56,35.7,14,38,36.8,6,18,33.3,10,16,62.5,15,24,39,14,16,22,10,4,56,1
17262,402565,455_14_38,GEORGIA,0,TOTALS,GEORGIA,200,29,66,43.9,17,41,41.5,12,25,48.0,10,15,66.7,14,24,38,16,16,15,7,1,80,0
17263,402578,455_14_38,ICELAND,0,TOTALS,ICELAND,200,31,67,46.3,15,28,53.6,16,39,41.0,8,12,66.7,12,26,38,25,20,14,9,2,86,1
17264,402591,455_14_39,DENMARK,0,TOTALS,DENMARK,200,24,55,43.6,22,40,55.0,2,15,13.3,14,24,58.3,14,24,38,13,18,18,12,1,64,1
17265,402604,455_14_39,SCOTLAND,0,TOTALS,SCOTLAND,200,19,52,36.5,12,31,38.7,7,21,33.3,8,15,53.3,11,23,34,10,23,25,12,3,53,0
17266,402617,455_14_40,SLOVENIA,0,TOTALS,SLOVENIA,200,29,60,48.3,15,32,46.9,14,28,50.0,12,15,80.0,10,34,44,18,22,16,6,7,84,1
17267,402630,455_14_40,NORWAY,0,TOTALS,NORWAY,200,24,64,37.5,13,38,34.2,11,26,42.3,14,16,87.5,6,23,29,11,22,12,8,2,73,0
17268,402643,455_14_41,NETHERLANDS,0,TOTALS,NETHERLANDS,200,15,49,30.6,13,40,32.5,2,9,22.2,9,12,75.0,9,23,32,8,16,22,10,4,41,1
17269,402656,455_14_41,SWEDEN,0,TOTALS,SWEDEN,200,16,58,27.6,12,43,27.9,4,15,26.7,4,11,36.4,19,26,45,9,18,23,10,3,40,0
17270,402669,455_14_42,MKD,0,TOTALS,MKD,200,22,60,36.7,15,35,42.9,7,25,28.0,11,24,45.8,14,34,48,11,18,20,10,1,62,1
17271,402682,455_14_42,SWITZERLAND,0,TOTALS,SWITZERLAND,200,20,63,31.7,17,39,43.6,3,24,12.5,10,15,66.7,11,29,40,10,21,18,10,2,53,0
17272,402695,455_14_43,HUNGARY,0,TOTALS,HUNGARY,200,28,64,43.8,21,44,47.7,7,20,35.0,12,19,63.2,10,20,30,19,18,12,13,0,75,1
17273,402708,455_14_43,ROMANIA,0,TOTALS,ROMANIA,200,20,45,44.4,17,36,47.2,3,9,33.3,10,11,90.9,5,27,32,11,26,25,6,4,53,0
17274,402721,455_14_44,ICELAND,0,TOTALS,ICELAND,225,29,79,36.7,20,44,45.5,9,35,25.7,14,21,66.7,14,32,46,14,23,14,16,3,81,0
17275,402734,455_14_44,ISRAEL,0,TOTALS,ISRAEL,225,29,66,43.9,22,46,47.8,7,20,35.0,17,25,68.0,9,40,49,12,23,20,11,4,82,1
17276,402747,455_14_45,UKRAINE,0,TOTALS,UKRAINE,200,27,70,38.6,23,53,43.4,4,17,23.5,21,23,91.3,18,22,40,16,23,16,14,4,79,1
17277,402760,455_14_45,DENMARK,0,TOTALS,DENMARK,200,26,59,44.1,17,39,43.6,9,20,45.0,16,22,72.7,11,27,38,17,24,23,5,5,77,0
17278,402773,455_14_46,FINLAND,0,TOTALS,FINLAND,200,26,60,43.3,16,36,44.4,10,24,41.7,7,11,63.6,7,25,32,15,17,11,6,2,69,1
17279,402786,455_14_46,SLOVENIA,0,TOTALS,SLOVENIA,200,25,61,41.0,19,42,45.2,6,19,31.6,7,8,87.5,11,28,39,12,22,15,2,5,63,0
17280,402799,455_14_47,IRELAND,0,TOTALS,IRELAND,200,25,63,39.7,19,43,44.2,6,20,30.0,8,15,53.3,11,23,34,11,21,11,7,1,64,0
17281,402812,455_14_47,BULGARIA,0,TOTALS,BULGARIA,200,25,61,41.0,19,38,50.0,6,23,26.1,21,26,80.8,14,30,44,13,19,12,7,3,77,1
17282,402823,455_14_48,AUSTRIA,0,TOTALS,AUSTRIA,200,27,52,51.9,22,42,52.4,5,10,50.0,13,25,52.0,16,29,45,12,29,20,5,4,72,1
17283,402836,455_14_48,ESTONIA,0,TOTALS,ESTONIA,200,17,53,32.1,11,30,36.7,6,23,26.1,15,27,55.6,12,16,28,8,28,14,8,2,55,0
17284,402849,455_14_49,SCOTLAND,0,TOTALS,SCOTLAND,200,22,53,41.5,17,40,42.5,5,13,38.5,10,20,50.0,5,20,25,10,18,15,4,1,59,0
17285,402862,455_14_49,PORTUGAL,0,TOTALS,PORTUGAL,200,33,67,49.3,27,43,62.8,6,24,25.0,9,13,69.2,15,31,46,19,16,13,6,4,81,1
17286,402875,455_14_50,GERMANY,0,TOTALS,GERMANY,200,23,66,34.8,16,37,43.2,7,29,24.1,17,32,53.1,16,32,48,19,18,14,5,5,70,1
17287,402888,455_14_50,GEORGIA,0,TOTALS,GEORGIA,200,25,64,39.1,13,35,37.1,12,29,41.4,4,9,44.4,9,33,42,17,25,19,12,0,66,0
17288,402901,455_14_51,DENMARK,0,TOTALS,DENMARK,200,18,51,35.3,15,36,41.7,3,15,20.0,18,22,81.8,9,27,36,4,21,17,9,3,57,1
17289,402914,455_14_51,NETHERLANDS,0,TOTALS,NETHERLANDS,200,21,60,35.0,18,45,40.0,3,15,20.0,8,20,40.0,18,26,44,8,24,18,7,2,53,0
17290,402927,455_14_52,GEORGIA,0,TOTALS,GEORGIA,200,32,83,38.6,21,52,40.4,11,31,35.5,14,19,73.7,19,33,52,17,16,14,21,1,89,1
17291,402940,455_14_52,SWITZERLAND,0,TOTALS,SWITZERLAND,200,23,65,35.4,20,46,43.5,3,19,15.8,14,19,73.7,12,33,45,18,17,24,9,5,63,0
17292,402953,455_14_53,SLOVENIA,0,TOTALS,SLOVENIA,225,23,52,44.2,17,36,47.2,6,16,37.5,15,22,68.2,2,25,27,8,21,18,7,2,67,0
17293,402966,455_14_53,GERMANY,0,TOTALS,GERMANY,225,27,73,37.0,20,45,44.4,7,28,25.0,9,13,69.2,21,30,51,10,23,18,4,2,70,1
17294,402979,455_14_54,IRELAND,0,TOTALS,IRELAND,200,24,64,37.5,22,53,41.5,2,11,18.2,8,13,61.5,11,30,41,10,13,21,8,3,58,0
17295,402992,455_14_54,ROMANIA,0,TOTALS,ROMANIA,200,27,70,38.6,26,53,49.1,1,17,5.9,10,17,58.8,18,30,48,17,17,17,11,9,65,1
17296,403005,455_14_55,FINLAND,0,TOTALS,FINLAND,200,30,65,46.2,20,37,54.1,10,28,35.7,7,16,43.8,14,28,42,20,15,15,3,0,77,1
17297,403018,455_14_55,ISRAEL,0,TOTALS,ISRAEL,200,31,66,47.0,29,53,54.7,2,13,15.4,10,11,90.9,9,23,32,15,21,11,9,2,74,0
17298,403031,455_14_56,BULGARIA,0,TOTALS,BULGARIA,200,20,63,31.7,14,41,34.1,6,22,27.3,9,15,60.0,14,31,45,13,18,14,9,3,55,1
17299,403044,455_14_56,LUXEMBOURG,0,TOTALS,LUXEMBOURG,200,17,57,29.8,13,35,37.1,4,22,18.2,8,18,44.4,14,30,44,9,18,20,7,3,46,0
17300,403057,455_14_57,UKRAINE,0,TOTALS,UKRAINE,200,22,69,31.9,15,38,39.5,7,31,22.6,10,27,37.0,21,25,46,12,23,10,7,3,61,1
17301,403070,455_14_57,SWEDEN,0,TOTALS,SWEDEN,200,18,60,30.0,16,43,37.2,2,17,11.8,15,21,71.4,18,36,54,7,24,18,5,3,53,0
17302,403083,455_14_58,NORWAY,0,TOTALS,NORWAY,200,22,59,37.3,16,40,40.0,6,19,31.6,14,19,73.7,7,31,38,13,22,13,4,2,64,0
17303,403094,455_14_58,AUSTRIA,0,TOTALS,AUSTRIA,200,25,64,39.1,19,46,41.3,6,18,33.3,11,17,64.7,11,31,42,16,21,14,5,2,67,1
17304,403107,455_14_59,PORTUGAL,0,TOTALS,PORTUGAL,200,24,64,37.5,21,50,42.0,3,14,21.4,8,12,66.7,17,29,46,11,14,15,8,4,59,1
17305,403120,455_14_59,HUNGARY,0,TOTALS,HUNGARY,200,19,59,32.2,11,40,27.5,8,19,42.1,6,12,50.0,12,25,37,14,16,18,8,5,52,0
17306,403133,455_14_60,MKD,0,TOTALS,MKD,200,19,47,40.4,14,32,43.8,5,15,33.3,10,19,52.6,6,28,34,8,18,26,5,3,53,0
17307,403146,455_14_60,ICELAND,0,TOTALS,ICELAND,200,32,76,42.1,23,40,57.5,9,36,25.0,11,17,64.7,18,25,43,26,22,8,16,3,84,1
17308,403159,455_14_61,LUXEMBOURG,0,TOTALS,LUXEMBOURG,200,15,56,26.8,13,44,29.5,2,12,16.7,12,23,52.2,9,20,29,8,15,17,10,3,44,0
17309,403172,455_14_61,DENMARK,0,TOTALS,DENMARK,200,33,64,51.6,27,51,52.9,6,13,46.2,7,10,70.0,13,33,46,19,15,16,12,3,79,1
17310,403185,455_14_62,SWITZERLAND,0,TOTALS,SWITZERLAND,200,28,62,45.2,24,46,52.2,4,16,25.0,5,15,33.3,11,33,44,12,21,22,9,5,65,0
17311,403198,455_14_62,ESTONIA,0,TOTALS,ESTONIA,200,26,71,36.6,22,48,45.8,4,23,17.4,13,20,65.0,14,30,44,12,19,16,12,5,69,1
17312,403211,455_14_63,ISRAEL,0,TOTALS,ISRAEL,200,29,68,42.6,25,48,52.1,4,20,20.0,14,15,93.3,10,28,38,18,19,7,8,3,76,1
17313,403224,455_14_63,SLOVENIA,0,TOTALS,SLOVENIA,200,23,58,39.7,17,40,42.5,6,18,33.3,13,19,68.4,9,29,38,9,20,12,3,6,65,0
17314,403237,455_14_64,ROMANIA,0,TOTALS,ROMANIA,200,27,60,45.0,22,46,47.8,5,14,35.7,11,18,61.1,11,39,50,22,23,25,10,9,70,1
17315,403250,455_14_64,SCOTLAND,0,TOTALS,SCOTLAND,200,21,61,34.4,14,43,32.6,7,18,38.9,11,17,64.7,4,25,29,12,15,19,14,1,60,0
17316,403263,455_14_65,GERMANY,0,TOTALS,GERMANY,200,23,62,37.1,19,43,44.2,4,19,21.1,11,15,73.3,15,31,46,12,26,21,8,2,61,1
17317,403276,455_14_65,FINLAND,0,TOTALS,FINLAND,200,16,49,32.7,13,32,40.6,3,17,17.6,16,26,61.5,7,22,29,11,19,21,11,3,51,0
17318,403287,455_14_66,AUSTRIA,0,TOTALS,AUSTRIA,200,17,57,29.8,14,38,36.8,3,19,15.8,15,22,68.2,11,24,35,11,19,21,9,4,52,0
17319,403300,455_14_66,MKD,0,TOTALS,MKD,200,21,54,38.9,18,40,45.0,3,14,21.4,15,21,71.4,8,31,39,9,19,22,11,4,60,1
17320,403313,455_14_67,HUNGARY,0,TOTALS,HUNGARY,200,24,60,40.0,16,36,44.4,8,24,33.3,14,18,77.8,9,22,31,20,19,14,9,4,70,1
17321,403326,455_14_67,UKRAINE,0,TOTALS,UKRAINE,200,26,55,47.3,20,42,47.6,6,13,46.2,6,16,37.5,12,29,41,11,20,24,7,0,64,0
17322,403339,455_14_68,ICELAND,0,TOTALS,ICELAND,200,30,65,46.2,18,39,46.2,12,26,46.2,5,12,41.7,14,33,47,20,16,17,6,5,77,1
17323,403352,455_14_68,NORWAY,0,TOTALS,NORWAY,200,21,67,31.3,9,37,24.3,12,30,40.0,9,17,52.9,16,24,40,14,15,16,6,3,63,0
17324,403365,455_14_69,SWEDEN,0,TOTALS,SWEDEN,200,21,55,38.2,20,48,41.7,1,7,14.3,10,19,52.6,11,33,44,7,15,14,5,1,53,1
17325,403378,455_14_69,PORTUGAL,0,TOTALS,PORTUGAL,200,20,67,29.9,17,47,36.2,3,20,15.0,2,4,50.0,14,25,39,11,21,14,8,3,45,0
17326,403391,455_14_70,NETHERLANDS,0,TOTALS,NETHERLANDS,200,27,77,35.1,21,49,42.9,6,28,21.4,16,26,61.5,24,23,47,12,18,9,7,3,76,1
17327,403404,455_14_70,BULGARIA,0,TOTALS,BULGARIA,200,23,53,43.4,20,38,52.6,3,15,20.0,12,18,66.7,8,29,37,7,23,18,6,7,61,0
17328,403417,455_14_71,IRELAND,0,TOTALS,IRELAND,200,23,61,37.7,21,46,45.7,2,15,13.3,15,19,78.9,9,37,46,14,9,20,10,5,63,0
17329,403430,455_14_71,SWITZERLAND,0,TOTALS,SWITZERLAND,200,27,76,35.5,19,44,43.2,8,32,25.0,2,8,25.0,13,31,44,16,15,17,10,2,64,1
17330,403443,455_14_72,SCOTLAND,0,TOTALS,SCOTLAND,200,23,53,43.4,17,39,43.6,6,14,42.9,20,28,71.4,7,38,45,18,18,20,5,0,72,1
17331,403456,455_14_72,GEORGIA,0,TOTALS,GEORGIA,200,25,73,34.2,23,50,46.0,2,23,8.7,12,17,70.6,12,26,38,12,23,12,13,2,64,0
17332,403469,455_14_73,NETHERLANDS,0,TOTALS,NETHERLANDS,200,23,61,37.7,19,50,38.0,4,11,36.4,13,18,72.2,12,32,44,9,16,17,8,2,63,1
17333,403480,455_14_73,AUSTRIA,0,TOTALS,AUSTRIA,200,19,52,36.5,17,42,40.5,2,10,20.0,2,12,16.7,6,26,32,9,18,20,4,4,42,0
17334,403493,455_14_74,ISRAEL,0,TOTALS,ISRAEL,200,34,67,50.7,26,47,55.3,8,20,40.0,16,18,88.9,7,27,34,23,15,9,6,1,92,1
17335,403506,455_14_74,HUNGARY,0,TOTALS,HUNGARY,200,32,68,47.1,27,41,65.9,5,27,18.5,12,15,80.0,10,26,36,23,14,12,7,0,81,0
17336,403519,455_14_75,MKD,0,TOTALS,MKD,200,21,51,41.2,16,31,51.6,5,20,25.0,5,11,45.5,7,34,41,11,20,22,10,3,52,0
17337,403532,455_14_75,BULGARIA,0,TOTALS,BULGARIA,200,20,59,33.9,15,38,39.5,5,21,23.8,12,21,57.1,8,26,34,8,16,16,13,1,57,1
17338,403545,455_14_76,PORTUGAL,0,TOTALS,PORTUGAL,200,18,53,34.0,16,35,45.7,2,18,11.1,12,20,60.0,12,18,30,15,16,23,2,5,50,0
17339,403558,455_14_76,SLOVENIA,0,TOTALS,SLOVENIA,200,33,63,52.4,28,48,58.3,5,15,33.3,15,21,71.4,12,28,40,17,18,12,13,3,86,1
17340,403571,455_14_77,DENMARK,0,TOTALS,DENMARK,200,26,68,38.2,24,52,46.2,2,16,12.5,10,15,66.7,17,25,42,10,19,11,4,2,64,0
17341,403584,455_14_77,NORWAY,0,TOTALS,NORWAY,200,23,62,37.1,14,33,42.4,9,29,31.0,13,23,56.5,18,26,44,8,15,11,7,2,68,1
17342,403597,455_14_78,UKRAINE,0,TOTALS,UKRAINE,200,25,67,37.3,18,46,39.1,7,21,33.3,8,15,53.3,13,24,37,12,19,15,13,1,65,1
17343,403610,455_14_78,FINLAND,0,TOTALS,FINLAND,200,23,55,41.8,16,32,50.0,7,23,30.4,11,15,73.3,9,30,39,14,19,22,5,1,64,0
17344,403623,455_14_79,ICELAND,0,TOTALS,ICELAND,200,22,75,29.3,17,46,37.0,5,29,17.2,19,22,86.4,21,31,52,10,16,14,11,3,68,1
17345,403636,455_14_79,LUXEMBOURG,0,TOTALS,LUXEMBOURG,200,25,68,36.8,23,50,46.0,2,18,11.1,7,16,43.8,14,32,46,11,20,20,9,8,59,0
17346,403649,455_14_80,GERMANY,0,TOTALS,GERMANY,200,23,61,37.7,19,42,45.2,4,19,21.1,14,20,70.0,14,29,43,9,17,14,11,4,64,1
17347,403662,455_14_80,SWEDEN,0,TOTALS,SWEDEN,200,20,64,31.2,11,39,28.2,9,25,36.0,10,13,76.9,16,25,41,9,18,17,4,1,59,0
17348,403675,455_14_81,ROMANIA,0,TOTALS,ROMANIA,200,26,61,42.6,18,41,43.9,8,20,40.0,12,24,50.0,11,25,36,16,22,19,7,2,72,0
17349,403688,455_14_81,ESTONIA,0,TOTALS,ESTONIA,200,33,73,45.2,27,54,50.0,6,19,31.6,17,21,81.0,15,30,45,18,21,11,10,5,89,1
17350,403699,455_14_82,AUSTRIA,0,TOTALS,AUSTRIA,200,28,58,48.3,21,42,50.0,7,16,43.8,8,14,57.1,9,18,27,15,20,16,9,1,71,0
17351,403712,455_14_82,MKD,0,TOTALS,MKD,200,29,53,54.7,24,40,60.0,5,13,38.5,11,19,57.9,10,25,35,11,19,18,5,2,74,1
17352,403725,455_14_83,NETHERLANDS,0,TOTALS,NETHERLANDS,200,30,61,49.2,21,38,55.3,9,23,39.1,2,4,50.0,11,33,44,16,21,24,11,3,71,1
17353,403738,455_14_83,BULGARIA,0,TOTALS,BULGARIA,200,11,50,22.0,9,31,29.0,2,19,10.5,13,20,65.0,9,21,30,6,10,26,10,2,37,0
17354,403751,455_14_84,PORTUGAL,0,TOTALS,PORTUGAL,200,27,60,45.0,23,44,52.3,4,16,25.0,10,18,55.6,6,29,35,16,18,12,16,3,68,1
17355,403764,455_14_84,HUNGARY,0,TOTALS,HUNGARY,200,23,57,40.4,17,36,47.2,6,21,28.6,12,25,48.0,11,29,40,16,20,19,9,0,64,0
17356,403777,455_14_85,DENMARK,0,TOTALS,DENMARK,200,24,60,40.0,16,33,48.5,8,27,29.6,8,13,61.5,14,26,40,13,20,17,4,3,64,0
17357,403790,455_14_85,LUXEMBOURG,0,TOTALS,LUXEMBOURG,200,27,59,45.8,24,47,51.1,3,12,25.0,10,23,43.5,13,24,37,6,16,10,11,1,67,1
17358,403803,455_14_86,SLOVENIA,0,TOTALS,SLOVENIA,200,27,63,42.9,23,48,47.9,4,15,26.7,20,26,76.9,12,33,45,17,19,13,4,5,78,1
17359,403816,455_14_86,ISRAEL,0,TOTALS,ISRAEL,200,20,67,29.9,16,45,35.6,4,22,18.2,19,20,95.0,13,26,39,13,23,14,4,5,63,0
17360,403829,455_14_87,NORWAY,0,TOTALS,NORWAY,200,13,58,22.4,9,26,34.6,4,32,12.5,7,12,58.3,11,33,44,7,10,25,3,1,37,0
17361,403842,455_14_87,ICELAND,0,TOTALS,ICELAND,200,36,91,39.6,26,51,51.0,10,40,25.0,1,6,16.7,21,37,58,26,15,8,18,5,83,1
17362,403855,455_14_88,FINLAND,0,TOTALS,FINLAND,200,26,59,44.1,18,34,52.9,8,25,32.0,10,12,83.3,11,26,37,11,22,11,7,1,70,1
17363,403868,455_14_88,SWEDEN,0,TOTALS,SWEDEN,200,20,57,35.1,18,43,41.9,2,14,14.3,8,18,44.4,15,22,37,5,21,14,5,1,50,0
17364,403881,455_14_89,UKRAINE,0,TOTALS,UKRAINE,200,16,61,26.2,15,39,38.5,1,22,4.5,7,11,63.6,10,24,34,5,17,17,9,1,40,0
17365,403894,455_14_89,GERMANY,0,TOTALS,GERMANY,200,25,63,39.7,19,39,48.7,6,24,25.0,8,12,66.7,15,35,50,13,20,18,9,7,64,1
17366,403907,456_14_01,WALES,0,TOTALS,WALES,200,19,61,31.1,16,43,37.2,3,18,16.7,14,27,51.9,14,30,44,6,19,25,16,0,55,0
17367,403920,456_14_01,GIBRALTAR,0,TOTALS,GIBRALTAR,200,26,64,40.6,25,55,45.5,1,9,11.1,15,22,68.2,13,33,46,7,21,24,11,5,68,1
17368,403933,456_14_02,MALTA,0,TOTALS,MALTA,200,16,74,21.6,11,42,26.2,5,32,15.6,12,16,75.0,17,35,52,5,23,24,12,1,49,0
17369,403946,456_14_02,PRINCIPALITY OF MONACO,0,TOTALS,PRINCIPALITY OF MONACO,200,23,67,34.3,23,49,46.9,0,18,0.0,11,20,55.0,10,43,53,12,21,26,17,1,57,1
17370,403959,456_14_03,PRINCIPALITY OF MONACO,0,TOTALS,PRINCIPALITY OF MONACO,200,17,49,34.7,15,36,41.7,2,13,15.4,9,21,42.9,12,26,38,7,17,23,11,1,45,0
17371,403972,456_14_03,SAN MARINO,0,TOTALS,SAN MARINO,200,18,60,30.0,16,38,42.1,2,22,9.1,8,15,53.3,18,25,43,7,21,21,14,1,46,1
17372,403985,456_14_04,GIBRALTAR,0,TOTALS,GIBRALTAR,200,15,46,32.6,12,33,36.4,3,13,23.1,10,23,43.5,10,33,43,5,14,29,4,1,43,0
17373,403998,456_14_04,ANDORRA,0,TOTALS,ANDORRA,200,25,75,33.3,19,40,47.5,6,35,17.1,5,10,50.0,22,24,46,11,20,15,19,0,61,1
17374,404011,456_14_05,SAN MARINO,0,TOTALS,SAN MARINO,200,25,66,37.9,18,45,40.0,7,21,33.3,19,36,52.8,19,23,42,9,18,18,15,2,76,1
17375,404024,456_14_05,MALTA,0,TOTALS,MALTA,200,29,65,44.6,24,45,53.3,5,20,25.0,6,14,42.9,17,29,46,9,30,28,10,2,69,0
17376,404037,456_14_06,ANDORRA,0,TOTALS,ANDORRA,200,23,75,30.7,16,47,34.0,7,28,25.0,18,28,64.3,18,40,58,13,20,20,14,5,71,1
17377,404050,456_14_06,WALES,0,TOTALS,WALES,200,21,75,28.0,20,65,30.8,1,10,10.0,10,16,62.5,17,36,53,9,22,27,13,3,53,0
17378,404063,456_14_07,PRINCIPALITY OF MONACO,0,TOTALS,PRINCIPALITY OF MONACO,200,31,72,43.1,26,47,55.3,5,25,20.0,5,11,45.5,7,46,53,11,15,16,7,5,72,1
17379,404076,456_14_07,WALES,0,TOTALS,WALES,200,18,71,25.4,15,48,31.2,3,23,13.0,2,6,33.3,10,36,46,8,15,21,8,2,41,0
17380,404089,456_14_08,GIBRALTAR,0,TOTALS,GIBRALTAR,200,24,65,36.9,18,49,36.7,6,16,37.5,12,30,40.0,22,38,60,14,18,32,13,4,66,1
17381,404102,456_14_08,MALTA,0,TOTALS,MALTA,200,21,70,30.0,19,54,35.2,2,16,12.5,7,21,33.3,16,27,43,8,22,30,23,6,51,0
17382,404115,456_14_09,ANDORRA,0,TOTALS,ANDORRA,200,18,64,28.1,14,40,35.0,4,24,16.7,11,19,57.9,13,31,44,8,24,25,8,1,51,0
17383,404128,456_14_09,PRINCIPALITY OF MONACO,0,TOTALS,PRINCIPALITY OF MONACO,200,26,63,41.3,21,47,44.7,5,16,31.2,13,24,54.2,10,36,46,12,19,20,14,4,70,1
17384,404141,456_14_10,SAN MARINO,0,TOTALS,SAN MARINO,200,15,63,23.8,10,46,21.7,5,17,29.4,8,15,53.3,16,30,46,7,18,21,8,3,43,0
17385,404154,456_14_10,GIBRALTAR,0,TOTALS,GIBRALTAR,200,23,62,37.1,18,47,38.3,5,15,33.3,18,27,66.7,11,35,46,10,14,15,8,2,69,1
17386,404167,456_14_11,MALTA,0,TOTALS,MALTA,200,22,69,31.9,17,49,34.7,5,20,25.0,14,33,42.4,14,44,58,9,29,29,10,3,63,1
17387,404180,456_14_11,WALES,0,TOTALS,WALES,200,18,78,23.1,14,56,25.0,4,22,18.2,18,33,54.5,24,42,66,9,27,27,19,0,58,0
17388,404193,456_14_12,ANDORRA,0,TOTALS,ANDORRA,200,19,56,33.9,18,40,45.0,1,16,6.2,12,22,54.5,9,35,44,9,18,19,10,4,51,1
17389,404206,456_14_12,SAN MARINO,0,TOTALS,SAN MARINO,200,18,60,30.0,15,40,37.5,3,20,15.0,7,14,50.0,11,29,40,7,21,19,14,2,46,0
17390,404219,456_14_13,PRINCIPALITY OF MONACO,0,TOTALS,PRINCIPALITY OF MONACO,200,27,73,37.0,20,42,47.6,7,31,22.6,5,9,55.6,14,36,50,9,20,14,18,2,66,1
17391,404232,456_14_13,GIBRALTAR,0,TOTALS,GIBRALTAR,200,12,56,21.4,10,43,23.3,2,13,15.4,12,27,44.4,16,32,48,5,11,24,7,7,38,0
17392,408044,460_14_01,SERBIA,0,TOTALS,SERBIA,200,33,68,48.5,28,48,58.3,5,20,25.0,8,14,57.1,13,23,36,21,12,15,18,8,79,1
17393,408057,460_14_01,FINLAND,0,TOTALS,FINLAND,200,23,56,41.1,19,37,51.4,4,19,21.1,5,8,62.5,12,22,34,10,17,30,9,1,55,0
17394,408070,460_14_02,GERMANY,0,TOTALS,GERMANY,200,28,69,40.6,22,49,44.9,6,20,30.0,10,17,58.8,15,28,43,16,19,19,18,5,72,1
17395,408083,460_14_02,POLAND,0,TOTALS,POLAND,200,22,61,36.1,15,37,40.5,7,24,29.2,9,11,81.8,10,30,40,12,15,26,8,4,60,0
17396,408096,460_14_03,CROATIA,0,TOTALS,CROATIA,200,25,79,31.6,20,56,35.7,5,23,21.7,9,17,52.9,26,27,53,12,22,28,11,3,64,0
17397,408109,460_14_03,BOSNIA AND HERZEGOVINA,0,TOTALS,BOSNIA AND HERZEGOVINA,200,25,58,43.1,21,43,48.8,4,15,26.7,11,18,61.1,7,30,37,16,18,22,10,4,65,1
17398,408122,460_14_04,FRANCE,0,TOTALS,FRANCE,200,34,71,47.9,27,50,54.0,7,21,33.3,12,16,75.0,13,29,42,15,14,14,20,6,87,1
17399,408135,460_14_04,DENMARK,0,TOTALS,DENMARK,200,11,53,20.8,7,34,20.6,4,19,21.1,7,11,63.6,14,24,38,6,12,36,8,4,33,0
17400,408148,460_14_05,GREECE,0,TOTALS,GREECE,200,29,67,43.3,24,47,51.1,5,20,25.0,4,8,50.0,11,22,33,17,27,14,6,2,67,0
17401,408161,460_14_05,LATVIA,0,TOTALS,LATVIA,200,22,61,36.1,14,35,40.0,8,26,30.8,22,32,68.8,22,28,50,9,18,16,7,4,74,1
17402,408174,460_14_06,ITALY,0,TOTALS,ITALY,200,25,68,36.8,19,53,35.8,6,15,40.0,10,16,62.5,14,25,39,14,20,15,12,0,66,1
17403,408187,460_14_06,RUSSIA,0,TOTALS,RUSSIA,200,15,48,31.2,14,33,42.4,1,15,6.7,10,15,66.7,9,31,40,4,15,28,8,1,41,0
17404,408200,460_14_07,TURKEY,0,TOTALS,TURKEY,200,33,79,41.8,25,56,44.6,8,23,34.8,2,6,33.3,16,25,41,21,22,11,13,3,76,1
17405,408213,460_14_07,LITHUANIA,0,TOTALS,LITHUANIA,200,21,60,35.0,15,35,42.9,6,25,24.0,20,27,74.1,14,33,47,11,16,19,2,3,68,0
17406,408226,460_14_08,SPAIN,0,TOTALS,SPAIN,200,30,77,39.0,26,54,48.1,4,23,17.4,17,30,56.7,22,27,49,14,19,16,15,3,81,1
17407,408239,460_14_08,UKRAINE,0,TOTALS,UKRAINE,200,18,56,32.1,17,48,35.4,1,8,12.5,9,18,50.0,14,33,47,8,21,28,9,1,46,0
17408,408252,460_14_09,BOSNIA AND HERZEGOVINA,0,TOTALS,BOSNIA AND HERZEGOVINA,200,22,58,37.9,22,45,48.9,0,13,0.0,12,19,63.2,14,27,41,8,8,16,8,2,56,1
17409,408265,460_14_09,GREECE,0,TOTALS,GREECE,200,22,70,31.4,17,49,34.7,5,21,23.8,2,4,50.0,21,24,45,10,21,17,10,3,51,0
17410,408278,460_14_10,DENMARK,0,TOTALS,DENMARK,200,17,60,28.3,12,35,34.3,5,25,20.0,9,16,56.2,12,19,31,5,21,21,11,3,48,0
17411,408291,460_14_10,GERMANY,0,TOTALS,GERMANY,200,32,82,39.0,25,64,39.1,7,18,38.9,16,26,61.5,34,32,66,20,18,18,14,3,87,1
17412,408304,460_14_11,FINLAND,0,TOTALS,FINLAND,200,21,59,35.6,14,32,43.8,7,27,25.9,12,20,60.0,10,26,36,12,17,26,11,3,61,0
17413,408317,460_14_11,TURKEY,0,TOTALS,TURKEY,200,31,68,45.6,27,50,54.0,4,18,22.2,8,12,66.7,13,32,45,16,22,23,15,6,74,1
17414,408330,460_14_12,POLAND,0,TOTALS,POLAND,200,14,54,25.9,9,38,23.7,5,16,31.2,8,14,57.1,8,20,28,4,23,18,5,1,41,0
17415,408343,460_14_12,FRANCE,0,TOTALS,FRANCE,200,30,71,42.3,22,48,45.8,8,23,34.8,11,18,61.1,22,31,53,16,18,18,9,3,79,1
17416,408356,460_14_13,LATVIA,0,TOTALS,LATVIA,200,31,71,43.7,21,39,53.8,10,32,31.2,12,16,75.0,15,27,42,12,20,12,11,3,84,1
17417,408369,460_14_13,CROATIA,0,TOTALS,CROATIA,200,20,55,36.4,13,31,41.9,7,24,29.2,15,24,62.5,11,26,37,14,19,22,6,2,62,0
17418,408382,460_14_14,UKRAINE,0,TOTALS,UKRAINE,200,10,51,19.6,8,43,18.6,2,8,25.0,5,14,35.7,11,26,37,3,17,27,5,1,27,0
17419,408395,460_14_14,ITALY,0,TOTALS,ITALY,200,33,78,42.3,24,56,42.9,9,22,40.9,10,17,58.8,21,32,53,18,18,9,17,4,85,1
17420,408408,460_14_15,LITHUANIA,0,TOTALS,LITHUANIA,200,26,69,37.7,21,50,42.0,5,19,26.3,16,23,69.6,25,20,45,17,22,22,7,7,73,0
17421,408421,460_14_15,SERBIA,0,TOTALS,SERBIA,200,35,70,50.0,26,50,52.0,9,20,45.0,19,23,82.6,15,20,35,21,20,14,13,2,98,1
17422,408434,460_14_16,RUSSIA,0,TOTALS,RUSSIA,200,28,57,49.1,21,38,55.3,7,19,36.8,13,21,61.9,13,36,49,11,21,29,8,3,76,1
17423,408447,460_14_16,SPAIN,0,TOTALS,SPAIN,200,22,78,28.2,19,51,37.3,3,27,11.1,20,28,71.4,21,20,41,10,22,15,19,2,67,0
17424,408460,460_14_17,GREECE,0,TOTALS,GREECE,200,21,67,31.3,18,50,36.0,3,17,17.6,6,13,46.2,18,30,48,11,19,18,10,4,51,0
17425,408473,460_14_17,CROATIA,0,TOTALS,CROATIA,200,19,63,30.2,13,41,31.7,6,22,27.3,12,17,70.6,16,30,46,14,14,18,11,2,56,1
17426,408486,460_14_18,DENMARK,0,TOTALS,DENMARK,200,21,64,32.8,19,48,39.6,2,16,12.5,14,21,66.7,20,25,45,5,21,30,12,3,58,0
17427,408499,460_14_18,POLAND,0,TOTALS,POLAND,200,24,63,38.1,18,44,40.9,6,19,31.6,14,17,82.4,13,26,39,10,24,24,23,7,68,1
17428,408512,460_14_19,FINLAND,0,TOTALS,FINLAND,200,20,59,33.9,16,43,37.2,4,16,25.0,14,20,70.0,9,32,41,13,23,28,13,0,58,0
17429,408525,460_14_19,LITHUANIA,0,TOTALS,LITHUANIA,200,28,87,32.2,22,71,31.0,6,16,37.5,21,29,72.4,32,31,63,12,22,20,13,2,83,1
17430,408538,460_14_20,ITALY,0,TOTALS,ITALY,200,27,63,42.9,20,43,46.5,7,20,35.0,10,18,55.6,13,27,40,12,23,17,10,1,71,1
17431,408551,460_14_20,SPAIN,0,TOTALS,SPAIN,200,19,60,31.7,17,45,37.8,2,15,13.3,13,23,56.5,14,25,39,4,20,15,10,0,53,0
17432,408564,460_14_21,BOSNIA AND HERZEGOVINA,0,TOTALS,BOSNIA AND HERZEGOVINA,200,24,68,35.3,23,54,42.6,1,14,7.1,6,13,46.2,15,26,41,10,20,18,9,3,55,0
17433,408577,460_14_21,LATVIA,0,TOTALS,LATVIA,200,24,71,33.8,18,44,40.9,6,27,22.2,9,14,64.3,18,30,48,18,18,17,9,3,63,1
17434,408590,460_14_22,GERMANY,0,TOTALS,GERMANY,200,25,52,48.1,21,39,53.8,4,13,30.8,5,18,27.8,6,28,34,11,19,16,5,5,59,0
17435,408603,460_14_22,FRANCE,0,TOTALS,FRANCE,200,28,70,40.0,24,54,44.4,4,16,25.0,10,14,71.4,15,27,42,13,19,8,9,2,70,1
17436,408616,460_14_23,TURKEY,0,TOTALS,TURKEY,200,25,70,35.7,20,47,42.6,5,23,21.7,8,15,53.3,18,20,38,7,24,20,10,3,63,0
17437,408629,460_14_23,SERBIA,0,TOTALS,SERBIA,200,20,49,40.8,14,31,45.2,6,18,33.3,21,29,72.4,11,27,38,10,18,23,10,3,67,1
17438,408642,460_14_24,UKRAINE,0,TOTALS,UKRAINE,200,25,64,39.1,21,50,42.0,4,14,28.6,14,23,60.9,17,34,51,9,22,16,5,0,68,1
17439,408655,460_14_24,RUSSIA,0,TOTALS,RUSSIA,200,20,61,32.8,15,34,44.1,5,27,18.5,16,25,64.0,12,25,37,10,22,13,5,1,61,0
17440,408668,460_14_25,CROATIA,0,TOTALS,CROATIA,200,20,65,30.8,10,38,26.3,10,27,37.0,11,18,61.1,17,32,49,12,15,25,9,0,61,0
17441,408681,460_14_25,SERBIA,0,TOTALS,SERBIA,200,25,64,39.1,19,43,44.2,6,21,28.6,12,19,63.2,9,30,39,14,22,18,13,2,68,1
17442,408694,460_14_26,SPAIN,0,TOTALS,SPAIN,200,23,64,35.9,11,37,29.7,12,27,44.4,10,16,62.5,12,20,32,11,24,13,7,2,68,0
17443,408707,460_14_26,GERMANY,0,TOTALS,GERMANY,200,27,57,47.4,20,35,57.1,7,22,31.8,21,28,75.0,13,32,45,15,19,18,5,1,82,1
17444,408720,460_14_27,FINLAND,0,TOTALS,FINLAND,200,26,56,46.4,18,37,48.6,8,19,42.1,11,15,73.3,12,24,36,18,16,23,9,2,71,1
17445,408733,460_14_27,UKRAINE,0,TOTALS,UKRAINE,200,26,66,39.4,19,49,38.8,7,17,41.2,8,13,61.5,18,20,38,19,18,17,12,5,67,0
17446,408746,460_14_28,BOSNIA AND HERZEGOVINA,0,TOTALS,BOSNIA AND HERZEGOVINA,200,20,55,36.4,19,48,39.6,1,7,14.3,13,27,48.1,12,21,33,11,21,27,10,1,54,0
17447,408759,460_14_28,TURKEY,0,TOTALS,TURKEY,200,37,73,50.7,30,55,54.5,7,18,38.9,4,12,33.3,18,27,45,25,25,22,16,2,85,1
17448,408772,460_14_29,RUSSIA,0,TOTALS,RUSSIA,200,15,47,31.9,9,31,29.0,6,16,37.5,8,19,42.1,14,21,35,9,17,26,6,4,44,0
17449,408785,460_14_29,FRANCE,0,TOTALS,FRANCE,200,31,60,51.7,21,37,56.8,10,23,43.5,11,17,64.7,12,22,34,15,20,14,17,2,83,1
17450,408797,460_14_30,GREECE,0,TOTALS,GREECE,200,41,72,56.9,36,59,61.0,5,13,38.5,6,9,66.7,11,31,42,20,21,16,16,1,93,1
17451,408810,460_14_30,DENMARK,0,TOTALS,DENMARK,200,20,56,35.7,14,40,35.0,6,16,37.5,9,16,56.2,8,19,27,11,13,25,10,0,55,0
17452,408822,460_14_31,LITHUANIA,0,TOTALS,LITHUANIA,200,30,74,40.5,23,47,48.9,7,27,25.9,12,15,80.0,21,28,49,14,22,20,10,2,79,1
17453,408835,460_14_31,LATVIA,0,TOTALS,LATVIA,200,25,61,41.0,18,34,52.9,7,27,25.9,14,21,66.7,9,23,32,12,19,15,13,4,71,0
17454,408848,460_14_32,POLAND,0,TOTALS,POLAND,200,19,55,34.5,17,42,40.5,2,13,15.4,19,27,70.4,8,23,31,9,16,17,6,1,59,0
17455,408861,460_14_32,ITALY,0,TOTALS,ITALY,200,35,73,47.9,29,56,51.8,6,17,35.3,9,16,56.2,17,30,47,17,23,14,14,2,85,1
17456,408874,460_14_33,SERBIA,0,TOTALS,SERBIA,200,39,70,55.7,32,56,57.1,7,14,50.0,4,5,80.0,11,29,40,27,23,19,16,6,89,1
17457,408885,460_14_33,BOSNIA AND HERZEGOVINA,0,TOTALS,BOSNIA AND HERZEGOVINA,200,16,55,29.1,15,47,31.9,1,8,12.5,19,28,67.9,13,20,33,7,12,25,7,3,52,0
17458,408898,460_14_34,FRANCE,0,TOTALS,FRANCE,200,27,66,40.9,23,47,48.9,4,19,21.1,11,16,68.8,20,19,39,8,24,15,12,1,69,1
17459,408911,460_14_34,SPAIN,0,TOTALS,SPAIN,200,19,49,38.8,17,38,44.7,2,11,18.2,16,27,59.3,12,18,30,6,17,20,6,3,56,0
17460,408924,460_14_35,DENMARK,0,TOTALS,DENMARK,200,26,62,41.9,20,42,47.6,6,20,30.0,3,4,75.0,10,28,38,19,19,28,12,5,61,0
17461,408937,460_14_35,FINLAND,0,TOTALS,FINLAND,200,25,63,39.7,18,46,39.1,7,17,41.2,12,22,54.5,15,25,40,15,12,24,16,1,69,1
17462,408950,460_14_36,CROATIA,0,TOTALS,CROATIA,200,27,76,35.5,19,54,35.2,8,22,36.4,7,12,58.3,17,32,49,13,16,10,8,3,69,1
17463,408961,460_14_36,LITHUANIA,0,TOTALS,LITHUANIA,200,23,67,34.3,17,50,34.0,6,17,35.3,12,15,80.0,12,31,43,12,15,15,5,5,64,0
17464,408974,460_14_37,RUSSIA,0,TOTALS,RUSSIA,200,28,57,49.1,22,37,59.5,6,20,30.0,16,24,66.7,10,17,27,12,25,20,9,1,78,0
17465,408987,460_14_37,POLAND,0,TOTALS,POLAND,200,30,53,56.6,19,31,61.3,11,22,50.0,17,28,60.7,10,25,35,15,23,21,10,5,88,1
17466,409000,460_14_38,UKRAINE,0,TOTALS,UKRAINE,225,25,74,33.8,19,58,32.8,6,16,37.5,21,32,65.6,20,33,53,13,25,15,11,3,77,0
17467,409012,460_14_38,GREECE,0,TOTALS,GREECE,225,29,69,42.0,24,49,49.0,5,20,25.0,18,22,81.8,9,33,42,13,29,14,9,2,81,1
17468,409025,460_14_39,TURKEY,0,TOTALS,TURKEY,200,28,64,43.8,21,46,45.7,7,18,38.9,10,16,62.5,15,33,48,19,27,12,8,2,73,1
17469,409038,460_14_39,LATVIA,0,TOTALS,LATVIA,200,15,55,27.3,12,33,36.4,3,22,13.6,13,29,44.8,13,22,35,8,19,15,2,2,46,0
17470,409051,460_14_40,GERMANY,0,TOTALS,GERMANY,200,21,47,44.7,18,33,54.5,3,14,21.4,23,34,67.6,11,37,48,10,26,27,3,2,68,1
17471,409064,460_14_40,ITALY,0,TOTALS,ITALY,200,21,62,33.9,15,38,39.5,6,24,25.0,19,25,76.0,7,20,27,9,27,8,9,1,67,0
17472,409076,460_14_41,BOSNIA AND HERZEGOVINA,0,TOTALS,BOSNIA AND HERZEGOVINA,200,30,65,46.2,24,55,43.6,6,10,60.0,23,26,88.5,12,23,35,19,21,13,14,4,89,1
17473,409087,460_14_41,LITHUANIA,0,TOTALS,LITHUANIA,200,27,66,40.9,22,48,45.8,5,18,27.8,21,27,77.8,18,24,42,11,19,19,5,5,80,0
17474,409100,460_14_42,ITALY,0,TOTALS,ITALY,200,22,59,37.3,15,37,40.5,7,22,31.8,11,17,64.7,5,19,24,18,17,5,8,1,62,0
17475,409113,460_14_42,FRANCE,0,TOTALS,FRANCE,200,33,66,50.0,28,44,63.6,5,22,22.7,8,13,61.5,19,30,49,16,19,13,5,4,79,1
17476,409126,460_14_43,FINLAND,0,TOTALS,FINLAND,200,16,53,30.2,6,30,20.0,10,23,43.5,10,13,76.9,12,30,42,12,13,28,8,2,52,1
17477,409138,460_14_43,GREECE,0,TOTALS,GREECE,200,20,59,33.9,18,43,41.9,2,16,12.5,4,7,57.1,9,25,34,13,22,21,20,4,46,0
17478,409151,460_14_44,TURKEY,0,TOTALS,TURKEY,200,36,77,46.8,30,57,52.6,6,20,30.0,7,8,87.5,14,33,47,18,15,15,9,5,85,1
17479,409164,460_14_44,CROATIA,0,TOTALS,CROATIA,200,25,67,37.3,14,38,36.8,11,29,37.9,12,15,80.0,9,26,35,13,12,16,9,1,73,0
17480,409177,460_14_45,GERMANY,0,TOTALS,GERMANY,200,23,60,38.3,23,49,46.9,0,11,0.0,18,28,64.3,18,29,47,11,17,14,6,5,64,1
17481,409190,460_14_45,RUSSIA,0,TOTALS,RUSSIA,200,23,65,35.4,17,42,40.5,6,23,26.1,4,6,66.7,13,22,35,10,23,12,5,3,56,0
17482,409203,460_14_46,DENMARK,0,TOTALS,DENMARK,200,21,57,36.8,14,40,35.0,7,17,41.2,11,17,64.7,16,32,48,12,19,22,3,3,60,0
17483,409216,460_14_46,UKRAINE,0,TOTALS,UKRAINE,200,25,74,33.8,21,63,33.3,4,11,36.4,8,12,66.7,19,21,40,9,19,11,13,2,62,1
17484,409229,460_14_47,LATVIA,0,TOTALS,LATVIA,200,17,49,34.7,14,32,43.8,3,17,17.6,14,24,58.3,11,31,42,9,21,24,4,1,51,0
17485,409242,460_14_47,SERBIA,0,TOTALS,SERBIA,200,19,58,32.8,12,32,37.5,7,26,26.9,14,20,70.0,12,22,34,10,26,19,17,4,59,1
17486,409255,460_14_48,SPAIN,0,TOTALS,SPAIN,200,30,61,49.2,22,41,53.7,8,20,40.0,10,15,66.7,12,27,39,14,20,17,8,6,78,1
17487,409268,460_14_48,POLAND,0,TOTALS,POLAND,200,20,57,35.1,17,38,44.7,3,19,15.8,11,13,84.6,10,21,31,8,18,20,9,0,54,0
17488,409281,460_14_49,TURKEY,0,TOTALS,TURKEY,200,32,59,54.2,28,46,60.9,4,13,30.8,14,27,51.9,15,28,43,20,20,21,6,0,82,1
17489,409294,460_14_49,ITALY,0,TOTALS,ITALY,200,28,66,42.4,22,38,57.9,6,28,21.4,11,14,78.6,10,20,30,15,24,12,10,5,73,0
17490,409307,460_14_50,LITHUANIA,0,TOTALS,LITHUANIA,200,32,68,47.1,26,51,51.0,6,17,35.3,18,27,66.7,10,29,39,12,19,15,16,5,88,1
17491,409320,460_14_50,DENMARK,0,TOTALS,DENMARK,200,24,65,36.9,17,42,40.5,7,23,30.4,7,12,58.3,10,30,40,16,24,27,9,7,62,0
17492,409333,460_14_51,FRANCE,0,TOTALS,FRANCE,200,33,73,45.2,28,60,46.7,5,13,38.5,11,17,64.7,25,30,55,21,20,15,8,1,82,1
17493,409346,460_14_51,BOSNIA AND HERZEGOVINA,0,TOTALS,BOSNIA AND HERZEGOVINA,200,20,53,37.7,19,44,43.2,1,9,11.1,11,17,64.7,5,17,22,16,16,15,4,3,52,0
17494,409359,460_14_52,RUSSIA,0,TOTALS,RUSSIA,200,28,63,44.4,19,35,54.3,9,28,32.1,7,8,87.5,15,24,39,18,9,16,6,5,72,1
17495,409372,460_14_52,FINLAND,0,TOTALS,FINLAND,200,24,63,38.1,17,42,40.5,7,21,33.3,6,11,54.5,15,19,34,12,14,14,5,0,61,0
17496,409385,460_14_53,SERBIA,0,TOTALS,SERBIA,200,20,60,33.3,14,42,33.3,6,18,33.3,18,24,75.0,11,23,34,15,19,12,11,3,64,0
17497,409398,460_14_53,SPAIN,0,TOTALS,SPAIN,200,29,66,43.9,20,38,52.6,9,28,32.1,11,16,68.8,17,33,50,17,20,16,7,6,78,1
17498,409411,460_14_54,POLAND,0,TOTALS,POLAND,200,16,61,26.2,13,40,32.5,3,21,14.3,7,14,50.0,6,19,25,12,15,14,10,0,42,0
17499,409423,460_14_54,GREECE,0,TOTALS,GREECE,200,26,61,42.6,21,49,42.9,5,12,41.7,9,10,90.0,16,41,57,15,17,24,7,2,66,1
17500,409436,460_14_55,GERMANY,0,TOTALS,GERMANY,200,14,58,24.1,12,41,29.3,2,17,11.8,9,16,56.2,6,28,34,8,15,14,8,3,39,0
17501,409449,460_14_55,LATVIA,0,TOTALS,LATVIA,200,21,61,34.4,14,32,43.8,7,29,24.1,4,7,57.1,13,40,53,14,20,18,4,4,53,1
17502,409462,460_14_56,CROATIA,0,TOTALS,CROATIA,200,24,59,40.7,19,44,43.2,5,15,33.3,22,38,57.9,20,31,51,14,16,16,12,1,75,1
17503,409475,460_14_56,UKRAINE,0,TOTALS,UKRAINE,200,19,62,30.6,17,49,34.7,2,13,15.4,9,15,60.0,14,23,37,8,27,21,9,2,49,0
17504,409488,460_14_57,DENMARK,0,TOTALS,DENMARK,200,21,75,28.0,18,49,36.7,3,26,11.5,8,20,40.0,21,19,40,9,20,18,12,2,53,0
17505,409501,460_14_57,FINLAND,0,TOTALS,FINLAND,200,23,48,47.9,19,38,50.0,4,10,40.0,12,17,70.6,9,38,47,8,20,32,10,6,62,1
17506,409513,460_14_58,BOSNIA AND HERZEGOVINA,0,TOTALS,BOSNIA AND HERZEGOVINA,200,20,57,35.1,20,51,39.2,0,6,0.0,26,33,78.8,13,28,41,7,15,23,4,6,66,0
17507,409526,460_14_58,ITALY,0,TOTALS,ITALY,200,36,76,47.4,32,62,51.6,4,14,28.6,10,14,71.4,13,28,41,19,24,13,19,7,86,1
17508,409539,460_14_59,UKRAINE,0,TOTALS,UKRAINE,200,22,64,34.4,21,45,46.7,1,19,5.3,17,22,77.3,14,30,44,10,15,17,10,3,62,1
17509,409552,460_14_59,POLAND,0,TOTALS,POLAND,200,24,65,36.9,20,46,43.5,4,19,21.1,4,8,50.0,10,28,38,15,21,17,7,3,56,0
17510,409565,460_14_60,SERBIA,0,TOTALS,SERBIA,200,27,57,47.4,21,37,56.8,6,20,30.0,13,17,76.5,10,27,37,16,27,17,8,4,73,1
17511,409578,460_14_60,GERMANY,0,TOTALS,GERMANY,200,22,62,35.5,18,43,41.9,4,19,21.1,20,29,69.0,14,22,36,15,21,13,7,1,68,0
17512,409591,460_14_61,LITHUANIA,0,TOTALS,LITHUANIA,200,30,64,46.9,21,39,53.8,9,25,36.0,9,13,69.2,15,26,41,12,16,12,4,3,78,1
17513,409604,460_14_61,RUSSIA,0,TOTALS,RUSSIA,200,26,63,41.3,18,35,51.4,8,28,28.6,6,7,85.7,11,21,32,16,13,12,7,5,66,0
17514,409617,460_14_62,FRANCE,0,TOTALS,FRANCE,200,27,68,39.7,17,42,40.5,10,26,38.5,14,20,70.0,19,22,41,18,16,10,10,2,78,1
17515,409630,460_14_62,TURKEY,0,TOTALS,TURKEY,200,26,60,43.3,20,38,52.6,6,22,27.3,7,12,58.3,16,24,40,16,20,18,4,2,65,0
17516,409643,460_14_63,CROATIA,0,TOTALS,CROATIA,200,20,64,31.2,13,36,36.1,7,28,25.0,13,19,68.4,18,31,49,15,9,23,6,4,60,0
17517,409655,460_14_63,GREECE,0,TOTALS,GREECE,200,29,69,42.0,27,55,49.1,2,14,14.3,4,6,66.7,9,28,37,18,17,12,15,2,64,1
17518,409668,460_14_64,SPAIN,0,TOTALS,SPAIN,200,22,60,36.7,14,34,41.2,8,26,30.8,19,27,70.4,10,27,37,13,22,13,7,2,71,0
17519,409681,460_14_64,LATVIA,0,TOTALS,LATVIA,200,28,66,42.4,20,39,51.3,8,27,29.6,17,23,73.9,13,28,41,16,23,15,5,4,81,1
17520,409693,460_14_65,DENMARK,0,TOTALS,DENMARK,200,21,64,32.8,16,48,33.3,5,16,31.2,7,10,70.0,15,20,35,14,16,32,14,5,54,0
17521,409706,460_14_65,POLAND,0,TOTALS,POLAND,200,29,62,46.8,25,49,51.0,4,13,30.8,7,8,87.5,12,28,40,20,13,33,24,6,69,1
17522,409719,460_14_66,GERMANY,0,TOTALS,GERMANY,200,44,76,57.9,33,57,57.9,11,19,57.9,11,16,68.8,17,26,43,30,22,15,14,5,110,0
17523,409732,460_14_66,BOSNIA AND HERZEGOVINA,0,TOTALS,BOSNIA AND HERZEGOVINA,200,22,54,40.7,17,41,41.5,5,13,38.5,20,27,74.1,11,17,28,7,15,23,9,6,69,1
17524,409745,460_14_67,FINLAND,0,TOTALS,FINLAND,225,22,50,44.0,17,28,60.7,5,22,22.7,17,25,68.0,7,40,47,11,22,26,6,1,66,1
17525,409758,460_14_67,UKRAINE,0,TOTALS,UKRAINE,225,23,76,30.3,21,56,37.5,2,20,10.0,13,22,59.1,17,24,41,11,22,16,14,2,61,0
17526,409771,460_14_68,SERBIA,0,TOTALS,SERBIA,200,23,62,37.1,17,38,44.7,6,24,25.0,14,22,63.6,18,33,51,13,25,22,5,4,66,0
17527,409784,460_14_68,ITALY,0,TOTALS,ITALY,200,26,60,43.3,20,42,47.6,6,18,33.3,14,27,51.9,7,20,27,21,16,11,13,2,72,1
17528,409797,460_14_69,RUSSIA,0,TOTALS,RUSSIA,200,26,69,37.7,19,43,44.2,7,26,26.9,5,7,71.4,12,20,32,16,17,14,12,3,64,0
17529,409810,460_14_69,CROATIA,0,TOTALS,CROATIA,200,24,58,41.4,18,39,46.2,6,19,31.6,15,18,83.3,15,32,47,10,13,23,7,2,69,1
17530,409823,460_14_70,SPAIN,0,TOTALS,SPAIN,200,25,55,45.5,19,35,54.3,6,20,30.0,21,28,75.0,11,26,37,16,16,17,4,0,77,1
17531,409836,460_14_70,TURKEY,0,TOTALS,TURKEY,200,32,76,42.1,25,51,49.0,7,25,28.0,2,3,66.7,17,20,37,16,22,14,9,1,73,0
17532,409847,460_14_71,LITHUANIA,0,TOTALS,LITHUANIA,200,25,57,43.9,18,38,47.4,7,19,36.8,11,15,73.3,9,22,31,15,14,20,6,3,68,0
17533,409859,460_14_71,GREECE,0,TOTALS,GREECE,200,32,69,46.4,27,46,58.7,5,23,21.7,8,12,66.7,14,26,40,17,20,15,16,2,77,1
17534,409872,460_14_72,LATVIA,0,TOTALS,LATVIA,200,14,45,31.1,9,25,36.0,5,20,25.0,20,27,74.1,10,23,33,9,18,21,2,3,53,0
17535,409885,460_14_72,FRANCE,0,TOTALS,FRANCE,200,32,73,43.8,27,53,50.9,5,20,25.0,9,13,69.2,20,26,46,18,26,13,14,3,78,1
17536,409898,461_14_01,SCOTLAND,0,TOTALS,SCOTLAND,200,17,65,26.2,15,46,32.6,2,19,10.5,15,23,65.2,20,29,49,7,15,27,5,3,51,0
17537,409911,461_14_01,ENGLAND,0,TOTALS,ENGLAND,200,41,87,47.1,37,64,57.8,4,23,17.4,8,16,50.0,22,28,50,18,20,13,17,1,94,1
17538,409924,461_14_02,IRELAND,0,TOTALS,IRELAND,200,18,63,28.6,14,46,30.4,4,17,23.5,2,7,28.6,7,22,29,8,13,18,10,2,42,0
17539,409937,461_14_02,NETHERLANDS,0,TOTALS,NETHERLANDS,200,32,77,41.6,26,55,47.3,6,22,27.3,4,8,50.0,24,41,65,19,13,22,7,3,74,1
17540,409950,461_14_03,ROMANIA,0,TOTALS,ROMANIA,200,29,66,43.9,25,45,55.6,4,21,19.0,12,17,70.6,18,33,51,13,28,23,11,1,74,1
17541,409963,461_14_03,LUXEMBOURG,0,TOTALS,LUXEMBOURG,200,21,62,33.9,18,43,41.9,3,19,15.8,17,29,58.6,11,22,33,10,18,14,10,2,62,0
17542,409976,461_14_04,BULGARIA,0,TOTALS,BULGARIA,200,17,53,32.1,13,39,33.3,4,14,28.6,16,25,64.0,17,30,47,4,15,24,4,0,54,0
17543,409989,461_14_04,CZECH REPUBLIC,0,TOTALS,CZECH REPUBLIC,200,27,67,40.3,24,50,48.0,3,17,17.6,7,10,70.0,9,23,32,16,19,11,17,3,64,1
17544,410002,461_14_05,BELGIUM,0,TOTALS,BELGIUM,200,25,68,36.8,23,53,43.4,2,15,13.3,8,10,80.0,18,20,38,15,17,16,15,2,60,1
17545,410015,461_14_05,ESTONIA,0,TOTALS,ESTONIA,200,17,52,32.7,13,33,39.4,4,19,21.1,5,10,50.0,15,24,39,8,17,29,9,3,43,0
17546,410028,461_14_06,ALBANIA,0,TOTALS,ALBANIA,200,18,67,26.9,15,57,26.3,3,10,30.0,6,14,42.9,16,24,40,7,19,11,6,1,45,0
17547,410041,461_14_06,SWEDEN,0,TOTALS,SWEDEN,200,17,45,37.8,11,19,57.9,6,26,23.1,7,14,50.0,7,37,44,9,20,23,7,3,47,1
17548,410054,461_14_07,NORWAY,0,TOTALS,NORWAY,200,16,62,25.8,13,44,29.5,3,18,16.7,5,6,83.3,11,26,37,7,15,19,10,2,40,0
17549,410067,461_14_07,MKD,0,TOTALS,MKD,200,30,65,46.2,21,38,55.3,9,27,33.3,8,14,57.1,13,35,48,23,12,19,10,3,77,1
17550,410080,461_14_08,PORTUGAL,0,TOTALS,PORTUGAL,200,18,53,34.0,11,34,32.4,7,19,36.8,9,19,47.4,9,30,39,12,16,20,14,7,52,1
17551,410093,461_14_08,AUSTRIA,0,TOTALS,AUSTRIA,200,19,56,33.9,15,41,36.6,4,15,26.7,7,18,38.9,10,32,42,6,21,19,15,1,49,0
17552,410106,461_14_09,GEORGIA,0,TOTALS,GEORGIA,200,26,67,38.8,22,48,45.8,4,19,21.1,17,22,77.3,15,28,43,12,19,24,14,3,73,0
17553,410119,461_14_09,SLOVENIA,0,TOTALS,SLOVENIA,200,30,73,41.1,24,52,46.2,6,21,28.6,15,20,75.0,17,30,47,15,21,22,13,5,81,1
17554,410132,461_14_10,MONTENEGRO,0,TOTALS,MONTENEGRO,200,39,67,58.2,39,60,65.0,0,7,0.0,15,23,65.2,11,36,47,15,17,15,14,2,93,1
17555,410145,461_14_10,SWITZERLAND,0,TOTALS,SWITZERLAND,200,17,62,27.4,15,51,29.4,2,11,18.2,8,17,47.1,12,19,31,12,23,21,9,0,44,0
17556,410158,461_14_11,LUXEMBOURG,0,TOTALS,LUXEMBOURG,200,13,32,40.6,12,25,48.0,1,7,14.3,6,8,75.0,6,25,31,7,10,40,6,1,33,0
17557,410171,461_14_11,BELGIUM,0,TOTALS,BELGIUM,200,29,75,38.7,24,48,50.0,5,27,18.5,8,10,80.0,21,12,33,20,13,14,27,2,71,1
17558,410184,461_14_12,SWEDEN,0,TOTALS,SWEDEN,200,16,48,33.3,10,25,40.0,6,23,26.1,13,20,65.0,7,37,44,10,23,24,10,3,51,1
17559,410197,461_14_12,PORTUGAL,0,TOTALS,PORTUGAL,200,15,62,24.2,13,41,31.7,2,21,9.5,14,24,58.3,13,25,38,7,17,17,15,3,46,0
17560,410210,461_14_13,ISRAEL,0,TOTALS,ISRAEL,200,32,71,45.1,23,42,54.8,9,29,31.0,13,28,46.4,17,28,45,19,27,16,15,2,86,1
17561,410223,461_14_13,GEORGIA,0,TOTALS,GEORGIA,200,18,51,35.3,10,27,37.0,8,24,33.3,19,31,61.3,11,22,33,10,25,24,10,4,63,0
17562,410236,461_14_14,SWITZERLAND,0,TOTALS,SWITZERLAND,200,25,52,48.1,20,39,51.3,5,13,38.5,17,26,65.4,5,29,34,10,20,21,13,6,72,1
17563,410249,461_14_14,ALBANIA,0,TOTALS,ALBANIA,200,22,76,28.9,18,62,29.0,4,14,28.6,13,17,76.5,26,22,48,13,26,24,13,2,61,0
17564,410262,461_14_15,SLOVENIA,0,TOTALS,SLOVENIA,200,31,73,42.5,28,59,47.5,3,14,21.4,12,26,46.2,21,35,56,19,14,14,20,4,77,1
17565,410275,461_14_15,NORWAY,0,TOTALS,NORWAY,200,16,69,23.2,10,43,23.3,6,26,23.1,1,4,25.0,19,26,45,10,25,26,7,5,39,0
17566,410288,461_14_16,AUSTRIA,0,TOTALS,AUSTRIA,200,22,51,43.1,16,40,40.0,6,11,54.5,11,21,52.4,5,17,22,7,23,22,10,0,61,0
17567,410301,461_14_16,MONTENEGRO,0,TOTALS,MONTENEGRO,200,28,62,45.2,24,45,53.3,4,17,23.5,20,25,80.0,14,25,39,14,20,18,10,1,80,1
17568,410314,461_14_17,ENGLAND,0,TOTALS,ENGLAND,200,27,70,38.6,20,44,45.5,7,26,26.9,7,12,58.3,20,34,54,12,21,23,12,1,68,1
17569,410327,461_14_17,ROMANIA,0,TOTALS,ROMANIA,200,18,55,32.7,16,40,40.0,2,15,13.3,9,17,52.9,4,25,29,10,16,19,8,3,47,0
17570,410340,461_14_18,HUNGARY,0,TOTALS,HUNGARY,200,30,65,46.2,28,53,52.8,2,12,16.7,11,19,57.9,13,29,42,10,20,20,9,2,73,1
17571,410353,461_14_18,BULGARIA,0,TOTALS,BULGARIA,200,22,56,39.3,18,39,46.2,4,17,23.5,11,22,50.0,8,26,34,10,19,21,14,2,59,0
17572,410366,461_14_19,ESTONIA,0,TOTALS,ESTONIA,200,25,74,33.8,20,43,46.5,5,31,16.1,12,22,54.5,24,34,58,14,25,18,15,6,67,1
17573,410379,461_14_19,SCOTLAND,0,TOTALS,SCOTLAND,200,18,62,29.0,16,46,34.8,2,16,12.5,10,20,50.0,15,30,45,8,22,24,8,1,48,0
17574,410392,461_14_20,CZECH REPUBLIC,0,TOTALS,CZECH REPUBLIC,200,31,68,45.6,27,53,50.9,4,15,26.7,10,19,52.6,14,31,45,21,19,17,8,5,76,1
17575,410405,461_14_20,IRELAND,0,TOTALS,IRELAND,200,18,55,32.7,11,29,37.9,7,26,26.9,9,20,45.0,8,30,38,11,20,18,9,1,52,0
17576,410418,461_14_21,BELGIUM,0,TOTALS,BELGIUM,200,28,75,37.3,25,57,43.9,3,18,16.7,5,10,50.0,25,25,50,11,15,16,13,5,64,1
17577,410431,461_14_21,ROMANIA,0,TOTALS,ROMANIA,200,17,51,33.3,15,40,37.5,2,11,18.2,6,15,40.0,14,22,36,12,17,21,8,6,42,0
17578,410444,461_14_22,ALBANIA,0,TOTALS,ALBANIA,200,16,58,27.6,14,41,34.1,2,17,11.8,11,14,78.6,12,25,37,9,24,27,19,1,45,0
17579,410457,461_14_22,AUSTRIA,0,TOTALS,AUSTRIA,200,23,54,42.6,19,35,54.3,4,19,21.1,17,26,65.4,9,28,37,11,19,27,15,3,67,1
17580,410470,461_14_23,SCOTLAND,0,TOTALS,SCOTLAND,200,24,66,36.4,16,31,51.6,8,35,22.9,22,31,71.0,21,26,47,10,16,20,11,5,78,1
17581,410483,461_14_23,LUXEMBOURG,0,TOTALS,LUXEMBOURG,200,23,63,36.5,17,45,37.8,6,18,33.3,15,18,83.3,14,24,38,15,24,22,12,1,67,0
17582,410496,461_14_24,NETHERLANDS,0,TOTALS,NETHERLANDS,200,15,51,29.4,10,37,27.0,5,14,35.7,7,17,41.2,11,30,41,8,14,25,13,4,42,0
17583,410509,461_14_24,CZECH REPUBLIC,0,TOTALS,CZECH REPUBLIC,200,18,58,31.0,16,46,34.8,2,12,16.7,5,12,41.7,14,30,44,5,14,25,13,2,43,1
17584,410522,461_14_25,ESTONIA,0,TOTALS,ESTONIA,225,29,67,43.3,22,44,50.0,7,23,30.4,10,16,62.5,7,31,38,15,21,23,10,3,75,0
17585,410535,461_14_25,ENGLAND,0,TOTALS,ENGLAND,225,32,71,45.1,25,50,50.0,7,21,33.3,12,22,54.5,11,33,44,18,20,18,12,1,83,1
17586,410548,461_14_26,IRELAND,0,TOTALS,IRELAND,200,14,55,25.5,9,32,28.1,5,23,21.7,9,19,47.4,4,22,26,9,20,17,9,1,42,0
17587,410561,461_14_26,HUNGARY,0,TOTALS,HUNGARY,200,23,62,37.1,21,48,43.8,2,14,14.3,7,14,50.0,19,41,60,8,21,28,5,3,55,1
17588,410574,461_14_27,MKD,0,TOTALS,MKD,200,27,58,46.6,16,30,53.3,11,28,39.3,15,22,68.2,12,31,43,17,18,20,6,1,80,1
17589,410587,461_14_27,SLOVENIA,0,TOTALS,SLOVENIA,200,30,76,39.5,23,47,48.9,7,29,24.1,11,13,84.6,16,24,40,15,21,10,9,2,78,0
17590,410600,461_14_28,SWITZERLAND,0,TOTALS,SWITZERLAND,200,18,64,28.1,14,47,29.8,4,17,23.5,13,25,52.0,13,31,44,6,19,13,4,1,53,1
17591,410613,461_14_28,SWEDEN,0,TOTALS,SWEDEN,200,18,62,29.0,15,31,48.4,3,31,9.7,8,18,44.4,17,40,57,7,24,21,6,7,47,0
17592,410626,461_14_29,NORWAY,0,TOTALS,NORWAY,200,14,63,22.2,12,39,30.8,2,24,8.3,6,9,66.7,8,34,42,5,19,28,4,4,36,0
17593,410639,461_14_29,ISRAEL,0,TOTALS,ISRAEL,200,29,78,37.2,22,51,43.1,7,27,25.9,17,21,81.0,18,40,58,19,17,11,17,4,82,1
17594,410652,461_14_30,MONTENEGRO,0,TOTALS,MONTENEGRO,200,22,53,41.5,14,34,41.2,8,19,42.1,21,43,48.8,18,30,48,16,16,16,12,5,73,1
17595,410665,461_14_30,PORTUGAL,0,TOTALS,PORTUGAL,200,19,60,31.7,15,40,37.5,4,20,20.0,5,9,55.6,11,24,35,9,33,20,4,2,47,0
17596,410678,461_14_31,LUXEMBOURG,0,TOTALS,LUXEMBOURG,200,22,61,36.1,21,51,41.2,1,10,10.0,7,11,63.6,13,25,38,13,20,32,9,0,52,0
17597,410691,461_14_31,ESTONIA,0,TOTALS,ESTONIA,200,30,76,39.5,23,42,54.8,7,34,20.6,11,17,64.7,20,25,45,16,16,23,20,5,78,1
17598,410704,461_14_32,BULGARIA,0,TOTALS,BULGARIA,200,25,65,38.5,21,49,42.9,4,16,25.0,8,18,44.4,15,37,52,14,17,31,18,4,62,1
17599,410717,461_14_32,IRELAND,0,TOTALS,IRELAND,200,22,62,35.5,19,46,41.3,3,16,18.8,2,11,18.2,6,30,36,10,17,30,18,5,49,0
17600,410730,461_14_33,ROMANIA,0,TOTALS,ROMANIA,200,28,67,41.8,23,48,47.9,5,19,26.3,16,22,72.7,16,33,49,14,27,23,9,2,77,1
17601,410743,461_14_33,SCOTLAND,0,TOTALS,SCOTLAND,200,23,74,31.1,20,54,37.0,3,20,15.0,19,28,67.9,19,20,39,9,22,18,16,3,68,0
17602,410756,461_14_34,AUSTRIA,0,TOTALS,AUSTRIA,200,26,59,44.1,22,45,48.9,4,14,28.6,11,15,73.3,15,28,43,16,15,20,14,2,67,1
17603,410769,461_14_34,SWITZERLAND,0,TOTALS,SWITZERLAND,200,18,51,35.3,14,37,37.8,4,14,28.6,4,11,36.4,9,20,29,10,14,21,10,1,44,0
17604,410782,461_14_35,GEORGIA,0,TOTALS,GEORGIA,200,40,75,53.3,38,62,61.3,2,13,15.4,29,40,72.5,14,41,55,20,15,15,11,7,111,0
17605,410795,461_14_35,NORWAY,0,TOTALS,NORWAY,200,16,78,20.5,14,55,25.5,2,23,8.7,8,15,53.3,21,23,44,10,27,29,8,7,42,1
17606,410808,461_14_36,PORTUGAL,0,TOTALS,PORTUGAL,200,14,52,26.9,11,38,28.9,3,14,21.4,6,13,46.2,11,28,39,9,12,26,7,5,37,0
17607,410821,461_14_36,ALBANIA,0,TOTALS,ALBANIA,200,22,67,32.8,19,51,37.3,3,16,18.8,7,10,70.0,18,29,47,9,16,19,15,1,54,1
17608,410834,461_14_37,ISRAEL,0,TOTALS,ISRAEL,200,38,62,61.3,31,43,72.1,7,19,36.8,17,25,68.0,6,26,32,19,25,11,13,1,100,0
17609,410847,461_14_37,MKD,0,TOTALS,MKD,200,19,55,34.5,11,28,39.3,8,27,29.6,17,29,58.6,14,19,33,9,23,20,2,0,63,1
17610,410860,461_14_38,SWEDEN,0,TOTALS,SWEDEN,200,24,49,49.0,20,36,55.6,4,13,30.8,10,17,58.8,6,27,33,9,29,17,4,1,62,0
17611,410873,461_14_38,MONTENEGRO,0,TOTALS,MONTENEGRO,200,25,61,41.0,21,48,43.8,4,13,30.8,17,31,54.8,17,20,37,14,21,14,6,1,71,1
17612,410886,461_14_39,ENGLAND,0,TOTALS,ENGLAND,200,15,53,28.3,10,33,30.3,5,20,25.0,17,20,85.0,9,33,42,9,19,22,11,4,52,0
17613,410899,461_14_39,BELGIUM,0,TOTALS,BELGIUM,200,22,65,33.8,19,48,39.6,3,17,17.6,9,15,60.0,13,28,41,9,18,17,16,4,56,1
17614,410912,461_14_40,HUNGARY,0,TOTALS,HUNGARY,200,26,69,37.7,23,53,43.4,3,16,18.8,16,24,66.7,11,27,38,9,23,14,9,5,71,1
17615,410925,461_14_40,NETHERLANDS,0,TOTALS,NETHERLANDS,200,24,68,35.3,15,42,35.7,9,26,34.6,13,22,59.1,21,34,55,15,23,22,4,2,70,0
17616,410938,461_14_41,SLOVENIA,0,TOTALS,SLOVENIA,225,25,74,33.8,21,50,42.0,4,24,16.7,16,22,72.7,19,30,49,12,22,21,11,8,70,0
17617,410951,461_14_41,ISRAEL,0,TOTALS,ISRAEL,225,26,73,35.6,18,46,39.1,8,27,29.6,12,22,54.5,20,32,52,11,22,16,12,8,72,1
17618,410964,461_14_42,AUSTRIA,0,TOTALS,AUSTRIA,200,22,57,38.6,19,39,48.7,3,18,16.7,8,20,40.0,11,38,49,7,14,20,6,3,55,1
17619,410977,461_14_42,SWEDEN,0,TOTALS,SWEDEN,200,15,61,24.6,12,35,34.3,3,26,11.5,2,4,50.0,7,29,36,10,20,19,8,2,35,0
17620,410990,461_14_43,SCOTLAND,0,TOTALS,SCOTLAND,200,17,53,32.1,12,37,32.4,5,16,31.2,6,12,50.0,11,20,31,8,10,25,5,0,45,0
17621,411003,461_14_43,BELGIUM,0,TOTALS,BELGIUM,200,38,64,59.4,35,49,71.4,3,15,20.0,7,12,58.3,10,27,37,19,10,12,19,3,86,1
17622,411016,461_14_44,NETHERLANDS,0,TOTALS,NETHERLANDS,200,26,69,37.7,19,48,39.6,7,21,33.3,5,21,23.8,19,23,42,12,19,21,9,4,64,0
17623,411029,461_14_44,BULGARIA,0,TOTALS,BULGARIA,200,31,65,47.7,25,45,55.6,6,20,30.0,13,20,65.0,13,29,42,16,21,15,11,3,81,1
17624,411042,461_14_45,LUXEMBOURG,0,TOTALS,LUXEMBOURG,200,13,48,27.1,13,36,36.1,0,12,0.0,6,15,40.0,10,27,37,11,8,37,6,0,32,0
17625,411055,461_14_45,ENGLAND,0,TOTALS,ENGLAND,200,32,77,41.6,23,51,45.1,9,26,34.6,6,9,66.7,18,26,44,20,17,17,26,3,79,1
17626,411068,461_14_46,CZECH REPUBLIC,0,TOTALS,CZECH REPUBLIC,200,23,65,35.4,16,41,39.0,7,24,29.2,12,15,80.0,17,24,41,11,22,16,9,5,65,1
17627,411081,461_14_46,HUNGARY,0,TOTALS,HUNGARY,200,23,65,35.4,21,51,41.2,2,14,14.3,16,23,69.6,20,27,47,9,19,13,7,2,64,0
17628,411094,461_14_47,MKD,0,TOTALS,MKD,200,26,70,37.1,17,38,44.7,9,32,28.1,16,27,59.3,16,22,38,17,25,18,6,1,77,0
17629,411107,461_14_47,GEORGIA,0,TOTALS,GEORGIA,200,29,77,37.7,22,41,53.7,7,36,19.4,22,32,68.8,28,30,58,10,25,18,10,1,87,1
17630,411120,461_14_48,SWITZERLAND,0,TOTALS,SWITZERLAND,200,21,49,42.9,20,41,48.8,1,8,12.5,10,21,47.6,10,32,42,12,19,25,13,1,53,1
17631,411133,461_14_48,PORTUGAL,0,TOTALS,PORTUGAL,200,17,60,28.3,15,41,36.6,2,19,10.5,4,11,36.4,12,24,36,9,23,21,12,4,40,0
17632,411146,461_14_49,ESTONIA,0,TOTALS,ESTONIA,200,21,72,29.2,18,45,40.0,3,27,11.1,12,15,80.0,18,25,43,8,24,20,10,3,57,0
17633,411159,461_14_49,ROMANIA,0,TOTALS,ROMANIA,200,24,61,39.3,21,49,42.9,3,12,25.0,13,23,56.5,14,31,45,14,21,19,10,2,64,1
17634,411172,461_14_50,ALBANIA,0,TOTALS,ALBANIA,200,21,66,31.8,19,56,33.9,2,10,20.0,6,9,66.7,8,23,31,8,30,21,8,2,50,0
17635,411185,461_14_50,MONTENEGRO,0,TOTALS,MONTENEGRO,200,29,67,43.3,24,50,48.0,5,17,29.4,24,39,61.5,21,36,57,14,14,16,10,6,87,1
17636,411198,461_14_51,LUXEMBOURG,0,TOTALS,LUXEMBOURG,200,20,67,29.9,18,47,38.3,2,20,10.0,2,9,22.2,15,29,44,12,17,18,10,1,44,0
17637,411211,461_14_51,NORWAY,0,TOTALS,NORWAY,200,23,76,30.3,18,55,32.7,5,21,23.8,14,16,87.5,22,34,56,10,13,15,10,3,65,1
17638,411224,461_14_52,PORTUGAL,0,TOTALS,PORTUGAL,200,33,67,49.3,26,45,57.8,7,22,31.8,11,23,47.8,18,26,44,14,20,28,23,7,84,1
17639,411237,461_14_52,IRELAND,0,TOTALS,IRELAND,200,22,55,40.0,21,45,46.7,1,10,10.0,13,22,59.1,10,19,29,9,17,34,14,1,58,0
17640,411250,461_14_53,CZECH REPUBLIC,0,TOTALS,CZECH REPUBLIC,200,27,60,45.0,23,45,51.1,4,15,26.7,4,9,44.4,9,28,37,12,22,21,17,3,62,1
17641,411263,461_14_53,AUSTRIA,0,TOTALS,AUSTRIA,200,14,49,28.6,10,32,31.2,4,17,23.5,7,23,30.4,16,27,43,3,17,33,9,6,39,0
17642,411276,461_14_54,BULGARIA,0,TOTALS,BULGARIA,200,29,71,40.8,28,58,48.3,1,13,7.7,7,15,46.7,17,23,40,10,19,14,9,1,66,0
17643,411289,461_14_54,SWEDEN,0,TOTALS,SWEDEN,200,27,58,46.6,22,43,51.2,5,15,33.3,8,17,47.1,10,28,38,16,16,18,10,4,67,1
17644,411302,461_14_55,HUNGARY,0,TOTALS,HUNGARY,200,23,56,41.1,18,41,43.9,5,15,33.3,8,23,34.8,10,24,34,7,28,15,8,2,59,0
17645,411315,461_14_55,MONTENEGRO,0,TOTALS,MONTENEGRO,200,28,60,46.7,23,38,60.5,5,22,22.7,25,37,67.6,14,30,44,11,20,11,6,1,86,1
17646,411328,461_14_56,NETHERLANDS,0,TOTALS,NETHERLANDS,200,25,66,37.9,16,46,34.8,9,20,45.0,4,12,33.3,23,28,51,12,10,20,9,1,63,1
17647,411341,461_14_56,SWITZERLAND,0,TOTALS,SWITZERLAND,200,24,62,38.7,17,44,38.6,7,18,38.9,5,8,62.5,11,19,30,8,13,15,6,4,60,0
17648,411354,461_14_57,BELGIUM,0,TOTALS,BELGIUM,200,24,65,36.9,20,50,40.0,4,15,26.7,9,18,50.0,11,19,30,11,18,12,14,7,61,0
17649,411367,461_14_57,SLOVENIA,0,TOTALS,SLOVENIA,200,26,61,42.6,19,41,46.3,7,20,35.0,11,12,91.7,16,35,51,13,18,20,3,0,70,1
17650,411380,461_14_58,ESTONIA,0,TOTALS,ESTONIA,200,25,62,40.3,20,46,43.5,5,16,31.2,5,15,33.3,12,27,39,11,25,27,2,5,60,0
17651,411393,461_14_58,GEORGIA,0,TOTALS,GEORGIA,200,34,77,44.2,28,57,49.1,6,20,30.0,18,26,69.2,20,26,46,23,22,13,10,8,92,1
17652,411406,461_14_59,ENGLAND,0,TOTALS,ENGLAND,200,27,64,42.2,20,43,46.5,7,21,33.3,15,22,68.2,13,30,43,16,26,19,9,3,76,0
17653,411419,461_14_59,ISRAEL,0,TOTALS,ISRAEL,200,28,67,41.8,18,36,50.0,10,31,32.3,21,36,58.3,14,27,41,12,22,13,10,0,87,1
17654,411432,461_14_60,ROMANIA,0,TOTALS,ROMANIA,200,27,65,41.5,19,36,52.8,8,29,27.6,6,11,54.5,16,28,44,15,24,16,3,1,68,0
17655,411445,461_14_60,MKD,0,TOTALS,MKD,200,30,74,40.5,20,46,43.5,10,28,35.7,12,25,48.0,20,24,44,16,16,7,10,4,82,1
17656,411458,461_14_61,NORWAY,0,TOTALS,NORWAY,200,27,85,31.8,22,61,36.1,5,24,20.8,6,7,85.7,20,37,57,16,21,17,8,5,65,0
17657,411471,461_14_61,SCOTLAND,0,TOTALS,SCOTLAND,200,21,72,29.2,13,41,31.7,8,31,25.8,17,26,65.4,16,35,51,10,12,15,7,5,67,1
17658,411484,461_14_62,IRELAND,0,TOTALS,IRELAND,200,23,71,32.4,14,39,35.9,9,32,28.1,9,12,75.0,11,31,42,15,28,22,10,2,64,0
17659,411497,461_14_62,ALBANIA,0,TOTALS,ALBANIA,200,26,75,34.7,23,57,40.4,3,18,16.7,20,31,64.5,21,37,58,10,17,21,10,0,75,1
17660,411510,461_14_63,AUSTRIA,0,TOTALS,AUSTRIA,200,16,51,31.4,9,33,27.3,7,18,38.9,10,14,71.4,16,22,38,9,24,29,6,7,49,0
17661,411523,461_14_63,HUNGARY,0,TOTALS,HUNGARY,200,22,53,41.5,17,36,47.2,5,17,29.4,10,26,38.5,13,18,31,13,23,17,15,3,59,1
17662,411536,461_14_64,GEORGIA,0,TOTALS,GEORGIA,200,38,84,45.2,35,66,53.0,3,18,16.7,18,37,48.6,22,35,57,19,26,24,18,5,97,1
17663,411549,461_14_64,ROMANIA,0,TOTALS,ROMANIA,200,23,74,31.1,21,57,36.8,2,17,11.8,15,27,55.6,19,30,49,9,30,31,14,3,63,0
17664,411562,461_14_65,ISRAEL,0,TOTALS,ISRAEL,200,22,69,31.9,14,45,31.1,8,24,33.3,16,25,64.0,20,22,42,10,25,21,12,3,68,1
17665,411575,461_14_65,BELGIUM,0,TOTALS,BELGIUM,200,18,55,32.7,17,47,36.2,1,8,12.5,22,27,81.5,15,30,45,7,21,28,15,6,59,0
17666,411588,461_14_66,MKD,0,TOTALS,MKD,200,23,66,34.8,15,39,38.5,8,27,29.6,21,24,87.5,16,37,53,17,13,14,7,4,75,1
17667,411601,461_14_66,ESTONIA,0,TOTALS,ESTONIA,200,23,66,34.8,16,40,40.0,7,26,26.9,2,5,40.0,8,29,37,12,21,13,8,4,55,0
17668,411614,461_14_67,SLOVENIA,0,TOTALS,SLOVENIA,200,25,73,34.2,22,48,45.8,3,25,12.0,12,17,70.6,18,24,42,9,15,17,8,1,65,0
17669,411627,461_14_67,ENGLAND,0,TOTALS,ENGLAND,200,29,69,42.0,23,50,46.0,6,19,31.6,9,12,75.0,14,33,47,15,19,18,9,6,73,1
17670,411640,461_14_68,SWITZERLAND,0,TOTALS,SWITZERLAND,250,28,80,35.0,20,47,42.6,8,33,24.2,4,8,50.0,14,26,40,21,21,24,16,4,68,0
17671,411653,461_14_68,BULGARIA,0,TOTALS,BULGARIA,250,30,76,39.5,26,59,44.1,4,17,23.5,10,17,58.8,22,40,62,15,17,27,13,2,74,1
17672,411666,461_14_69,MONTENEGRO,0,TOTALS,MONTENEGRO,200,25,66,37.9,22,50,44.0,3,16,18.8,17,24,70.8,13,32,45,8,17,8,6,3,70,1
17673,411679,461_14_69,CZECH REPUBLIC,0,TOTALS,CZECH REPUBLIC,200,17,56,30.4,14,44,31.8,3,12,25.0,12,16,75.0,9,30,39,11,21,16,5,1,49,0
17674,411692,461_14_70,SWEDEN,0,TOTALS,SWEDEN,200,16,52,30.8,14,38,36.8,2,14,14.3,5,9,55.6,8,30,38,8,16,28,8,1,39,0
17675,411705,461_14_70,NETHERLANDS,0,TOTALS,NETHERLANDS,200,26,65,40.0,19,45,42.2,7,20,35.0,4,9,44.4,11,30,41,9,11,16,14,6,63,1
17676,411718,461_14_71,LUXEMBOURG,0,TOTALS,LUXEMBOURG,200,23,55,41.8,21,45,46.7,2,10,20.0,8,14,57.1,11,44,55,16,19,37,7,3,56,0
17677,411731,461_14_71,IRELAND,0,TOTALS,IRELAND,200,21,73,28.8,14,41,34.1,7,32,21.9,8,17,47.1,11,20,31,13,11,15,18,5,57,1
17678,411744,461_14_72,NORWAY,0,TOTALS,NORWAY,200,19,54,35.2,15,43,34.9,4,11,36.4,15,25,60.0,11,37,48,11,14,22,13,2,57,1
17679,411757,461_14_72,PORTUGAL,0,TOTALS,PORTUGAL,200,20,72,27.8,15,40,37.5,5,32,15.6,5,11,45.5,15,28,43,11,23,16,14,4,50,0
17680,411770,461_14_73,ROMANIA,0,TOTALS,ROMANIA,200,20,59,33.9,15,43,34.9,5,16,31.2,9,18,50.0,10,25,35,8,25,14,11,2,54,0
17681,411783,461_14_73,SWEDEN,0,TOTALS,SWEDEN,200,21,57,36.8,15,36,41.7,6,21,28.6,9,26,34.6,17,32,49,15,16,24,5,1,57,1
17682,411796,461_14_74,SLOVENIA,0,TOTALS,SLOVENIA,200,29,60,48.3,26,47,55.3,3,13,23.1,16,18,88.9,14,22,36,20,21,14,9,2,77,1
17683,411809,461_14_74,AUSTRIA,0,TOTALS,AUSTRIA,200,24,59,40.7,19,41,46.3,5,18,27.8,12,17,70.6,14,15,29,11,19,19,4,5,65,0
17684,411822,461_14_75,SWITZERLAND,0,TOTALS,SWITZERLAND,200,22,58,37.9,19,46,41.3,3,12,25.0,9,16,56.2,16,28,44,10,12,33,16,3,56,0
17685,411835,461_14_75,ESTONIA,0,TOTALS,ESTONIA,200,32,74,43.2,21,46,45.7,11,28,39.3,0,8,0.0,16,24,40,19,16,22,21,7,75,1
17686,411848,461_14_76,HUNGARY,0,TOTALS,HUNGARY,200,22,62,35.5,16,44,36.4,6,18,33.3,6,12,50.0,18,23,41,9,18,16,5,0,56,0
17687,411861,461_14_76,BELGIUM,0,TOTALS,BELGIUM,200,25,60,41.7,20,39,51.3,5,21,23.8,5,11,45.5,13,23,36,17,17,12,7,6,60,1
17688,411874,461_14_77,GEORGIA,0,TOTALS,GEORGIA,200,35,74,47.3,28,52,53.8,7,22,31.8,15,29,51.7,18,34,52,22,16,17,20,5,92,1
17689,411887,461_14_77,NETHERLANDS,0,TOTALS,NETHERLANDS,200,12,56,21.4,8,39,20.5,4,17,23.5,9,13,69.2,11,27,38,7,20,32,6,2,37,0
17690,411900,461_14_78,ISRAEL,0,TOTALS,ISRAEL,200,28,80,35.0,23,62,37.1,5,18,27.8,15,19,78.9,17,28,45,18,27,9,11,5,76,1
17691,411913,461_14_78,CZECH REPUBLIC,0,TOTALS,CZECH REPUBLIC,200,22,59,37.3,19,40,47.5,3,19,15.8,16,33,48.5,14,34,48,14,19,20,3,11,63,0
17692,411926,461_14_79,BULGARIA,0,TOTALS,BULGARIA,200,21,51,41.2,17,37,45.9,4,14,28.6,22,32,68.8,14,25,39,10,16,29,11,2,68,0
17693,411939,461_14_79,MKD,0,TOTALS,MKD,200,29,74,39.2,23,49,46.9,6,25,24.0,16,20,80.0,19,22,41,19,26,19,19,6,80,1
17694,411952,461_14_80,MONTENEGRO,0,TOTALS,MONTENEGRO,200,25,65,38.5,16,36,44.4,9,29,31.0,23,33,69.7,16,29,45,9,15,10,5,1,82,1
17695,411965,461_14_80,ENGLAND,0,TOTALS,ENGLAND,200,25,65,38.5,22,48,45.8,3,17,17.6,9,14,64.3,9,22,31,8,29,10,4,1,62,0
17696,411978,461_14_81,SCOTLAND,0,TOTALS,SCOTLAND,200,26,66,39.4,21,44,47.7,5,22,22.7,3,9,33.3,12,29,41,13,18,19,7,6,60,0
17697,411991,461_14_81,ALBANIA,0,TOTALS,ALBANIA,200,23,66,34.8,21,48,43.8,2,18,11.1,19,28,67.9,17,32,49,10,17,15,16,0,67,1
17698,412004,461_14_82,ROMANIA,0,TOTALS,ROMANIA,200,34,62,54.8,29,53,54.7,5,9,55.6,4,12,33.3,13,29,42,23,22,25,13,9,77,1
17699,412017,461_14_82,SWITZERLAND,0,TOTALS,SWITZERLAND,200,17,62,27.4,13,44,29.5,4,18,22.2,11,18,61.1,16,17,33,6,16,23,12,5,49,0
17700,412030,461_14_83,SWEDEN,0,TOTALS,SWEDEN,200,24,56,42.9,18,39,46.2,6,17,35.3,9,14,64.3,10,36,46,17,15,22,6,5,63,1
17701,412043,461_14_83,ESTONIA,0,TOTALS,ESTONIA,200,22,70,31.4,17,46,37.0,5,24,20.8,2,8,25.0,14,24,38,12,17,14,11,4,51,0
17702,412056,461_14_84,AUSTRIA,0,TOTALS,AUSTRIA,200,20,58,34.5,16,39,41.0,4,19,21.1,7,14,50.0,10,17,27,11,15,25,11,4,51,0
17703,412069,461_14_84,HUNGARY,0,TOTALS,HUNGARY,200,32,67,47.8,27,48,56.2,5,19,26.3,9,14,64.3,17,29,46,23,19,23,18,2,78,1
17704,412082,461_14_85,NETHERLANDS,0,TOTALS,NETHERLANDS,200,25,66,37.9,18,50,36.0,7,16,43.8,6,10,60.0,11,25,36,14,18,23,14,2,63,1
17705,412095,461_14_85,BULGARIA,0,TOTALS,BULGARIA,200,17,48,35.4,11,31,35.5,6,17,35.3,10,20,50.0,8,29,37,12,15,31,14,5,50,0
17706,412108,461_14_86,SLOVENIA,0,TOTALS,SLOVENIA,200,18,54,33.3,11,26,42.3,7,28,25.0,4,5,80.0,14,19,33,13,11,29,11,3,47,0
17707,412121,461_14_86,BELGIUM,0,TOTALS,BELGIUM,200,30,58,51.7,26,44,59.1,4,14,28.6,3,4,75.0,10,23,33,21,12,22,18,1,67,1
17708,412134,461_14_87,GEORGIA,0,TOTALS,GEORGIA,200,28,70,40.0,20,43,46.5,8,27,29.6,17,32,53.1,18,26,44,18,19,17,11,1,81,0
17709,412147,461_14_87,MKD,0,TOTALS,MKD,200,34,66,51.5,22,35,62.9,12,31,38.7,13,24,54.2,11,32,43,23,24,16,10,3,93,1
17710,412160,461_14_88,CZECH REPUBLIC,0,TOTALS,CZECH REPUBLIC,200,24,75,32.0,23,52,44.2,1,23,4.3,11,19,57.9,13,26,39,11,23,12,6,0,60,0
17711,412173,461_14_88,ENGLAND,0,TOTALS,ENGLAND,200,31,69,44.9,25,51,49.0,6,18,33.3,16,30,53.3,16,44,60,13,23,17,10,5,84,1
17712,412186,461_14_89,ISRAEL,0,TOTALS,ISRAEL,200,32,82,39.0,28,62,45.2,4,20,20.0,5,11,45.5,20,26,46,14,36,19,13,0,73,0
17713,412199,461_14_89,MONTENEGRO,0,TOTALS,MONTENEGRO,200,24,54,44.4,22,38,57.9,2,16,12.5,26,41,63.4,10,29,39,9,19,21,9,5,76,1
17714,412212,462_14_01,GIBRALTAR,0,TOTALS,GIBRALTAR,200,13,53,24.5,13,46,28.3,0,7,0.0,10,27,37.0,19,32,51,6,13,30,15,3,36,0
17715,412225,462_14_01,WALES,0,TOTALS,WALES,200,18,64,28.1,15,45,33.3,3,19,15.8,8,14,57.1,13,27,40,7,20,25,17,1,47,1
17716,412238,462_14_02,ANDORRA,0,TOTALS,ANDORRA,200,21,92,22.8,20,65,30.8,1,27,3.7,18,26,69.2,26,28,54,3,20,18,22,2,61,0
17717,412251,462_14_02,MALTA,0,TOTALS,MALTA,200,26,64,40.6,23,50,46.0,3,14,21.4,8,18,44.4,11,46,57,11,22,39,12,3,63,1
17718,412264,462_14_03,SAN MARINO,0,TOTALS,SAN MARINO,200,16,64,25.0,12,40,30.0,4,24,16.7,6,14,42.9,12,32,44,8,19,22,15,0,42,0
17719,412277,462_14_03,GIBRALTAR,0,TOTALS,GIBRALTAR,200,19,64,29.7,18,58,31.0,1,6,16.7,9,22,40.9,18,41,59,6,13,27,9,3,48,1
17720,412290,462_14_04,WALES,0,TOTALS,WALES,200,20,63,31.7,18,50,36.0,2,13,15.4,10,24,41.7,12,40,52,3,21,27,8,2,52,0
17721,412303,462_14_04,ANDORRA,0,TOTALS,ANDORRA,200,27,86,31.4,21,62,33.9,6,24,25.0,7,17,41.2,21,35,56,8,20,17,13,4,67,1
17722,412316,462_14_05,ANDORRA,0,TOTALS,ANDORRA,200,41,89,46.1,35,70,50.0,6,19,31.6,15,24,62.5,24,29,53,21,16,22,28,3,103,0
17723,412329,462_14_05,SAN MARINO,0,TOTALS,SAN MARINO,200,18,55,32.7,14,41,34.1,4,14,28.6,7,13,53.8,10,26,36,10,20,44,10,1,47,1
17724,412342,462_14_06,MALTA,0,TOTALS,MALTA,200,25,69,36.2,15,51,29.4,10,18,55.6,5,22,22.7,16,38,54,13,18,22,16,6,65,1
17725,412355,462_14_06,WALES,0,TOTALS,WALES,200,18,68,26.5,14,51,27.5,4,17,23.5,6,12,50.0,14,35,49,6,17,25,9,6,46,0
17726,412368,462_14_07,GIBRALTAR,0,TOTALS,GIBRALTAR,200,30,71,42.3,27,64,42.2,3,7,42.9,5,14,35.7,24,41,65,14,30,42,15,3,68,1
17727,412381,462_14_07,ANDORRA,0,TOTALS,ANDORRA,200,19,84,22.6,15,60,25.0,4,24,16.7,21,35,60.0,30,19,49,9,16,22,22,5,63,0
17728,412394,462_14_08,SAN MARINO,0,TOTALS,SAN MARINO,200,29,76,38.2,21,49,42.9,8,27,29.6,5,11,45.5,11,24,35,22,14,17,18,0,71,0
17729,412407,462_14_08,MALTA,0,TOTALS,MALTA,200,32,78,41.0,28,67,41.8,4,11,36.4,4,11,36.4,19,37,56,15,14,28,10,4,72,1
17730,412420,462_14_09,WALES,0,TOTALS,WALES,200,22,52,42.3,18,38,47.4,4,14,28.6,13,22,59.1,7,34,41,10,8,20,7,1,61,1
17731,412433,462_14_09,SAN MARINO,0,TOTALS,SAN MARINO,200,24,70,34.3,17,44,38.6,7,26,26.9,1,2,50.0,11,23,34,9,18,15,10,0,56,0
17732,412446,462_14_10,MALTA,0,TOTALS,MALTA,200,20,65,30.8,13,42,31.0,7,23,30.4,12,20,60.0,13,38,51,15,16,17,11,9,59,1
17733,412459,462_14_10,GIBRALTAR,0,TOTALS,GIBRALTAR,200,13,65,20.0,12,54,22.2,1,11,9.1,6,16,37.5,18,33,51,7,14,22,7,4,33,0
17734,416210,466_14_01,SOLOMON ISLANDS,0,TOTALS,SOLOMON ISLANDS,200,5,43,11.6,5,35,14.3,0,8,0.0,3,6,50.0,7,22,29,4,13,33,4,0,13,0
17735,416221,466_14_01,GUAM,0,TOTALS,GUAM,200,38,70,54.3,33,57,57.9,5,13,38.5,7,11,63.6,13,27,40,18,15,14,11,2,88,1
17736,416232,466_14_02,TAHITI,0,TOTALS,TAHITI,200,10,62,16.1,6,37,16.2,4,25,16.0,3,9,33.3,9,15,24,2,20,31,5,1,27,1
17737,416243,466_14_02,NEW ZEALAND,0,TOTALS,NEW ZEALAND,200,49,77,63.6,36,56,64.3,13,21,61.9,15,31,48.4,17,35,52,19,9,16,17,4,126,0
17738,416254,466_14_03,AUSTRALIA,0,TOTALS,AUSTRALIA,200,43,74,58.1,34,51,66.7,9,23,39.1,17,30,56.7,15,31,46,19,18,22,5,4,112,0
17739,416265,466_14_03,NEW CALEDONIA,0,TOTALS,NEW CALEDONIA,200,13,47,27.7,7,28,25.0,6,19,31.6,6,16,37.5,2,20,22,4,24,39,3,1,38,1
17740,416276,466_14_04,AMERICAN SAMOA,0,TOTALS,AMERICAN SAMOA,200,28,80,35.0,28,73,38.4,0,7,0.0,5,20,25.0,18,33,51,5,21,37,15,3,61,1
17741,416287,466_14_04,FIJI,0,TOTALS,FIJI,200,13,61,21.3,7,39,17.9,6,22,27.3,15,26,57.7,14,35,49,3,24,42,15,5,47,0
17742,416298,466_14_05,SOLOMON ISLANDS,0,TOTALS,SOLOMON ISLANDS,200,12,66,18.2,10,54,18.5,2,12,16.7,7,24,29.2,10,17,27,3,27,43,4,0,33,1
17743,416309,466_14_05,SAMOA,0,TOTALS,SAMOA,200,43,98,43.9,42,81,51.9,1,17,5.9,18,39,46.2,40,47,87,13,21,36,6,4,105,0
17744,416317,466_14_06,PAPUA NEW GUINEA,0,TOTALS,PAPUA NEW GUINEA,240,12,60,20.0,10,34,29.4,2,26,7.7,9,20,45.0,8,17,25,3,4,22,4,3,35,0
17745,416328,466_14_06,NEW ZEALAND,0,TOTALS,NEW ZEALAND,200,38,85,44.7,30,59,50.8,8,26,30.8,1,3,33.3,29,32,61,10,12,10,4,2,85,1
17746,416339,466_14_07,GUAM,0,TOTALS,GUAM,200,17,75,22.7,14,53,26.4,3,22,13.6,17,29,58.6,20,25,45,3,32,21,6,4,54,0
17747,416350,466_14_07,NEW CALEDONIA,0,TOTALS,NEW CALEDONIA,200,18,57,31.6,16,45,35.6,2,12,16.7,21,38,55.3,11,35,46,2,26,26,2,4,59,1
17748,416361,466_14_08,TAHITI,0,TOTALS,TAHITI,200,17,64,26.6,14,50,28.0,3,14,21.4,18,44,40.9,15,30,45,4,22,29,5,4,55,1
17749,416372,466_14_08,AMERICAN SAMOA,0,TOTALS,AMERICAN SAMOA,200,18,65,27.7,17,57,29.8,1,8,12.5,11,22,50.0,16,31,47,2,34,29,10,2,48,0
17750,416383,466_14_09,SAMOA,0,TOTALS,SAMOA,200,11,55,20.0,9,39,23.1,2,16,12.5,2,9,22.2,5,14,19,3,25,32,5,3,26,1
17751,416394,466_14_09,AUSTRALIA,0,TOTALS,AUSTRALIA,200,49,84,58.3,38,60,63.3,11,24,45.8,21,32,65.6,17,37,54,29,6,10,8,4,130,0
17752,416405,466_14_10,NEW CALEDONIA,0,TOTALS,NEW CALEDONIA,200,33,82,40.2,28,57,49.1,5,25,20.0,21,37,56.8,23,34,57,6,14,31,9,1,92,1
17753,416416,466_14_10,SOLOMON ISLANDS,0,TOTALS,SOLOMON ISLANDS,200,11,65,16.9,10,51,19.6,1,14,7.1,4,12,33.3,17,18,35,0,31,49,3,2,27,0
17754,416427,466_14_11,FIJI,0,TOTALS,FIJI,200,17,72,23.6,15,52,28.8,2,20,10.0,10,35,28.6,21,29,50,0,29,26,3,0,46,0
17755,416438,466_14_11,TAHITI,0,TOTALS,TAHITI,200,23,65,35.4,19,36,52.8,4,29,13.8,11,32,34.4,15,35,50,13,26,30,2,3,61,1
17756,416449,466_14_12,AUSTRALIA,0,TOTALS,AUSTRALIA,200,39,67,58.2,31,44,70.5,8,23,34.8,17,27,63.0,19,27,46,14,13,19,2,3,103,0
17757,416460,466_14_12,GUAM,0,TOTALS,GUAM,200,16,54,29.6,13,34,38.2,3,20,15.0,5,10,50.0,7,13,20,7,23,21,1,0,40,1
17758,416471,466_14_13,NEW CALEDONIA,0,TOTALS,NEW CALEDONIA,200,41,78,52.6,39,69,56.5,2,9,22.2,25,45,55.6,22,34,56,4,24,28,10,3,109,0
17759,416482,466_14_13,SAMOA,0,TOTALS,SAMOA,200,26,80,32.5,24,63,38.1,2,17,11.8,10,25,40.0,17,23,40,1,33,39,6,5,64,1
17760,416487,466_14_14,PAPUA NEW GUINEA,0,TOTALS,PAPUA NEW GUINEA,125,6,25,24.0,6,19,31.6,0,6,0.0,6,8,75.0,7,13,20,7,6,17,3,0,18,0
17761,416498,466_14_14,TAHITI,0,TOTALS,TAHITI,200,24,75,32.0,20,46,43.5,4,29,13.8,10,19,52.6,21,33,54,12,15,20,13,2,62,1
17762,416509,466_14_15,NEW ZEALAND,0,TOTALS,NEW ZEALAND,200,49,76,64.5,40,60,66.7,9,16,56.2,8,18,44.4,20,31,51,21,6,12,7,3,115,0
17763,416520,466_14_15,FIJI,0,TOTALS,FIJI,200,7,51,13.7,1,18,5.6,6,33,18.2,0,0,0.0,7,7,14,0,22,29,3,0,20,1
17764,416531,466_14_16,GUAM,0,TOTALS,GUAM,200,41,93,44.1,39,85,45.9,2,8,25.0,20,30,66.7,23,12,35,12,14,21,8,2,104,0
17765,416542,466_14_16,SAMOA,0,TOTALS,SAMOA,200,30,68,44.1,27,60,45.0,3,8,37.5,6,11,54.5,18,30,48,11,29,51,6,6,69,1
17766,416553,466_14_17,NEW ZEALAND,0,TOTALS,NEW ZEALAND,200,42,81,51.9,33,55,60.0,9,26,34.6,13,22,59.1,25,32,57,17,17,14,5,4,106,0
17767,416564,466_14_17,AMERICAN SAMOA,0,TOTALS,AMERICAN SAMOA,200,9,48,18.8,8,35,22.9,1,13,7.7,1,14,7.1,6,16,22,1,21,27,4,1,20,1
17768,416575,466_14_18,AUSTRALIA,0,TOTALS,AUSTRALIA,200,42,94,44.7,30,42,71.4,12,52,23.1,7,9,77.8,32,41,73,16,10,9,4,3,103,0
17769,416586,466_14_18,SOLOMON ISLANDS,0,TOTALS,SOLOMON ISLANDS,200,7,56,12.5,5,33,15.2,2,23,8.7,2,6,33.3,4,16,20,0,10,21,0,0,18,1
17770,416597,466_14_19,FIJI,0,TOTALS,FIJI,200,25,75,33.3,14,51,27.5,11,24,45.8,2,9,22.2,16,20,36,13,22,25,16,3,63,1
17771,416604,466_14_19,PAPUA NEW GUINEA,0,TOTALS,PAPUA NEW GUINEA,200,19,53,35.8,18,48,37.5,1,5,20.0,9,22,40.9,12,26,38,7,13,37,5,7,48,0
17772,416615,466_14_20,SOLOMON ISLANDS,0,TOTALS,SOLOMON ISLANDS,200,20,82,24.4,18,68,26.5,2,14,14.3,8,15,53.3,18,26,44,2,14,22,3,0,50,0
17773,416622,466_14_20,PAPUA NEW GUINEA,0,TOTALS,PAPUA NEW GUINEA,200,46,98,46.9,44,90,48.9,2,8,25.0,4,10,40.0,22,39,61,6,9,12,6,12,98,1
17774,416633,466_14_21,GUAM,0,TOTALS,GUAM,200,25,83,30.1,22,70,31.4,3,13,23.1,15,29,51.7,21,33,54,8,10,16,14,3,68,1
17775,416644,466_14_21,FIJI,0,TOTALS,FIJI,200,11,58,19.0,8,40,20.0,3,18,16.7,4,9,44.4,11,34,45,5,27,34,3,4,29,0
17776,416655,466_14_22,AUSTRALIA,0,TOTALS,AUSTRALIA,200,48,77,62.3,43,62,69.4,5,15,33.3,11,20,55.0,20,26,46,17,17,13,4,1,112,0
17777,416666,466_14_22,TAHITI,0,TOTALS,TAHITI,200,11,43,25.6,7,27,25.9,4,16,25.0,8,17,47.1,6,11,17,2,16,29,0,1,34,1
17778,416677,466_14_23,AMERICAN SAMOA,0,TOTALS,AMERICAN SAMOA,200,29,74,39.2,27,62,43.5,2,12,16.7,3,13,23.1,14,29,43,4,20,36,8,6,63,0
17779,416688,466_14_23,SAMOA,0,TOTALS,SAMOA,200,29,88,33.0,28,82,34.1,1,6,16.7,9,26,34.6,26,25,51,6,15,30,4,2,68,1
17780,416699,466_14_24,NEW ZEALAND,0,TOTALS,NEW ZEALAND,200,36,75,48.0,24,47,51.1,12,28,42.9,22,31,71.0,22,28,50,25,18,20,10,4,106,0
17781,416710,466_14_24,NEW CALEDONIA,0,TOTALS,NEW CALEDONIA,200,18,53,34.0,14,38,36.8,4,15,26.7,5,17,29.4,3,15,18,10,21,28,9,4,45,1
17782,416721,466_14_25,FIJI,0,TOTALS,FIJI,200,20,61,32.8,16,43,37.2,4,18,22.2,11,25,44.0,13,27,40,5,15,30,5,0,55,1
17783,416732,466_14_25,AMERICAN SAMOA,0,TOTALS,AMERICAN SAMOA,200,21,69,30.4,20,59,33.9,1,10,10.0,4,10,40.0,14,25,39,9,24,24,4,6,47,0
17784,416743,466_14_26,GUAM,0,TOTALS,GUAM,200,40,88,45.5,38,80,47.5,2,8,25.0,13,26,50.0,17,24,41,7,21,16,6,5,95,1
17785,416754,466_14_26,SAMOA,0,TOTALS,SAMOA,200,29,77,37.7,26,69,37.7,3,8,37.5,13,31,41.9,26,31,57,12,23,33,3,6,74,0
17786,416765,466_14_27,TAHITI,0,TOTALS,TAHITI,200,20,60,33.3,16,37,43.2,4,23,17.4,12,36,33.3,9,29,38,8,26,21,12,3,56,0
17787,416776,466_14_27,NEW CALEDONIA,0,TOTALS,NEW CALEDONIA,200,26,73,35.6,23,63,36.5,3,10,30.0,8,17,47.1,19,36,55,14,32,31,8,1,63,1
17788,416787,466_14_28,AUSTRALIA,0,TOTALS,AUSTRALIA,200,29,66,43.9,17,42,40.5,12,24,50.0,14,21,66.7,9,23,32,16,24,19,6,2,84,1
17789,416798,466_14_28,NEW ZEALAND,0,TOTALS,NEW ZEALAND,200,31,70,44.3,28,54,51.9,3,16,18.8,16,22,72.7,10,23,33,14,22,15,3,7,81,0
17790,417417,468_15_01,ARGENTINA,0,TOTALS,ARGENTINA,200,22,68,32.4,15,38,39.5,7,30,23.3,13,23,56.5,17,24,41,13,22,12,6,0,64,0
17791,417430,468_15_01,TURKEY,0,TOTALS,TURKEY,200,27,61,44.3,21,41,51.2,6,20,30.0,14,23,60.9,12,34,46,17,19,17,6,7,74,1
17792,417443,468_15_02,ITALY,0,TOTALS,ITALY,200,36,77,46.8,25,43,58.1,11,34,32.4,6,12,50.0,19,32,51,22,26,13,8,4,89,1
17793,417456,468_15_02,TUNISIA,0,TOTALS,TUNISIA,200,19,54,35.2,18,39,46.2,1,15,6.7,23,34,67.6,8,25,33,7,15,18,6,2,62,0
17794,417469,468_15_03,CANADA,0,TOTALS,CANADA,200,27,64,42.2,21,39,53.8,6,25,24.0,14,25,56.0,16,34,50,10,19,21,8,9,74,1
17795,417482,468_15_03,AUSTRALIA,0,TOTALS,AUSTRALIA,200,29,81,35.8,24,56,42.9,5,25,20.0,8,13,61.5,21,27,48,16,20,15,9,1,71,0
17796,417495,468_15_04,SPAIN,0,TOTALS,SPAIN,200,31,62,50.0,19,39,48.7,12,23,52.2,10,12,83.3,6,20,26,26,21,17,11,5,84,1
17797,417508,468_15_04,CHINA,0,TOTALS,CHINA,200,26,56,46.4,23,40,57.5,3,16,18.8,18,27,66.7,9,25,34,15,19,21,8,2,73,0
17798,417521,468_15_05,IRAN,0,TOTALS,IRAN,200,19,58,32.8,13,40,32.5,6,18,33.3,9,17,52.9,16,30,46,15,29,33,8,2,53,0
17799,417534,468_15_05,USA,0,TOTALS,USA,200,29,76,38.2,27,61,44.3,2,15,13.3,23,37,62.2,26,25,51,19,22,17,20,7,83,1
17800,417547,468_15_06,DOMINICAN REPUBLIC,0,TOTALS,DOMINICAN REPUBLIC,200,23,61,37.7,17,44,38.6,6,17,35.3,25,39,64.1,17,21,38,7,29,13,10,2,77,0
17801,417560,468_15_06,SERBIA,0,TOTALS,SERBIA,200,27,61,44.3,21,41,51.2,6,20,30.0,22,36,61.1,14,24,38,15,28,17,6,1,82,1
17802,417573,468_15_07,CROATIA,0,TOTALS,CROATIA,200,41,76,53.9,38,59,64.4,3,17,17.6,26,34,76.5,18,31,49,20,29,16,15,4,111,0
17803,417586,468_15_07,EGYPT,0,TOTALS,EGYPT,200,21,59,35.6,18,39,46.2,3,20,15.0,23,34,67.6,10,16,26,7,28,27,11,1,68,1
17804,417599,468_15_08,KOREA,0,TOTALS,KOREA,200,19,72,26.4,9,39,23.1,10,33,30.3,7,11,63.6,8,22,30,18,23,13,8,2,55,0
17805,417612,468_15_08,GREECE,0,TOTALS,GREECE,200,35,65,53.8,33,55,60.0,2,10,20.0,11,17,64.7,11,46,57,24,18,19,4,6,83,1
17806,417625,468_15_09,CHINA,0,TOTALS,CHINA,200,22,53,41.5,13,32,40.6,9,21,42.9,21,25,84.0,11,31,42,11,18,21,7,3,74,1
17807,417638,468_15_09,ARGENTINA,0,TOTALS,ARGENTINA,200,26,76,34.2,22,47,46.8,4,29,13.8,11,16,68.8,18,23,41,16,22,12,11,2,67,0
17808,417651,468_15_10,AUSTRALIA,0,TOTALS,AUSTRALIA,200,27,68,39.7,24,55,43.6,3,13,23.1,10,17,58.8,20,29,49,17,13,20,9,4,67,0
17809,417664,468_15_10,ITALY,0,TOTALS,ITALY,200,24,66,36.4,12,38,31.6,12,28,42.9,9,12,75.0,15,23,38,14,18,16,11,6,69,1
17810,417677,468_15_11,TUNISIA,0,TOTALS,TUNISIA,200,12,64,18.8,8,36,22.2,4,28,14.3,8,14,57.1,11,17,28,10,15,20,14,3,36,0
17811,417690,468_15_11,CANADA,0,TOTALS,CANADA,200,36,70,51.4,21,37,56.8,15,33,45.5,6,11,54.5,17,41,58,25,18,26,16,5,93,1
17812,417703,468_15_12,TURKEY,0,TOTALS,TURKEY,200,27,68,39.7,20,50,40.0,7,18,38.9,11,18,61.1,18,25,43,25,17,8,6,2,72,1
17813,417716,468_15_12,SPAIN,0,TOTALS,SPAIN,200,23,60,38.3,18,38,47.4,5,22,22.7,14,21,66.7,13,26,39,12,22,10,4,3,65,0
17814,417729,468_15_13,SERBIA,0,TOTALS,SERBIA,200,46,71,64.8,41,65,63.1,5,6,83.3,16,27,59.3,14,33,47,36,27,17,10,4,113,0
17815,417742,468_15_13,KOREA,0,TOTALS,KOREA,200,24,71,33.8,14,48,29.2,10,23,43.5,25,31,80.6,14,15,29,18,20,13,7,2,83,1
17816,417755,468_15_14,USA,0,TOTALS,USA,200,44,84,52.4,42,73,57.5,2,11,18.2,13,19,68.4,17,24,41,24,22,12,18,6,103,0
17817,417768,468_15_14,CROATIA,0,TOTALS,CROATIA,200,28,63,44.4,26,51,51.0,2,12,16.7,23,33,69.7,15,27,42,24,18,25,6,2,81,1
17818,417781,468_15_15,EGYPT,0,TOTALS,EGYPT,200,18,54,33.3,14,42,33.3,4,12,33.3,22,32,68.8,9,24,33,13,27,17,16,5,62,1
17819,417794,468_15_15,IRAN,0,TOTALS,IRAN,200,20,61,32.8,17,40,42.5,3,21,14.3,16,25,64.0,19,31,50,14,26,27,13,2,59,0
17820,417807,468_15_16,GREECE,0,TOTALS,GREECE,200,24,59,40.7,18,37,48.6,6,22,27.3,16,25,64.0,7,34,41,15,18,11,11,7,70,1
17821,417820,468_15_16,DOMINICAN REPUBLIC,0,TOTALS,DOMINICAN REPUBLIC,200,26,72,36.1,20,58,34.5,6,14,42.9,7,12,58.3,12,28,40,16,23,12,4,3,65,0
17822,417833,468_15_17,ARGENTINA,0,TOTALS,ARGENTINA,200,17,73,23.3,11,44,25.0,6,29,20.7,11,16,68.8,19,19,38,11,31,17,14,0,51,0
17823,417846,468_15_17,SPAIN,0,TOTALS,SPAIN,200,19,51,37.3,10,24,41.7,9,27,33.3,28,37,75.7,15,34,49,15,18,25,9,8,75,1
17824,417859,468_15_18,CHINA,0,TOTALS,CHINA,200,19,57,33.3,14,34,41.2,5,23,21.7,8,12,66.7,8,27,35,19,20,23,12,2,51,0
17825,417872,468_15_18,TURKEY,0,TOTALS,TURKEY,200,24,66,36.4,21,48,43.8,3,18,16.7,11,18,61.1,17,31,48,21,17,21,17,5,62,1
17826,417885,468_15_19,CROATIA,0,TOTALS,CROATIA,200,34,61,55.7,28,44,63.6,6,17,35.3,12,18,66.7,13,35,48,30,18,19,12,2,86,1
17827,417898,468_15_19,IRAN,0,TOTALS,IRAN,200,12,52,23.1,11,38,28.9,1,14,7.1,11,19,57.9,8,17,25,8,17,23,7,1,36,0
17828,417911,468_15_20,USA,0,TOTALS,USA,200,38,68,55.9,33,52,63.5,5,16,31.2,11,22,50.0,10,37,47,27,24,15,13,9,92,1
17829,417924,468_15_20,EGYPT,0,TOTALS,EGYPT,200,20,71,28.2,18,57,31.6,2,14,14.3,8,18,44.4,20,26,46,15,19,22,7,3,50,0
17830,417937,468_15_21,CANADA,0,TOTALS,CANADA,200,27,64,42.2,19,43,44.2,8,21,38.1,16,26,61.5,13,36,49,11,21,11,6,5,78,1
17831,417950,468_15_21,ITALY,0,TOTALS,ITALY,200,18,71,25.4,14,41,34.1,4,30,13.3,14,19,73.7,14,26,40,13,22,10,7,3,54,0
17832,417963,468_15_22,TUNISIA,0,TOTALS,TUNISIA,200,23,65,35.4,18,50,36.0,5,15,33.3,13,17,76.5,8,17,25,19,20,18,13,3,64,0
17833,417976,468_15_22,AUSTRALIA,0,TOTALS,AUSTRALIA,200,36,65,55.4,26,36,72.2,10,29,34.5,11,15,73.3,13,38,51,24,20,25,10,7,93,1
17834,417989,468_15_23,DOMINICAN REPUBLIC,0,TOTALS,DOMINICAN REPUBLIC,200,43,71,60.6,40,59,67.8,3,12,25.0,13,19,68.4,15,28,43,24,18,15,9,2,102,0
17835,418002,468_15_23,KOREA,0,TOTALS,KOREA,200,31,72,43.1,18,35,51.4,13,37,35.1,14,18,77.8,14,16,30,27,19,16,7,1,89,1
17836,418015,468_15_24,GREECE,0,TOTALS,GREECE,200,20,57,35.1,16,39,41.0,4,18,22.2,25,38,65.8,11,27,38,12,20,14,17,5,69,1
17837,418028,468_15_24,SERBIA,0,TOTALS,SERBIA,200,23,64,35.9,19,47,40.4,4,17,23.5,10,13,76.9,16,29,45,14,28,23,8,4,60,0
17838,418041,468_15_25,EGYPT,0,TOTALS,EGYPT,200,23,58,39.7,21,48,43.8,2,10,20.0,12,20,60.0,14,29,43,12,20,23,5,9,60,0
17839,418054,468_15_25,SPAIN,0,TOTALS,SPAIN,200,21,75,28.0,12,42,28.6,9,33,27.3,16,22,72.7,27,24,51,16,19,17,12,2,67,1
17840,418067,468_15_26,IRAN,0,TOTALS,IRAN,200,25,58,43.1,20,41,48.8,5,17,29.4,8,14,57.1,7,27,34,13,19,19,9,2,63,0
17841,418080,468_15_26,TURKEY,0,TOTALS,TURKEY,200,27,69,39.1,21,47,44.7,6,22,27.3,13,17,76.5,18,24,42,18,18,18,10,1,73,1
17842,418093,468_15_27,ITALY,0,TOTALS,ITALY,200,28,55,50.9,21,34,61.8,7,21,33.3,19,26,73.1,4,24,28,19,26,12,9,4,82,1
17843,418106,468_15_27,DOMINICAN REPUBLIC,0,TOTALS,DOMINICAN REPUBLIC,200,27,71,38.0,25,60,41.7,2,11,18.2,17,25,68.0,22,28,50,9,22,16,7,1,73,0
17844,418119,468_15_28,CROATIA,0,TOTALS,CROATIA,200,32,72,44.4,26,49,53.1,6,23,26.1,5,9,55.6,14,31,45,21,18,9,2,2,75,1
17845,418132,468_15_28,CHINA,0,TOTALS,CHINA,200,25,61,41.0,18,34,52.9,7,27,25.9,11,15,73.3,8,30,38,23,10,10,7,0,68,0
17846,418145,468_15_29,CANADA,0,TOTALS,CANADA,200,40,78,51.3,36,60,60.0,4,18,22.2,16,25,64.0,16,40,56,26,15,20,12,1,100,0
17847,418158,468_15_29,KOREA,0,TOTALS,KOREA,200,26,80,32.5,18,46,39.1,8,34,23.5,4,10,40.0,17,24,41,14,22,22,8,1,64,1
17848,418171,468_15_30,USA,0,TOTALS,USA,200,36,62,58.1,29,42,69.0,7,20,35.0,14,20,70.0,11,42,53,21,19,26,15,9,93,1
17849,418184,468_15_30,ARGENTINA,0,TOTALS,ARGENTINA,200,13,62,21.0,9,39,23.1,4,23,17.4,15,22,68.2,9,18,27,12,23,23,9,0,45,0
17850,418197,468_15_31,AUSTRALIA,0,TOTALS,AUSTRALIA,200,24,62,38.7,18,46,39.1,6,16,37.5,15,22,68.2,10,28,38,5,26,14,12,3,69,1
17851,418210,468_15_31,SERBIA,0,TOTALS,SERBIA,200,19,58,32.8,16,45,35.6,3,13,23.1,15,24,62.5,12,31,43,8,23,20,5,5,56,0
17852,418223,468_15_32,TUNISIA,0,TOTALS,TUNISIA,200,19,62,30.6,14,36,38.9,5,26,19.2,5,7,71.4,15,10,25,7,18,24,9,0,48,1
17853,418236,468_15_32,GREECE,0,TOTALS,GREECE,200,38,61,62.3,26,38,68.4,12,23,52.2,12,15,80.0,15,29,44,34,15,20,18,6,100,0
17854,418249,468_15_33,ARGENTINA,0,TOTALS,ARGENTINA,200,27,64,42.2,15,32,46.9,12,32,37.5,5,12,41.7,7,22,29,17,15,13,13,1,71,1
17855,418262,468_15_33,DOMINICAN REPUBLIC,0,TOTALS,DOMINICAN REPUBLIC,200,28,63,44.4,24,49,49.0,4,14,28.6,6,11,54.5,14,30,44,15,19,21,3,2,66,0
17856,418275,468_15_34,CHINA,0,TOTALS,CHINA,200,18,60,30.0,14,38,36.8,4,22,18.2,14,19,73.7,16,29,45,15,12,18,6,2,54,0
17857,418288,468_15_34,KOREA,0,TOTALS,KOREA,200,31,64,48.4,22,37,59.5,9,27,33.3,6,15,40.0,8,27,35,23,17,13,9,2,77,1
17858,418301,468_15_35,TURKEY,0,TOTALS,TURKEY,200,33,67,49.3,28,54,51.9,5,13,38.5,10,12,83.3,12,26,38,24,17,17,9,3,81,1
17859,418314,468_15_35,AUSTRALIA,0,TOTALS,AUSTRALIA,200,27,61,44.3,23,43,53.5,4,18,22.2,12,14,85.7,7,23,30,15,20,16,9,1,70,0
17860,418327,468_15_36,EGYPT,0,TOTALS,EGYPT,200,30,72,41.7,23,53,43.4,7,19,36.8,14,23,60.9,18,30,48,22,16,19,14,6,81,1
17861,418340,468_15_36,TUNISIA,0,TOTALS,TUNISIA,200,27,69,39.1,19,44,43.2,8,25,32.0,6,16,37.5,16,28,44,13,24,23,12,2,68,0
17862,418353,468_15_37,CROATIA,0,TOTALS,CROATIA,200,32,65,49.2,26,44,59.1,6,21,28.6,14,25,56.0,15,31,46,18,24,16,8,3,84,1
17863,418366,468_15_37,CANADA,0,TOTALS,CANADA,200,26,69,37.7,18,44,40.9,8,25,32.0,11,22,50.0,16,21,37,15,26,16,6,2,71,0
17864,418379,468_15_38,IRAN,0,TOTALS,IRAN,200,23,67,34.3,15,42,35.7,8,25,32.0,16,25,64.0,13,20,33,16,25,14,10,2,70,0
17865,418392,468_15_38,SERBIA,0,TOTALS,SERBIA,200,32,64,50.0,26,46,56.5,6,18,33.3,13,21,61.9,13,33,46,19,24,17,7,3,83,1
17866,418405,468_15_39,USA,0,TOTALS,USA,200,32,59,54.2,27,50,54.0,5,9,55.6,17,22,77.3,16,31,47,14,21,22,12,5,86,1
17867,418418,468_15_39,ITALY,0,TOTALS,ITALY,200,22,65,33.8,16,43,37.2,6,22,27.3,15,22,68.2,15,13,28,16,20,18,8,4,65,0
17868,418431,468_15_40,SPAIN,0,TOTALS,SPAIN,200,20,59,33.9,18,44,40.9,2,15,13.3,17,25,68.0,14,26,40,16,21,13,6,4,59,0
17869,418444,468_15_40,GREECE,0,TOTALS,GREECE,200,25,63,39.7,18,42,42.9,7,21,33.3,13,21,61.9,11,30,41,13,25,9,8,3,70,1
17870,418457,468_15_41,DOMINICAN REPUBLIC,0,TOTALS,DOMINICAN REPUBLIC,200,29,65,44.6,20,43,46.5,9,22,40.9,11,21,52.4,19,37,56,24,9,29,13,10,78,1
17871,418470,468_15_41,TUNISIA,0,TOTALS,TUNISIA,200,25,76,32.9,22,52,42.3,3,24,12.5,6,11,54.5,15,22,37,10,18,18,14,4,59,0
17872,418483,468_15_42,CHINA,0,TOTALS,CHINA,200,19,59,32.2,15,34,44.1,4,25,16.0,17,26,65.4,14,26,40,17,17,18,10,3,59,0
17873,418496,468_15_42,IRAN,0,TOTALS,IRAN,200,22,55,40.0,13,37,35.1,9,18,50.0,11,17,64.7,9,31,40,10,22,21,9,3,64,1
17874,418509,468_15_43,CANADA,0,TOTALS,CANADA,200,25,65,38.5,19,53,35.8,6,12,50.0,10,16,62.5,19,31,50,8,13,22,8,5,66,1
17875,418522,468_15_43,AUSTRALIA,0,TOTALS,AUSTRALIA,200,22,64,34.4,16,37,43.2,6,27,22.2,8,11,72.7,12,23,35,11,19,18,11,4,58,0
17876,418535,468_15_44,ARGENTINA,0,TOTALS,ARGENTINA,200,24,52,46.2,17,30,56.7,7,22,31.8,19,24,79.2,7,36,43,17,13,19,6,3,74,1
17877,418548,468_15_44,EGYPT,0,TOTALS,EGYPT,200,24,76,31.6,16,49,32.7,8,27,29.6,8,11,72.7,15,23,38,16,21,11,11,4,64,0
17878,418561,468_15_45,ITALY,0,TOTALS,ITALY,225,30,81,37.0,23,46,50.0,7,35,20.0,16,22,72.7,16,31,47,25,23,14,20,1,83,1
17879,418574,468_15_45,SPAIN,0,TOTALS,SPAIN,225,27,66,40.9,18,39,46.2,9,27,33.3,14,18,77.8,9,36,45,21,21,23,9,0,77,0
17880,418587,468_15_46,KOREA,0,TOTALS,KOREA,225,40,74,54.1,31,49,63.3,9,25,36.0,20,32,62.5,11,18,29,24,28,21,17,2,109,0
17881,418600,468_15_46,SERBIA,0,TOTALS,SERBIA,225,45,83,54.2,42,72,58.3,3,11,27.3,20,28,71.4,23,25,48,22,26,23,11,5,113,1
17882,418613,468_15_47,CROATIA,0,TOTALS,CROATIA,200,32,56,57.1,28,42,66.7,4,14,28.6,23,29,79.3,10,35,45,23,13,15,7,1,91,1
17883,418626,468_15_47,TURKEY,0,TOTALS,TURKEY,200,24,69,34.8,21,49,42.9,3,20,15.0,5,6,83.3,10,16,26,15,24,11,6,1,56,0
17884,418639,468_15_48,USA,0,TOTALS,USA,200,28,58,48.3,22,42,52.4,6,16,37.5,20,32,62.5,14,30,44,10,28,22,8,4,82,1
17885,418652,468_15_48,GREECE,0,TOTALS,GREECE,200,24,58,41.4,14,33,42.4,10,25,40.0,18,32,56.2,11,22,33,16,29,19,7,3,76,0
17886,418665,468_15_49,TUNISIA,0,TOTALS,TUNISIA,200,24,67,35.8,16,36,44.4,8,31,25.8,12,19,63.2,14,25,39,12,25,11,5,1,68,0
17887,418678,468_15_49,CHINA,0,TOTALS,CHINA,200,24,59,40.7,10,22,45.5,14,37,37.8,18,26,69.2,14,31,45,22,18,15,4,3,80,1
17888,418691,468_15_50,DOMINICAN REPUBLIC,0,TOTALS,DOMINICAN REPUBLIC,200,29,70,41.4,23,52,44.2,6,18,33.3,7,8,87.5,13,34,47,16,21,20,17,3,71,1
17889,418704,468_15_50,IRAN,0,TOTALS,IRAN,200,16,56,28.6,12,37,32.4,4,19,21.1,14,23,60.9,11,28,39,11,14,25,7,5,50,0
17890,418717,468_15_51,SPAIN,0,TOTALS,SPAIN,200,24,61,39.3,21,43,48.8,3,18,16.7,21,26,80.8,12,14,26,14,20,19,16,4,72,1
17891,418730,468_15_51,AUSTRALIA,0,TOTALS,AUSTRALIA,200,38,68,55.9,27,44,61.4,11,24,45.8,16,22,72.7,17,24,41,24,22,21,9,4,103,0
17892,418743,468_15_52,EGYPT,0,TOTALS,EGYPT,200,44,88,50.0,43,78,55.1,1,10,10.0,12,20,60.0,25,31,56,19,21,17,12,2,101,0
17893,418756,468_15_52,KOREA,0,TOTALS,KOREA,200,32,73,43.8,21,44,47.7,11,29,37.9,13,27,48.1,17,20,37,24,20,18,7,2,88,1
17894,418769,468_15_53,ITALY,0,TOTALS,ITALY,200,15,66,22.7,10,37,27.0,5,29,17.2,9,9,100.0,10,24,34,9,23,17,7,4,44,0
17895,418782,468_15_53,CANADA,0,TOTALS,CANADA,200,26,65,40.0,20,48,41.7,6,17,35.3,19,26,73.1,18,40,58,17,15,17,10,6,77,1
17896,418795,468_15_54,ARGENTINA,0,TOTALS,ARGENTINA,200,25,55,45.5,10,24,41.7,15,31,48.4,11,21,52.4,6,20,26,19,25,17,14,0,76,0
17897,418808,468_15_54,SERBIA,0,TOTALS,SERBIA,200,27,54,50.0,21,34,61.8,6,20,30.0,17,25,68.0,12,30,42,15,23,22,10,2,77,1
17898,418821,468_15_55,GREECE,0,TOTALS,GREECE,200,24,61,39.3,18,46,39.1,6,15,40.0,17,24,70.8,12,33,45,15,20,17,3,1,71,0
17899,418834,468_15_55,TURKEY,0,TOTALS,TURKEY,200,32,75,42.7,27,51,52.9,5,24,20.8,11,16,68.8,12,28,40,16,24,6,10,4,80,1
17900,418847,468_15_56,USA,0,TOTALS,USA,225,29,79,36.7,20,59,33.9,9,20,45.0,12,18,66.7,20,32,52,19,23,14,5,5,79,1
17901,418860,468_15_56,CROATIA,0,TOTALS,CROATIA,225,27,74,36.5,24,53,45.3,3,21,14.3,14,23,60.9,20,30,50,16,19,16,7,5,71,0
17902,420328,470_15_01,EGYPT,0,TOTALS,EGYPT,200,35,76,46.1,23,40,57.5,12,36,33.3,14,20,70.0,22,31,53,21,23,19,9,6,96,1
17903,420341,470_15_01,GABON,0,TOTALS,GABON,200,18,53,34.0,18,35,51.4,0,18,0.0,13,25,52.0,5,21,26,8,16,19,10,2,49,0
17904,420354,470_15_02,NIGERIA,0,TOTALS,NIGERIA,200,30,57,52.6,22,35,62.9,8,22,36.4,20,34,58.8,14,37,51,19,27,22,10,0,88,1
17905,420367,470_15_02,CAF,0,TOTALS,CAF,200,18,60,30.0,11,29,37.9,7,31,22.6,20,30,66.7,5,19,24,11,29,21,11,1,63,0
17906,420380,470_15_03,MALI,0,TOTALS,MALI,200,14,49,28.6,12,32,37.5,2,17,11.8,26,33,78.8,9,32,41,8,22,19,3,1,56,0
17907,420393,470_15_03,CAMEROON,0,TOTALS,CAMEROON,200,23,64,35.9,15,32,46.9,8,32,25.0,16,29,55.2,11,26,37,13,26,12,5,1,70,1
17908,420406,470_15_04,TUNISIA,0,TOTALS,TUNISIA,200,28,71,39.4,22,48,45.8,6,23,26.1,15,20,75.0,13,35,48,17,19,11,8,4,77,1
17909,420418,470_15_04,UGANDA,0,TOTALS,UGANDA,200,20,63,31.7,13,37,35.1,7,26,26.9,8,11,72.7,9,30,39,9,24,17,0,2,55,0
17910,420430,470_15_05,COTE D'IVOIRE,0,TOTALS,COTE D'IVOIRE,200,17,54,31.5,15,34,44.1,2,20,10.0,20,31,64.5,10,33,43,10,15,29,7,1,56,0
17911,420443,470_15_05,CAPE VERDE,0,TOTALS,CAPE VERDE,184,27,72,37.5,15,36,41.7,12,36,33.3,7,10,70.0,16,30,46,19,22,22,11,4,73,1
17912,420456,470_15_06,ANGOLA,0,TOTALS,ANGOLA,200,25,53,47.2,18,32,56.2,7,21,33.3,27,38,71.1,15,30,45,11,34,22,8,2,84,1
17913,420469,470_15_06,MOZAMBIQUE,0,TOTALS,MOZAMBIQUE,200,18,54,33.3,15,32,46.9,3,22,13.6,33,43,76.7,7,19,26,9,29,16,10,0,72,0
17914,420482,470_15_07,ALGERIA,0,TOTALS,ALGERIA,200,29,67,43.3,22,46,47.8,7,21,33.3,22,35,62.9,15,35,50,14,27,12,4,4,87,1
17915,420495,470_15_07,ZIMBABWE,0,TOTALS,ZIMBABWE,200,21,67,31.3,17,48,35.4,4,19,21.1,21,35,60.0,17,26,43,5,27,17,7,5,67,0
17916,420508,470_15_08,SENEGAL,0,TOTALS,SENEGAL,200,26,61,42.6,19,33,57.6,7,28,25.0,18,26,69.2,11,30,41,16,19,19,8,2,77,1
17917,420521,470_15_08,MOROCCO,0,TOTALS,MOROCCO,200,30,63,47.6,28,51,54.9,2,12,16.7,9,16,56.2,7,26,33,18,21,20,7,1,71,0
17918,420534,470_15_09,GABON,0,TOTALS,GABON,200,17,55,30.9,14,37,37.8,3,18,16.7,17,34,50.0,17,20,37,7,29,27,16,4,54,0
17919,420547,470_15_09,MALI,0,TOTALS,MALI,200,23,52,44.2,11,28,39.3,12,24,50.0,20,28,71.4,14,29,43,12,28,29,12,4,78,1
17920,420559,470_15_10,UGANDA,0,TOTALS,UGANDA,200,19,62,30.6,13,33,39.4,6,29,20.7,15,31,48.4,11,27,38,12,23,16,2,0,59,0
17921,420572,470_15_10,NIGERIA,0,TOTALS,NIGERIA,200,30,63,47.6,15,29,51.7,15,34,44.1,23,30,76.7,6,37,43,23,29,13,10,4,98,1
17922,420585,470_15_11,EGYPT,0,TOTALS,EGYPT,200,29,62,46.8,19,39,48.7,10,23,43.5,15,33,45.5,13,28,41,20,33,18,11,2,83,1
17923,420598,470_15_11,CAMEROON,0,TOTALS,CAMEROON,200,19,60,31.7,12,30,40.0,7,30,23.3,32,42,76.2,16,28,44,8,29,23,6,3,77,0
17924,420611,470_15_12,TUNISIA,0,TOTALS,TUNISIA,200,21,58,36.2,17,31,54.8,4,27,14.8,22,32,68.8,14,29,43,12,24,16,10,3,68,1
17925,420624,470_15_12,CAF,0,TOTALS,CAF,200,17,56,30.4,13,30,43.3,4,26,15.4,14,30,46.7,14,28,42,7,27,18,7,0,52,0
17926,420636,470_15_13,COTE D'IVOIRE,0,TOTALS,COTE D'IVOIRE,200,22,59,37.3,15,31,48.4,7,28,25.0,13,22,59.1,12,29,41,15,20,15,12,1,64,1
17927,420649,470_15_13,ZIMBABWE,0,TOTALS,ZIMBABWE,200,18,56,32.1,13,33,39.4,5,23,21.7,11,23,47.8,15,29,44,9,20,21,4,3,52,0
17928,420662,470_15_14,MOZAMBIQUE,0,TOTALS,MOZAMBIQUE,200,25,68,36.8,19,44,43.2,6,24,25.0,20,29,69.0,9,17,26,10,20,7,7,1,76,0
17929,420675,470_15_14,SENEGAL,0,TOTALS,SENEGAL,200,33,61,54.1,25,39,64.1,8,22,36.4,12,16,75.0,11,34,45,21,25,22,3,3,86,1
17930,420688,470_15_15,CAPE VERDE,0,TOTALS,CAPE VERDE,200,29,73,39.7,19,36,52.8,10,37,27.0,10,12,83.3,7,26,33,13,17,10,14,5,78,1
17931,420701,470_15_15,ALGERIA,0,TOTALS,ALGERIA,200,26,62,41.9,23,46,50.0,3,16,18.8,14,19,73.7,12,36,48,13,19,23,5,1,69,0
17932,420714,470_15_16,ANGOLA,0,TOTALS,ANGOLA,200,20,52,38.5,15,32,46.9,5,20,25.0,23,30,76.7,15,20,35,8,27,19,8,1,68,1
17933,420727,470_15_16,MOROCCO,0,TOTALS,MOROCCO,200,22,49,44.9,19,35,54.3,3,14,21.4,20,28,71.4,10,20,30,13,28,16,7,0,67,0
17934,420740,470_15_17,CAMEROON,0,TOTALS,CAMEROON,200,24,57,42.1,12,30,40.0,12,27,44.4,33,47,70.2,11,33,44,16,29,24,14,3,93,1
17935,420753,470_15_17,GABON,0,TOTALS,GABON,200,22,65,33.8,16,37,43.2,6,28,21.4,17,20,85.0,9,26,35,8,36,27,13,4,67,0
17936,420766,470_15_18,CAF,0,TOTALS,CAF,200,21,61,34.4,15,38,39.5,6,23,26.1,12,21,57.1,14,35,49,5,28,18,5,0,60,1
17937,420778,470_15_18,UGANDA,0,TOTALS,UGANDA,200,18,64,28.1,11,36,30.6,7,28,25.0,13,32,40.6,17,31,48,15,20,12,4,2,56,0
17938,420791,470_15_19,MALI,0,TOTALS,MALI,200,15,50,30.0,9,23,39.1,6,27,22.2,13,18,72.2,7,28,35,11,20,18,6,0,49,0
17939,420804,470_15_19,EGYPT,0,TOTALS,EGYPT,200,19,53,35.8,13,23,56.5,6,30,20.0,11,20,55.0,8,28,36,8,20,15,6,2,55,1
17940,420817,470_15_20,NIGERIA,0,TOTALS,NIGERIA,200,19,53,35.8,12,31,38.7,7,22,31.8,14,17,82.4,13,23,36,9,16,22,5,5,59,0
17941,420830,470_15_20,TUNISIA,0,TOTALS,TUNISIA,200,25,61,41.0,15,34,44.1,10,27,37.0,10,16,62.5,15,21,36,19,19,16,10,4,70,1
17942,420843,470_15_21,ZIMBABWE,0,TOTALS,ZIMBABWE,200,21,57,36.8,17,35,48.6,4,22,18.2,19,27,70.4,18,29,47,14,28,27,4,3,65,0
17943,420856,470_15_21,CAPE VERDE,0,TOTALS,CAPE VERDE,200,22,75,29.3,12,33,36.4,10,42,23.8,22,39,56.4,28,23,51,15,21,17,14,4,76,1
17944,420869,470_15_22,MOROCCO,0,TOTALS,MOROCCO,200,33,66,50.0,31,47,66.0,2,19,10.5,14,23,60.9,18,25,43,19,27,21,7,6,82,0
17945,420882,470_15_22,MOZAMBIQUE,0,TOTALS,MOZAMBIQUE,200,29,67,43.3,24,46,52.2,5,21,23.8,22,29,75.9,17,18,35,9,21,12,11,0,85,1
17946,420895,470_15_23,ALGERIA,0,TOTALS,ALGERIA,200,27,59,45.8,19,34,55.9,8,25,32.0,12,21,57.1,13,25,38,11,19,20,1,5,74,0
17947,420907,470_15_23,COTE D'IVOIRE,0,TOTALS,COTE D'IVOIRE,200,31,68,45.6,27,46,58.7,4,22,18.2,15,20,75.0,14,18,32,17,25,10,6,2,81,1
17948,420920,470_15_24,SENEGAL,0,TOTALS,SENEGAL,200,21,55,38.2,17,37,45.9,4,18,22.2,28,41,68.3,17,23,40,16,17,12,5,4,74,1
17949,420933,470_15_24,ANGOLA,0,TOTALS,ANGOLA,200,26,63,41.3,14,33,42.4,12,30,40.0,9,13,69.2,16,18,34,11,28,12,2,3,73,0
17950,420946,470_15_25,EGYPT,0,TOTALS,EGYPT,200,38,82,46.3,21,44,47.7,17,38,44.7,9,19,47.4,21,24,45,23,24,7,13,4,102,0
17951,420959,470_15_25,ZIMBABWE,0,TOTALS,ZIMBABWE,200,21,52,40.4,17,42,40.5,4,10,40.0,16,23,69.6,10,28,38,7,17,24,4,6,62,1
17952,420972,470_15_26,ANGOLA,0,TOTALS,ANGOLA,200,23,60,38.3,17,36,47.2,6,24,25.0,10,13,76.9,16,25,41,13,18,21,7,2,62,1
17953,420985,470_15_26,CAF,0,TOTALS,CAF,200,21,58,36.2,16,37,43.2,5,21,23.8,14,16,87.5,11,19,30,6,16,15,8,3,61,0
17954,420997,470_15_27,COTE D'IVOIRE,0,TOTALS,COTE D'IVOIRE,200,14,56,25.0,13,32,40.6,1,24,4.2,28,40,70.0,12,25,37,8,20,16,9,0,57,0
17955,421010,470_15_27,MALI,0,TOTALS,MALI,200,24,55,43.6,15,30,50.0,9,25,36.0,19,28,67.9,11,35,46,19,34,22,9,1,76,1
17956,421023,470_15_28,TUNISIA,0,TOTALS,TUNISIA,225,28,72,38.9,24,43,55.8,4,29,13.8,9,17,52.9,15,22,37,13,19,20,19,5,69,1
17957,421036,470_15_28,MOROCCO,0,TOTALS,MOROCCO,225,28,56,50.0,23,40,57.5,5,16,31.2,7,14,50.0,7,30,37,16,18,30,13,2,68,0
17958,421049,470_15_29,SENEGAL,0,TOTALS,SENEGAL,200,30,67,44.8,23,44,52.3,7,23,30.4,12,21,57.1,15,41,56,15,16,15,9,4,79,1
17959,421061,470_15_29,UGANDA,0,TOTALS,UGANDA,200,17,77,22.1,10,42,23.8,7,35,20.0,7,10,70.0,22,26,48,10,20,15,8,3,48,0
17960,421074,470_15_30,CAPE VERDE,0,TOTALS,CAPE VERDE,200,27,74,36.5,18,45,40.0,9,29,31.0,4,8,50.0,18,20,38,13,19,19,15,2,67,0
17961,421087,470_15_30,GABON,0,TOTALS,GABON,200,30,55,54.5,24,37,64.9,6,18,33.3,11,24,45.8,12,30,42,15,16,24,9,3,77,1
17962,421100,470_15_31,NIGERIA,0,TOTALS,NIGERIA,200,28,70,40.0,21,42,50.0,7,28,25.0,20,27,74.1,20,35,55,17,11,14,10,5,83,1
17963,421113,470_15_31,MOZAMBIQUE,0,TOTALS,MOZAMBIQUE,200,18,57,31.6,14,34,41.2,4,23,17.4,7,8,87.5,3,26,29,9,21,20,10,0,47,0
17964,421126,470_15_32,CAMEROON,0,TOTALS,CAMEROON,200,24,80,30.0,13,33,39.4,11,47,23.4,12,21,57.1,15,30,45,14,32,13,11,4,71,0
17965,421139,470_15_32,ALGERIA,0,TOTALS,ALGERIA,200,23,50,46.0,18,33,54.5,5,17,29.4,22,34,64.7,2,40,42,18,23,25,6,0,73,1
17966,421152,470_15_33,ZIMBABWE,0,TOTALS,ZIMBABWE,200,22,60,36.7,15,38,39.5,7,22,31.8,13,17,76.5,12,25,37,9,21,23,10,4,64,0
17967,421164,470_15_33,UGANDA,0,TOTALS,UGANDA,200,23,61,37.7,15,31,48.4,8,30,26.7,18,22,81.8,12,28,40,15,17,20,10,3,72,1
17968,421177,470_15_34,GABON,0,TOTALS,GABON,200,19,67,28.4,9,30,30.0,10,37,27.0,16,22,72.7,16,26,42,8,24,23,10,3,64,0
17969,421190,470_15_34,NIGERIA,0,TOTALS,NIGERIA,200,30,62,48.4,24,39,61.5,6,23,26.1,22,34,64.7,12,33,45,23,20,20,17,5,88,1
17970,421203,470_15_35,EGYPT,0,TOTALS,EGYPT,200,21,64,32.8,10,34,29.4,11,30,36.7,10,15,66.7,17,20,37,14,27,21,7,4,63,0
17971,421216,470_15_35,ANGOLA,0,TOTALS,ANGOLA,200,28,55,50.9,20,31,64.5,8,24,33.3,19,24,79.2,10,28,38,17,18,19,10,4,83,1
17972,421229,470_15_36,SENEGAL,0,TOTALS,SENEGAL,200,27,58,46.6,17,30,56.7,10,28,35.7,11,16,68.8,10,32,42,13,17,13,3,5,75,1
17973,421242,470_15_36,ALGERIA,0,TOTALS,ALGERIA,200,22,70,31.4,15,46,32.6,7,24,29.2,7,12,58.3,17,22,39,4,17,13,2,0,58,0
17974,421255,470_15_37,TUNISIA,0,TOTALS,TUNISIA,200,22,53,41.5,14,32,43.8,8,21,38.1,15,25,60.0,9,22,31,14,25,9,8,4,67,1
17975,421268,470_15_37,MALI,0,TOTALS,MALI,200,22,54,40.7,16,34,47.1,6,20,30.0,10,17,58.8,14,26,40,8,26,15,1,1,60,0
17976,421281,470_15_38,CAF,0,TOTALS,CAF,200,30,65,46.2,23,39,59.0,7,26,26.9,7,14,50.0,10,20,30,15,24,14,5,1,74,0
17977,421294,470_15_38,MOROCCO,0,TOTALS,MOROCCO,200,32,57,56.1,27,41,65.9,5,16,31.2,17,27,63.0,10,29,39,19,12,15,9,3,86,1
17978,421306,470_15_39,COTE D'IVOIRE,0,TOTALS,COTE D'IVOIRE,200,23,58,39.7,20,34,58.8,3,24,12.5,14,20,70.0,9,24,33,12,19,15,9,3,63,0
17979,421319,470_15_39,MOZAMBIQUE,0,TOTALS,MOZAMBIQUE,200,23,58,39.7,18,38,47.4,5,20,25.0,19,25,76.0,12,29,41,13,19,16,6,2,70,1
17980,421332,470_15_40,CAPE VERDE,0,TOTALS,CAPE VERDE,200,23,68,33.8,12,33,36.4,11,35,31.4,9,14,64.3,15,29,44,14,17,13,3,1,66,0
17981,421345,470_15_40,CAMEROON,0,TOTALS,CAMEROON,200,34,71,47.9,25,44,56.8,9,27,33.3,11,15,73.3,9,31,40,13,18,9,5,0,88,1
17982,421358,470_15_41,MALI,0,TOTALS,MALI,200,13,47,27.7,11,32,34.4,2,15,13.3,23,36,63.9,9,22,31,2,23,17,4,0,51,0
17983,421371,470_15_41,EGYPT,0,TOTALS,EGYPT,200,28,65,43.1,19,34,55.9,9,31,29.0,9,16,56.2,18,30,48,13,29,17,8,5,74,1
17984,421384,470_15_42,ALGERIA,0,TOTALS,ALGERIA,200,26,57,45.6,23,42,54.8,3,15,20.0,29,36,80.6,9,34,43,9,31,20,8,1,84,1
17985,421397,470_15_42,GABON,0,TOTALS,GABON,200,22,62,35.5,18,39,46.2,4,23,17.4,28,37,75.7,11,23,34,7,31,16,9,4,76,0
17986,421410,470_15_43,MALI,0,TOTALS,MALI,200,28,63,44.4,17,36,47.2,11,27,40.7,27,30,90.0,14,30,44,17,28,18,8,2,94,1
17987,421423,470_15_43,GABON,0,TOTALS,GABON,200,28,60,46.7,19,40,47.5,9,20,45.0,17,29,58.6,7,22,29,11,28,17,9,5,82,0
17988,421436,470_15_44,EGYPT,0,TOTALS,EGYPT,200,25,67,37.3,21,43,48.8,4,24,16.7,15,26,57.7,18,28,46,12,21,12,6,2,69,1
17989,421449,470_15_44,ALGERIA,0,TOTALS,ALGERIA,200,23,61,37.7,16,37,43.2,7,24,29.2,10,14,71.4,11,28,39,11,22,15,5,2,63,0
17990,421462,470_15_45,SENEGAL,0,TOTALS,SENEGAL,225,28,77,36.4,17,38,44.7,11,39,28.2,12,13,92.3,12,29,41,18,20,10,4,3,79,0
17991,421475,470_15_45,NIGERIA,0,TOTALS,NIGERIA,225,30,69,43.5,20,38,52.6,10,31,32.3,18,26,69.2,10,38,48,15,17,12,4,2,88,1
17992,421488,470_15_46,TUNISIA,0,TOTALS,TUNISIA,200,19,60,31.7,15,36,41.7,4,24,16.7,9,11,81.8,17,22,39,8,21,20,7,2,51,0
17993,421501,470_15_46,ANGOLA,0,TOTALS,ANGOLA,200,19,52,36.5,15,31,48.4,4,21,19.0,16,20,80.0,11,25,36,6,17,19,11,3,58,1
17994,421514,470_15_47,TUNISIA,0,TOTALS,TUNISIA,200,28,64,43.8,18,41,43.9,10,23,43.5,16,18,88.9,12,22,34,16,25,10,6,4,82,1
17995,421527,470_15_47,SENEGAL,0,TOTALS,SENEGAL,200,24,58,41.4,17,29,58.6,7,29,24.1,18,27,66.7,17,23,40,14,22,17,3,5,73,0
17996,421540,470_15_48,ANGOLA,0,TOTALS,ANGOLA,200,23,68,33.8,12,32,37.5,11,36,30.6,8,16,50.0,10,27,37,13,33,15,8,3,65,0
17997,421553,470_15_48,NIGERIA,0,TOTALS,NIGERIA,200,18,63,28.6,13,40,32.5,5,23,21.7,33,47,70.2,24,36,60,7,14,17,7,4,74,1
17998,423447,476_15_01,KUWAIT,0,TOTALS,KUWAIT,200,19,58,32.8,12,41,29.3,7,17,41.2,5,13,38.5,11,22,33,9,22,22,6,4,50,0
17999,423460,476_15_01,HONG KONG,0,TOTALS,HONG KONG,200,32,67,47.8,24,41,58.5,8,26,30.8,15,26,57.7,20,29,49,17,16,17,15,5,87,1
18000,423473,476_15_02,PHILIPPINES,0,TOTALS,PHILIPPINES,200,26,77,33.8,19,47,40.4,7,30,23.3,14,18,77.8,17,36,53,8,23,15,4,2,73,0
18001,423486,476_15_02,PALESTINE,0,TOTALS,PALESTINE,200,27,83,32.5,19,55,34.5,8,28,28.6,13,18,72.2,23,35,58,11,20,14,6,1,75,1
18002,423499,476_15_03,IRAN,0,TOTALS,IRAN,200,29,67,43.3,21,43,48.8,8,24,33.3,20,27,74.1,19,26,45,13,22,7,13,1,86,1
18003,423511,476_15_03,JAPAN,0,TOTALS,JAPAN,200,17,49,34.7,13,35,37.1,4,14,28.6,10,17,58.8,9,20,29,4,25,19,3,0,48,0
18004,423524,476_15_04,KOREA,0,TOTALS,KOREA,200,32,54,59.3,17,30,56.7,15,24,62.5,8,15,53.3,13,27,40,24,17,17,6,0,87,1
18005,423537,476_15_04,JORDAN,0,TOTALS,JORDAN,200,22,74,29.7,14,46,30.4,8,28,28.6,8,11,72.7,25,12,37,11,18,13,6,1,60,0
18006,423550,476_15_05,MALAYSIA,0,TOTALS,MALAYSIA,200,26,62,41.9,18,40,45.0,8,22,36.4,13,16,81.2,9,26,35,8,22,19,2,1,73,1
18007,423563,476_15_05,INDIA,0,TOTALS,INDIA,200,38,79,48.1,27,53,50.9,11,26,42.3,15,25,60.0,21,29,50,16,17,9,8,3,102,0
18008,423576,476_15_06,SINGAPORE,0,TOTALS,SINGAPORE,200,17,58,29.3,13,41,31.7,4,17,23.5,4,8,50.0,9,14,23,1,23,17,8,0,42,0
18009,423589,476_15_06,CHINA,0,TOTALS,CHINA,200,31,59,52.5,23,39,59.0,8,20,40.0,21,28,75.0,17,29,46,13,20,13,8,8,91,1
18010,423602,476_15_07,CHINESE TAIPEI,0,TOTALS,CHINESE TAIPEI,200,35,66,53.0,28,41,68.3,7,25,28.0,10,22,45.5,9,24,33,13,23,15,6,3,87,0
18011,423615,476_15_07,LEBANON,0,TOTALS,LEBANON,200,32,64,50.0,19,34,55.9,13,30,43.3,15,23,65.2,11,25,36,13,22,10,10,4,92,1
18012,423628,476_15_08,QATAR,0,TOTALS,QATAR,225,28,72,38.9,23,49,46.9,5,23,21.7,18,33,54.5,12,44,56,8,31,15,6,2,79,1
18013,423641,476_15_08,KAZAKHSTAN,0,TOTALS,KAZAKHSTAN,225,22,71,31.0,15,38,39.5,7,33,21.2,24,39,61.5,13,36,49,9,30,14,6,0,75,0
18014,423654,476_15_09,PHILIPPINES,0,TOTALS,PHILIPPINES,200,35,76,46.1,21,42,50.0,14,34,41.2,17,28,60.7,16,46,62,16,16,10,8,6,101,0
18015,423667,476_15_09,HONG KONG,0,TOTALS,HONG KONG,200,20,76,26.3,15,48,31.2,5,28,17.9,5,8,62.5,11,27,38,10,21,14,4,1,50,1
18016,423680,476_15_10,IRAN,0,TOTALS,IRAN,200,34,73,46.6,29,49,59.2,5,24,20.8,15,22,68.2,16,30,46,15,20,18,12,4,88,1
18017,423693,476_15_10,INDIA,0,TOTALS,INDIA,200,26,64,40.6,21,48,43.8,5,16,31.2,9,16,56.2,10,22,32,8,18,17,6,3,66,0
18018,423705,476_15_11,JAPAN,0,TOTALS,JAPAN,200,44,79,55.7,27,44,61.4,17,35,48.6,14,21,66.7,12,39,51,25,17,7,20,2,119,0
18019,423718,476_15_11,MALAYSIA,0,TOTALS,MALAYSIA,200,17,62,27.4,10,35,28.6,7,27,25.9,7,11,63.6,6,28,34,5,16,26,3,2,48,1
18020,423731,476_15_12,CHINESE TAIPEI,0,TOTALS,CHINESE TAIPEI,200,27,73,37.0,17,45,37.8,10,28,35.7,9,11,81.8,15,31,46,12,26,19,11,4,73,0
18021,423744,476_15_12,KAZAKHSTAN,0,TOTALS,KAZAKHSTAN,200,28,77,36.4,18,45,40.0,10,32,31.2,18,26,69.2,21,32,53,12,16,15,10,0,84,1
18022,423757,476_15_13,PALESTINE,0,TOTALS,PALESTINE,200,30,64,46.9,21,46,45.7,9,18,50.0,21,30,70.0,11,36,47,14,15,17,11,2,90,1
18023,423768,476_15_13,KUWAIT,0,TOTALS,KUWAIT,200,26,70,37.1,16,36,44.4,10,34,29.4,7,13,53.8,10,28,38,8,26,15,9,2,69,0
18024,423781,476_15_14,KOREA,0,TOTALS,KOREA,200,27,61,44.3,20,44,45.5,7,17,41.2,12,13,92.3,11,22,33,8,28,9,3,6,73,0
18025,423794,476_15_14,CHINA,0,TOTALS,CHINA,200,27,68,39.7,24,56,42.9,3,12,25.0,19,27,70.4,22,22,44,11,19,8,3,5,76,1
18026,423807,476_15_15,JORDAN,0,TOTALS,JORDAN,200,36,64,56.2,22,31,71.0,14,33,42.4,12,19,63.2,13,28,41,15,21,12,6,3,98,1
18027,423820,476_15_15,SINGAPORE,0,TOTALS,SINGAPORE,200,25,71,35.2,18,42,42.9,7,29,24.1,11,17,64.7,19,18,37,12,17,11,5,2,68,0
18028,423833,476_15_16,LEBANON,0,TOTALS,LEBANON,250,38,82,46.3,29,56,51.8,9,26,34.6,15,29,51.7,18,30,48,13,22,15,8,6,100,0
18029,423846,476_15_16,QATAR,0,TOTALS,QATAR,250,38,85,44.7,31,60,51.7,7,25,28.0,22,31,71.0,19,32,51,6,26,13,10,5,105,1
18030,423859,476_15_17,MALAYSIA,0,TOTALS,MALAYSIA,200,18,69,26.1,13,43,30.2,5,26,19.2,1,2,50.0,7,17,24,7,13,23,9,0,42,1
18031,423872,476_15_17,IRAN,0,TOTALS,IRAN,200,49,83,59.0,38,55,69.1,11,28,39.3,13,17,76.5,22,42,64,25,3,15,17,1,122,0
18032,423885,476_15_18,SINGAPORE,0,TOTALS,SINGAPORE,200,16,58,27.6,13,40,32.5,3,18,16.7,10,16,62.5,14,22,36,8,24,21,3,2,45,0
18033,423898,476_15_18,KOREA,0,TOTALS,KOREA,200,29,61,47.5,22,43,51.2,7,18,38.9,22,28,78.6,12,30,42,22,18,13,10,5,87,1
18034,423911,476_15_19,INDIA,0,TOTALS,INDIA,200,24,66,36.4,16,46,34.8,8,20,40.0,9,15,60.0,15,28,43,11,12,15,6,5,65,0
18035,423923,476_15_19,JAPAN,0,TOTALS,JAPAN,200,35,77,45.5,28,53,52.8,7,24,29.2,6,8,75.0,16,29,45,17,18,7,7,2,83,1
18036,423934,476_15_20,KUWAIT,0,TOTALS,KUWAIT,200,24,66,36.4,14,37,37.8,10,29,34.5,6,9,66.7,8,18,26,11,26,17,7,2,64,1
18037,423947,476_15_20,PHILIPPINES,0,TOTALS,PHILIPPINES,200,41,73,56.2,32,57,56.1,9,16,56.2,19,31,61.3,18,34,52,14,16,15,10,4,110,0
18038,423960,476_15_21,HONG KONG,0,TOTALS,HONG KONG,200,29,74,39.2,20,46,43.5,9,28,32.1,12,13,92.3,7,36,43,10,21,15,5,7,79,0
18039,423973,476_15_21,PALESTINE,0,TOTALS,PALESTINE,200,30,74,40.5,20,46,43.5,10,28,35.7,15,21,71.4,12,36,48,17,18,15,5,4,85,1
18040,423986,476_15_22,CHINA,0,TOTALS,CHINA,200,33,60,55.0,27,49,55.1,6,11,54.5,12,19,63.2,12,36,48,19,15,14,3,1,84,1
18041,423999,476_15_22,JORDAN,0,TOTALS,JORDAN,200,27,77,35.1,18,52,34.6,9,25,36.0,4,12,33.3,17,19,36,7,17,7,9,1,67,0
18042,424012,476_15_23,QATAR,0,TOTALS,QATAR,200,27,75,36.0,22,49,44.9,5,26,19.2,5,9,55.6,15,27,42,8,22,14,5,2,64,0
18043,424025,476_15_23,CHINESE TAIPEI,0,TOTALS,CHINESE TAIPEI,200,25,64,39.1,17,38,44.7,8,26,30.8,14,22,63.6,13,37,50,13,15,15,5,3,72,1
18044,424038,476_15_24,KAZAKHSTAN,0,TOTALS,KAZAKHSTAN,200,17,53,32.1,9,28,32.1,8,25,32.0,13,20,65.0,9,20,29,9,22,17,4,2,55,0
18045,424051,476_15_24,LEBANON,0,TOTALS,LEBANON,200,35,65,53.8,27,50,54.0,8,15,53.3,13,18,72.2,13,30,43,12,16,12,10,4,91,1
18046,424064,476_15_25,IRAN,0,TOTALS,IRAN,200,42,76,55.3,28,39,71.8,14,37,37.8,13,17,76.5,17,38,55,30,13,13,12,2,111,0
18047,424077,476_15_25,HONG KONG,0,TOTALS,HONG KONG,200,20,64,31.2,12,43,27.9,8,21,38.1,8,12,66.7,8,17,25,9,20,17,4,0,56,1
18048,424090,476_15_26,PALESTINE,0,TOTALS,PALESTINE,200,26,71,36.6,21,53,39.6,5,18,27.8,13,18,72.2,20,29,49,12,18,17,8,2,70,0
18049,424103,476_15_26,INDIA,0,TOTALS,INDIA,200,27,71,38.0,20,49,40.8,7,22,31.8,12,14,85.7,13,25,38,14,20,13,11,0,73,1
18050,424116,476_15_27,KOREA,0,TOTALS,KOREA,200,34,64,53.1,26,47,55.3,8,17,47.1,9,11,81.8,7,25,32,24,17,11,12,4,85,1
18051,424129,476_15_27,LEBANON,0,TOTALS,LEBANON,200,29,64,45.3,23,45,51.1,6,19,31.6,7,11,63.6,12,25,37,12,12,17,9,4,71,0
18052,424141,476_15_28,JAPAN,0,TOTALS,JAPAN,200,26,65,40.0,21,44,47.7,5,21,23.8,9,10,90.0,11,32,43,12,25,15,3,1,66,0
18053,424154,476_15_28,PHILIPPINES,0,TOTALS,PHILIPPINES,200,24,62,38.7,18,41,43.9,6,21,28.6,19,28,67.9,11,26,37,7,15,8,8,1,73,1
18054,424167,476_15_29,MALAYSIA,0,TOTALS,MALAYSIA,200,23,82,28.0,16,54,29.6,7,28,25.0,8,15,53.3,19,33,52,8,27,19,4,1,61,0
18055,424178,476_15_29,KUWAIT,0,TOTALS,KUWAIT,200,27,67,40.3,20,45,44.4,7,22,31.8,22,34,64.7,12,40,52,8,18,15,14,5,83,1
18056,424191,476_15_30,CHINA,0,TOTALS,CHINA,200,29,54,53.7,23,32,71.9,6,22,27.3,11,16,68.8,8,28,36,11,22,19,7,5,75,1
18057,424204,476_15_30,KAZAKHSTAN,0,TOTALS,KAZAKHSTAN,200,21,58,36.2,15,40,37.5,6,18,33.3,14,19,73.7,10,18,28,10,21,13,8,0,62,0
18058,424217,476_15_31,SINGAPORE,0,TOTALS,SINGAPORE,200,26,75,34.7,19,44,43.2,7,31,22.6,6,8,75.0,12,21,33,11,15,15,7,1,65,1
18059,424230,476_15_31,CHINESE TAIPEI,0,TOTALS,CHINESE TAIPEI,200,41,70,58.6,28,44,63.6,13,26,50.0,16,18,88.9,10,36,46,19,13,13,10,3,111,0
18060,424243,476_15_32,QATAR,0,TOTALS,QATAR,200,28,65,43.1,22,43,51.2,6,22,27.3,11,19,57.9,14,27,41,11,25,17,7,1,73,0
18061,424256,476_15_32,JORDAN,0,TOTALS,JORDAN,200,29,68,42.6,18,37,48.6,11,31,35.5,15,23,65.2,15,28,43,12,20,14,7,3,84,1
18062,424269,476_15_33,INDIA,0,TOTALS,INDIA,200,30,76,39.5,23,45,51.1,7,31,22.6,9,14,64.3,17,30,47,15,13,12,8,4,76,1
18063,424282,476_15_33,HONG KONG,0,TOTALS,HONG KONG,200,29,69,42.0,23,49,46.9,6,20,30.0,7,10,70.0,11,31,42,11,11,13,5,1,71,0
18064,424295,476_15_34,PHILIPPINES,0,TOTALS,PHILIPPINES,200,29,62,46.8,20,40,50.0,9,22,40.9,20,30,66.7,10,30,40,9,19,12,12,5,87,1
18065,424308,476_15_34,IRAN,0,TOTALS,IRAN,200,27,67,40.3,16,43,37.2,11,24,45.8,8,15,53.3,13,26,39,10,21,16,5,1,73,0
18066,424321,476_15_35,PALESTINE,0,TOTALS,PALESTINE,200,26,62,41.9,20,48,41.7,6,14,42.9,9,12,75.0,6,30,36,12,20,11,4,1,67,0
18067,424333,476_15_35,JAPAN,0,TOTALS,JAPAN,200,29,76,38.2,23,52,44.2,6,24,25.0,10,21,47.6,22,31,53,18,17,10,5,2,74,1
18068,424346,476_15_36,QATAR,0,TOTALS,QATAR,200,24,65,36.9,17,44,38.6,7,21,33.3,14,19,73.7,19,29,48,6,17,11,4,1,69,1
18069,424359,476_15_36,KOREA,0,TOTALS,KOREA,200,25,64,39.1,19,39,48.7,6,25,24.0,7,12,58.3,11,24,35,11,18,8,8,4,63,0
18070,424372,476_15_37,LEBANON,0,TOTALS,LEBANON,200,29,68,42.6,22,48,45.8,7,20,35.0,7,9,77.8,12,18,30,11,18,13,9,2,72,0
18071,424385,476_15_37,CHINA,0,TOTALS,CHINA,200,33,64,51.6,27,49,55.1,6,15,40.0,18,23,78.3,16,27,43,16,18,15,10,4,90,1
18072,424398,476_15_38,MALAYSIA,0,TOTALS,MALAYSIA,200,24,74,32.4,19,52,36.5,5,22,22.7,6,11,54.5,14,24,38,10,16,15,5,3,59,0
18073,424411,476_15_38,SINGAPORE,0,TOTALS,SINGAPORE,200,37,70,52.9,28,52,53.8,9,18,50.0,9,11,81.8,11,37,48,15,17,15,8,1,92,1
18074,424424,476_15_39,JORDAN,0,TOTALS,JORDAN,200,33,75,44.0,22,46,47.8,11,29,37.9,10,14,71.4,13,30,43,16,20,8,8,4,87,1
18075,424437,476_15_39,KAZAKHSTAN,0,TOTALS,KAZAKHSTAN,200,24,60,40.0,16,40,40.0,8,20,40.0,17,25,68.0,9,28,37,8,20,13,3,2,73,0
18076,424448,476_15_40,KUWAIT,0,TOTALS,KUWAIT,200,26,74,35.1,19,51,37.3,7,23,30.4,10,16,62.5,19,25,44,7,15,21,5,2,69,0
18077,424461,476_15_40,CHINESE TAIPEI,0,TOTALS,CHINESE TAIPEI,200,38,72,52.8,25,47,53.2,13,25,52.0,10,12,83.3,10,32,42,29,20,14,15,4,99,1
18078,424474,476_15_41,PALESTINE,0,TOTALS,PALESTINE,200,19,59,32.2,15,41,36.6,4,18,22.2,6,11,54.5,9,22,31,10,18,22,12,1,48,0
18079,424487,476_15_41,IRAN,0,TOTALS,IRAN,200,37,80,46.2,29,54,53.7,8,26,30.8,12,18,66.7,20,34,54,16,15,15,18,2,94,1
18080,424499,476_15_42,JAPAN,0,TOTALS,JAPAN,200,34,63,54.0,25,41,61.0,9,22,40.9,12,14,85.7,9,25,34,17,19,13,9,2,89,1
18081,424512,476_15_42,HONG KONG,0,TOTALS,HONG KONG,200,20,49,40.8,10,29,34.5,10,20,50.0,12,16,75.0,6,20,26,10,17,24,4,3,62,0
18082,424525,476_15_43,PHILIPPINES,0,TOTALS,PHILIPPINES,200,41,85,48.2,32,59,54.2,9,26,34.6,8,9,88.9,15,35,50,21,15,10,15,2,99,1
18083,424538,476_15_43,INDIA,0,TOTALS,INDIA,200,25,69,36.2,16,47,34.0,9,22,40.9,6,8,75.0,9,29,38,11,12,22,7,3,65,0
18084,424551,476_15_44,LEBANON,0,TOTALS,LEBANON,200,27,65,41.5,17,40,42.5,10,25,40.0,16,27,59.3,17,28,45,14,20,15,5,4,80,1
18085,424564,476_15_44,JORDAN,0,TOTALS,JORDAN,200,26,70,37.1,22,49,44.9,4,21,19.0,20,24,83.3,13,28,41,10,22,10,10,4,76,0
18086,424577,476_15_45,CHINA,0,TOTALS,CHINA,200,28,58,48.3,19,37,51.4,9,21,42.9,24,29,82.8,8,32,40,13,20,10,6,3,89,1
18087,424590,476_15_45,QATAR,0,TOTALS,QATAR,200,20,59,33.9,11,39,28.2,9,20,45.0,16,24,66.7,10,25,35,6,22,13,5,0,65,0
18088,424603,476_15_46,KOREA,0,TOTALS,KOREA,200,32,57,56.1,27,40,67.5,5,17,29.4,10,11,90.9,4,23,27,16,19,11,14,2,79,1
18089,424616,476_15_46,KAZAKHSTAN,0,TOTALS,KAZAKHSTAN,200,22,50,44.0,17,30,56.7,5,20,25.0,14,19,73.7,7,22,29,12,17,20,4,0,63,0
18090,424629,476_15_47,HONG KONG,0,TOTALS,HONG KONG,200,25,63,39.7,15,35,42.9,10,28,35.7,2,2,100.0,8,28,36,16,26,19,7,1,62,0
18091,424642,476_15_47,JORDAN,0,TOTALS,JORDAN,200,27,65,41.5,13,32,40.6,14,33,42.4,14,19,73.7,13,29,42,19,9,15,8,2,82,1
18092,424655,476_15_48,PALESTINE,0,TOTALS,PALESTINE,225,31,78,39.7,24,59,40.7,7,19,36.8,14,25,56.0,22,31,53,18,12,20,9,2,83,1
18093,424668,476_15_48,KAZAKHSTAN,0,TOTALS,KAZAKHSTAN,225,34,79,43.0,23,43,53.5,11,36,30.6,2,3,66.7,14,31,45,14,28,20,8,3,81,0
18094,424681,476_15_49,IRAN,0,TOTALS,IRAN,200,30,65,46.2,24,50,48.0,6,15,40.0,9,16,56.2,19,25,44,15,21,14,9,1,75,1
18095,424694,476_15_49,KOREA,0,TOTALS,KOREA,200,22,50,44.0,20,37,54.1,2,13,15.4,16,18,88.9,4,20,24,15,18,12,8,5,62,0
18096,424706,476_15_50,JAPAN,0,TOTALS,JAPAN,200,27,56,48.2,21,39,53.8,6,17,35.3,21,29,72.4,9,25,34,12,19,10,8,2,81,1
18097,424719,476_15_50,QATAR,0,TOTALS,QATAR,200,23,56,41.1,17,31,54.8,6,25,24.0,15,22,68.2,12,24,36,14,22,14,6,0,67,0
18098,424732,476_15_51,INDIA,0,TOTALS,INDIA,200,23,61,37.7,18,42,42.9,5,19,26.3,7,12,58.3,9,21,30,10,20,21,6,2,58,1
18099,424745,476_15_51,CHINA,0,TOTALS,CHINA,200,38,68,55.9,27,45,60.0,11,23,47.8,17,21,81.0,7,30,37,26,18,14,9,5,104,0
18100,424758,476_15_52,PHILIPPINES,0,TOTALS,PHILIPPINES,200,32,75,42.7,23,45,51.1,9,30,30.0,9,12,75.0,18,26,44,8,22,9,9,2,82,1
18101,424771,476_15_52,LEBANON,0,TOTALS,LEBANON,200,27,67,40.3,21,43,48.8,6,24,25.0,10,18,55.6,17,23,40,10,13,13,3,3,70,0
18102,424784,476_15_53,HONG KONG,0,TOTALS,HONG KONG,200,20,64,31.2,13,40,32.5,7,24,29.2,15,17,88.2,10,26,36,12,24,15,10,4,62,0
18103,424797,476_15_53,KAZAKHSTAN,0,TOTALS,KAZAKHSTAN,200,23,54,42.6,22,42,52.4,1,12,8.3,21,30,70.0,8,33,41,6,20,18,8,2,68,1
18104,424810,476_15_54,JORDAN,0,TOTALS,JORDAN,200,35,83,42.2,24,49,49.0,11,34,32.4,13,20,65.0,16,29,45,19,17,6,13,3,94,1
18105,424823,476_15_54,PALESTINE,0,TOTALS,PALESTINE,200,31,73,42.5,21,49,42.9,10,24,41.7,10,11,90.9,13,36,49,10,17,16,3,0,82,0
18106,424836,476_15_55,INDIA,0,TOTALS,INDIA,200,30,61,49.2,25,40,62.5,5,21,23.8,7,11,63.6,5,21,26,9,16,22,2,0,72,1
18107,424849,476_15_55,KOREA,0,TOTALS,KOREA,200,48,78,61.5,38,55,69.1,10,23,43.5,11,17,64.7,13,28,41,33,11,10,16,1,117,0
18108,424862,476_15_56,QATAR,0,TOTALS,QATAR,200,31,67,46.3,24,44,54.5,7,23,30.4,17,25,68.0,12,28,40,9,21,9,4,1,86,0
18109,424875,476_15_56,LEBANON,0,TOTALS,LEBANON,200,34,68,50.0,27,46,58.7,7,22,31.8,14,22,63.6,9,25,34,10,20,7,7,2,89,1
18110,424888,476_15_57,CHINA,0,TOTALS,CHINA,200,25,54,46.3,18,37,48.6,7,17,41.2,13,20,65.0,10,28,38,13,24,16,6,8,70,1
18111,424901,476_15_57,IRAN,0,TOTALS,IRAN,200,18,63,28.6,16,47,34.0,2,16,12.5,19,26,73.1,18,23,41,2,21,12,7,3,57,0
18112,424913,476_15_58,JAPAN,0,TOTALS,JAPAN,200,23,63,36.5,23,52,44.2,0,11,0.0,24,29,82.8,15,26,41,7,16,9,5,2,70,0
18113,424926,476_15_58,PHILIPPINES,0,TOTALS,PHILIPPINES,200,31,68,45.6,18,37,48.6,13,31,41.9,6,6,100.0,9,28,37,13,24,11,7,4,81,1
18114,424939,476_15_59,INDIA,0,TOTALS,INDIA,200,23,63,36.5,18,39,46.2,5,24,20.8,7,11,63.6,13,21,34,11,12,19,8,3,58,0
18115,424952,476_15_59,QATAR,0,TOTALS,QATAR,200,33,62,53.2,22,42,52.4,11,20,55.0,7,15,46.7,10,29,39,19,11,15,8,2,84,1
18116,424965,476_15_60,LEBANON,0,TOTALS,LEBANON,200,37,72,51.4,30,49,61.2,7,23,30.4,7,10,70.0,11,20,31,19,15,15,14,3,88,1
18117,424978,476_15_60,KOREA,0,TOTALS,KOREA,200,35,69,50.7,28,54,51.9,7,15,46.7,10,13,76.9,15,23,38,24,13,17,10,1,87,0
18118,424991,476_15_61,IRAN,0,TOTALS,IRAN,200,22,59,37.3,11,24,45.8,11,35,31.4,13,21,61.9,12,22,34,12,17,11,9,1,68,1
18119,425003,476_15_61,JAPAN,0,TOTALS,JAPAN,200,22,51,43.1,12,27,44.4,10,24,41.7,9,14,64.3,7,26,33,15,21,18,5,0,63,0
18120,425016,476_15_62,CHINA,0,TOTALS,CHINA,200,24,64,37.5,15,40,37.5,9,24,37.5,21,33,63.6,11,35,46,11,24,10,1,5,78,1
18121,425029,476_15_62,PHILIPPINES,0,TOTALS,PHILIPPINES,200,23,65,35.4,17,41,41.5,6,24,25.0,15,26,57.7,11,32,43,7,28,9,7,3,67,0
18122,425966,478_15_01,JAPAN,0,TOTALS,JAPAN,200,34,74,45.9,26,56,46.4,8,18,44.4,8,12,66.7,13,40,53,27,24,15,9,7,84,1
18123,425979,478_15_01,KUWAIT,0,TOTALS,KUWAIT,200,15,65,23.1,14,47,29.8,1,18,5.6,18,29,62.1,15,31,46,6,11,20,7,3,49,0
18124,425992,478_15_02,PHILIPPINES,0,TOTALS,PHILIPPINES,200,40,83,48.2,34,63,54.0,6,20,30.0,12,19,63.2,19,30,49,27,21,24,23,0,98,1
18125,426005,478_15_02,BAHRAIN,0,TOTALS,BAHRAIN,200,19,54,35.2,12,34,35.3,7,20,35.0,13,25,52.0,11,28,39,14,19,35,11,1,58,0
18126,426018,478_15_03,CHINA,0,TOTALS,CHINA,200,44,73,60.3,39,56,69.6,5,17,29.4,23,33,69.7,14,42,56,32,20,19,10,5,116,0
18127,426031,478_15_03,INDIA,0,TOTALS,INDIA,200,21,69,30.4,17,52,32.7,4,17,23.5,11,17,64.7,10,18,28,8,20,21,14,0,57,1
18128,426044,478_15_04,MALAYSIA,0,TOTALS,MALAYSIA,200,28,80,35.0,18,57,31.6,10,23,43.5,3,7,42.9,25,34,59,17,25,22,13,5,69,1
18129,426057,478_15_04,HONG KONG,0,TOTALS,HONG KONG,200,20,67,29.9,19,52,36.5,1,15,6.7,12,22,54.5,18,30,48,6,14,26,11,6,53,0
18130,426070,478_15_05,IRAQ,0,TOTALS,IRAQ,200,30,66,45.5,27,53,50.9,3,13,23.1,11,20,55.0,9,27,36,12,25,14,8,2,74,0
18131,426083,478_15_05,KOREA,0,TOTALS,KOREA,200,32,66,48.5,21,40,52.5,11,26,42.3,17,32,53.1,16,30,46,25,19,18,7,2,92,1
18132,426096,478_15_06,CHINESE TAIPEI,0,TOTALS,CHINESE TAIPEI,200,65,115,56.5,61,86,70.9,4,29,13.8,11,16,68.8,34,30,64,40,21,16,35,5,145,0
18133,426107,478_15_06,BANGLADESH,0,TOTALS,BANGLADESH,200,11,50,22.0,11,42,26.2,0,8,0.0,9,21,42.9,16,20,36,3,13,58,5,1,31,1
18134,426120,478_15_07,LEBANON,0,TOTALS,LEBANON,200,35,69,50.7,31,56,55.4,4,13,30.8,9,19,47.4,15,35,50,20,24,28,23,10,83,1
18135,426133,478_15_07,INDONESIA,0,TOTALS,INDONESIA,200,17,70,24.3,14,48,29.2,3,22,13.6,18,31,58.1,24,24,48,15,18,33,12,1,55,0
18136,426146,478_15_08,CHINESE TAIPEI,0,TOTALS,CHINESE TAIPEI,200,32,66,48.5,26,43,60.5,6,23,26.1,24,39,61.5,17,34,51,22,25,21,5,3,94,1
18137,426159,478_15_08,LEBANON,0,TOTALS,LEBANON,200,26,71,36.6,20,48,41.7,6,23,26.1,28,39,71.8,12,21,33,11,30,12,14,7,86,0
18138,426172,478_15_09,JAPAN,0,TOTALS,JAPAN,200,30,71,42.3,20,41,48.8,10,30,33.3,7,8,87.5,12,28,40,25,19,17,17,6,77,1
18139,426185,478_15_09,MALAYSIA,0,TOTALS,MALAYSIA,200,12,50,24.0,10,39,25.6,2,11,18.2,13,22,59.1,15,28,43,6,11,33,8,0,39,0
18140,426198,478_15_10,CHINA,0,TOTALS,CHINA,200,21,53,39.6,17,33,51.5,4,20,20.0,21,36,58.3,14,38,52,15,19,27,7,2,67,1
18141,426211,478_15_10,IRAQ,0,TOTALS,IRAQ,200,20,72,27.8,18,58,31.0,2,14,14.3,14,27,51.9,17,25,42,8,29,14,12,3,56,0
18142,426224,478_15_11,KUWAIT,0,TOTALS,KUWAIT,200,24,80,30.0,18,53,34.0,6,27,22.2,5,7,71.4,16,35,51,9,24,16,7,6,59,0
18143,426237,478_15_11,HONG KONG,0,TOTALS,HONG KONG,200,26,74,35.1,25,65,38.5,1,9,11.1,18,36,50.0,22,39,61,14,13,14,4,3,71,1
18144,426250,478_15_12,PHILIPPINES,0,TOTALS,PHILIPPINES,200,33,86,38.4,33,70,47.1,0,16,0.0,4,9,44.4,24,39,63,16,19,25,20,4,70,1
18145,426263,478_15_12,THAILAND,0,TOTALS,THAILAND,200,21,67,31.3,19,41,46.3,2,26,7.7,7,16,43.8,11,31,42,13,8,28,12,2,51,0
18146,426276,478_15_13,INDIA,0,TOTALS,INDIA,200,33,71,46.5,29,54,53.7,4,17,23.5,15,21,71.4,9,27,36,17,12,26,8,5,85,1
18147,426289,478_15_13,KOREA,0,TOTALS,KOREA,200,45,86,52.3,38,63,60.3,7,23,30.4,7,11,63.6,15,33,48,27,19,21,18,4,104,0
18148,426300,478_15_14,BANGLADESH,0,TOTALS,BANGLADESH,200,10,57,17.5,10,42,23.8,0,15,0.0,9,22,40.9,20,21,41,5,17,31,7,0,29,0
18149,426313,478_15_14,INDONESIA,0,TOTALS,INDONESIA,200,37,80,46.2,31,55,56.4,6,25,24.0,10,18,55.6,26,33,59,28,22,18,16,3,90,1
18150,426326,478_15_15,IRAQ,0,TOTALS,IRAQ,200,39,86,45.3,32,67,47.8,7,19,36.8,5,10,50.0,24,35,59,21,15,19,14,8,90,1
18151,426339,478_15_15,INDIA,0,TOTALS,INDIA,200,28,78,35.9,23,55,41.8,5,23,21.7,8,16,50.0,17,27,44,17,15,21,10,2,69,0
18152,426352,478_15_16,KOREA,0,TOTALS,KOREA,200,23,77,29.9,17,53,32.1,6,24,25.0,13,17,76.5,12,15,27,11,21,8,7,1,65,0
18153,426365,478_15_16,CHINA,0,TOTALS,CHINA,200,33,64,51.6,28,49,57.1,5,15,33.3,20,28,71.4,19,41,60,18,19,21,6,4,91,1
18154,426378,478_15_17,HONG KONG,0,TOTALS,HONG KONG,200,14,48,29.2,14,41,34.1,0,7,0.0,23,35,65.7,13,22,35,5,16,25,6,2,51,0
18155,426391,478_15_17,JAPAN,0,TOTALS,JAPAN,200,35,66,53.0,27,48,56.2,8,18,44.4,8,14,57.1,11,22,33,19,24,12,14,4,86,1
18156,426404,478_15_18,MALAYSIA,0,TOTALS,MALAYSIA,200,27,86,31.4,23,51,45.1,4,35,11.4,8,17,47.1,23,27,50,10,27,19,16,0,66,0
18157,426417,478_15_18,KUWAIT,0,TOTALS,KUWAIT,200,26,67,38.8,19,45,42.2,7,22,31.8,22,37,59.5,20,40,60,10,18,29,10,2,81,1
18158,426430,478_15_19,THAILAND,0,TOTALS,THAILAND,200,23,61,37.7,15,38,39.5,8,23,34.8,11,23,47.8,19,24,43,21,13,27,18,1,65,1
18159,426443,478_15_19,BAHRAIN,0,TOTALS,BAHRAIN,200,25,67,37.3,22,48,45.8,3,19,15.8,5,16,31.2,25,27,52,10,22,32,19,2,58,0
18160,426456,478_15_20,INDONESIA,0,TOTALS,INDONESIA,200,23,69,33.3,21,53,39.6,2,16,12.5,8,16,50.0,14,21,35,9,21,21,12,3,56,0
18161,426469,478_15_20,CHINESE TAIPEI,0,TOTALS,CHINESE TAIPEI,200,29,72,40.3,25,63,39.7,4,9,44.4,17,26,65.4,27,34,61,16,19,26,14,6,79,1
18162,426482,478_15_21,THAILAND,0,TOTALS,THAILAND,200,19,56,33.9,13,29,44.8,6,27,22.2,8,15,53.3,15,18,33,11,13,26,10,1,52,0
18163,426495,478_15_21,KOREA,0,TOTALS,KOREA,200,31,65,47.7,26,45,57.8,5,20,25.0,9,12,75.0,16,25,41,25,14,16,16,2,76,1
18164,426508,478_15_22,CHINESE TAIPEI,0,TOTALS,CHINESE TAIPEI,200,36,79,45.6,28,47,59.6,8,32,25.0,10,14,71.4,25,35,60,25,8,23,10,6,90,1
18165,426521,478_15_22,MALAYSIA,0,TOTALS,MALAYSIA,200,23,72,31.9,12,43,27.9,11,29,37.9,2,5,40.0,13,19,32,13,16,21,10,1,59,0
18166,426534,478_15_23,CHINA,0,TOTALS,CHINA,200,31,79,39.2,22,44,50.0,9,35,25.7,14,21,66.7,21,32,53,23,14,15,11,3,85,1
18167,426547,478_15_23,BAHRAIN,0,TOTALS,BAHRAIN,200,15,55,27.3,9,33,27.3,6,22,27.3,7,12,58.3,10,30,40,11,23,26,5,1,43,0
18168,426560,478_15_24,HONG KONG,0,TOTALS,HONG KONG,200,31,80,38.8,28,52,53.8,3,28,10.7,12,19,63.2,22,37,59,15,14,23,14,5,77,1
18169,426571,478_15_24,BANGLADESH,0,TOTALS,BANGLADESH,200,28,75,37.3,23,56,41.1,5,19,26.3,4,14,28.6,18,29,47,20,17,24,11,1,65,0
18170,426584,478_15_25,PHILIPPINES,0,TOTALS,PHILIPPINES,200,29,79,36.7,23,57,40.4,6,22,27.3,14,30,46.7,24,30,54,20,21,25,26,6,78,1
18171,426597,478_15_25,IRAQ,0,TOTALS,IRAQ,200,27,68,39.7,23,58,39.7,4,10,40.0,11,20,55.0,17,34,51,11,25,35,13,5,69,0
18172,426610,478_15_26,KUWAIT,0,TOTALS,KUWAIT,200,29,74,39.2,22,47,46.8,7,27,25.9,14,20,70.0,19,28,47,16,22,13,3,1,79,0
18173,426623,478_15_26,LEBANON,0,TOTALS,LEBANON,200,27,63,42.9,19,41,46.3,8,22,36.4,19,23,82.6,7,29,36,24,20,13,11,6,81,1
18174,426636,478_15_27,JAPAN,0,TOTALS,JAPAN,200,33,68,48.5,30,49,61.2,3,19,15.8,11,16,68.8,17,30,47,20,19,17,14,4,80,1
18175,426649,478_15_27,INDONESIA,0,TOTALS,INDONESIA,200,12,56,21.4,10,37,27.0,2,19,10.5,13,22,59.1,16,20,36,9,13,28,6,3,39,0
18176,426662,478_15_28,CHINA,0,TOTALS,CHINA,200,39,75,52.0,35,56,62.5,4,19,21.1,9,12,75.0,22,39,61,32,7,12,9,5,91,1
18177,426675,478_15_28,THAILAND,0,TOTALS,THAILAND,200,12,59,20.3,9,35,25.7,3,24,12.5,1,2,50.0,8,17,25,12,7,16,7,1,28,0
18178,426688,478_15_29,CHINESE TAIPEI,0,TOTALS,CHINESE TAIPEI,200,33,79,41.8,31,67,46.3,2,12,16.7,12,20,60.0,19,35,54,23,15,20,15,17,80,1
18179,426701,478_15_29,KUWAIT,0,TOTALS,KUWAIT,200,26,90,28.9,20,71,28.2,6,19,31.6,9,12,75.0,30,30,60,10,15,25,11,7,67,0
18180,426714,478_15_30,LEBANON,0,TOTALS,LEBANON,200,33,81,40.7,25,57,43.9,8,24,33.3,10,15,66.7,21,37,58,15,18,17,7,4,84,1
18181,426727,478_15_30,JAPAN,0,TOTALS,JAPAN,200,24,71,33.8,16,44,36.4,8,27,29.6,14,25,56.0,11,27,38,20,16,10,8,4,70,0
18182,426740,478_15_31,HONG KONG,0,TOTALS,HONG KONG,200,30,79,38.0,25,56,44.6,5,23,21.7,5,16,31.2,20,23,43,13,14,17,4,0,70,0
18183,426753,478_15_31,INDIA,0,TOTALS,INDIA,200,35,70,50.0,30,58,51.7,5,12,41.7,5,9,55.6,15,33,48,22,15,16,8,8,80,1
18184,426766,478_15_32,KOREA,0,TOTALS,KOREA,200,31,77,40.3,23,44,52.3,8,33,24.2,7,13,53.8,16,23,39,21,16,12,4,5,77,1
18185,426779,478_15_32,PHILIPPINES,0,TOTALS,PHILIPPINES,200,29,66,43.9,25,47,53.2,4,19,21.1,12,18,66.7,15,32,47,22,16,17,6,3,74,0
18186,426792,478_15_33,IRAQ,0,TOTALS,IRAQ,200,28,61,45.9,27,52,51.9,1,9,11.1,7,9,77.8,11,27,38,22,11,21,15,2,64,1
18187,426805,478_15_33,BAHRAIN,0,TOTALS,BAHRAIN,200,17,61,27.9,10,30,33.3,7,31,22.6,3,4,75.0,17,23,40,13,13,30,8,0,44,0
18188,426818,478_15_34,INDONESIA,0,TOTALS,INDONESIA,200,27,75,36.0,19,55,34.5,8,20,40.0,19,34,55.9,25,30,55,22,15,12,9,7,81,1
18189,426831,478_15_34,MALAYSIA,0,TOTALS,MALAYSIA,200,27,75,36.0,20,55,36.4,7,20,35.0,10,14,71.4,21,28,49,17,30,17,7,1,71,0
18190,426844,478_15_35,THAILAND,0,TOTALS,THAILAND,200,18,57,31.6,13,32,40.6,5,25,20.0,11,16,68.8,12,24,36,13,10,19,16,2,52,1
18191,426857,478_15_35,IRAQ,0,TOTALS,IRAQ,200,20,60,33.3,18,50,36.0,2,10,20.0,7,10,70.0,17,29,46,10,15,22,5,6,49,0
18192,426870,478_15_36,JAPAN,0,TOTALS,JAPAN,200,30,80,37.5,26,64,40.6,4,16,25.0,11,13,84.6,14,21,35,15,20,12,12,3,75,0
18193,426883,478_15_36,CHINESE TAIPEI,0,TOTALS,CHINESE TAIPEI,200,31,64,48.4,26,49,53.1,5,15,33.3,16,26,61.5,14,36,50,14,16,22,9,5,83,1
18194,426896,478_15_37,MALAYSIA,0,TOTALS,MALAYSIA,200,27,73,37.0,18,40,45.0,9,33,27.3,16,26,61.5,20,33,53,19,18,16,7,2,79,0
18195,426909,478_15_37,LEBANON,0,TOTALS,LEBANON,200,28,87,32.2,19,50,38.0,9,37,24.3,18,21,85.7,27,31,58,17,21,16,12,4,83,1
18196,426922,478_15_38,PHILIPPINES,0,TOTALS,PHILIPPINES,200,28,73,38.4,15,45,33.3,13,28,46.4,9,10,90.0,8,25,33,24,23,13,19,4,78,1
18197,426935,478_15_38,CHINA,0,TOTALS,CHINA,200,24,68,35.3,21,48,43.8,3,20,15.0,21,26,80.8,22,36,58,14,11,27,4,5,72,0
18198,426948,478_15_39,BAHRAIN,0,TOTALS,BAHRAIN,200,25,67,37.3,21,55,38.2,4,12,33.3,15,21,71.4,15,33,48,16,11,22,11,0,69,0
18199,426961,478_15_39,KOREA,0,TOTALS,KOREA,200,37,80,46.2,27,47,57.4,10,33,30.3,6,10,60.0,13,30,43,31,18,17,14,4,90,1
18200,426974,478_15_40,KUWAIT,0,TOTALS,KUWAIT,200,34,78,43.6,28,58,48.3,6,20,30.0,5,10,50.0,22,40,62,11,17,25,7,8,79,1
18201,426987,478_15_40,INDONESIA,0,TOTALS,INDONESIA,200,24,78,30.8,20,59,33.9,4,19,21.1,11,16,68.8,13,24,37,17,17,12,11,3,63,0
18202,427000,478_15_41,CHINESE TAIPEI,0,TOTALS,CHINESE TAIPEI,200,36,72,50.0,32,54,59.3,4,18,22.2,12,16,75.0,16,39,55,22,10,17,14,9,88,1
18203,427013,478_15_41,THAILAND,0,TOTALS,THAILAND,200,13,67,19.4,7,43,16.3,6,24,25.0,7,7,100.0,14,22,36,5,12,23,11,2,39,0
18204,427026,478_15_42,LEBANON,0,TOTALS,LEBANON,200,29,77,37.7,22,55,40.0,7,22,31.8,14,22,63.6,23,21,44,16,19,12,8,0,79,1
18205,427039,478_15_42,KOREA,0,TOTALS,KOREA,200,36,64,56.2,23,33,69.7,13,31,41.9,20,25,80.0,9,30,39,31,18,13,10,6,105,0
18206,427052,478_15_43,INDONESIA,0,TOTALS,INDONESIA,200,28,61,45.9,21,41,51.2,7,20,35.0,19,25,76.0,17,32,49,18,27,33,9,5,82,1
18207,427065,478_15_43,BAHRAIN,0,TOTALS,BAHRAIN,200,28,72,38.9,24,57,42.1,4,15,26.7,21,38,55.3,20,18,38,15,24,19,24,4,81,0
18208,427078,478_15_44,JAPAN,0,TOTALS,JAPAN,200,26,62,41.9,20,48,41.7,6,14,42.9,15,22,68.2,6,34,40,18,15,12,4,5,73,1
18209,427091,478_15_44,PHILIPPINES,0,TOTALS,PHILIPPINES,200,27,76,35.5,22,50,44.0,5,26,19.2,7,10,70.0,14,32,46,16,22,11,7,5,66,0
18210,427104,478_15_45,IRAQ,0,TOTALS,IRAQ,200,33,78,42.3,29,59,49.2,4,19,21.1,5,10,50.0,22,38,60,18,9,23,16,2,75,1
18211,427117,478_15_45,MALAYSIA,0,TOTALS,MALAYSIA,200,19,63,30.2,11,30,36.7,8,33,24.2,3,8,37.5,10,26,36,17,11,25,8,1,49,0
18212,427130,478_15_46,KUWAIT,0,TOTALS,KUWAIT,200,16,73,21.9,13,50,26.0,3,23,13.0,7,10,70.0,12,20,32,6,23,12,6,2,42,1
18213,427143,478_15_46,CHINA,0,TOTALS,CHINA,200,38,66,57.6,31,52,59.6,7,14,50.0,20,28,71.4,11,46,57,30,14,13,12,10,103,0
18214,427156,478_15_47,THAILAND,0,TOTALS,THAILAND,200,17,61,27.9,11,31,35.5,6,30,20.0,6,14,42.9,8,29,37,16,11,21,6,1,46,0
18215,427169,478_15_47,PHILIPPINES,0,TOTALS,PHILIPPINES,200,28,69,40.6,19,45,42.2,9,24,37.5,16,20,80.0,12,41,53,25,15,16,14,3,81,1
18216,427182,478_15_48,LEBANON,0,TOTALS,LEBANON,200,29,74,39.2,26,59,44.1,3,15,20.0,18,30,60.0,18,31,49,13,27,19,21,4,79,1
18217,427195,478_15_48,KUWAIT,0,TOTALS,KUWAIT,200,17,56,30.4,11,29,37.9,6,27,22.2,16,35,45.7,13,30,43,12,22,28,6,4,56,0
18218,427208,478_15_49,BAHRAIN,0,TOTALS,BAHRAIN,200,32,71,45.1,27,48,56.2,5,23,21.7,15,28,53.6,15,29,44,20,15,23,14,6,84,0
18219,427221,478_15_49,MALAYSIA,0,TOTALS,MALAYSIA,200,33,78,42.3,22,57,38.6,11,21,52.4,10,18,55.6,21,27,48,25,25,27,9,2,87,1
18220,427234,478_15_50,CHINESE TAIPEI,0,TOTALS,CHINESE TAIPEI,200,23,59,39.0,18,42,42.9,5,17,29.4,9,14,64.3,13,32,45,16,14,22,10,6,60,1
18221,427247,478_15_50,JAPAN,0,TOTALS,JAPAN,200,24,70,34.3,21,51,41.2,3,19,15.8,6,8,75.0,15,24,39,17,16,14,10,11,57,0
18222,427260,478_15_51,INDONESIA,0,TOTALS,INDONESIA,200,24,61,39.3,23,48,47.9,1,13,7.7,7,11,63.6,9,27,36,17,21,26,18,3,56,0
18223,427273,478_15_51,IRAQ,0,TOTALS,IRAQ,200,28,71,39.4,24,50,48.0,4,21,19.0,11,22,50.0,23,30,53,20,17,27,14,5,71,1
18224,427286,478_15_52,KOREA,0,TOTALS,KOREA,200,32,76,42.1,19,44,43.2,13,32,40.6,13,17,76.5,14,20,34,26,19,5,13,1,90,1
18225,427299,478_15_52,CHINA,0,TOTALS,CHINA,200,31,55,56.4,23,36,63.9,8,19,42.1,14,19,73.7,5,31,36,17,19,19,2,3,84,0
18226,427312,478_15_53,THAILAND,0,TOTALS,THAILAND,200,28,75,37.3,23,53,43.4,5,22,22.7,8,15,53.3,14,35,49,27,8,11,13,3,69,1
18227,427325,478_15_53,KUWAIT,0,TOTALS,KUWAIT,200,21,70,30.0,20,51,39.2,1,19,5.3,6,9,66.7,14,36,50,12,15,21,5,5,49,0
18228,427338,478_15_54,PHILIPPINES,0,TOTALS,PHILIPPINES,200,31,83,37.3,22,49,44.9,9,34,26.5,18,25,72.0,22,32,54,27,29,19,13,5,89,1
18229,427351,478_15_54,LEBANON,0,TOTALS,LEBANON,200,24,59,40.7,18,45,40.0,6,14,42.9,20,34,58.8,9,31,40,12,20,24,7,7,74,0
18230,427364,478_15_55,JAPAN,0,TOTALS,JAPAN,200,21,65,32.3,16,44,36.4,5,21,23.8,11,15,73.3,12,20,32,12,12,9,4,5,58,0
18231,427377,478_15_55,CHINA,0,TOTALS,CHINA,200,28,62,45.2,19,43,44.2,9,19,47.4,15,16,93.8,13,32,45,23,18,14,6,4,80,1
18232,427390,478_15_56,CHINESE TAIPEI,0,TOTALS,CHINESE TAIPEI,200,30,74,40.5,26,51,51.0,4,23,17.4,5,13,38.5,25,30,55,13,14,19,2,1,69,0
18233,427403,478_15_56,KOREA,0,TOTALS,KOREA,200,31,76,40.8,23,47,48.9,8,29,27.6,8,9,88.9,14,21,35,25,13,9,14,3,78,1
18234,428341,480_15_01,CUBA,0,TOTALS,CUBA,200,19,63,30.2,16,55,29.1,3,8,37.5,11,21,52.4,16,30,46,13,22,22,6,3,52,0
18235,428354,480_15_01,VENEZUELA,0,TOTALS,VENEZUELA,200,27,64,42.2,23,40,57.5,4,24,16.7,15,24,62.5,11,33,44,15,23,13,12,6,73,1
18236,428367,480_15_02,URUGUAY,0,TOTALS,URUGUAY,200,22,63,34.9,17,45,37.8,5,18,27.8,22,32,68.8,17,26,43,12,23,13,10,1,71,1
18237,428380,480_15_02,BRAZIL,0,TOTALS,BRAZIL,200,20,57,35.1,18,36,50.0,2,21,9.5,15,25,60.0,13,29,42,14,31,21,8,5,57,0
18238,428393,480_15_03,ARGENTINA,0,TOTALS,ARGENTINA,200,33,68,48.5,25,42,59.5,8,26,30.8,17,27,63.0,13,32,45,18,22,13,5,2,91,1
18239,428406,480_15_03,PUERTO RICO,0,TOTALS,PUERTO RICO,200,31,68,45.6,22,47,46.8,9,21,42.9,15,20,75.0,6,25,31,19,26,12,5,3,86,0
18240,428419,480_15_04,DOMINICAN REPUBLIC,0,TOTALS,DOMINICAN REPUBLIC,200,22,61,36.1,14,40,35.0,8,21,38.1,14,21,66.7,12,27,39,13,16,13,1,1,66,0
18241,428432,480_15_04,MEXICO,0,TOTALS,MEXICO,200,32,75,42.7,21,49,42.9,11,26,42.3,9,14,64.3,17,30,47,23,23,6,7,4,84,1
18242,428445,480_15_05,PANAMA,0,TOTALS,PANAMA,200,31,69,44.9,25,46,54.3,6,23,26.1,10,19,52.6,19,32,51,24,27,17,8,2,78,1
18243,428458,480_15_05,URUGUAY,0,TOTALS,URUGUAY,200,25,64,39.1,19,38,50.0,6,26,23.1,15,23,65.2,12,23,35,21,22,13,8,2,71,0
18244,428471,480_15_06,CANADA,0,TOTALS,CANADA,200,31,73,42.5,25,53,47.2,6,20,30.0,19,28,67.9,14,30,44,22,25,13,4,2,87,0
18245,428484,480_15_06,ARGENTINA,0,TOTALS,ARGENTINA,200,35,77,45.5,30,58,51.7,5,19,26.3,19,25,76.0,15,33,48,17,25,10,6,2,94,1
18246,428497,480_15_07,BRAZIL,0,TOTALS,BRAZIL,200,27,69,39.1,20,44,45.5,7,25,28.0,10,15,66.7,13,28,41,20,28,13,4,3,71,1
18247,428510,480_15_07,DOMINICAN REPUBLIC,0,TOTALS,DOMINICAN REPUBLIC,200,19,55,34.5,13,38,34.2,6,17,35.3,21,29,72.4,12,30,42,13,17,16,5,2,65,0
18248,428523,480_15_08,PUERTO RICO,0,TOTALS,PUERTO RICO,200,31,66,47.0,22,45,48.9,9,21,42.9,20,28,71.4,11,30,41,21,26,12,12,3,91,1
18249,428536,480_15_08,CUBA,0,TOTALS,CUBA,200,18,62,29.0,13,48,27.1,5,14,35.7,20,29,69.0,18,27,45,13,25,20,5,3,61,0
18250,428549,480_15_09,DOMINICAN REPUBLIC,0,TOTALS,DOMINICAN REPUBLIC,200,31,71,43.7,21,45,46.7,10,26,38.5,11,20,55.0,14,35,49,21,23,15,9,4,83,1
18251,428562,480_15_09,PANAMA,0,TOTALS,PANAMA,200,20,68,29.4,16,42,38.1,4,26,15.4,22,28,78.6,16,30,46,12,18,15,8,2,66,0
18252,428575,480_15_10,CUBA,0,TOTALS,CUBA,200,21,76,27.6,16,56,28.6,5,20,25.0,12,15,80.0,12,30,42,14,28,7,1,3,59,1
18253,428588,480_15_10,CANADA,0,TOTALS,CANADA,200,35,73,47.9,26,47,55.3,9,26,34.6,22,31,71.0,14,44,58,29,16,5,4,8,101,0
18254,428601,480_15_11,VENEZUELA,0,TOTALS,VENEZUELA,200,29,57,50.9,20,35,57.1,9,22,40.9,7,14,50.0,11,23,34,21,17,15,6,5,74,1
18255,428614,480_15_11,PUERTO RICO,0,TOTALS,PUERTO RICO,200,25,51,49.0,20,35,57.1,5,16,31.2,8,11,72.7,5,19,24,17,20,16,10,1,63,0
18256,428627,480_15_12,MEXICO,0,TOTALS,MEXICO,200,24,65,36.9,23,46,50.0,1,19,5.3,16,19,84.2,20,24,44,14,18,14,11,2,65,1
18257,428640,480_15_12,BRAZIL,0,TOTALS,BRAZIL,200,18,51,35.3,14,38,36.8,4,13,30.8,18,21,85.7,9,22,31,12,20,18,5,1,58,0
18258,428653,480_15_13,URUGUAY,0,TOTALS,URUGUAY,200,27,68,39.7,24,43,55.8,3,25,12.0,13,21,61.9,16,25,41,15,26,14,2,5,70,0
18259,428666,480_15_13,DOMINICAN REPUBLIC,0,TOTALS,DOMINICAN REPUBLIC,200,30,57,52.6,18,28,64.3,12,29,41.4,18,25,72.0,5,27,32,21,21,12,10,1,90,1
18260,428679,480_15_14,ARGENTINA,0,TOTALS,ARGENTINA,200,36,72,50.0,26,48,54.2,10,24,41.7,14,20,70.0,5,38,43,24,16,11,7,8,96,1
18261,428692,480_15_14,CUBA,0,TOTALS,CUBA,200,27,80,33.8,25,63,39.7,2,17,11.8,8,14,57.1,16,32,48,20,18,17,9,2,64,0
18262,428705,480_15_15,CANADA,0,TOTALS,CANADA,200,30,59,50.8,24,43,55.8,6,16,37.5,16,20,80.0,12,40,52,24,14,22,4,6,82,1
18263,428718,480_15_15,VENEZUELA,0,TOTALS,VENEZUELA,200,23,74,31.1,16,45,35.6,7,29,24.1,9,13,69.2,14,19,33,14,22,9,14,3,62,0
18264,428731,480_15_16,PANAMA,0,TOTALS,PANAMA,200,26,59,44.1,24,49,49.0,2,10,20.0,14,21,66.7,12,23,35,18,15,10,2,1,68,0
18265,428744,480_15_16,MEXICO,0,TOTALS,MEXICO,200,32,65,49.2,20,33,60.6,12,32,37.5,6,7,85.7,11,25,36,28,20,9,6,2,82,1
18266,428757,480_15_17,VENEZUELA,0,TOTALS,VENEZUELA,200,28,67,41.8,22,41,53.7,6,26,23.1,6,7,85.7,11,25,36,17,18,14,10,4,68,0
18267,428770,480_15_17,ARGENTINA,0,TOTALS,ARGENTINA,200,28,58,48.3,22,41,53.7,6,17,35.3,15,20,75.0,6,29,35,20,15,13,7,1,77,1
18268,428783,480_15_18,BRAZIL,0,TOTALS,BRAZIL,200,23,70,32.9,17,43,39.5,6,27,22.2,20,28,71.4,18,25,43,15,28,11,9,1,72,0
18269,428796,480_15_18,PANAMA,0,TOTALS,PANAMA,200,31,64,48.4,27,53,50.9,4,11,36.4,23,33,69.7,16,34,50,18,20,15,6,9,89,1
18270,428809,480_15_19,PUERTO RICO,0,TOTALS,PUERTO RICO,200,35,81,43.2,25,52,48.1,10,29,34.5,12,25,48.0,14,26,40,23,30,8,6,2,92,1
18271,428822,480_15_19,CANADA,0,TOTALS,CANADA,200,33,71,46.5,20,41,48.8,13,30,43.3,33,44,75.0,19,39,58,25,28,13,2,5,112,0
18272,428835,480_15_20,MEXICO,0,TOTALS,MEXICO,200,27,57,47.4,23,42,54.8,4,15,26.7,20,22,90.9,9,31,40,18,22,14,7,1,78,1
18273,428848,480_15_20,URUGUAY,0,TOTALS,URUGUAY,200,21,53,39.6,14,37,37.8,7,16,43.8,14,22,63.6,5,22,27,15,18,14,5,0,63,0
18274,428861,480_15_21,DOMINICAN REPUBLIC,0,TOTALS,DOMINICAN REPUBLIC,200,23,54,42.6,18,37,48.6,5,17,29.4,17,25,68.0,4,25,29,12,16,12,9,3,68,0
18275,428874,480_15_21,VENEZUELA,0,TOTALS,VENEZUELA,200,28,65,43.1,21,46,45.7,7,19,36.8,9,15,60.0,14,31,45,19,26,15,8,3,72,1
18276,428887,480_15_22,ARGENTINA,0,TOTALS,ARGENTINA,200,29,70,41.4,18,34,52.9,11,36,30.6,21,30,70.0,12,25,37,18,27,6,4,3,90,1
18277,428900,480_15_22,URUGUAY,0,TOTALS,URUGUAY,200,33,65,50.8,31,56,55.4,2,9,22.2,19,29,65.5,11,34,45,18,27,12,5,2,87,0
18278,428913,480_15_23,CANADA,0,TOTALS,CANADA,200,33,75,44.0,19,39,48.7,14,36,38.9,23,27,85.2,20,35,55,20,17,11,6,4,103,0
18279,428926,480_15_23,PANAMA,0,TOTALS,PANAMA,200,23,69,33.3,16,45,35.6,7,24,29.2,13,15,86.7,12,22,34,15,20,14,6,2,66,1
18280,428939,480_15_24,MEXICO,0,TOTALS,MEXICO,200,34,71,47.9,24,47,51.1,10,24,41.7,14,20,70.0,15,31,46,27,22,16,5,3,92,1
18281,428952,480_15_24,PUERTO RICO,0,TOTALS,PUERTO RICO,200,30,72,41.7,22,50,44.0,8,22,36.4,18,24,75.0,13,25,38,19,21,11,5,8,86,0
18282,428965,480_15_25,PANAMA,0,TOTALS,PANAMA,200,19,74,25.7,12,51,23.5,7,23,30.4,12,21,57.1,16,30,46,10,17,9,4,2,57,0
18283,428978,480_15_25,ARGENTINA,0,TOTALS,ARGENTINA,200,33,66,50.0,22,41,53.7,11,25,44.0,7,14,50.0,5,43,48,22,23,11,7,5,84,1
18284,428991,480_15_26,PUERTO RICO,0,TOTALS,PUERTO RICO,200,35,75,46.7,29,55,52.7,6,20,30.0,22,26,84.6,10,29,39,20,17,16,11,2,98,1
18285,429004,480_15_26,DOMINICAN REPUBLIC,0,TOTALS,DOMINICAN REPUBLIC,200,35,68,51.5,27,42,64.3,8,26,30.8,14,15,93.3,5,33,38,18,24,17,9,4,92,0
18286,429017,480_15_27,URUGUAY,0,TOTALS,URUGUAY,200,29,63,46.0,18,35,51.4,11,28,39.3,13,29,44.8,7,20,27,22,23,10,3,1,82,1
18287,429030,480_15_27,CANADA,0,TOTALS,CANADA,200,37,70,52.9,24,45,53.3,13,25,52.0,22,27,81.5,16,35,51,27,27,11,6,3,109,0
18288,429043,480_15_28,VENEZUELA,0,TOTALS,VENEZUELA,200,27,75,36.0,20,47,42.6,7,28,25.0,9,15,60.0,21,19,40,14,18,6,9,1,70,0
18289,429056,480_15_28,MEXICO,0,TOTALS,MEXICO,200,26,51,51.0,19,39,48.7,7,12,58.3,14,17,82.4,8,31,39,17,18,16,2,4,73,1
18290,429069,480_15_29,ARGENTINA,0,TOTALS,ARGENTINA,200,35,79,44.3,21,44,47.7,14,35,40.0,8,13,61.5,15,29,44,24,20,10,6,3,92,1
18291,429082,480_15_29,DOMINICAN REPUBLIC,0,TOTALS,DOMINICAN REPUBLIC,200,28,60,46.7,17,35,48.6,11,25,44.0,17,21,81.0,5,32,37,23,15,15,6,2,84,0
18292,429095,480_15_30,VENEZUELA,0,TOTALS,VENEZUELA,200,28,67,41.8,20,39,51.3,8,28,28.6,11,14,78.6,16,19,35,19,21,11,5,3,75,0
18293,429108,480_15_30,URUGUAY,0,TOTALS,URUGUAY,200,32,56,57.1,28,39,71.8,4,17,23.5,9,15,60.0,8,26,34,24,19,16,3,3,77,1
18294,429121,480_15_31,PANAMA,0,TOTALS,PANAMA,200,24,56,42.9,16,30,53.3,8,26,30.8,15,22,68.2,12,24,36,13,24,20,7,3,71,0
18295,429134,480_15_31,PUERTO RICO,0,TOTALS,PUERTO RICO,200,25,56,44.6,22,42,52.4,3,14,21.4,25,33,75.8,10,22,32,16,22,12,9,1,78,1
18296,429147,480_15_32,MEXICO,0,TOTALS,MEXICO,200,32,67,47.8,24,45,53.3,8,22,36.4,1,2,50.0,10,23,33,22,18,14,5,0,73,0
18297,429160,480_15_32,CANADA,0,TOTALS,CANADA,200,34,64,53.1,21,39,53.8,13,25,52.0,13,16,81.2,7,26,33,22,11,8,7,3,94,1
18298,429173,480_15_33,PANAMA,0,TOTALS,PANAMA,200,27,63,42.9,24,48,50.0,3,15,20.0,5,8,62.5,8,26,34,14,17,10,7,0,62,0
18299,429186,480_15_33,VENEZUELA,0,TOTALS,VENEZUELA,200,29,63,46.0,23,42,54.8,6,21,28.6,11,15,73.3,10,30,40,20,19,12,7,4,75,1
18300,429199,480_15_34,DOMINICAN REPUBLIC,0,TOTALS,DOMINICAN REPUBLIC,200,36,79,45.6,19,38,50.0,17,41,41.5,14,22,63.6,6,24,30,27,17,6,5,0,103,0
18301,429212,480_15_34,CANADA,0,TOTALS,CANADA,200,46,81,56.8,32,56,57.1,14,25,56.0,14,17,82.4,14,40,54,29,23,15,3,1,120,1
18302,429225,480_15_35,URUGUAY,0,TOTALS,URUGUAY,200,27,62,43.5,21,42,50.0,6,20,30.0,9,12,75.0,10,24,34,19,15,19,6,2,69,0
18303,429238,480_15_35,PUERTO RICO,0,TOTALS,PUERTO RICO,200,31,62,50.0,23,41,56.1,8,21,38.1,10,17,58.8,11,27,38,16,17,15,8,4,80,1
18304,429251,480_15_36,MEXICO,0,TOTALS,MEXICO,200,38,66,57.6,34,54,63.0,4,12,33.3,15,19,78.9,11,26,37,23,22,11,7,5,95,1
18305,429264,480_15_36,ARGENTINA,0,TOTALS,ARGENTINA,200,30,64,46.9,21,43,48.8,9,21,42.9,14,19,73.7,10,17,27,15,22,11,7,2,83,0
18306,429277,480_15_37,CANADA,0,TOTALS,CANADA,200,28,58,48.3,23,41,56.1,5,17,29.4,17,22,77.3,13,29,42,14,18,17,7,0,78,0
18307,429290,480_15_37,VENEZUELA,0,TOTALS,VENEZUELA,200,27,67,40.3,17,39,43.6,10,28,35.7,15,19,78.9,12,20,32,16,22,11,11,3,79,1
18308,429303,480_15_38,ARGENTINA,0,TOTALS,ARGENTINA,200,30,67,44.8,22,40,55.0,8,27,29.6,10,15,66.7,12,26,38,18,18,13,10,3,78,1
18309,429316,480_15_38,MEXICO,0,TOTALS,MEXICO,200,27,61,44.3,18,38,47.4,9,23,39.1,7,8,87.5,9,26,35,17,22,15,9,1,70,0
18310,429329,480_15_39,CANADA,0,TOTALS,CANADA,200,34,71,47.9,21,47,44.7,13,24,54.2,6,8,75.0,11,30,41,20,18,8,4,2,87,1
18311,429342,480_15_39,MEXICO,0,TOTALS,MEXICO,200,32,70,45.7,19,39,48.7,13,31,41.9,9,16,56.2,12,28,40,26,16,7,3,3,86,0
18312,429355,480_15_40,VENEZUELA,0,TOTALS,VENEZUELA,200,31,75,41.3,28,54,51.9,3,21,14.3,11,18,61.1,14,23,37,13,27,9,10,1,76,1
18313,429368,480_15_40,ARGENTINA,0,TOTALS,ARGENTINA,200,23,57,40.4,18,35,51.4,5,22,22.7,20,28,71.4,11,32,43,16,16,19,4,5,71,0
18314,430018,482_15_01,BRAZIL,0,TOTALS,BRAZIL,200,34,64,53.1,18,30,60.0,16,34,47.1,8,11,72.7,11,30,41,24,29,16,4,2,92,1
18315,430031,482_15_01,PUERTO RICO,0,TOTALS,PUERTO RICO,200,20,60,33.3,18,45,40.0,2,15,13.3,17,27,63.0,7,14,21,9,19,14,10,2,59,0
18316,430044,482_15_02,MEXICO,0,TOTALS,MEXICO,225,25,65,38.5,20,53,37.7,5,12,41.7,31,36,86.1,13,26,39,6,33,11,6,1,86,1
18317,430057,482_15_02,ARGENTINA,0,TOTALS,ARGENTINA,225,25,57,43.9,21,37,56.8,4,20,20.0,30,39,76.9,6,22,28,16,30,15,5,0,84,0
18318,430070,482_15_03,CANADA,0,TOTALS,CANADA,200,44,80,55.0,36,59,61.0,8,21,38.1,9,17,52.9,12,22,34,16,25,18,3,4,105,0
18319,430083,482_15_03,DOMINICAN REPUBLIC,0,TOTALS,DOMINICAN REPUBLIC,200,32,77,41.6,28,59,47.5,4,18,22.2,20,28,71.4,13,17,30,10,19,14,8,0,88,1
18320,430096,482_15_04,USA,0,TOTALS,USA,200,28,62,45.2,23,45,51.1,5,17,29.4,24,31,77.4,13,29,42,5,20,13,3,4,85,1
18321,430109,482_15_04,VENEZUELA,0,TOTALS,VENEZUELA,200,21,59,35.6,15,35,42.9,6,24,25.0,14,24,58.3,5,22,27,8,25,13,5,0,62,0
18322,430122,482_15_05,DOMINICAN REPUBLIC,0,TOTALS,DOMINICAN REPUBLIC,200,33,62,53.2,26,45,57.8,7,17,41.2,22,31,71.0,7,17,24,13,18,10,5,2,95,1
18323,430135,482_15_05,MEXICO,0,TOTALS,MEXICO,200,22,57,38.6,16,31,51.6,6,26,23.1,17,21,81.0,11,17,28,14,23,20,1,2,70,0
18324,430148,482_15_06,VENEZUELA,0,TOTALS,VENEZUELA,200,26,53,49.1,22,38,57.9,4,15,26.7,8,15,53.3,1,15,16,8,20,14,1,1,64,0
18325,430160,482_15_06,BRAZIL,0,TOTALS,BRAZIL,200,27,48,56.2,22,36,61.1,5,12,41.7,20,27,74.1,3,25,28,11,18,12,5,1,79,1
18326,430173,482_15_07,ARGENTINA,0,TOTALS,ARGENTINA,200,24,62,38.7,13,32,40.6,11,30,36.7,24,28,85.7,5,21,26,18,30,10,7,2,83,0
18327,430186,482_15_07,CANADA,0,TOTALS,CANADA,200,28,62,45.2,20,42,47.6,8,20,40.0,24,29,82.8,9,26,35,13,26,12,2,7,88,1
18328,430199,482_15_08,PUERTO RICO,0,TOTALS,PUERTO RICO,200,25,83,30.1,22,56,39.3,3,27,11.1,17,23,73.9,16,23,39,8,24,11,8,2,70,1
18329,430212,482_15_08,USA,0,TOTALS,USA,200,36,72,50.0,25,42,59.5,11,30,36.7,19,27,70.4,13,40,53,20,21,15,8,4,102,0
18330,430225,482_15_09,DOMINICAN REPUBLIC,0,TOTALS,DOMINICAN REPUBLIC,200,26,61,42.6,22,50,44.0,4,11,36.4,14,21,66.7,7,25,32,14,23,15,3,3,70,0
18331,430238,482_15_09,ARGENTINA,0,TOTALS,ARGENTINA,200,27,66,40.9,15,31,48.4,12,35,34.3,14,22,63.6,12,24,36,15,23,14,1,3,80,1
18332,430251,482_15_10,PUERTO RICO,0,TOTALS,PUERTO RICO,200,35,62,56.5,25,41,61.0,10,21,47.6,9,11,81.8,7,25,32,17,22,9,5,6,89,1
18333,430264,482_15_10,VENEZUELA,0,TOTALS,VENEZUELA,200,21,58,36.2,14,34,41.2,7,24,29.2,23,27,85.2,8,18,26,11,15,10,5,0,72,0
18334,430277,482_15_11,CANADA,0,TOTALS,CANADA,200,32,61,52.5,19,33,57.6,13,28,46.4,19,29,65.5,13,31,44,9,19,14,6,1,96,1
18335,430290,482_15_11,MEXICO,0,TOTALS,MEXICO,200,27,69,39.1,16,36,44.4,11,33,33.3,11,15,73.3,10,20,30,8,28,9,6,4,76,0
18336,430303,482_15_12,USA,0,TOTALS,USA,200,25,55,45.5,19,38,50.0,6,17,35.3,27,31,87.1,8,20,28,5,22,10,2,2,83,0
18337,430315,482_15_12,BRAZIL,0,TOTALS,BRAZIL,200,31,59,52.5,16,33,48.5,15,26,57.7,16,23,69.6,11,21,32,16,26,12,1,2,93,1
18338,430328,482_15_13,VENEZUELA,0,TOTALS,VENEZUELA,200,31,62,50.0,20,36,55.6,11,26,42.3,10,13,76.9,8,15,23,13,9,11,10,2,83,1
18339,430341,482_15_13,MEXICO,0,TOTALS,MEXICO,200,25,51,49.0,17,34,50.0,8,17,47.1,1,1,100.0,7,24,31,12,13,23,4,1,59,0
18340,430353,482_15_14,BRAZIL,0,TOTALS,BRAZIL,200,24,61,39.3,19,40,47.5,5,21,23.8,15,22,68.2,14,26,40,10,22,16,5,2,68,1
18341,430366,482_15_14,DOMINICAN REPUBLIC,0,TOTALS,DOMINICAN REPUBLIC,200,21,59,35.6,19,43,44.2,2,16,12.5,18,22,81.8,7,26,33,6,22,14,4,0,62,0
18342,430379,482_15_15,CANADA,0,TOTALS,CANADA,225,43,86,50.0,30,48,62.5,13,38,34.2,12,16,75.0,17,33,50,18,24,12,0,3,111,1
18343,430392,482_15_15,USA,0,TOTALS,USA,225,38,80,47.5,25,46,54.3,13,34,38.2,19,23,82.6,9,20,29,16,20,4,4,5,108,0
18344,430405,482_15_16,PUERTO RICO,0,TOTALS,PUERTO RICO,200,28,68,41.2,25,52,48.1,3,16,18.8,26,31,83.9,9,17,26,12,29,10,8,3,85,1
18345,430418,482_15_16,ARGENTINA,0,TOTALS,ARGENTINA,200,33,60,55.0,22,41,53.7,11,19,57.9,28,34,82.4,9,29,38,20,26,23,6,2,105,0
18346,430431,482_15_17,DOMINICAN REPUBLIC,0,TOTALS,DOMINICAN REPUBLIC,200,28,58,48.3,17,36,47.2,11,22,50.0,15,21,71.4,8,24,32,15,21,17,3,1,82,0
18347,430444,482_15_17,USA,0,TOTALS,USA,200,30,68,44.1,21,46,45.7,9,22,40.9,18,20,90.0,15,20,35,13,20,12,8,2,87,1
18348,430456,482_15_18,BRAZIL,0,TOTALS,BRAZIL,200,34,64,53.1,25,42,59.5,9,22,40.9,9,13,69.2,6,29,35,25,26,15,6,2,86,1
18349,430469,482_15_18,CANADA,0,TOTALS,CANADA,200,21,65,32.3,15,41,36.6,6,24,25.0,23,27,85.2,17,23,40,11,18,13,6,2,71,0
18350,430949,484_15_01,CAYMAN ISLANDS,0,TOTALS,CAYMAN ISLANDS,192,23,60,38.3,15,41,36.6,8,19,42.1,11,19,57.9,8,22,30,10,23,11,13,3,65,0
18351,430962,484_15_01,VIRGIN ISLANDS,0,TOTALS,VIRGIN ISLANDS,200,27,69,39.1,20,47,42.6,7,22,31.8,16,20,80.0,15,25,40,14,19,14,4,3,77,1
18352,430975,484_15_02,BAHAMAS,0,TOTALS,BAHAMAS,200,23,61,37.7,20,39,51.3,3,22,13.6,8,15,53.3,11,34,45,12,17,16,14,3,57,1
18353,430987,484_15_02,BERMUDA,0,TOTALS,BERMUDA,200,14,52,26.9,8,28,28.6,6,24,25.0,4,11,36.4,3,25,28,8,14,21,6,2,38,0
18354,431000,484_15_03,ANTIGUA,0,TOTALS,ANTIGUA,200,29,74,39.2,22,54,40.7,7,20,35.0,15,25,60.0,15,31,46,19,9,17,14,2,80,1
18355,431013,484_15_03,GUYANA,0,TOTALS,GUYANA,200,26,79,32.9,23,54,42.6,3,25,12.0,5,13,38.5,20,30,50,9,17,21,10,5,60,0
18356,431026,484_15_04,ST.VINCENT AND THE GRENADINES,0,TOTALS,ST.VINCENT AND THE GRENADINES,200,27,68,39.7,22,47,46.8,5,21,23.8,10,15,66.7,17,25,42,14,15,25,8,7,69,0
18357,431039,484_15_04,BRITISH VIRGIN ISLANDS,0,TOTALS,BRITISH VIRGIN ISLANDS,200,32,76,42.1,21,46,45.7,11,30,36.7,9,14,64.3,17,21,38,22,18,15,12,9,84,1
18358,431052,484_15_05,SURINAM,0,TOTALS,SURINAM,200,21,77,27.3,19,67,28.4,2,10,20.0,6,12,50.0,14,27,41,15,21,17,12,4,50,0
18359,431065,484_15_05,ANTIGUA,0,TOTALS,ANTIGUA,200,32,65,49.2,25,44,56.8,7,21,33.3,14,26,53.8,8,40,48,16,12,20,11,6,85,1
18360,431076,484_15_06,BARBADOS,0,TOTALS,BARBADOS,200,26,70,37.1,23,50,46.0,3,20,15.0,8,15,53.3,20,24,44,12,21,20,13,5,63,0
18361,431089,484_15_06,ST.VINCENT AND THE GRENADINES,0,TOTALS,ST.VINCENT AND THE GRENADINES,200,27,64,42.2,24,54,44.4,3,10,30.0,13,19,68.4,14,27,41,14,15,23,13,1,70,1
18362,431102,484_15_07,GUYANA,0,TOTALS,GUYANA,200,22,81,27.2,14,51,27.5,8,30,26.7,17,19,89.5,17,18,35,13,21,14,14,0,69,0
18363,431115,484_15_07,BAHAMAS,0,TOTALS,BAHAMAS,200,35,62,56.5,30,49,61.2,5,13,38.5,14,26,53.8,13,38,51,11,17,22,7,12,89,1
18364,431128,484_15_08,BRITISH VIRGIN ISLANDS,0,TOTALS,BRITISH VIRGIN ISLANDS,200,32,63,50.8,27,44,61.4,5,19,26.3,23,36,63.9,22,37,59,15,15,27,8,6,92,1
18365,431140,484_15_08,CAYMAN ISLANDS,0,TOTALS,CAYMAN ISLANDS,200,29,77,37.7,17,47,36.2,12,30,40.0,8,12,66.7,12,15,27,12,27,15,11,0,78,0
18366,431153,484_15_09,GUYANA,0,TOTALS,GUYANA,200,25,71,35.2,20,48,41.7,5,23,21.7,10,19,52.6,19,30,49,13,22,19,11,4,65,0
18367,431165,484_15_09,BERMUDA,0,TOTALS,BERMUDA,200,22,58,37.9,13,32,40.6,9,26,34.6,21,32,65.6,12,30,42,12,17,16,10,1,74,1
18368,431178,484_15_10,SURINAM,0,TOTALS,SURINAM,200,19,62,30.6,12,44,27.3,7,18,38.9,12,25,48.0,14,23,37,11,24,15,8,5,57,0
18369,431191,484_15_10,BAHAMAS,0,TOTALS,BAHAMAS,200,21,59,35.6,19,46,41.3,2,13,15.4,28,38,73.7,18,30,48,6,21,14,9,6,72,1
18370,431204,484_15_11,ST.VINCENT AND THE GRENADINES,0,TOTALS,ST.VINCENT AND THE GRENADINES,200,23,73,31.5,17,46,37.0,6,27,22.2,10,22,45.5,15,30,45,8,17,22,9,3,62,0
18371,431217,484_15_11,VIRGIN ISLANDS,0,TOTALS,VIRGIN ISLANDS,200,33,73,45.2,23,46,50.0,10,27,37.0,17,22,77.3,11,35,46,21,20,15,11,5,93,1
18372,431230,484_15_12,BRITISH VIRGIN ISLANDS,0,TOTALS,BRITISH VIRGIN ISLANDS,200,26,78,33.3,19,51,37.3,7,27,25.9,17,25,68.0,23,21,44,15,20,18,14,5,76,0
18373,431241,484_15_12,BARBADOS,0,TOTALS,BARBADOS,200,23,62,37.1,12,40,30.0,11,22,50.0,20,25,80.0,17,26,43,13,20,25,8,3,77,1
18374,431253,484_15_13,CAYMAN ISLANDS,0,TOTALS,CAYMAN ISLANDS,200,28,72,38.9,21,42,50.0,7,30,23.3,8,15,53.3,15,18,33,17,25,9,8,1,71,0
18375,431266,484_15_13,ST.VINCENT AND THE GRENADINES,0,TOTALS,ST.VINCENT AND THE GRENADINES,200,28,61,45.9,25,43,58.1,3,18,16.7,21,30,70.0,17,32,49,18,11,16,3,5,80,1
18376,431278,484_15_14,BERMUDA,0,TOTALS,BERMUDA,200,24,68,35.3,15,45,33.3,9,23,39.1,14,19,73.7,19,31,50,12,10,15,11,2,71,1
18377,431291,484_15_14,SURINAM,0,TOTALS,SURINAM,200,19,59,32.2,15,45,33.3,4,14,28.6,8,10,80.0,9,27,36,16,22,18,8,3,50,0
18378,431304,484_15_15,BAHAMAS,0,TOTALS,BAHAMAS,200,25,73,34.2,18,54,33.3,7,19,36.8,12,19,63.2,15,35,50,12,14,17,9,12,69,1
18379,431317,484_15_15,ANTIGUA,0,TOTALS,ANTIGUA,200,19,74,25.7,13,48,27.1,6,26,23.1,17,23,73.9,10,29,39,10,14,13,7,4,61,0
18380,431330,484_15_16,VIRGIN ISLANDS,0,TOTALS,VIRGIN ISLANDS,200,23,69,33.3,13,45,28.9,10,24,41.7,22,25,88.0,11,33,44,14,23,14,6,2,78,1
18381,431341,484_15_16,BARBADOS,0,TOTALS,BARBADOS,200,24,74,32.4,19,56,33.9,5,18,27.8,18,25,72.0,20,33,53,8,21,14,4,1,71,0
18382,431354,484_15_17,ANTIGUA,0,TOTALS,ANTIGUA,200,24,63,38.1,19,49,38.8,5,14,35.7,18,27,66.7,14,37,51,15,17,19,8,7,71,1
18383,431366,484_15_17,BERMUDA,0,TOTALS,BERMUDA,200,23,76,30.3,17,46,37.0,6,30,20.0,12,17,70.6,16,29,45,13,24,11,12,4,64,0
18384,431377,484_15_18,BARBADOS,0,TOTALS,BARBADOS,200,32,64,50.0,22,40,55.0,10,24,41.7,11,16,68.8,14,39,53,23,9,17,6,0,85,1
18385,431389,484_15_18,CAYMAN ISLANDS,0,TOTALS,CAYMAN ISLANDS,200,20,66,30.3,15,42,35.7,5,24,20.8,5,5,100.0,5,20,25,15,13,13,7,2,50,0
18386,431402,484_15_19,SURINAM,0,TOTALS,SURINAM,200,29,60,48.3,23,45,51.1,6,15,40.0,17,22,77.3,10,35,45,17,14,21,12,2,81,1
18387,431415,484_15_19,GUYANA,0,TOTALS,GUYANA,200,17,75,22.7,11,46,23.9,6,29,20.7,8,14,57.1,18,20,38,6,17,18,14,2,48,0
18388,431427,484_15_20,VIRGIN ISLANDS,0,TOTALS,VIRGIN ISLANDS,200,32,66,48.5,25,44,56.8,7,22,31.8,18,22,81.8,5,29,34,19,14,10,10,5,89,1
18389,431440,484_15_20,BRITISH VIRGIN ISLANDS,0,TOTALS,BRITISH VIRGIN ISLANDS,200,25,72,34.7,15,40,37.5,10,32,31.2,10,14,71.4,17,25,42,10,20,16,7,3,70,0
18390,431452,484_15_21,CAYMAN ISLANDS,0,TOTALS,CAYMAN ISLANDS,200,31,74,41.9,24,51,47.1,7,23,30.4,20,33,60.6,20,29,49,12,12,11,14,5,89,1
18391,431465,484_15_21,GUYANA,0,TOTALS,GUYANA,200,25,69,36.2,21,45,46.7,4,24,16.7,7,11,63.6,15,29,44,10,20,21,4,3,61,0
18392,431478,484_15_22,ST.VINCENT AND THE GRENADINES,0,TOTALS,ST.VINCENT AND THE GRENADINES,200,29,55,52.7,25,42,59.5,4,13,30.8,12,24,50.0,13,33,46,20,16,33,5,6,74,1
18393,431490,484_15_22,BERMUDA,0,TOTALS,BERMUDA,200,26,70,37.1,16,33,48.5,10,37,27.0,11,15,73.3,11,16,27,18,22,18,24,2,73,0
18394,431501,484_15_23,BARBADOS,0,TOTALS,BARBADOS,200,16,69,23.2,14,41,34.1,2,28,7.1,15,24,62.5,24,20,44,3,10,11,6,1,49,0
18395,431514,484_15_23,SURINAM,0,TOTALS,SURINAM,200,30,69,43.5,22,46,47.8,8,23,34.8,3,7,42.9,20,29,49,19,20,13,6,3,71,1
18396,431527,484_15_24,ANTIGUA,0,TOTALS,ANTIGUA,200,24,74,32.4,19,45,42.2,5,29,17.2,13,22,59.1,9,25,34,11,17,9,6,1,66,1
18397,431540,484_15_24,VIRGIN ISLANDS,0,TOTALS,VIRGIN ISLANDS,200,43,88,48.9,34,65,52.3,9,23,39.1,13,20,65.0,21,45,66,26,20,7,9,0,108,0
18398,431553,484_15_25,BRITISH VIRGIN ISLANDS,0,TOTALS,BRITISH VIRGIN ISLANDS,200,23,73,31.5,16,46,34.8,7,27,25.9,15,23,65.2,18,21,39,9,17,20,5,3,68,0
18399,431566,484_15_25,BAHAMAS,0,TOTALS,BAHAMAS,200,36,78,46.2,33,58,56.9,3,20,15.0,10,16,62.5,20,32,52,17,21,18,12,5,85,1
18400,431578,484_15_26,BERMUDA,0,TOTALS,BERMUDA,200,27,66,40.9,19,38,50.0,8,28,28.6,11,20,55.0,6,30,36,18,18,15,14,4,73,0
18401,431589,484_15_26,BARBADOS,0,TOTALS,BARBADOS,200,28,72,38.9,23,47,48.9,5,25,20.0,17,21,81.0,14,37,51,21,18,18,7,2,78,1
18402,431602,484_15_27,ST.VINCENT AND THE GRENADINES,0,TOTALS,ST.VINCENT AND THE GRENADINES,200,31,54,57.4,24,36,66.7,7,18,38.9,11,20,55.0,12,30,42,21,15,34,3,10,80,0
18403,431615,484_15_27,SURINAM,0,TOTALS,SURINAM,200,31,74,41.9,22,51,43.1,9,23,39.1,16,20,80.0,13,17,30,19,17,17,17,3,87,1
18404,431628,484_15_28,BRITISH VIRGIN ISLANDS,0,TOTALS,BRITISH VIRGIN ISLANDS,200,26,72,36.1,18,49,36.7,8,23,34.8,13,23,56.5,15,23,38,18,17,15,12,7,73,0
18405,431641,484_15_28,ANTIGUA,0,TOTALS,ANTIGUA,200,32,67,47.8,25,47,53.2,7,20,35.0,11,23,47.8,12,34,46,14,18,23,8,7,82,1
18406,431654,484_15_29,BAHAMAS,0,TOTALS,BAHAMAS,200,23,74,31.1,19,53,35.8,4,21,19.0,15,22,68.2,16,29,45,16,17,13,7,6,65,0
18407,431667,484_15_29,VIRGIN ISLANDS,0,TOTALS,VIRGIN ISLANDS,200,24,68,35.3,13,35,37.1,11,33,33.3,12,16,75.0,11,31,42,15,20,18,6,5,71,1
18408,432185,486_15_01,NICARAGUA,0,TOTALS,NICARAGUA,200,25,62,40.3,21,52,40.4,4,10,40.0,21,31,67.7,11,30,41,7,13,19,11,5,75,1
18409,432198,486_15_01,EL SALVADOR,0,TOTALS,EL SALVADOR,200,27,74,36.5,20,50,40.0,7,24,29.2,5,14,35.7,12,27,39,18,26,18,11,5,66,0
18410,432211,486_15_02,HONDURAS,0,TOTALS,HONDURAS,200,28,65,43.1,22,44,50.0,6,21,28.6,15,19,78.9,4,32,36,12,24,12,8,0,77,0
18411,432224,486_15_02,MEXICO,0,TOTALS,MEXICO,200,27,60,45.0,17,39,43.6,10,21,47.6,18,32,56.2,6,29,35,17,17,15,4,1,82,1
18412,432237,486_15_03,GUATEMALA,0,TOTALS,GUATEMALA,200,23,54,42.6,13,27,48.1,10,27,37.0,9,17,52.9,9,25,34,15,20,19,4,0,59,0
18413,432250,486_15_03,COSTA RICA,0,TOTALS,COSTA RICA,200,29,54,53.7,22,31,71.0,7,23,30.4,20,30,66.7,3,23,26,17,17,7,9,0,85,1
18414,432262,486_15_04,PANAMA,0,TOTALS,PANAMA,200,29,67,43.3,19,36,52.8,10,31,32.3,20,28,71.4,10,31,41,16,17,12,12,1,88,1
18415,432275,486_15_04,NICARAGUA,0,TOTALS,NICARAGUA,200,25,69,36.2,24,60,40.0,1,9,11.1,12,18,66.7,15,27,42,8,22,17,7,1,63,0
18416,432288,486_15_05,GUATEMALA,0,TOTALS,GUATEMALA,200,26,73,35.6,18,44,40.9,8,29,27.6,4,5,80.0,11,21,32,15,21,24,14,2,64,0
18417,432301,486_15_05,MEXICO,0,TOTALS,MEXICO,200,34,61,55.7,29,50,58.0,5,11,45.5,16,26,61.5,10,26,36,24,13,26,17,3,89,1
18418,432314,486_15_06,HONDURAS,0,TOTALS,HONDURAS,200,18,53,34.0,15,40,37.5,3,13,23.1,15,27,55.6,12,24,36,11,17,16,10,4,54,0
18419,432327,486_15_06,COSTA RICA,0,TOTALS,COSTA RICA,200,22,54,40.7,10,32,31.2,12,22,54.5,9,10,90.0,5,23,28,16,20,15,9,4,65,1
18420,432340,486_15_07,EL SALVADOR,0,TOTALS,EL SALVADOR,200,29,73,39.7,22,58,37.9,7,15,46.7,8,13,61.5,10,25,35,15,21,18,9,2,73,0
18421,432352,486_15_07,PANAMA,0,TOTALS,PANAMA,200,26,57,45.6,19,36,52.8,7,21,33.3,17,26,65.4,6,32,38,10,18,20,9,1,76,1
18422,432365,486_15_08,HONDURAS,0,TOTALS,HONDURAS,200,36,60,60.0,23,36,63.9,13,24,54.2,10,22,45.5,5,34,39,23,16,8,8,0,95,1
18423,432378,486_15_08,GUATEMALA,0,TOTALS,GUATEMALA,200,19,71,26.8,13,33,39.4,6,38,15.8,12,15,80.0,14,24,38,14,20,12,6,1,56,0
18424,432391,486_15_09,COSTA RICA,0,TOTALS,COSTA RICA,200,22,47,46.8,14,25,56.0,8,22,36.4,11,18,61.1,3,19,22,15,22,18,10,2,63,1
18425,432404,486_15_09,MEXICO,0,TOTALS,MEXICO,200,24,50,48.0,21,40,52.5,3,10,30.0,10,17,58.8,6,17,23,13,23,21,12,1,61,0
18426,432417,486_15_10,EL SALVADOR,0,TOTALS,EL SALVADOR,200,32,69,46.4,27,54,50.0,5,15,33.3,15,18,83.3,10,30,40,22,18,20,6,0,84,1
18427,432430,486_15_10,GUATEMALA,0,TOTALS,GUATEMALA,200,25,73,34.2,15,33,45.5,10,40,25.0,16,21,76.2,12,26,38,18,19,20,14,1,76,0
18428,432442,486_15_11,PANAMA,0,TOTALS,PANAMA,250,32,68,47.1,21,46,45.7,11,22,50.0,35,50,70.0,17,31,48,20,26,20,14,2,110,1
18429,432455,486_15_11,MEXICO,0,TOTALS,MEXICO,250,36,70,51.4,27,45,60.0,9,25,36.0,24,32,75.0,4,24,28,26,30,19,10,1,105,0
18430,432468,486_15_12,COSTA RICA,0,TOTALS,COSTA RICA,200,15,56,26.8,10,35,28.6,5,21,23.8,16,22,72.7,6,33,39,10,21,10,8,5,51,1
18431,432481,486_15_12,NICARAGUA,0,TOTALS,NICARAGUA,200,13,52,25.0,11,39,28.2,2,13,15.4,15,26,57.7,7,36,43,7,19,14,5,5,43,0
18432,432494,486_15_13,HONDURAS,0,TOTALS,HONDURAS,200,23,62,37.1,13,39,33.3,10,23,43.5,9,15,60.0,9,31,40,12,22,20,15,0,65,1
18433,432507,486_15_13,EL SALVADOR,0,TOTALS,EL SALVADOR,200,15,57,26.3,13,41,31.7,2,16,12.5,14,26,53.8,14,27,41,11,12,26,7,3,46,0
18434,432520,486_15_14,NICARAGUA,0,TOTALS,NICARAGUA,200,29,66,43.9,24,55,43.6,5,11,45.5,12,18,66.7,16,34,50,17,18,17,6,5,75,1
18435,432533,486_15_14,MEXICO,0,TOTALS,MEXICO,200,24,63,38.1,16,40,40.0,8,23,34.8,15,23,65.2,6,20,26,22,17,12,10,3,71,0
18436,432546,486_15_15,COSTA RICA,0,TOTALS,COSTA RICA,200,17,66,25.8,12,42,28.6,5,24,20.8,7,12,58.3,14,12,26,14,19,15,8,4,46,0
18437,432558,486_15_15,PANAMA,0,TOTALS,PANAMA,200,24,45,53.3,16,30,53.3,8,15,53.3,18,23,78.3,7,32,39,8,11,20,8,5,74,1
18438,432949,488_15_01,VENEZUELA,0,TOTALS,VENEZUELA,200,15,59,25.4,12,40,30.0,3,19,15.8,22,36,61.1,9,26,35,3,18,22,11,4,55,0
18439,432962,488_15_01,CANADA,0,TOTALS,CANADA,200,33,87,37.9,26,59,44.1,7,28,25.0,11,21,52.4,27,38,65,18,25,21,10,2,84,1
18440,432975,488_15_02,USA,0,TOTALS,USA,207,41,80,51.2,38,69,55.1,3,11,27.3,20,34,58.8,23,40,63,13,18,22,14,8,105,0
18441,432988,488_15_02,PUERTO RICO,0,TOTALS,PUERTO RICO,200,21,78,26.9,13,48,27.1,8,30,26.7,4,10,40.0,20,21,41,5,27,32,12,2,54,1
18442,433001,488_15_03,BRAZIL,0,TOTALS,BRAZIL,200,22,65,33.8,19,50,38.0,3,15,20.0,11,31,35.5,20,26,46,8,22,32,14,6,58,0
18443,433014,488_15_03,DOMINICAN REPUBLIC,0,TOTALS,DOMINICAN REPUBLIC,200,18,59,30.5,13,40,32.5,5,19,26.3,25,28,89.3,14,27,41,10,26,34,14,4,66,1
18444,433027,488_15_04,ARGENTINA,0,TOTALS,ARGENTINA,200,30,60,50.0,27,41,65.9,3,19,15.8,22,34,64.7,13,33,46,11,17,22,7,1,85,1
18445,433040,488_15_04,MEXICO,0,TOTALS,MEXICO,200,27,78,34.6,19,48,39.6,8,30,26.7,8,17,47.1,19,21,40,7,27,12,12,1,70,0
18446,433053,488_15_05,DOMINICAN REPUBLIC,0,TOTALS,DOMINICAN REPUBLIC,200,18,60,30.0,16,45,35.6,2,15,13.3,13,21,61.9,8,32,40,4,17,44,8,4,51,1
18447,433066,488_15_05,USA,0,TOTALS,USA,200,43,102,42.2,24,58,41.4,19,44,43.2,10,20,50.0,27,39,66,24,22,22,25,9,115,0
18448,433079,488_15_06,PUERTO RICO,0,TOTALS,PUERTO RICO,200,28,75,37.3,23,52,44.2,5,23,21.7,21,30,70.0,14,26,40,13,26,20,12,4,82,1
18449,433092,488_15_06,BRAZIL,0,TOTALS,BRAZIL,200,25,61,41.0,21,48,43.8,4,13,30.8,21,36,58.3,16,37,53,13,25,28,5,5,75,0
18450,433105,488_15_07,CANADA,0,TOTALS,CANADA,200,35,74,47.3,29,56,51.8,6,18,33.3,25,43,58.1,23,49,72,13,22,31,11,11,101,0
18451,433118,488_15_07,MEXICO,0,TOTALS,MEXICO,200,21,79,26.6,12,50,24.0,9,29,31.0,13,25,52.0,13,23,36,5,30,23,14,0,64,1
18452,433131,488_15_08,VENEZUELA,0,TOTALS,VENEZUELA,200,17,60,28.3,14,48,29.2,3,12,25.0,14,34,41.2,15,29,44,5,23,25,12,4,51,0
18453,433144,488_15_08,ARGENTINA,0,TOTALS,ARGENTINA,200,24,67,35.8,16,43,37.2,8,24,33.3,15,22,68.2,15,32,47,13,25,23,15,4,71,1
18454,433157,488_15_09,DOMINICAN REPUBLIC,0,TOTALS,DOMINICAN REPUBLIC,200,26,56,46.4,24,47,51.1,2,9,22.2,17,31,54.8,11,34,45,9,26,26,12,8,71,1
18455,433170,488_15_09,PUERTO RICO,0,TOTALS,PUERTO RICO,200,23,75,30.7,17,50,34.0,6,25,24.0,14,26,53.8,24,24,48,5,24,19,15,3,66,0
18456,433183,488_15_10,MEXICO,0,TOTALS,MEXICO,200,34,86,39.5,24,64,37.5,10,22,45.5,10,16,62.5,18,31,49,22,30,17,17,8,88,1
18457,433196,488_15_10,VENEZUELA,0,TOTALS,VENEZUELA,200,22,67,32.8,20,51,39.2,2,16,12.5,24,41,58.5,17,34,51,4,18,25,6,2,70,0
18458,433209,488_15_11,USA,0,TOTALS,USA,200,49,102,48.0,43,83,51.8,6,19,31.6,19,30,63.3,38,31,69,18,18,21,20,5,123,0
18459,433222,488_15_11,BRAZIL,0,TOTALS,BRAZIL,200,28,64,43.8,20,40,50.0,8,24,33.3,19,26,73.1,7,21,28,13,25,32,16,4,83,1
18460,433235,488_15_12,ARGENTINA,0,TOTALS,ARGENTINA,200,22,65,33.8,17,43,39.5,5,22,22.7,13,25,52.0,16,30,46,9,23,20,3,4,62,0
18461,433248,488_15_12,CANADA,0,TOTALS,CANADA,206,25,64,39.1,17,39,43.6,8,25,32.0,18,30,60.0,15,31,46,9,30,15,13,8,76,1
18462,433261,488_15_13,PUERTO RICO,0,TOTALS,PUERTO RICO,200,29,72,40.3,21,49,42.9,8,23,34.8,15,21,71.4,14,32,46,8,24,24,15,13,81,1
18463,433274,488_15_13,VENEZUELA,0,TOTALS,VENEZUELA,200,23,71,32.4,20,59,33.9,3,12,25.0,21,32,65.6,19,28,47,9,20,24,13,1,70,0
18464,433287,488_15_14,MEXICO,0,TOTALS,MEXICO,200,22,71,31.0,16,43,37.2,6,28,21.4,19,26,73.1,16,31,47,6,27,25,13,1,69,0
18465,433300,488_15_14,BRAZIL,0,TOTALS,BRAZIL,200,25,63,39.7,19,43,44.2,6,20,30.0,24,43,55.8,12,36,48,16,23,22,15,4,80,1
18466,433313,488_15_15,CANADA,0,TOTALS,CANADA,200,37,79,46.8,27,53,50.9,10,26,38.5,11,15,73.3,22,38,60,18,13,16,10,2,95,1
18467,433326,488_15_15,DOMINICAN REPUBLIC,0,TOTALS,DOMINICAN REPUBLIC,200,18,61,29.5,17,41,41.5,1,20,5.0,12,17,70.6,8,19,27,7,15,17,8,2,49,0
18468,433339,488_15_16,USA,0,TOTALS,USA,200,41,82,50.0,34,61,55.7,7,21,33.3,30,38,78.9,17,31,48,15,28,10,17,1,119,0
18469,433352,488_15_16,ARGENTINA,0,TOTALS,ARGENTINA,200,26,62,41.9,15,34,44.1,11,28,39.3,13,25,52.0,12,26,38,14,32,27,3,2,76,1
18470,433365,488_15_17,VENEZUELA,0,TOTALS,VENEZUELA,200,26,71,36.6,23,54,42.6,3,17,17.6,25,42,59.5,20,43,63,10,17,24,9,6,80,1
18471,433378,488_15_17,MEXICO,0,TOTALS,MEXICO,200,25,88,28.4,19,58,32.8,6,30,20.0,15,20,75.0,21,31,52,10,32,19,15,3,71,0
18472,433391,488_15_18,PUERTO RICO,0,TOTALS,PUERTO RICO,200,18,60,30.0,13,42,31.0,5,18,27.8,2,4,50.0,6,25,31,10,14,18,17,5,43,0
18473,433404,488_15_18,BRAZIL,0,TOTALS,BRAZIL,200,26,71,36.6,21,55,38.2,5,16,31.2,5,12,41.7,19,38,57,14,12,21,9,5,62,1
18474,433417,488_15_19,ARGENTINA,0,TOTALS,ARGENTINA,200,26,62,41.9,21,48,43.8,5,14,35.7,17,22,77.3,10,35,45,11,22,16,9,5,74,1
18475,433430,488_15_19,DOMINICAN REPUBLIC,0,TOTALS,DOMINICAN REPUBLIC,200,18,59,30.5,12,42,28.6,6,17,35.3,17,28,60.7,9,26,35,8,19,15,10,6,59,0
18476,433443,488_15_20,USA,0,TOTALS,USA,200,32,82,39.0,27,61,44.3,5,21,23.8,8,15,53.3,20,35,55,6,17,23,13,8,77,1
18477,433456,488_15_20,CANADA,0,TOTALS,CANADA,200,23,75,30.7,18,56,32.1,5,19,26.3,9,16,56.2,19,35,54,11,12,27,13,6,60,0
18478,433983,490_15_01,PERU,0,TOTALS,PERU,200,23,73,31.5,17,43,39.5,6,30,20.0,18,22,81.8,16,19,35,8,15,30,11,0,70,0
18479,433996,490_15_01,COLOMBIA,0,TOTALS,COLOMBIA,200,35,81,43.2,31,72,43.1,4,9,44.4,10,22,45.5,24,21,45,13,19,28,18,2,84,1
18480,434009,490_15_02,VENEZUELA,0,TOTALS,VENEZUELA,200,17,65,26.2,14,50,28.0,3,15,20.0,9,22,40.9,16,40,56,3,25,23,4,4,46,0
18481,434022,490_15_02,PARAGUAY,0,TOTALS,PARAGUAY,200,22,77,28.6,16,49,32.7,6,28,21.4,16,22,72.7,12,33,45,10,21,12,9,4,66,1
18482,434035,490_15_03,VENEZUELA,0,TOTALS,VENEZUELA,200,23,73,31.5,17,48,35.4,6,25,24.0,16,23,69.6,20,30,50,7,16,18,5,7,68,1
18483,434048,490_15_03,PERU,0,TOTALS,PERU,200,24,66,36.4,19,41,46.3,5,25,20.0,4,11,36.4,13,24,37,9,18,16,5,3,57,0
18484,434061,490_15_04,PARAGUAY,0,TOTALS,PARAGUAY,200,22,71,31.0,18,43,41.9,4,28,14.3,7,14,50.0,17,20,37,4,19,17,7,2,55,0
18485,434074,490_15_04,BRAZIL,0,TOTALS,BRAZIL,200,33,67,49.3,28,49,57.1,5,18,27.8,12,23,52.2,11,33,44,12,14,15,11,3,83,1
18486,434087,490_15_05,URUGUAY,0,TOTALS,URUGUAY,225,24,73,32.9,24,59,40.7,0,14,0.0,9,11,81.8,20,35,55,5,26,29,11,2,57,0
18487,434100,490_15_05,CHILE,0,TOTALS,CHILE,225,20,61,32.8,19,38,50.0,1,23,4.3,17,27,63.0,7,28,35,8,13,18,12,2,58,1
18488,434113,490_15_06,BRAZIL,0,TOTALS,BRAZIL,200,26,65,40.0,20,43,46.5,6,22,27.3,22,36,61.1,21,29,50,9,19,16,11,4,80,1
18489,434126,490_15_06,PERU,0,TOTALS,PERU,200,26,58,44.8,20,33,60.6,6,25,24.0,9,18,50.0,5,20,25,6,23,19,6,1,67,0
18490,434139,490_15_07,ARGENTINA,0,TOTALS,ARGENTINA,200,38,64,59.4,33,46,71.7,5,18,27.8,17,29,58.6,8,47,55,28,17,19,20,5,98,1
18491,434152,490_15_07,ECUADOR,0,TOTALS,ECUADOR,200,10,66,15.2,7,42,16.7,3,24,12.5,8,21,38.1,12,24,36,2,23,28,6,0,31,0
18492,434165,490_15_08,COLOMBIA,0,TOTALS,COLOMBIA,200,29,65,44.6,27,53,50.9,2,12,16.7,17,31,54.8,13,30,43,11,33,41,15,7,77,0
18493,434178,490_15_08,VENEZUELA,0,TOTALS,VENEZUELA,200,32,81,39.5,25,58,43.1,7,23,30.4,21,38,55.3,25,21,46,13,22,33,19,7,92,1
18494,434191,490_15_09,ECUADOR,0,TOTALS,ECUADOR,200,20,60,33.3,15,37,40.5,5,23,21.7,10,20,50.0,15,21,36,10,29,25,7,1,55,0
18495,434204,490_15_09,URUGUAY,0,TOTALS,URUGUAY,200,23,55,41.8,18,41,43.9,5,14,35.7,23,38,60.5,15,27,42,10,25,22,10,1,74,1
18496,434217,490_15_10,PARAGUAY,0,TOTALS,PARAGUAY,200,36,85,42.4,23,53,43.4,13,32,40.6,16,31,51.6,20,28,48,17,24,24,11,5,101,0
18497,434230,490_15_10,COLOMBIA,0,TOTALS,COLOMBIA,200,30,74,40.5,28,49,57.1,2,25,8.0,21,36,58.3,15,30,45,4,25,22,9,4,83,1
18498,434243,490_15_11,CHILE,0,TOTALS,CHILE,200,24,69,34.8,17,40,42.5,7,29,24.1,14,20,70.0,11,25,36,12,13,11,11,1,69,0
18499,434256,490_15_11,ARGENTINA,0,TOTALS,ARGENTINA,200,29,71,40.8,18,46,39.1,11,25,44.0,5,8,62.5,15,35,50,16,20,19,8,0,74,1
18500,434269,490_15_12,VENEZUELA,0,TOTALS,VENEZUELA,200,23,53,43.4,20,45,44.4,3,8,37.5,18,22,81.8,12,20,32,4,25,23,11,5,67,0
18501,434282,490_15_12,BRAZIL,0,TOTALS,BRAZIL,200,27,73,37.0,20,48,41.7,7,25,28.0,19,29,65.5,21,16,37,8,25,18,11,5,80,1
18502,434295,490_15_13,PARAGUAY,0,TOTALS,PARAGUAY,200,36,71,50.7,31,49,63.3,5,22,22.7,13,22,59.1,18,42,60,11,21,20,2,3,90,1
18503,434308,490_15_13,PERU,0,TOTALS,PERU,200,26,72,36.1,21,49,42.9,5,23,21.7,15,25,60.0,5,21,26,8,21,11,8,1,72,0
18504,434321,490_15_14,BRAZIL,0,TOTALS,BRAZIL,200,31,80,38.8,24,57,42.1,7,23,30.4,18,22,81.8,19,41,60,13,11,22,8,14,87,1
18505,434334,490_15_14,COLOMBIA,0,TOTALS,COLOMBIA,200,29,87,33.3,22,67,32.8,7,20,35.0,4,14,28.6,16,27,43,10,20,15,10,7,69,0
18506,434347,490_15_15,CHILE,0,TOTALS,CHILE,200,26,73,35.6,18,50,36.0,8,23,34.8,9,14,64.3,12,28,40,16,16,17,15,3,69,1
18507,434360,490_15_15,ECUADOR,0,TOTALS,ECUADOR,200,20,67,29.9,17,50,34.0,3,17,17.6,10,18,55.6,20,34,54,4,16,26,7,1,53,0
18508,434373,490_15_16,ARGENTINA,0,TOTALS,ARGENTINA,200,27,70,38.6,23,50,46.0,4,20,20.0,10,18,55.6,15,32,47,15,27,15,9,3,68,1
18509,434386,490_15_16,URUGUAY,0,TOTALS,URUGUAY,200,15,55,27.3,13,41,31.7,2,14,14.3,22,35,62.9,13,31,44,6,23,20,7,1,54,0
18510,434399,490_15_17,VENEZUELA,0,TOTALS,VENEZUELA,200,37,87,42.5,34,71,47.9,3,16,18.8,14,30,46.7,22,36,58,19,23,17,15,6,91,1
18511,434412,490_15_17,ECUADOR,0,TOTALS,ECUADOR,200,23,72,31.9,20,54,37.0,3,18,16.7,13,27,48.1,16,36,52,10,20,26,10,2,62,0
18512,434425,490_15_18,BRAZIL,0,TOTALS,BRAZIL,200,23,72,31.9,17,41,41.5,6,31,19.4,7,9,77.8,22,29,51,13,17,17,9,2,59,1
18513,434438,490_15_18,CHILE,0,TOTALS,CHILE,200,20,64,31.2,17,38,44.7,3,26,11.5,12,15,80.0,15,27,42,7,10,16,12,0,55,0
18514,434451,490_15_19,COLOMBIA,0,TOTALS,COLOMBIA,200,32,75,42.7,29,56,51.8,3,19,15.8,5,15,33.3,16,46,62,13,19,31,10,4,72,1
18515,434464,490_15_19,ECUADOR,0,TOTALS,ECUADOR,200,27,88,30.7,25,68,36.8,2,20,10.0,7,22,31.8,23,28,51,14,13,20,20,6,63,0
18516,434477,490_15_20,URUGUAY,0,TOTALS,URUGUAY,225,21,60,35.0,18,38,47.4,3,22,13.6,25,31,80.6,11,37,48,7,21,24,10,6,70,0
18517,434490,490_15_20,VENEZUELA,0,TOTALS,VENEZUELA,225,29,86,33.7,25,65,38.5,4,21,19.0,12,24,50.0,26,27,53,13,24,18,7,3,74,1
18518,434503,490_15_21,CHILE,0,TOTALS,CHILE,200,26,65,40.0,20,43,46.5,6,22,27.3,11,17,64.7,11,34,45,9,11,11,6,3,69,1
18519,434516,490_15_21,PARAGUAY,0,TOTALS,PARAGUAY,200,23,71,32.4,17,43,39.5,6,28,21.4,4,9,44.4,18,29,47,4,18,14,6,2,56,0
18520,434529,490_15_22,BRAZIL,0,TOTALS,BRAZIL,200,16,67,23.9,11,40,27.5,5,27,18.5,12,18,66.7,15,32,47,8,19,21,2,9,49,0
18521,434542,490_15_22,ARGENTINA,0,TOTALS,ARGENTINA,200,28,69,40.6,24,54,44.4,4,15,26.7,13,25,52.0,14,35,49,19,16,12,16,4,73,1
18522,435075,492_15_01,ARGENTINA,0,TOTALS,ARGENTINA,200,22,61,36.1,17,37,45.9,5,24,20.8,6,11,54.5,6,23,29,9,16,10,6,2,57,1
18523,435088,492_15_01,CHILE,0,TOTALS,CHILE,200,19,56,33.9,16,42,38.1,3,14,21.4,3,13,23.1,7,23,30,4,9,16,6,1,50,0
18524,435101,492_15_02,VENEZUELA,0,TOTALS,VENEZUELA,200,22,60,36.7,19,44,43.2,3,16,18.8,10,21,47.6,9,19,28,3,17,11,8,0,57,0
18525,435114,492_15_02,COLOMBIA,0,TOTALS,COLOMBIA,200,26,58,44.8,25,46,54.3,1,12,8.3,20,25,80.0,7,23,30,5,18,14,5,0,73,1
18526,435127,492_15_03,PARAGUAY,0,TOTALS,PARAGUAY,200,31,81,38.3,24,60,40.0,7,21,33.3,20,28,71.4,18,24,42,15,14,16,17,3,89,1
18527,435140,492_15_03,PERU,0,TOTALS,PERU,200,18,53,34.0,17,39,43.6,1,14,7.1,6,13,46.2,7,21,28,2,19,34,4,1,43,0
18528,435153,492_15_04,CHILE,0,TOTALS,CHILE,200,15,41,36.6,13,34,38.2,2,7,28.6,7,10,70.0,0,20,20,4,10,14,2,2,39,0
18529,435166,492_15_04,URUGUAY,0,TOTALS,URUGUAY,200,28,67,41.8,26,57,45.6,2,10,20.0,5,10,50.0,14,16,30,0,16,11,10,3,63,1
18530,435179,492_15_05,PERU,0,TOTALS,PERU,200,15,54,27.8,12,37,32.4,3,17,17.6,5,11,45.5,3,20,23,4,15,26,5,1,38,0
18531,435192,492_15_05,ARGENTINA,0,TOTALS,ARGENTINA,200,31,62,50.0,24,43,55.8,7,19,36.8,18,22,81.8,8,32,40,13,14,12,21,2,87,1
18532,435205,492_15_06,COLOMBIA,0,TOTALS,COLOMBIA,200,17,52,32.7,16,36,44.4,1,16,6.2,10,22,45.5,7,17,24,5,16,18,14,2,45,0
18533,435218,492_15_06,PARAGUAY,0,TOTALS,PARAGUAY,200,25,62,40.3,20,41,48.8,5,21,23.8,7,14,50.0,14,24,38,9,25,25,10,1,62,1
18534,435231,492_15_07,PERU,0,TOTALS,PERU,200,26,59,44.1,22,47,46.8,4,12,33.3,12,31,38.7,9,28,37,7,21,23,16,1,68,1
18535,435244,492_15_07,CHILE,0,TOTALS,CHILE,200,24,63,38.1,23,55,41.8,1,8,12.5,15,30,50.0,14,21,35,8,20,23,11,3,64,0
18536,435257,492_15_08,ARGENTINA,0,TOTALS,ARGENTINA,200,27,62,43.5,23,40,57.5,4,22,18.2,17,26,65.4,11,23,34,7,21,18,15,4,75,1
18537,435270,492_15_08,COLOMBIA,0,TOTALS,COLOMBIA,200,17,50,34.0,15,36,41.7,2,14,14.3,15,32,46.9,4,25,29,2,21,26,8,0,51,0
18538,435283,492_15_09,URUGUAY,0,TOTALS,URUGUAY,200,25,64,39.1,21,48,43.8,4,16,25.0,11,23,47.8,10,19,29,5,19,13,10,2,65,0
18539,435296,492_15_09,VENEZUELA,0,TOTALS,VENEZUELA,200,27,56,48.2,19,37,51.4,8,19,42.1,9,21,42.9,7,27,34,10,21,19,4,1,71,1
18540,435309,492_15_10,COLOMBIA,0,TOTALS,COLOMBIA,200,23,55,41.8,23,47,48.9,0,8,0.0,11,33,33.3,12,16,28,3,15,15,9,1,57,1
18541,435322,492_15_10,PERU,0,TOTALS,PERU,200,20,52,38.5,18,41,43.9,2,11,18.2,8,13,61.5,3,23,26,7,20,17,6,2,50,0
18542,435335,492_15_11,CHILE,0,TOTALS,CHILE,200,19,47,40.4,19,38,50.0,0,9,0.0,11,19,57.9,6,12,18,3,12,21,9,2,49,0
18543,435348,492_15_11,VENEZUELA,0,TOTALS,VENEZUELA,200,23,56,41.1,22,43,51.2,1,13,7.7,13,19,68.4,10,19,29,6,15,22,9,1,60,1
18544,435361,492_15_12,PARAGUAY,0,TOTALS,PARAGUAY,200,30,62,48.4,27,50,54.0,3,12,25.0,8,14,57.1,12,26,38,11,15,25,15,0,71,1
18545,435374,492_15_12,URUGUAY,0,TOTALS,URUGUAY,200,23,56,41.1,18,42,42.9,5,14,35.7,7,13,53.8,5,17,22,9,14,25,13,0,58,0
18546,435387,492_15_13,URUGUAY,0,TOTALS,URUGUAY,200,22,66,33.3,21,48,43.8,1,18,5.6,9,14,64.3,13,23,36,6,26,27,13,0,54,0
18547,435400,492_15_13,ARGENTINA,0,TOTALS,ARGENTINA,200,25,59,42.4,14,28,50.0,11,31,35.5,22,33,66.7,10,26,36,8,14,19,14,3,83,1
18548,435413,492_15_14,CHILE,0,TOTALS,CHILE,200,16,57,28.1,13,42,31.0,3,15,20.0,7,13,53.8,8,17,25,5,19,25,8,1,42,0
18549,435426,492_15_14,COLOMBIA,0,TOTALS,COLOMBIA,200,26,56,46.4,25,48,52.1,1,8,12.5,14,24,58.3,9,30,39,8,14,17,17,3,67,1
18550,435439,492_15_15,VENEZUELA,0,TOTALS,VENEZUELA,200,27,59,45.8,24,42,57.1,3,17,17.6,14,30,46.7,11,16,27,3,22,23,12,1,71,0
18551,435452,492_15_15,PARAGUAY,0,TOTALS,PARAGUAY,200,27,55,49.1,24,44,54.5,3,11,27.3,15,25,60.0,11,18,29,8,21,21,10,1,72,1
18552,435465,492_15_16,PERU,0,TOTALS,PERU,200,14,50,28.0,9,30,30.0,5,20,25.0,5,10,50.0,3,23,26,6,16,31,5,3,38,0
18553,435478,492_15_16,URUGUAY,0,TOTALS,URUGUAY,200,31,76,40.8,26,62,41.9,5,14,35.7,10,17,58.8,15,28,43,9,14,19,17,3,77,1
18554,435491,492_15_17,ARGENTINA,0,TOTALS,ARGENTINA,200,29,63,46.0,22,37,59.5,7,26,26.9,11,26,42.3,12,26,38,8,26,19,6,2,76,1
18555,435504,492_15_17,VENEZUELA,0,TOTALS,VENEZUELA,200,25,68,36.8,19,43,44.2,6,25,24.0,16,32,50.0,12,21,33,4,24,20,11,0,72,0
18556,435517,492_15_18,PARAGUAY,0,TOTALS,PARAGUAY,200,29,80,36.2,26,56,46.4,3,24,12.5,10,20,50.0,20,18,38,5,20,9,15,3,71,1
18557,435530,492_15_18,CHILE,0,TOTALS,CHILE,200,20,49,40.8,17,42,40.5,3,7,42.9,9,21,42.9,6,25,31,7,14,20,2,3,52,0
18558,435543,492_15_19,VENEZUELA,0,TOTALS,VENEZUELA,200,27,70,38.6,18,47,38.3,9,23,39.1,9,17,52.9,17,28,45,6,16,11,9,1,72,1
18559,435556,492_15_19,PERU,0,TOTALS,PERU,200,22,52,42.3,22,46,47.8,0,6,0.0,13,24,54.2,2,20,22,4,13,15,7,0,57,0
18560,435569,492_15_20,URUGUAY,0,TOTALS,URUGUAY,200,24,57,42.1,19,39,48.7,5,18,27.8,9,19,47.4,10,25,35,8,24,27,14,3,62,1
18561,435582,492_15_20,COLOMBIA,0,TOTALS,COLOMBIA,200,21,54,38.9,19,36,52.8,2,18,11.1,16,31,51.6,11,21,32,5,18,25,19,1,60,0
18562,435595,492_15_21,PARAGUAY,0,TOTALS,PARAGUAY,200,20,65,30.8,18,45,40.0,2,20,10.0,10,17,58.8,9,25,34,6,15,16,9,2,52,0
18563,435608,492_15_21,ARGENTINA,0,TOTALS,ARGENTINA,200,36,70,51.4,25,41,61.0,11,29,37.9,13,20,65.0,8,26,34,11,12,17,6,2,96,1
18564,435621,492_15_22,COLOMBIA,0,TOTALS,COLOMBIA,200,18,51,35.3,15,36,41.7,3,15,20.0,12,18,66.7,8,17,25,6,14,20,6,2,51,0
18565,435634,492_15_22,URUGUAY,0,TOTALS,URUGUAY,200,31,63,49.2,28,55,50.9,3,8,37.5,12,17,70.6,10,21,31,8,23,13,12,0,77,1
18566,435647,492_15_23,VENEZUELA,0,TOTALS,VENEZUELA,200,32,74,43.2,28,54,51.9,4,20,20.0,8,20,40.0,14,19,33,7,5,8,17,5,76,1
18567,435660,492_15_23,PERU,0,TOTALS,PERU,200,19,53,35.8,17,42,40.5,2,11,18.2,4,7,57.1,8,26,34,6,14,20,4,1,44,0
18568,435673,492_15_24,ARGENTINA,0,TOTALS,ARGENTINA,200,27,63,42.9,21,39,53.8,6,24,25.0,14,18,77.8,8,23,31,7,12,25,9,4,74,1
18569,435686,492_15_24,PARAGUAY,0,TOTALS,PARAGUAY,200,22,76,28.9,18,50,36.0,4,26,15.4,7,13,53.8,20,21,41,8,15,19,18,4,55,0
18570,436089,494_15_01,BAHAMAS,0,TOTALS,BAHAMAS,200,33,97,34.0,29,80,36.2,4,17,23.5,9,24,37.5,32,31,63,18,18,13,16,7,79,0
18571,436102,494_15_01,VIRGIN ISLANDS,0,TOTALS,VIRGIN ISLANDS,200,32,86,37.2,26,54,48.1,6,32,18.8,12,22,54.5,29,41,70,16,21,23,5,14,82,1
18572,436115,494_15_02,GUATEMALA,0,TOTALS,GUATEMALA,200,22,68,32.4,15,42,35.7,7,26,26.9,5,13,38.5,14,35,49,12,10,35,7,0,56,0
18573,436128,494_15_02,MEXICO,0,TOTALS,MEXICO,200,40,96,41.7,31,58,53.4,9,38,23.7,5,8,62.5,23,36,59,27,14,18,27,5,94,1
18574,436141,494_15_03,DOMINICAN REPUBLIC,0,TOTALS,DOMINICAN REPUBLIC,200,35,83,42.2,29,54,53.7,6,29,20.7,12,22,54.5,21,44,65,21,18,16,19,11,88,1
18575,436154,494_15_03,COSTA RICA,0,TOTALS,COSTA RICA,200,18,74,24.3,16,58,27.6,2,16,12.5,7,14,50.0,16,33,49,7,21,20,8,0,45,0
18576,436167,494_15_04,PUERTO RICO,0,TOTALS,PUERTO RICO,200,38,79,48.1,30,50,60.0,8,29,27.6,13,30,43.3,22,26,48,24,19,20,25,10,97,1
18577,436180,494_15_04,BARBADOS,0,TOTALS,BARBADOS,200,14,53,26.4,11,44,25.0,3,9,33.3,6,16,37.5,17,26,43,1,22,43,5,2,37,0
18578,436193,494_15_05,COSTA RICA,0,TOTALS,COSTA RICA,200,26,60,43.3,20,47,42.6,6,13,46.2,11,13,84.6,11,42,53,18,19,26,7,5,69,1
18579,436206,494_15_05,GUATEMALA,0,TOTALS,GUATEMALA,200,16,65,24.6,14,41,34.1,2,24,8.3,12,17,70.6,11,23,34,10,19,21,16,1,46,0
18580,436219,494_15_06,BARBADOS,0,TOTALS,BARBADOS,200,18,65,27.7,14,53,26.4,4,12,33.3,2,6,33.3,11,39,50,12,22,42,7,3,42,0
18581,436232,494_15_06,BAHAMAS,0,TOTALS,BAHAMAS,200,38,90,42.2,36,70,51.4,2,20,10.0,18,31,58.1,19,38,57,24,14,12,26,13,96,1
18582,436245,494_15_07,MEXICO,0,TOTALS,MEXICO,200,25,78,32.1,14,40,35.0,11,38,28.9,10,14,71.4,16,39,55,14,18,13,11,4,71,1
18583,436258,494_15_07,DOMINICAN REPUBLIC,0,TOTALS,DOMINICAN REPUBLIC,200,24,73,32.9,19,47,40.4,5,26,19.2,10,20,50.0,16,39,55,12,18,17,8,5,63,0
18584,436271,494_15_08,VIRGIN ISLANDS,0,TOTALS,VIRGIN ISLANDS,200,24,60,40.0,18,37,48.6,6,23,26.1,15,27,55.6,13,40,53,14,21,24,5,6,69,0
18585,436284,494_15_08,PUERTO RICO,0,TOTALS,PUERTO RICO,200,30,84,35.7,23,51,45.1,7,33,21.2,11,15,73.3,16,31,47,20,23,11,12,5,78,1
18586,436297,494_15_09,DOMINICAN REPUBLIC,0,TOTALS,DOMINICAN REPUBLIC,200,33,87,37.9,28,60,46.7,5,27,18.5,16,24,66.7,28,42,70,17,6,16,10,6,87,1
18587,436310,494_15_09,GUATEMALA,0,TOTALS,GUATEMALA,200,23,76,30.3,19,58,32.8,4,18,22.2,2,3,66.7,12,30,42,16,18,20,10,2,52,0
18588,436323,494_15_10,BARBADOS,0,TOTALS,BARBADOS,200,17,55,30.9,15,41,36.6,2,14,14.3,8,14,57.1,12,25,37,7,24,36,11,1,44,1
18589,436336,494_15_10,VIRGIN ISLANDS,0,TOTALS,VIRGIN ISLANDS,200,43,93,46.2,27,47,57.4,16,46,34.8,17,30,56.7,30,31,61,27,21,15,22,3,119,0
18590,436349,494_15_11,MEXICO,0,TOTALS,MEXICO,200,32,75,42.7,22,44,50.0,10,31,32.3,5,10,50.0,23,24,47,20,19,26,33,6,79,1
18591,436362,494_15_11,COSTA RICA,0,TOTALS,COSTA RICA,200,15,58,25.9,13,40,32.5,2,18,11.1,5,12,41.7,20,21,41,10,13,43,15,1,37,0
18592,436375,494_15_12,PUERTO RICO,0,TOTALS,PUERTO RICO,200,33,65,50.8,23,42,54.8,10,23,43.5,17,29,58.6,10,29,39,16,24,14,5,3,93,1
18593,436388,494_15_12,BAHAMAS,0,TOTALS,BAHAMAS,200,26,66,39.4,22,58,37.9,4,8,50.0,18,33,54.5,19,26,45,8,24,16,10,5,74,0
18594,436401,494_15_13,GUATEMALA,0,TOTALS,GUATEMALA,200,24,69,34.8,16,42,38.1,8,27,29.6,10,18,55.6,12,27,39,15,21,15,12,2,66,1
18595,436414,494_15_13,BARBADOS,0,TOTALS,BARBADOS,200,21,61,34.4,18,40,45.0,3,21,14.3,12,22,54.5,17,39,56,16,18,23,8,1,57,0
18596,436427,494_15_14,COSTA RICA,0,TOTALS,COSTA RICA,200,17,54,31.5,15,45,33.3,2,9,22.2,14,31,45.2,9,35,44,12,21,18,6,3,50,0
18597,436440,494_15_14,BAHAMAS,0,TOTALS,BAHAMAS,200,22,70,31.4,19,53,35.8,3,17,17.6,14,32,43.8,22,37,59,13,25,15,10,4,61,1
18598,436453,494_15_15,MEXICO,0,TOTALS,MEXICO,200,20,73,27.4,15,42,35.7,5,31,16.1,10,16,62.5,18,24,42,13,20,11,10,4,55,0
18599,436466,494_15_15,VIRGIN ISLANDS,0,TOTALS,VIRGIN ISLANDS,200,25,60,41.7,19,39,48.7,6,21,28.6,14,24,58.3,16,39,55,20,17,18,7,7,70,1
18600,436479,494_15_16,PUERTO RICO,0,TOTALS,PUERTO RICO,200,32,72,44.4,24,45,53.3,8,27,29.6,14,29,48.3,19,28,47,15,22,11,11,12,86,1
18601,436492,494_15_16,DOMINICAN REPUBLIC,0,TOTALS,DOMINICAN REPUBLIC,200,25,63,39.7,19,46,41.3,6,17,35.3,11,22,50.0,17,25,42,8,23,18,4,4,67,0
18602,436505,494_15_17,BARBADOS,0,TOTALS,BARBADOS,200,19,58,32.8,16,47,34.0,3,11,27.3,16,28,57.1,12,32,44,13,21,21,10,1,57,0
18603,436518,494_15_17,COSTA RICA,0,TOTALS,COSTA RICA,200,20,61,32.8,16,45,35.6,4,16,25.0,15,23,65.2,11,34,45,11,26,19,8,3,59,1
18604,436531,494_15_18,GUATEMALA,0,TOTALS,GUATEMALA,200,28,60,46.7,22,39,56.4,6,21,28.6,7,10,70.0,6,26,32,18,16,17,10,4,69,0
18605,436544,494_15_18,BAHAMAS,0,TOTALS,BAHAMAS,200,31,82,37.8,30,72,41.7,1,10,10.0,11,21,52.4,31,27,58,15,9,14,9,4,74,1
18606,436557,494_15_19,MEXICO,0,TOTALS,MEXICO,200,25,72,34.7,20,44,45.5,5,28,17.9,5,8,62.5,18,21,39,11,23,20,14,3,60,0
18607,436570,494_15_19,DOMINICAN REPUBLIC,0,TOTALS,DOMINICAN REPUBLIC,200,25,65,38.5,23,53,43.4,2,12,16.7,24,33,72.7,23,30,53,7,11,20,7,1,76,1
18608,436583,494_15_20,VIRGIN ISLANDS,0,TOTALS,VIRGIN ISLANDS,200,20,63,31.7,15,46,32.6,5,17,29.4,12,17,70.6,17,26,43,7,24,23,10,5,57,1
18609,436596,494_15_20,PUERTO RICO,0,TOTALS,PUERTO RICO,200,36,79,45.6,25,49,51.0,11,30,36.7,18,27,66.7,23,30,53,24,14,13,11,8,101,0
18610,436869,496_15_01,COSTA RICA,0,TOTALS,COSTA RICA,200,29,63,46.0,25,50,50.0,4,13,30.8,18,26,69.2,12,31,43,14,25,18,20,5,80,1
18611,436882,496_15_01,HONDURAS,0,TOTALS,HONDURAS,200,25,59,42.4,23,50,46.0,2,9,22.2,15,33,45.5,14,25,39,4,19,25,12,2,67,0
18612,436895,496_15_02,PANAMA,0,TOTALS,PANAMA,200,23,43,53.5,23,38,60.5,0,5,0.0,16,27,59.3,7,44,51,11,9,32,17,6,62,1
18613,436908,496_15_02,GUATEMALA,0,TOTALS,GUATEMALA,200,12,74,16.2,9,54,16.7,3,20,15.0,2,10,20.0,19,19,38,2,21,23,16,4,29,0
18614,436921,496_15_03,MEXICO,0,TOTALS,MEXICO,200,50,106,47.2,35,70,50.0,15,36,41.7,8,14,57.1,34,33,67,26,8,14,20,4,123,0
18615,436933,496_15_03,EL SALVADOR,0,TOTALS,EL SALVADOR,200,15,55,27.3,11,46,23.9,4,9,44.4,4,8,50.0,6,17,23,6,13,36,7,2,38,1
18616,436946,496_15_04,HONDURAS,0,TOTALS,HONDURAS,200,22,77,28.6,20,70,28.6,2,7,28.6,11,23,47.8,18,23,41,10,16,31,20,3,57,0
18617,436959,496_15_04,PANAMA,0,TOTALS,PANAMA,200,25,54,46.3,25,49,51.0,0,5,0.0,10,17,58.8,8,36,44,11,19,37,24,3,60,1
18618,436971,496_15_05,EL SALVADOR,0,TOTALS,EL SALVADOR,200,28,65,43.1,23,45,51.1,5,20,25.0,4,8,50.0,5,26,31,7,33,39,14,1,65,1
18619,436984,496_15_05,COSTA RICA,0,TOTALS,COSTA RICA,200,36,84,42.9,34,72,47.2,2,12,16.7,32,51,62.7,29,33,62,16,11,27,28,3,106,0
18620,436997,496_15_06,GUATEMALA,0,TOTALS,GUATEMALA,200,10,45,22.2,9,35,25.7,1,10,10.0,5,12,41.7,7,17,24,1,24,46,9,0,26,1
18621,437010,496_15_06,MEXICO,0,TOTALS,MEXICO,200,40,97,41.2,33,75,44.0,7,22,31.8,24,35,68.6,41,31,72,21,13,22,32,4,111,0
18622,437023,496_15_07,PANAMA,0,TOTALS,PANAMA,200,25,59,42.4,22,48,45.8,3,11,27.3,10,16,62.5,14,35,49,10,15,36,11,4,63,0
18623,437036,496_15_07,COSTA RICA,0,TOTALS,COSTA RICA,200,25,70,35.7,19,49,38.8,6,21,28.6,11,16,68.8,11,23,34,10,19,23,23,3,67,1
18624,437049,496_15_08,GUATEMALA,0,TOTALS,GUATEMALA,200,23,80,28.7,20,62,32.3,3,18,16.7,6,12,50.0,30,36,66,7,14,30,14,1,55,1
18625,437061,496_15_08,EL SALVADOR,0,TOTALS,EL SALVADOR,200,22,66,33.3,20,49,40.8,2,17,11.8,7,17,41.2,12,27,39,7,12,24,21,4,53,0
18626,437074,496_15_09,MEXICO,0,TOTALS,MEXICO,200,30,87,34.5,26,62,41.9,4,25,16.0,11,18,61.1,27,25,52,12,22,26,31,4,75,1
18627,437087,496_15_09,HONDURAS,0,TOTALS,HONDURAS,200,13,46,28.3,13,39,33.3,0,7,0.0,9,20,45.0,10,31,41,5,15,45,14,0,35,0
18628,437100,496_15_10,HONDURAS,0,TOTALS,HONDURAS,200,18,62,29.0,16,48,33.3,2,14,14.3,13,22,59.1,17,29,46,7,13,24,18,3,51,1
18629,437113,496_15_10,GUATEMALA,0,TOTALS,GUATEMALA,200,15,60,25.0,11,41,26.8,4,19,21.1,5,14,35.7,18,31,49,5,18,32,14,5,39,0
18630,437125,496_15_11,EL SALVADOR,0,TOTALS,EL SALVADOR,200,14,69,20.3,11,55,20.0,3,14,21.4,1,6,16.7,11,32,43,7,21,24,6,5,32,0
18631,437138,496_15_11,PANAMA,0,TOTALS,PANAMA,200,24,71,33.8,23,57,40.4,1,14,7.1,20,29,69.0,19,47,66,10,9,11,14,4,69,1
18632,437151,496_15_12,COSTA RICA,0,TOTALS,COSTA RICA,200,16,60,26.7,12,45,26.7,4,15,26.7,12,15,80.0,11,27,38,6,21,27,7,0,48,0
18633,437164,496_15_12,MEXICO,0,TOTALS,MEXICO,200,35,92,38.0,28,62,45.2,7,30,23.3,10,20,50.0,35,32,67,13,16,15,19,10,87,1
18634,437177,496_15_13,HONDURAS,0,TOTALS,HONDURAS,200,30,68,44.1,28,64,43.8,2,4,50.0,7,22,31.8,20,38,58,13,13,25,16,2,69,1
18635,437189,496_15_13,EL SALVADOR,0,TOTALS,EL SALVADOR,200,14,63,22.2,14,54,25.9,0,9,0.0,7,14,50.0,11,26,37,7,17,28,14,8,35,0
18636,437202,496_15_14,GUATEMALA,0,TOTALS,GUATEMALA,200,16,74,21.6,14,45,31.1,2,29,6.9,0,2,0.0,18,31,49,9,12,24,11,6,34,0
18637,437215,496_15_14,COSTA RICA,0,TOTALS,COSTA RICA,200,20,68,29.4,17,48,35.4,3,20,15.0,12,18,66.7,16,40,56,10,8,24,12,4,55,1
18638,437228,496_15_15,MEXICO,0,TOTALS,MEXICO,200,46,92,50.0,40,70,57.1,6,22,27.3,10,13,76.9,22,31,53,17,17,20,26,1,108,0
18639,437241,496_15_15,PANAMA,0,TOTALS,PANAMA,200,13,45,28.9,12,38,31.6,1,7,14.3,13,26,50.0,7,25,32,4,13,37,10,4,40,1
18640,437254,497_15_01,POLAND,0,TOTALS,POLAND,200,24,57,42.1,19,36,52.8,5,21,23.8,15,24,62.5,9,33,42,16,20,16,8,2,68,1
18641,437267,497_15_01,BOSNIA AND HERZEGOVINA,0,TOTALS,BOSNIA AND HERZEGOVINA,200,25,66,37.9,19,44,43.2,6,22,27.3,8,16,50.0,13,26,39,19,25,14,9,1,64,0
18642,437280,497_15_02,GERMANY,0,TOTALS,GERMANY,200,29,62,46.8,23,42,54.8,6,20,30.0,7,13,53.8,8,35,43,16,25,15,4,2,71,1
18643,437293,497_15_02,ICELAND,0,TOTALS,ICELAND,200,23,62,37.1,16,37,43.2,7,25,28.0,12,22,54.5,8,27,35,11,23,12,6,1,65,0
18644,437306,497_15_03,GEORGIA,0,TOTALS,GEORGIA,200,23,59,39.0,14,36,38.9,9,23,39.1,17,18,94.4,13,23,36,15,22,15,5,4,72,0
18645,437319,497_15_03,NETHERLANDS,0,TOTALS,NETHERLANDS,200,26,58,44.8,20,44,45.5,6,14,42.9,15,23,65.2,14,23,37,13,22,12,5,0,73,1
18646,437332,497_15_04,CZECH REPUBLIC,0,TOTALS,CZECH REPUBLIC,200,32,68,47.1,25,50,50.0,7,18,38.9,9,16,56.2,11,30,41,18,17,9,5,2,80,1
18647,437345,497_15_04,ESTONIA,0,TOTALS,ESTONIA,200,22,64,34.4,18,44,40.9,4,20,20.0,9,10,90.0,11,28,39,8,22,15,4,1,57,0
18648,437358,497_15_05,ISRAEL,0,TOTALS,ISRAEL,200,25,49,51.0,22,38,57.9,3,11,27.3,23,34,67.6,4,25,29,20,25,11,9,0,76,1
18649,437371,497_15_05,RUSSIA,0,TOTALS,RUSSIA,200,21,59,35.6,10,30,33.3,11,29,37.9,20,24,83.3,12,27,39,15,24,17,4,1,73,0
18650,437384,497_15_06,SPAIN,0,TOTALS,SPAIN,200,23,65,35.4,20,46,43.5,3,19,15.8,21,25,84.0,8,24,32,18,22,8,5,6,70,0
18651,437397,497_15_06,SERBIA,0,TOTALS,SERBIA,200,28,59,47.5,19,36,52.8,9,23,39.1,15,21,71.4,10,34,44,18,27,14,3,3,80,1
18652,437410,497_15_07,MKD,0,TOTALS,MKD,200,22,63,34.9,10,33,30.3,12,30,40.0,9,11,81.8,11,17,28,12,21,15,3,0,65,0
18653,437423,497_15_07,GREECE,0,TOTALS,GREECE,200,32,58,55.2,27,46,58.7,5,12,41.7,16,22,72.7,11,28,39,23,20,12,2,2,85,1
18654,437436,497_15_08,BELGIUM,0,TOTALS,BELGIUM,200,26,61,42.6,20,42,47.6,6,19,31.6,9,12,75.0,11,23,34,19,24,16,7,1,67,0
18655,437449,497_15_08,LATVIA,0,TOTALS,LATVIA,200,25,53,47.2,17,31,54.8,8,22,36.4,20,24,83.3,7,26,33,22,23,15,5,6,78,1
18656,437462,497_15_09,FRANCE,0,TOTALS,FRANCE,225,37,68,54.4,32,48,66.7,5,20,25.0,18,23,78.3,13,30,43,21,16,17,6,5,97,1
18657,437475,497_15_09,FINLAND,0,TOTALS,FINLAND,225,37,78,47.4,29,50,58.0,8,28,28.6,5,8,62.5,13,19,32,16,22,10,10,5,87,0
18658,437488,497_15_10,ITALY,0,TOTALS,ITALY,200,30,54,55.6,22,34,64.7,8,20,40.0,19,21,90.5,9,22,31,19,25,14,2,0,87,0
18659,437501,497_15_10,TURKEY,0,TOTALS,TURKEY,200,31,72,43.1,23,52,44.2,8,20,40.0,19,27,70.4,21,15,36,20,20,8,8,1,89,1
18660,437514,497_15_11,CROATIA,0,TOTALS,CROATIA,200,25,52,48.1,19,36,52.8,6,16,37.5,24,35,68.6,15,28,43,14,23,19,4,4,80,1
18661,437527,497_15_11,SLOVENIA,0,TOTALS,SLOVENIA,200,26,63,41.3,16,35,45.7,10,28,35.7,11,18,61.1,9,16,25,20,29,13,5,1,73,0
18662,437540,497_15_12,LITHUANIA,0,TOTALS,LITHUANIA,200,22,64,34.4,17,51,33.3,5,13,38.5,20,25,80.0,16,23,39,17,14,11,8,2,69,1
18663,437553,497_15_12,UKRAINE,0,TOTALS,UKRAINE,200,31,62,50.0,27,47,57.4,4,15,26.7,2,3,66.7,7,26,33,18,23,14,7,3,68,0
18664,437566,497_15_13,RUSSIA,0,TOTALS,RUSSIA,200,26,64,40.6,17,39,43.6,9,25,36.0,18,24,75.0,17,24,41,20,25,12,4,1,79,0
18665,437579,497_15_13,POLAND,0,TOTALS,POLAND,200,28,58,48.3,21,38,55.3,7,20,35.0,19,25,76.0,8,23,31,20,21,8,3,1,82,1
18666,437592,497_15_14,SERBIA,0,TOTALS,SERBIA,200,24,65,36.9,20,35,57.1,4,30,13.3,16,23,69.6,14,26,40,14,22,7,6,2,68,1
18667,437605,497_15_14,GERMANY,0,TOTALS,GERMANY,200,23,57,40.4,15,32,46.9,8,25,32.0,12,15,80.0,6,30,36,20,22,11,3,2,66,0
18668,437618,497_15_15,NETHERLANDS,0,TOTALS,NETHERLANDS,200,28,63,44.4,24,50,48.0,4,13,30.8,11,20,55.0,17,25,42,10,18,12,1,1,71,0
18669,437631,497_15_15,MKD,0,TOTALS,MKD,200,29,60,48.3,17,30,56.7,12,30,40.0,8,14,57.1,8,21,29,20,22,7,5,3,78,1
18670,437644,497_15_16,ESTONIA,0,TOTALS,ESTONIA,200,18,60,30.0,14,33,42.4,4,27,14.8,15,17,88.2,9,21,30,10,28,12,4,3,55,0
18671,437657,497_15_16,BELGIUM,0,TOTALS,BELGIUM,200,28,52,53.8,17,30,56.7,11,22,50.0,17,26,65.4,8,30,38,16,23,13,2,4,84,1
18672,437670,497_15_17,FINLAND,0,TOTALS,FINLAND,200,24,70,34.3,14,36,38.9,10,34,29.4,8,16,50.0,11,24,35,16,21,8,2,4,66,0
18673,437683,497_15_17,ISRAEL,0,TOTALS,ISRAEL,200,29,58,50.0,26,50,52.0,3,8,37.5,18,26,69.2,7,35,42,20,22,12,4,4,79,1
18674,437696,497_15_18,ICELAND,0,TOTALS,ICELAND,200,21,60,35.0,12,33,36.4,9,27,33.3,13,19,68.4,8,24,32,15,20,10,3,1,64,0
18675,437709,497_15_18,ITALY,0,TOTALS,ITALY,200,23,61,37.7,18,43,41.9,5,18,27.8,20,23,87.0,13,32,45,13,23,15,4,6,71,1
18676,437722,497_15_19,SLOVENIA,0,TOTALS,SLOVENIA,200,26,45,57.8,15,24,62.5,11,21,52.4,16,17,94.1,3,28,31,19,25,23,1,1,79,1
18677,437735,497_15_19,GEORGIA,0,TOTALS,GEORGIA,200,24,57,42.1,21,37,56.8,3,20,15.0,17,21,81.0,5,15,20,18,26,12,5,2,68,0
18678,437748,497_15_20,LATVIA,0,TOTALS,LATVIA,200,18,58,31.0,12,28,42.9,6,30,20.0,7,9,77.8,8,25,33,15,22,11,3,4,49,0
18679,437761,497_15_20,LITHUANIA,0,TOTALS,LITHUANIA,200,26,64,40.6,20,52,38.5,6,12,50.0,10,12,83.3,13,32,45,18,16,8,5,5,68,1
18680,437774,497_15_21,BOSNIA AND HERZEGOVINA,0,TOTALS,BOSNIA AND HERZEGOVINA,200,20,59,33.9,16,39,41.0,4,20,20.0,10,18,55.6,8,22,30,12,24,14,6,0,54,0
18681,437787,497_15_21,FRANCE,0,TOTALS,FRANCE,200,30,58,51.7,24,42,57.1,6,16,37.5,15,22,68.2,9,35,44,22,20,12,5,4,81,1
18682,437800,497_15_22,TURKEY,0,TOTALS,TURKEY,200,29,70,41.4,21,44,47.7,8,26,30.8,11,14,78.6,17,13,30,10,24,12,4,1,77,1
18683,437813,497_15_22,SPAIN,0,TOTALS,SPAIN,200,40,63,63.5,28,42,66.7,12,21,57.1,12,23,52.2,9,26,35,24,21,10,7,4,104,0
18684,437826,497_15_23,GREECE,0,TOTALS,GREECE,200,29,67,43.3,25,47,53.2,4,20,20.0,10,13,76.9,14,26,40,21,24,9,2,1,72,1
18685,437839,497_15_23,CROATIA,0,TOTALS,CROATIA,200,23,55,41.8,15,30,50.0,8,25,32.0,16,20,80.0,7,25,32,10,16,10,3,2,70,0
18686,437852,497_15_24,UKRAINE,0,TOTALS,UKRAINE,200,25,67,37.3,20,50,40.0,5,17,29.4,9,15,60.0,18,21,39,15,17,13,4,0,64,0
18687,437865,497_15_24,CZECH REPUBLIC,0,TOTALS,CZECH REPUBLIC,200,33,65,50.8,30,50,60.0,3,15,20.0,9,16,56.2,13,28,41,22,18,13,5,1,78,1
18688,437878,497_15_25,FINLAND,0,TOTALS,FINLAND,200,30,59,50.8,21,38,55.3,9,21,42.9,12,18,66.7,12,23,35,15,23,12,4,1,81,1
18689,437891,497_15_25,RUSSIA,0,TOTALS,RUSSIA,200,29,60,48.3,21,42,50.0,8,18,44.4,13,18,72.2,10,19,29,20,20,11,8,1,79,0
18690,437904,497_15_26,LITHUANIA,0,TOTALS,LITHUANIA,200,27,57,47.4,26,44,59.1,1,13,7.7,19,22,86.4,11,25,36,24,18,14,4,1,74,0
18691,437917,497_15_26,BELGIUM,0,TOTALS,BELGIUM,200,31,60,51.7,20,34,58.8,11,26,42.3,3,5,60.0,4,18,22,22,24,10,6,1,76,1
18692,437930,497_15_27,ISRAEL,0,TOTALS,ISRAEL,225,35,60,58.3,28,47,59.6,7,13,53.8,7,17,41.2,4,27,31,25,22,19,4,4,84,0
18693,437943,497_15_27,BOSNIA AND HERZEGOVINA,0,TOTALS,BOSNIA AND HERZEGOVINA,225,30,75,40.0,19,46,41.3,11,29,37.9,15,23,65.2,19,23,42,16,22,18,9,0,86,1
18694,437956,497_15_28,CZECH REPUBLIC,0,TOTALS,CZECH REPUBLIC,200,25,67,37.3,21,48,43.8,4,19,21.1,11,24,45.8,14,23,37,19,17,6,2,4,65,0
18695,437969,497_15_28,LATVIA,0,TOTALS,LATVIA,200,27,57,47.4,20,34,58.8,7,23,30.4,11,13,84.6,8,35,43,18,21,14,2,1,72,1
18696,437982,497_15_29,FRANCE,0,TOTALS,FRANCE,200,29,65,44.6,27,52,51.9,2,13,15.4,9,12,75.0,8,27,35,13,17,9,6,4,69,1
18697,437995,497_15_29,POLAND,0,TOTALS,POLAND,200,26,62,41.9,20,39,51.3,6,23,26.1,8,13,61.5,10,29,39,15,15,15,5,2,66,0
18698,438008,497_15_30,UKRAINE,0,TOTALS,UKRAINE,200,21,56,37.5,15,33,45.5,6,23,26.1,23,29,79.3,14,23,37,13,26,18,2,3,71,0
18699,438021,497_15_30,ESTONIA,0,TOTALS,ESTONIA,200,25,63,39.7,14,30,46.7,11,33,33.3,17,22,77.3,14,23,37,18,26,11,6,3,78,1
18700,438034,497_15_31,SERBIA,0,TOTALS,SERBIA,200,34,53,64.2,26,33,78.8,8,20,40.0,17,23,73.9,5,35,40,32,15,21,7,1,93,1
18701,438047,497_15_31,ICELAND,0,TOTALS,ICELAND,200,23,72,31.9,15,40,37.5,8,32,25.0,10,12,83.3,13,17,30,15,27,15,7,1,64,0
18702,438060,497_15_32,SLOVENIA,0,TOTALS,SLOVENIA,200,27,60,45.0,17,29,58.6,10,31,32.3,17,19,89.5,10,21,31,20,31,12,7,0,81,1
18703,438073,497_15_32,NETHERLANDS,0,TOTALS,NETHERLANDS,200,24,49,49.0,20,40,50.0,4,9,44.4,22,31,71.0,8,22,30,8,24,16,5,0,74,0
18704,438086,497_15_33,GERMANY,0,TOTALS,GERMANY,200,22,64,34.4,17,38,44.7,5,26,19.2,26,27,96.3,13,29,42,14,27,9,2,3,75,0
18705,438099,497_15_33,TURKEY,0,TOTALS,TURKEY,200,27,60,45.0,18,40,45.0,9,20,45.0,17,25,68.0,8,27,35,14,25,7,6,5,80,1
18706,438112,497_15_34,GEORGIA,0,TOTALS,GEORGIA,200,27,54,50.0,20,39,51.3,7,15,46.7,7,12,58.3,5,22,27,19,20,17,8,1,68,0
18707,438125,497_15_34,GREECE,0,TOTALS,GREECE,200,30,54,55.6,20,37,54.1,10,17,58.8,9,17,52.9,5,23,28,28,17,14,2,5,79,1
18708,438138,497_15_35,SPAIN,0,TOTALS,SPAIN,200,34,63,54.0,28,45,62.2,6,18,33.3,24,27,88.9,9,24,33,25,27,8,0,2,98,1
18709,438151,497_15_35,ITALY,0,TOTALS,ITALY,200,32,64,50.0,21,40,52.5,11,24,45.8,30,34,88.2,9,20,29,24,26,3,3,2,105,0
18710,438164,497_15_36,CROATIA,0,TOTALS,CROATIA,200,26,64,40.6,20,40,50.0,6,24,25.0,15,20,75.0,13,29,42,21,15,10,7,2,73,1
18711,438177,497_15_36,MKD,0,TOTALS,MKD,200,21,57,36.8,12,31,38.7,9,26,34.6,4,6,66.7,8,25,33,13,23,16,1,5,55,0
18712,438190,497_15_37,TURKEY,0,TOTALS,TURKEY,200,28,61,45.9,23,37,62.2,5,24,20.8,11,15,73.3,12,20,32,18,21,15,3,3,72,0
18713,438203,497_15_37,SERBIA,0,TOTALS,SERBIA,200,33,64,51.6,24,38,63.2,9,26,34.6,16,23,69.6,14,21,35,28,21,8,9,1,91,1
18714,438216,497_15_38,BOSNIA AND HERZEGOVINA,0,TOTALS,BOSNIA AND HERZEGOVINA,200,22,50,44.0,20,36,55.6,2,14,14.3,13,21,61.9,8,24,32,14,18,21,3,1,59,0
18715,438229,497_15_38,FINLAND,0,TOTALS,FINLAND,200,34,71,47.9,22,43,51.2,12,28,42.9,8,9,88.9,12,21,33,22,21,10,10,1,88,1
18716,438242,497_15_39,GREECE,0,TOTALS,GREECE,200,32,52,61.5,27,39,69.2,5,13,38.5,14,22,63.6,10,23,33,21,22,14,2,3,83,1
18717,438255,497_15_39,SLOVENIA,0,TOTALS,SLOVENIA,200,27,58,46.6,20,38,52.6,7,20,35.0,11,16,68.8,9,14,23,13,25,11,2,0,72,0
18718,438268,497_15_40,BELGIUM,0,TOTALS,BELGIUM,200,26,58,44.8,18,38,47.4,8,20,40.0,4,8,50.0,11,29,40,20,22,16,6,3,64,0
18719,438281,497_15_40,CZECH REPUBLIC,0,TOTALS,CZECH REPUBLIC,200,26,61,42.6,21,47,44.7,5,14,35.7,9,15,60.0,10,23,33,21,16,10,6,3,66,1
18720,438294,497_15_41,POLAND,0,TOTALS,POLAND,200,27,55,49.1,21,35,60.0,6,20,30.0,13,16,81.2,9,24,33,20,15,23,4,2,73,0
18721,438307,497_15_41,ISRAEL,0,TOTALS,ISRAEL,200,32,67,47.8,28,59,47.5,4,8,50.0,7,9,77.8,10,18,28,18,19,13,9,3,75,1
18722,438320,497_15_42,ITALY,0,TOTALS,ITALY,225,29,70,41.4,19,38,50.0,10,32,31.2,21,25,84.0,9,29,38,17,27,9,5,3,89,1
18723,438333,497_15_42,GERMANY,0,TOTALS,GERMANY,225,29,67,43.3,25,47,53.2,4,20,20.0,20,24,83.3,7,32,39,18,25,11,2,3,82,0
18724,438346,497_15_43,MKD,0,TOTALS,MKD,200,26,62,41.9,16,31,51.6,10,31,32.3,13,15,86.7,14,17,31,16,28,16,4,3,75,0
18725,438359,497_15_43,GEORGIA,0,TOTALS,GEORGIA,200,29,54,53.7,21,38,55.3,8,16,50.0,24,33,72.7,11,22,33,16,20,12,5,2,90,1
18726,438372,497_15_44,LATVIA,0,TOTALS,LATVIA,200,27,65,41.5,19,39,48.7,8,26,30.8,12,15,80.0,8,27,35,20,19,7,3,0,74,0
18727,438385,497_15_44,UKRAINE,0,TOTALS,UKRAINE,200,27,58,46.6,20,44,45.5,7,14,50.0,14,23,60.9,10,27,37,14,23,9,2,1,75,1
18728,438398,497_15_45,RUSSIA,0,TOTALS,RUSSIA,200,25,58,43.1,15,33,45.5,10,25,40.0,7,13,53.8,9,22,31,22,25,15,4,4,67,0
18729,438411,497_15_45,FRANCE,0,TOTALS,FRANCE,200,22,57,38.6,14,36,38.9,8,21,38.1,22,29,75.9,12,25,37,11,19,13,10,3,74,1
18730,438424,497_15_46,ICELAND,0,TOTALS,ICELAND,200,29,73,39.7,18,39,46.2,11,34,32.4,4,5,80.0,13,16,29,19,25,10,3,2,73,0
18731,438437,497_15_46,SPAIN,0,TOTALS,SPAIN,200,34,61,55.7,25,39,64.1,9,22,40.9,22,29,75.9,14,31,45,28,13,12,4,4,99,1
18732,438450,497_15_47,NETHERLANDS,0,TOTALS,NETHERLANDS,200,27,58,46.6,18,38,47.4,9,20,45.0,9,14,64.3,5,29,34,18,23,9,5,1,72,0
18733,438463,497_15_47,CROATIA,0,TOTALS,CROATIA,200,26,61,42.6,17,34,50.0,9,27,33.3,17,25,68.0,10,27,37,20,18,9,4,0,78,1
18734,438476,497_15_48,ESTONIA,0,TOTALS,ESTONIA,200,21,53,39.6,16,32,50.0,5,21,23.8,15,16,93.8,5,21,26,14,28,15,5,3,62,0
18735,438489,497_15_48,LITHUANIA,0,TOTALS,LITHUANIA,200,18,50,36.0,14,36,38.9,4,14,28.6,24,32,75.0,12,24,36,13,19,16,5,2,64,1
18736,438502,497_15_49,SERBIA,0,TOTALS,SERBIA,200,37,68,54.4,26,38,68.4,11,30,36.7,16,18,88.9,9,25,34,29,28,5,4,3,101,0
18737,438515,497_15_49,ITALY,0,TOTALS,ITALY,200,29,58,50.0,21,39,53.8,8,19,42.1,16,23,69.6,5,23,28,20,19,8,1,1,82,1
18738,438528,497_15_50,FINLAND,0,TOTALS,FINLAND,200,27,71,38.0,20,46,43.5,7,25,28.0,4,5,80.0,12,25,37,17,23,10,3,0,65,0
18739,438541,497_15_50,POLAND,0,TOTALS,POLAND,200,27,57,47.4,21,38,55.3,6,19,31.6,18,22,81.8,7,31,38,21,13,12,2,3,78,1
18740,438554,497_15_51,SLOVENIA,0,TOTALS,SLOVENIA,200,26,59,44.1,22,41,53.7,4,18,22.2,6,10,60.0,11,32,43,16,19,14,5,1,62,1
18741,438567,497_15_51,MKD,0,TOTALS,MKD,200,19,63,30.2,15,43,34.9,4,20,20.0,9,17,52.9,16,23,39,10,20,13,9,3,51,0
18742,438580,497_15_52,UKRAINE,0,TOTALS,UKRAINE,200,27,67,40.3,21,43,48.8,6,24,25.0,11,17,64.7,21,24,45,16,21,12,1,0,71,0
18743,438593,497_15_52,BELGIUM,0,TOTALS,BELGIUM,200,28,62,45.2,18,35,51.4,10,27,37.0,13,18,72.2,13,20,33,23,19,8,1,3,79,1
18744,438606,497_15_53,BOSNIA AND HERZEGOVINA,0,TOTALS,BOSNIA AND HERZEGOVINA,200,21,57,36.8,19,40,47.5,2,17,11.8,17,23,73.9,10,23,33,19,25,18,7,3,61,0
18745,438619,497_15_53,RUSSIA,0,TOTALS,RUSSIA,200,26,58,44.8,14,24,58.3,12,34,35.3,17,20,85.0,9,27,36,23,26,18,9,5,81,1
18746,438632,497_15_54,GERMANY,0,TOTALS,GERMANY,200,28,58,48.3,19,36,52.8,9,22,40.9,11,12,91.7,3,34,37,14,24,14,1,2,76,0
18747,438645,497_15_54,SPAIN,0,TOTALS,SPAIN,200,26,64,40.6,19,43,44.2,7,21,33.3,18,24,75.0,9,26,35,15,16,6,8,3,77,1
18748,438658,497_15_55,GEORGIA,0,TOTALS,GEORGIA,200,27,53,50.9,20,34,58.8,7,19,36.8,10,13,76.9,3,27,30,20,16,13,5,9,71,1
18749,438671,497_15_55,CROATIA,0,TOTALS,CROATIA,200,21,62,33.9,17,39,43.6,4,23,17.4,12,13,92.3,13,24,37,21,18,17,1,3,58,0
18750,438684,497_15_56,LATVIA,0,TOTALS,LATVIA,200,26,56,46.4,20,37,54.1,6,19,31.6,17,23,73.9,9,27,36,16,17,13,6,3,75,1
18751,438697,497_15_56,ESTONIA,0,TOTALS,ESTONIA,200,22,59,37.3,12,37,32.4,10,22,45.5,10,12,83.3,9,27,36,17,26,14,3,3,64,0
18752,438710,497_15_57,ISRAEL,0,TOTALS,ISRAEL,200,25,63,39.7,20,53,37.7,5,10,50.0,6,8,75.0,8,21,29,22,19,13,4,7,61,0
18753,438723,497_15_57,FRANCE,0,TOTALS,FRANCE,200,34,70,48.6,26,50,52.0,8,20,40.0,10,13,76.9,17,29,46,22,12,13,6,2,86,1
18754,438736,497_15_58,TURKEY,0,TOTALS,TURKEY,225,37,74,50.0,28,48,58.3,9,26,34.6,28,34,82.4,19,34,53,29,19,13,3,2,111,1
18755,438749,497_15_58,ICELAND,0,TOTALS,ICELAND,225,36,77,46.8,19,36,52.8,17,41,41.5,13,21,61.9,10,21,31,27,25,7,3,1,102,0
18756,438762,497_15_59,GREECE,0,TOTALS,GREECE,200,25,54,46.3,18,33,54.5,7,21,33.3,11,17,64.7,11,24,35,23,24,13,2,4,68,1
18757,438775,497_15_59,NETHERLANDS,0,TOTALS,NETHERLANDS,200,24,54,44.4,20,40,50.0,4,14,28.6,13,23,56.5,11,22,33,13,20,10,2,1,65,0
18758,438788,497_15_60,CZECH REPUBLIC,0,TOTALS,CZECH REPUBLIC,225,31,67,46.3,20,41,48.8,11,26,42.3,8,14,57.1,8,28,36,27,23,20,5,1,81,0
18759,438801,497_15_60,LITHUANIA,0,TOTALS,LITHUANIA,225,31,71,43.7,23,49,46.9,8,22,36.4,15,21,71.4,10,28,38,15,21,17,7,5,85,1
18760,438814,497_15_61,LATVIA,0,TOTALS,LATVIA,200,26,53,49.1,20,32,62.5,6,21,28.6,15,19,78.9,6,29,35,19,19,16,1,6,73,1
18761,438827,497_15_61,SLOVENIA,0,TOTALS,SLOVENIA,200,24,66,36.4,16,41,39.0,8,25,32.0,10,12,83.3,13,21,34,13,22,10,4,2,66,0
18762,438840,497_15_62,GREECE,0,TOTALS,GREECE,200,28,57,49.1,23,41,56.1,5,16,31.2,14,21,66.7,10,28,38,19,18,7,2,2,75,1
18763,438853,497_15_62,BELGIUM,0,TOTALS,BELGIUM,200,21,55,38.2,14,26,53.8,7,29,24.1,5,9,55.6,6,23,29,13,23,12,3,2,54,0
18764,438866,497_15_63,SPAIN,0,TOTALS,SPAIN,200,28,56,50.0,17,30,56.7,11,26,42.3,13,17,76.5,10,28,38,21,14,16,2,1,80,1
18765,438879,497_15_63,POLAND,0,TOTALS,POLAND,200,27,62,43.5,22,44,50.0,5,18,27.8,7,12,58.3,6,20,26,16,20,9,4,0,66,0
18766,438892,497_15_64,FRANCE,0,TOTALS,FRANCE,200,30,63,47.6,19,38,50.0,11,25,44.0,5,9,55.6,12,29,41,18,22,16,10,6,76,1
18767,438905,497_15_64,TURKEY,0,TOTALS,TURKEY,200,19,59,32.2,13,33,39.4,6,26,23.1,9,14,64.3,12,22,34,11,14,14,2,1,53,0
18768,438918,497_15_65,CROATIA,0,TOTALS,CROATIA,200,20,54,37.0,13,33,39.4,7,21,33.3,12,14,85.7,7,24,31,13,14,24,8,2,59,0
18769,438931,497_15_65,CZECH REPUBLIC,0,TOTALS,CZECH REPUBLIC,200,32,64,50.0,25,47,53.2,7,17,41.2,9,13,69.2,9,26,35,27,19,12,11,2,80,1
18770,438944,497_15_66,SERBIA,0,TOTALS,SERBIA,200,35,59,59.3,26,36,72.2,9,23,39.1,15,18,83.3,6,33,39,30,19,14,3,4,94,1
18771,438957,497_15_66,FINLAND,0,TOTALS,FINLAND,200,32,79,40.5,24,53,45.3,8,26,30.8,9,13,69.2,14,20,34,13,19,8,5,1,81,0
18772,438970,497_15_67,ISRAEL,0,TOTALS,ISRAEL,200,21,56,37.5,18,48,37.5,3,8,37.5,7,11,63.6,5,31,36,16,23,14,1,3,52,0
18773,438983,497_15_67,ITALY,0,TOTALS,ITALY,200,29,71,40.8,18,41,43.9,11,30,36.7,13,17,76.5,13,33,46,21,16,6,6,6,82,1
18774,438996,497_15_68,LITHUANIA,0,TOTALS,LITHUANIA,200,28,54,51.9,20,30,66.7,8,24,33.3,21,27,77.8,9,22,31,22,24,17,5,3,85,1
18775,439009,497_15_68,GEORGIA,0,TOTALS,GEORGIA,200,28,61,45.9,20,39,51.3,8,22,36.4,17,17,100.0,9,20,29,15,25,15,4,0,81,0
18776,439022,497_15_69,SPAIN,0,TOTALS,SPAIN,200,23,55,41.8,16,37,43.2,7,18,38.9,20,24,83.3,10,23,33,17,17,10,3,2,73,1
18777,439035,497_15_69,GREECE,0,TOTALS,GREECE,200,30,66,45.5,23,44,52.3,7,22,31.8,4,9,44.4,13,25,38,21,24,11,5,5,71,0
18778,439048,497_15_70,FRANCE,0,TOTALS,FRANCE,200,30,65,46.2,27,52,51.9,3,13,23.1,21,26,80.8,15,26,41,18,20,12,8,4,84,1
18779,439061,497_15_70,LATVIA,0,TOTALS,LATVIA,200,28,66,42.4,22,45,48.9,6,21,28.6,8,14,57.1,13,22,35,13,22,15,5,5,70,0
18780,439074,497_15_71,SERBIA,0,TOTALS,SERBIA,200,31,58,53.4,24,33,72.7,7,25,28.0,20,24,83.3,7,26,33,26,21,11,7,2,89,1
18781,439087,497_15_71,CZECH REPUBLIC,0,TOTALS,CZECH REPUBLIC,200,28,59,47.5,22,39,56.4,6,20,30.0,13,18,72.2,7,22,29,20,21,15,5,2,75,0
18782,439100,497_15_72,ITALY,0,TOTALS,ITALY,225,33,75,44.0,25,47,53.2,8,28,28.6,11,15,73.3,9,23,32,16,19,7,7,1,85,0
18783,439113,497_15_72,LITHUANIA,0,TOTALS,LITHUANIA,225,36,64,56.2,25,46,54.3,11,18,61.1,12,14,85.7,5,32,37,28,21,12,1,1,95,1
18784,439126,497_15_73,GREECE,0,TOTALS,GREECE,200,28,60,46.7,18,39,46.2,10,21,47.6,31,35,88.6,8,26,34,19,23,16,6,1,97,1
18785,439139,497_15_73,LATVIA,0,TOTALS,LATVIA,200,32,63,50.8,24,34,70.6,8,29,27.6,18,23,78.3,8,23,31,24,30,16,5,2,90,0
18786,439152,497_15_74,CZECH REPUBLIC,0,TOTALS,CZECH REPUBLIC,200,27,63,42.9,22,53,41.5,5,10,50.0,11,17,64.7,8,20,28,22,18,10,2,0,70,0
18787,439165,497_15_74,ITALY,0,TOTALS,ITALY,200,30,58,51.7,22,42,52.4,8,16,50.0,17,20,85.0,8,30,38,17,19,13,2,9,85,1
18788,439178,497_15_75,SPAIN,0,TOTALS,SPAIN,225,26,68,38.2,22,47,46.8,4,21,19.0,24,26,92.3,16,28,44,18,19,9,5,8,80,1
18789,439191,497_15_75,FRANCE,0,TOTALS,FRANCE,225,28,73,38.4,19,52,36.5,9,21,42.9,10,17,58.8,18,26,44,16,28,12,3,3,75,0
18790,439204,497_15_76,LATVIA,0,TOTALS,LATVIA,200,25,65,38.5,21,44,47.7,4,21,19.0,16,21,76.2,18,25,43,16,23,20,7,1,70,0
18791,439217,497_15_76,CZECH REPUBLIC,0,TOTALS,CZECH REPUBLIC,200,37,66,56.1,35,50,70.0,2,16,12.5,21,26,80.8,8,24,32,28,18,11,4,3,97,1
18792,439230,497_15_77,SERBIA,0,TOTALS,SERBIA,200,19,58,32.8,13,30,43.3,6,28,21.4,20,25,80.0,7,22,29,13,23,12,7,3,64,0
18793,439243,497_15_77,LITHUANIA,0,TOTALS,LITHUANIA,200,25,55,45.5,23,41,56.1,2,14,14.3,15,18,83.3,8,32,40,13,25,20,5,6,67,1
18794,439256,497_15_78,FRANCE,0,TOTALS,FRANCE,200,30,68,44.1,25,52,48.1,5,16,31.2,16,22,72.7,16,27,43,21,24,10,7,5,81,1
18795,439269,497_15_78,SERBIA,0,TOTALS,SERBIA,200,22,55,40.0,14,24,58.3,8,31,25.8,16,20,80.0,7,22,29,17,27,13,3,1,68,0
18796,439282,497_15_79,SPAIN,0,TOTALS,SPAIN,200,30,60,50.0,22,38,57.9,8,22,36.4,12,14,85.7,8,28,36,19,20,10,5,6,80,1
18797,439295,497_15_79,LITHUANIA,0,TOTALS,LITHUANIA,200,23,65,35.4,16,43,37.2,7,22,31.8,10,17,58.8,18,23,41,14,19,13,4,1,63,0
18798,439308,498_13_01,SWITZERLAND,0,TOTALS,SWITZERLAND,200,30,60,50.0,20,36,55.6,10,24,41.7,8,11,72.7,7,33,40,15,16,8,5,3,78,1
18799,439321,498_13_01,DENMARK,0,TOTALS,DENMARK,200,16,60,26.7,11,38,28.9,5,22,22.7,0,6,0.0,8,16,24,5,18,11,5,0,37,0
18800,439334,498_13_02,ROMANIA,0,TOTALS,ROMANIA,200,26,61,42.6,21,42,50.0,5,19,26.3,11,16,68.8,11,21,32,14,27,17,13,2,68,0
18801,439347,498_13_02,BULGARIA,0,TOTALS,BULGARIA,200,25,58,43.1,15,39,38.5,10,19,52.6,24,28,85.7,15,27,42,19,18,18,13,2,84,1
18802,439360,498_13_03,BELARUS,0,TOTALS,BELARUS,200,28,68,41.2,20,46,43.5,8,22,36.4,15,21,71.4,9,36,45,18,25,14,10,6,79,1
18803,439373,498_13_03,HUNGARY,0,TOTALS,HUNGARY,200,26,65,40.0,19,42,45.2,7,23,30.4,16,24,66.7,8,34,42,11,27,15,1,1,75,0
18804,439386,498_13_04,AUSTRIA,0,TOTALS,AUSTRIA,200,36,63,57.1,25,40,62.5,11,23,47.8,28,41,68.3,12,32,44,23,17,15,14,7,111,0
18805,439398,498_13_04,LUXEMBOURG,0,TOTALS,LUXEMBOURG,200,27,72,37.5,18,40,45.0,9,32,28.1,14,23,60.9,15,21,36,10,28,19,9,1,77,1
18806,439411,498_13_05,DENMARK,0,TOTALS,DENMARK,200,27,66,40.9,21,51,41.2,6,15,40.0,12,16,75.0,13,25,38,7,21,9,5,3,72,0
18807,439424,498_13_05,AUSTRIA,0,TOTALS,AUSTRIA,200,30,62,48.4,23,45,51.1,7,17,41.2,13,20,65.0,9,27,36,18,20,9,4,1,80,1
18808,439436,498_13_06,LUXEMBOURG,0,TOTALS,LUXEMBOURG,200,21,60,35.0,14,37,37.8,7,23,30.4,8,11,72.7,10,23,33,10,24,19,4,2,57,0
18809,439448,498_13_06,SWITZERLAND,0,TOTALS,SWITZERLAND,200,22,54,40.7,15,28,53.6,7,26,26.9,24,31,77.4,13,29,42,15,16,17,8,5,75,1
18810,439461,498_13_07,HUNGARY,0,TOTALS,HUNGARY,200,28,64,43.8,18,36,50.0,10,28,35.7,9,12,75.0,11,32,43,17,19,18,12,4,75,1
18811,439474,498_13_07,SLOVAK REPUBLIC,0,TOTALS,SLOVAK REPUBLIC,200,17,63,27.0,15,46,32.6,2,17,11.8,7,10,70.0,13,28,41,4,12,20,10,1,43,0
18812,439487,498_13_08,BULGARIA,0,TOTALS,BULGARIA,200,35,64,54.7,28,45,62.2,7,19,36.8,11,22,50.0,17,39,56,21,20,20,3,1,88,1
18813,439500,498_13_08,ICELAND,0,TOTALS,ICELAND,200,23,65,35.4,16,40,40.0,7,25,28.0,6,11,54.5,4,18,22,11,24,12,8,1,59,0
18814,439512,498_13_09,ESTONIA,0,TOTALS,ESTONIA,200,26,68,38.2,16,30,53.3,10,38,26.3,4,10,40.0,21,19,40,16,25,16,6,1,66,0
18815,439525,498_13_09,PORTUGAL,0,TOTALS,PORTUGAL,200,24,52,46.2,12,23,52.2,12,29,41.4,12,20,60.0,10,24,34,16,20,15,7,1,72,1
18816,439538,498_13_10,ROMANIA,0,TOTALS,ROMANIA,200,25,58,43.1,22,42,52.4,3,16,18.8,11,17,64.7,11,35,46,21,23,19,6,4,64,0
18817,439551,498_13_10,ICELAND,0,TOTALS,ICELAND,200,25,63,39.7,16,37,43.2,9,26,34.6,13,24,54.2,11,24,35,18,17,11,8,1,72,1
18818,439564,498_13_11,SLOVAK REPUBLIC,0,TOTALS,SLOVAK REPUBLIC,200,36,74,48.6,23,45,51.1,13,29,44.8,12,17,70.6,12,18,30,23,30,9,10,2,97,1
18819,439577,498_13_11,BELARUS,0,TOTALS,BELARUS,200,28,53,52.8,23,38,60.5,5,15,33.3,24,32,75.0,12,23,35,9,21,19,4,4,85,0
18820,439589,498_13_12,LUXEMBOURG,0,TOTALS,LUXEMBOURG,200,26,66,39.4,22,43,51.2,4,23,17.4,6,9,66.7,8,23,31,13,20,11,5,2,62,0
18821,439601,498_13_12,DENMARK,0,TOTALS,DENMARK,200,28,65,43.1,20,41,48.8,8,24,33.3,9,15,60.0,16,34,50,11,17,19,4,0,73,1
18822,439613,498_13_13,SWITZERLAND,0,TOTALS,SWITZERLAND,200,27,64,42.2,21,45,46.7,6,19,31.6,9,16,56.2,9,23,32,13,22,11,6,2,69,1
18823,439626,498_13_13,AUSTRIA,0,TOTALS,AUSTRIA,200,24,52,46.2,20,35,57.1,4,17,23.5,11,15,73.3,6,20,26,10,20,18,4,0,63,0
18824,439639,498_13_14,HUNGARY,0,TOTALS,HUNGARY,200,24,59,40.7,16,31,51.6,8,28,28.6,5,12,41.7,17,18,35,8,17,7,3,0,61,0
18825,439652,498_13_14,BELARUS,0,TOTALS,BELARUS,200,23,56,41.1,19,38,50.0,4,18,22.2,13,16,81.2,10,17,27,8,20,10,7,3,63,1
18826,439664,498_13_15,LUXEMBOURG,0,TOTALS,LUXEMBOURG,200,22,60,36.7,18,40,45.0,4,20,20.0,17,21,81.0,11,24,35,18,32,23,6,4,65,0
18827,439677,498_13_15,AUSTRIA,0,TOTALS,AUSTRIA,200,29,55,52.7,19,35,54.3,10,20,50.0,30,39,76.9,5,24,29,21,19,15,13,1,98,1
18828,439690,498_13_16,BULGARIA,0,TOTALS,BULGARIA,200,27,65,41.5,21,38,55.3,6,27,22.2,14,23,60.9,15,19,34,8,18,10,6,3,74,0
18829,439703,498_13_16,ROMANIA,0,TOTALS,ROMANIA,200,31,55,56.4,23,36,63.9,8,19,42.1,7,18,38.9,10,27,37,22,26,15,4,0,77,1
18830,439716,498_13_17,DENMARK,0,TOTALS,DENMARK,200,23,63,36.5,16,37,43.2,7,26,26.9,12,14,85.7,9,26,35,12,17,12,11,0,65,0
18831,439728,498_13_17,SWITZERLAND,0,TOTALS,SWITZERLAND,200,27,67,40.3,20,46,43.5,7,21,33.3,5,8,62.5,13,33,46,13,19,16,5,4,66,1
18832,439741,498_13_18,ESTONIA,0,TOTALS,ESTONIA,200,20,57,35.1,13,30,43.3,7,27,25.9,17,19,89.5,9,23,32,11,24,11,6,3,64,1
18833,439752,498_13_18,NETHERLANDS,0,TOTALS,NETHERLANDS,200,22,50,44.0,19,40,47.5,3,10,30.0,16,30,53.3,12,28,40,5,19,14,8,1,63,0
18834,439765,498_13_19,SLOVAK REPUBLIC,0,TOTALS,SLOVAK REPUBLIC,200,29,58,50.0,19,35,54.3,10,23,43.5,11,17,64.7,13,26,39,14,25,14,8,1,79,1
18835,439778,498_13_19,HUNGARY,0,TOTALS,HUNGARY,200,23,55,41.8,15,32,46.9,8,23,34.8,13,23,56.5,8,17,25,12,21,12,6,3,67,0
18836,439791,498_13_20,ICELAND,0,TOTALS,ICELAND,200,31,70,44.3,19,38,50.0,12,32,37.5,5,8,62.5,9,20,29,19,23,16,15,4,79,0
18837,439804,498_13_20,BULGARIA,0,TOTALS,BULGARIA,200,29,63,46.0,23,41,56.1,6,22,27.3,17,25,68.0,18,31,49,16,19,23,12,1,81,1
18838,439817,498_13_21,PORTUGAL,0,TOTALS,PORTUGAL,200,23,58,39.7,19,41,46.3,4,17,23.5,14,23,60.9,5,16,21,18,17,7,8,1,64,0
18839,439830,498_13_21,ESTONIA,0,TOTALS,ESTONIA,200,30,53,56.6,18,28,64.3,12,25,48.0,13,14,92.9,4,24,28,21,28,15,3,2,85,1
18840,439842,498_13_22,SWITZERLAND,0,TOTALS,SWITZERLAND,200,23,46,50.0,14,25,56.0,9,21,42.9,22,38,57.9,11,30,41,14,20,19,3,3,77,1
18841,439854,498_13_22,LUXEMBOURG,0,TOTALS,LUXEMBOURG,200,20,56,35.7,14,35,40.0,6,21,28.6,13,22,59.1,4,18,22,10,32,12,6,1,59,0
18842,439867,498_13_23,AUSTRIA,0,TOTALS,AUSTRIA,200,31,68,45.6,22,43,51.2,9,25,36.0,15,21,71.4,13,22,35,19,15,12,12,5,86,1
18843,439879,498_13_23,DENMARK,0,TOTALS,DENMARK,200,27,60,45.0,21,41,51.2,6,19,31.6,6,9,66.7,11,28,39,7,21,22,4,1,66,0
18844,439892,498_13_24,AUSTRIA,0,TOTALS,AUSTRIA,225,33,69,47.8,18,40,45.0,15,29,51.7,16,30,53.3,10,28,38,15,29,10,5,5,97,1
18845,439904,498_13_24,SWITZERLAND,0,TOTALS,SWITZERLAND,225,31,70,44.3,21,44,47.7,10,26,38.5,24,32,75.0,13,31,44,11,27,12,6,1,96,0
18846,439917,498_13_25,BELARUS,0,TOTALS,BELARUS,200,38,81,46.9,23,50,46.0,15,31,48.4,23,34,67.6,18,41,59,28,26,17,15,6,114,0
18847,439929,498_13_25,SLOVAK REPUBLIC,0,TOTALS,SLOVAK REPUBLIC,200,24,77,31.2,19,49,38.8,5,28,17.9,20,35,57.1,20,28,48,10,27,22,9,8,73,1
18848,439942,498_13_26,DENMARK,0,TOTALS,DENMARK,200,32,67,47.8,25,47,53.2,7,20,35.0,16,23,69.6,14,31,45,20,23,18,8,0,87,1
18849,439954,498_13_26,LUXEMBOURG,0,TOTALS,LUXEMBOURG,200,21,65,32.3,18,44,40.9,3,21,14.3,13,18,72.2,11,24,35,9,26,18,5,1,58,0
18850,439967,498_13_27,ICELAND,0,TOTALS,ICELAND,200,23,56,41.1,20,35,57.1,3,21,14.3,28,32,87.5,8,32,40,20,22,21,8,5,77,1
18851,439980,498_13_27,ROMANIA,0,TOTALS,ROMANIA,200,29,68,42.6,25,54,46.3,4,14,28.6,9,20,45.0,15,26,41,15,29,21,9,5,71,0
18852,439991,498_13_28,NETHERLANDS,0,TOTALS,NETHERLANDS,200,28,55,50.9,24,43,55.8,4,12,33.3,11,18,61.1,13,35,48,13,17,22,12,3,71,1
18853,440004,498_13_28,PORTUGAL,0,TOTALS,PORTUGAL,200,18,62,29.0,10,29,34.5,8,33,24.2,9,12,75.0,12,19,31,8,19,17,12,1,53,0
18854,440017,498_13_29,BELARUS,0,TOTALS,BELARUS,200,28,65,43.1,21,47,44.7,7,18,38.9,13,16,81.2,15,24,39,9,15,10,6,2,76,1
18855,440030,498_13_29,ESTONIA,0,TOTALS,ESTONIA,200,27,65,41.5,20,45,44.4,7,20,35.0,9,12,75.0,15,21,36,9,24,11,6,6,70,0
18856,440043,498_13_30,BULGARIA,0,TOTALS,BULGARIA,200,32,61,52.5,17,31,54.8,15,30,50.0,13,18,72.2,9,27,36,26,21,12,7,5,92,1
18857,440055,498_13_30,SWITZERLAND,0,TOTALS,SWITZERLAND,200,29,69,42.0,22,47,46.8,7,22,31.8,6,12,50.0,13,20,33,14,21,13,9,3,71,0
18858,440067,498_13_31,SWITZERLAND,0,TOTALS,SWITZERLAND,200,27,68,39.7,24,48,50.0,3,20,15.0,10,13,76.9,11,16,27,10,26,16,14,2,67,0
18859,440080,498_13_31,BULGARIA,0,TOTALS,BULGARIA,200,29,51,56.9,19,32,59.4,10,19,52.6,19,25,76.0,6,27,33,14,19,20,11,0,87,1
18860,440093,498_13_32,ESTONIA,0,TOTALS,ESTONIA,200,31,66,47.0,24,42,57.1,7,24,29.2,10,13,76.9,10,29,39,18,27,8,8,2,79,1
18861,440106,498_13_32,BELARUS,0,TOTALS,BELARUS,200,20,51,39.2,18,36,50.0,2,15,13.3,19,31,61.3,10,26,36,5,20,16,4,7,61,0
18862,440119,498_13_33,BULGARIA,0,TOTALS,BULGARIA,200,17,55,30.9,11,33,33.3,6,22,27.3,18,24,75.0,12,33,45,10,17,15,6,0,58,1
18863,440132,498_13_33,ESTONIA,0,TOTALS,ESTONIA,200,22,58,37.9,16,34,47.1,6,24,25.0,5,10,50.0,3,28,31,11,23,13,5,2,55,0
18864,440145,498_13_34,ESTONIA,0,TOTALS,ESTONIA,200,21,58,36.2,13,35,37.1,8,23,34.8,11,17,64.7,10,25,35,13,23,6,12,4,61,1
18865,440158,498_13_34,BULGARIA,0,TOTALS,BULGARIA,200,16,54,29.6,11,30,36.7,5,24,20.8,12,17,70.6,16,29,45,8,19,18,5,3,49,0
18866,440171,499_14_01,SWITZERLAND,0,TOTALS,SWITZERLAND,200,22,47,46.8,11,28,39.3,11,19,57.9,24,33,72.7,8,22,30,13,31,17,9,1,79,1
18867,440184,499_14_01,RUSSIA,0,TOTALS,RUSSIA,200,21,51,41.2,12,26,46.2,9,25,36.0,26,32,81.2,10,21,31,15,28,17,12,2,77,0
18868,440197,499_14_02,BELARUS,0,TOTALS,BELARUS,200,35,71,49.3,28,49,57.1,7,22,31.8,20,30,66.7,16,41,57,23,22,18,15,2,97,1
18869,440210,499_14_02,DENMARK,0,TOTALS,DENMARK,200,25,75,33.3,17,45,37.8,8,30,26.7,14,21,66.7,11,25,36,16,25,17,8,1,72,0
18870,440222,499_14_03,SLOVAK REPUBLIC,0,TOTALS,SLOVAK REPUBLIC,200,25,63,39.7,16,32,50.0,9,31,29.0,10,16,62.5,13,24,37,17,25,17,3,1,69,0
18871,440235,499_14_03,ROMANIA,0,TOTALS,ROMANIA,200,28,59,47.5,24,39,61.5,4,20,20.0,21,28,75.0,9,28,37,13,19,13,8,0,81,1
18872,440248,499_14_04,SWEDEN,0,TOTALS,SWEDEN,200,19,52,36.5,18,44,40.9,1,8,12.5,11,18,61.1,7,27,34,8,25,14,6,1,50,0
18873,440261,499_14_04,LATVIA,0,TOTALS,LATVIA,200,18,51,35.3,8,26,30.8,10,25,40.0,16,23,69.6,8,30,38,9,22,14,5,3,62,1
18874,440274,499_14_05,ICELAND,0,TOTALS,ICELAND,200,34,72,47.2,28,49,57.1,6,23,26.1,9,11,81.8,11,24,35,23,23,9,5,4,83,1
18875,440287,499_14_05,GREAT BRITAIN,0,TOTALS,GREAT BRITAIN,200,24,57,42.1,18,43,41.9,6,14,42.9,16,23,69.6,11,28,39,14,18,15,5,6,70,0
18876,440300,499_14_06,ISRAEL,0,TOTALS,ISRAEL,225,35,68,51.5,30,54,55.6,5,14,35.7,22,29,75.9,7,24,31,22,24,10,10,5,97,1
18877,440313,499_14_06,MONTENEGRO,0,TOTALS,MONTENEGRO,225,37,67,55.2,28,49,57.1,9,18,50.0,17,22,77.3,9,26,35,17,29,17,5,1,100,0
18878,440326,499_14_07,GEORGIA,0,TOTALS,GEORGIA,200,26,62,41.9,21,47,44.7,5,15,33.3,16,22,72.7,16,25,41,18,19,12,11,2,73,1
18879,440339,499_14_07,CZECH REPUBLIC,0,TOTALS,CZECH REPUBLIC,200,24,63,38.1,19,39,48.7,5,24,20.8,9,10,90.0,12,21,33,17,20,14,6,4,62,0
18880,440352,499_14_08,PORTUGAL,0,TOTALS,PORTUGAL,200,15,52,28.8,11,31,35.5,4,21,19.0,4,7,57.1,6,19,25,6,18,15,5,3,38,0
18881,440365,499_14_08,HUNGARY,0,TOTALS,HUNGARY,200,21,57,36.8,15,36,41.7,6,21,28.6,10,11,90.9,11,27,38,8,22,14,6,2,58,1
18882,440378,499_14_09,POLAND,0,TOTALS,POLAND,200,25,60,41.7,17,31,54.8,8,29,27.6,10,14,71.4,10,24,34,15,23,12,3,4,68,1
18883,440391,499_14_09,GERMANY,0,TOTALS,GERMANY,200,24,57,42.1,19,42,45.2,5,15,33.3,14,19,73.7,12,27,39,10,20,13,4,2,67,0
18884,440404,499_14_10,AUSTRIA,0,TOTALS,AUSTRIA,200,32,60,53.3,21,31,67.7,11,29,37.9,9,14,64.3,9,24,33,16,16,17,16,2,84,1
18885,440417,499_14_10,LUXEMBOURG,0,TOTALS,LUXEMBOURG,200,27,56,48.2,14,27,51.9,13,29,44.8,9,13,69.2,7,20,27,12,18,21,6,0,76,0
18886,440430,499_14_11,BULGARIA,0,TOTALS,BULGARIA,200,18,57,31.6,8,25,32.0,10,32,31.2,7,13,53.8,8,24,32,12,18,15,7,2,53,0
18887,440443,499_14_11,NETHERLANDS,0,TOTALS,NETHERLANDS,200,24,59,40.7,20,46,43.5,4,13,30.8,10,16,62.5,14,33,47,14,19,17,7,1,62,1
18888,440456,499_14_12,MKD,0,TOTALS,MKD,225,28,61,45.9,17,31,54.8,11,30,36.7,9,14,64.3,12,27,39,13,21,15,4,8,76,1
18889,440469,499_14_12,BELGIUM,0,TOTALS,BELGIUM,225,25,67,37.3,18,38,47.4,7,29,24.1,16,18,88.9,14,22,36,15,21,10,8,2,73,0
18890,440482,499_14_13,CZECH REPUBLIC,0,TOTALS,CZECH REPUBLIC,200,32,62,51.6,24,44,54.5,8,18,44.4,17,24,70.8,15,37,52,17,19,18,8,7,89,1
18891,440495,499_14_13,PORTUGAL,0,TOTALS,PORTUGAL,200,19,63,30.2,12,41,29.3,7,22,31.8,8,12,66.7,9,18,27,11,23,14,6,4,53,0
18892,440508,499_14_14,HUNGARY,0,TOTALS,HUNGARY,200,28,52,53.8,17,26,65.4,11,26,42.3,7,11,63.6,4,17,21,11,29,15,10,1,74,1
18893,440521,499_14_14,GEORGIA,0,TOTALS,GEORGIA,200,27,49,55.1,21,35,60.0,6,14,42.9,13,23,56.5,8,18,26,13,21,14,5,1,73,0
18894,440534,499_14_15,ROMANIA,0,TOTALS,ROMANIA,225,28,62,45.2,22,38,57.9,6,24,25.0,15,26,57.7,10,29,39,21,27,17,8,3,77,1
18895,440547,499_14_15,SWEDEN,0,TOTALS,SWEDEN,225,22,64,34.4,14,34,41.2,8,30,26.7,20,30,66.7,14,28,42,15,25,17,7,5,72,0
18896,440560,499_14_16,RUSSIA,0,TOTALS,RUSSIA,200,23,62,37.1,21,46,45.7,2,16,12.5,15,23,65.2,17,27,44,12,22,8,3,3,63,0
18897,440573,499_14_16,ITALY,0,TOTALS,ITALY,200,26,61,42.6,24,50,48.0,2,11,18.2,11,15,73.3,10,24,34,5,23,5,3,6,65,1
18898,440586,499_14_17,LUXEMBOURG,0,TOTALS,LUXEMBOURG,200,23,57,40.4,16,33,48.5,7,24,29.2,8,11,72.7,7,6,13,3,15,16,7,0,61,1
18899,440598,499_14_17,POLAND,0,TOTALS,POLAND,200,46,65,70.8,34,43,79.1,12,22,54.5,9,12,75.0,11,27,38,17,13,20,7,2,113,0
18900,440611,499_14_18,NETHERLANDS,0,TOTALS,NETHERLANDS,200,24,61,39.3,20,48,41.7,4,13,30.8,5,5,100.0,14,27,41,17,20,18,7,0,57,0
18901,440624,499_14_18,ISRAEL,0,TOTALS,ISRAEL,200,25,57,43.9,18,37,48.6,7,20,35.0,9,16,56.2,9,23,32,19,16,17,11,1,66,1
18902,440637,499_14_19,DENMARK,0,TOTALS,DENMARK,200,28,66,42.4,20,49,40.8,8,17,47.1,11,15,73.3,13,22,35,12,17,15,6,1,75,0
18903,440650,499_14_19,MKD,0,TOTALS,MKD,200,33,61,54.1,25,35,71.4,8,26,30.8,7,11,63.6,5,23,28,16,20,13,10,4,81,1
18904,440663,499_14_20,GREAT BRITAIN,0,TOTALS,GREAT BRITAIN,200,24,65,36.9,21,42,50.0,3,23,13.0,16,22,72.7,13,25,38,8,20,10,6,2,67,0
18905,440676,499_14_20,BOSNIA AND HERZEGOVINA,0,TOTALS,BOSNIA AND HERZEGOVINA,200,29,56,51.8,21,37,56.8,8,19,42.1,14,19,73.7,6,29,35,18,23,11,7,2,80,1
18906,440689,499_14_21,LATVIA,0,TOTALS,LATVIA,200,29,60,48.3,21,36,58.3,8,24,33.3,20,25,80.0,10,31,41,25,15,17,8,5,86,1
18907,440701,499_14_21,SLOVAK REPUBLIC,0,TOTALS,SLOVAK REPUBLIC,200,26,66,39.4,18,43,41.9,8,23,34.8,6,9,66.7,8,21,29,16,20,17,6,4,66,0
18908,440714,499_14_22,AUSTRIA,0,TOTALS,AUSTRIA,200,25,65,38.5,17,33,51.5,8,32,25.0,6,6,100.0,8,21,29,16,24,13,6,3,64,0
18909,440727,499_14_22,GERMANY,0,TOTALS,GERMANY,200,25,52,48.1,18,33,54.5,7,19,36.8,20,27,74.1,7,26,33,11,18,13,6,2,77,1
18910,440740,499_14_23,BELGIUM,0,TOTALS,BELGIUM,200,25,65,38.5,16,38,42.1,9,27,33.3,12,13,92.3,15,26,41,14,21,18,13,4,71,1
18911,440753,499_14_23,BELARUS,0,TOTALS,BELARUS,200,19,54,35.2,14,37,37.8,5,17,29.4,14,19,73.7,9,25,34,7,19,22,8,0,57,0
18912,440766,499_14_24,MONTENEGRO,0,TOTALS,MONTENEGRO,225,30,76,39.5,27,52,51.9,3,24,12.5,7,9,77.8,19,31,50,14,16,13,8,3,70,1
18913,440779,499_14_24,BULGARIA,0,TOTALS,BULGARIA,225,28,62,45.2,24,47,51.1,4,15,26.7,4,9,44.4,9,28,37,13,18,13,7,3,64,0
18914,440792,499_14_25,BELGIUM,0,TOTALS,BELGIUM,200,26,58,44.8,15,28,53.6,11,30,36.7,8,13,61.5,12,26,38,17,20,18,9,3,71,1
18915,440805,499_14_25,DENMARK,0,TOTALS,DENMARK,200,19,54,35.2,14,39,35.9,5,15,33.3,7,14,50.0,13,22,35,5,19,25,9,1,50,0
18916,440818,499_14_26,PORTUGAL,0,TOTALS,PORTUGAL,225,31,79,39.2,18,47,38.3,13,32,40.6,15,19,78.9,12,22,34,24,37,16,7,2,90,0
18917,440831,499_14_26,GEORGIA,0,TOTALS,GEORGIA,225,26,52,50.0,23,36,63.9,3,16,18.8,36,53,67.9,9,28,37,15,25,18,6,4,91,1
18918,440844,499_14_27,BELARUS,0,TOTALS,BELARUS,200,23,56,41.1,13,28,46.4,10,28,35.7,14,19,73.7,12,29,41,11,16,14,2,1,70,0
18919,440857,499_14_27,MKD,0,TOTALS,MKD,200,28,65,43.1,12,34,35.3,16,31,51.6,9,10,90.0,9,22,31,18,19,8,8,1,81,1
18920,440870,499_14_28,CZECH REPUBLIC,0,TOTALS,CZECH REPUBLIC,200,25,55,45.5,19,40,47.5,6,15,40.0,10,19,52.6,11,24,35,14,14,15,10,3,66,1
18921,440883,499_14_28,HUNGARY,0,TOTALS,HUNGARY,200,25,59,42.4,19,42,45.2,6,17,35.3,7,9,77.8,11,22,33,9,22,15,6,1,63,0
18922,440895,499_14_29,SLOVAK REPUBLIC,0,TOTALS,SLOVAK REPUBLIC,200,27,55,49.1,21,39,53.8,6,16,37.5,12,16,75.0,9,23,32,11,23,17,10,3,72,0
18923,440908,499_14_29,SWEDEN,0,TOTALS,SWEDEN,200,26,63,41.3,18,35,51.4,8,28,28.6,15,17,88.2,15,19,34,14,19,14,9,3,75,1
18924,440921,499_14_30,GERMANY,0,TOTALS,GERMANY,200,43,61,70.5,30,35,85.7,13,26,50.0,10,17,58.8,12,41,53,25,12,23,9,0,109,0
18925,440934,499_14_30,LUXEMBOURG,0,TOTALS,LUXEMBOURG,200,20,63,31.7,15,31,48.4,5,32,15.6,4,7,57.1,4,9,13,12,15,16,9,0,49,1
18926,440947,499_14_31,BOSNIA AND HERZEGOVINA,0,TOTALS,BOSNIA AND HERZEGOVINA,200,27,70,38.6,18,43,41.9,9,27,33.3,9,16,56.2,18,40,58,10,22,13,5,3,72,1
18927,440960,499_14_31,ICELAND,0,TOTALS,ICELAND,200,21,65,32.3,13,42,31.0,8,23,34.8,12,19,63.2,9,27,36,7,16,9,5,3,62,0
18928,440973,499_14_32,LATVIA,0,TOTALS,LATVIA,200,29,61,47.5,22,38,57.9,7,23,30.4,23,32,71.9,16,21,37,19,22,13,9,3,88,1
18929,440986,499_14_32,ROMANIA,0,TOTALS,ROMANIA,200,25,53,47.2,21,38,55.3,4,15,26.7,11,21,52.4,9,18,27,10,30,18,7,1,65,0
18930,440999,499_14_33,AUSTRIA,0,TOTALS,AUSTRIA,200,30,63,47.6,20,36,55.6,10,27,37.0,13,17,76.5,11,17,28,16,18,10,10,2,83,1
18931,441011,499_14_33,POLAND,0,TOTALS,POLAND,200,29,55,52.7,18,33,54.5,11,22,50.0,12,14,85.7,9,23,32,14,17,19,6,2,81,0
18932,441024,499_14_34,BULGARIA,0,TOTALS,BULGARIA,200,31,72,43.1,22,45,48.9,9,27,33.3,13,16,81.2,20,17,37,15,20,14,6,1,84,1
18933,441037,499_14_34,ISRAEL,0,TOTALS,ISRAEL,200,41,64,64.1,37,52,71.2,4,12,33.3,14,16,87.5,5,24,29,20,18,10,7,5,100,0
18934,441050,499_14_35,ITALY,0,TOTALS,ITALY,200,29,58,50.0,17,33,51.5,12,25,48.0,20,24,83.3,10,32,42,24,12,9,4,6,90,1
18935,441062,499_14_35,SWITZERLAND,0,TOTALS,SWITZERLAND,200,23,65,35.4,16,41,39.0,7,24,29.2,7,11,63.6,11,19,30,8,22,13,3,1,60,0
18936,441075,499_14_36,MONTENEGRO,0,TOTALS,MONTENEGRO,200,20,54,37.0,11,24,45.8,9,30,30.0,11,20,55.0,10,25,35,15,16,17,6,4,60,0
18937,441088,499_14_36,NETHERLANDS,0,TOTALS,NETHERLANDS,200,27,55,49.1,23,41,56.1,4,14,28.6,7,12,58.3,10,30,40,11,22,17,12,2,65,1
18938,441101,499_14_37,HUNGARY,0,TOTALS,HUNGARY,200,27,54,50.0,24,35,68.6,3,19,15.8,8,14,57.1,6,24,30,10,22,11,8,0,65,1
18939,441114,499_14_37,PORTUGAL,0,TOTALS,PORTUGAL,200,17,53,32.1,11,27,40.7,6,26,23.1,12,13,92.3,8,18,26,4,21,15,2,0,52,0
18940,441127,499_14_38,CZECH REPUBLIC,0,TOTALS,CZECH REPUBLIC,200,33,58,56.9,24,38,63.2,9,20,45.0,11,14,78.6,6,24,30,19,25,11,11,3,86,1
18941,441140,499_14_38,GEORGIA,0,TOTALS,GEORGIA,200,20,51,39.2,16,38,42.1,4,13,30.8,23,31,74.2,11,18,29,9,20,16,6,2,67,0
18942,441153,499_14_39,ROMANIA,0,TOTALS,ROMANIA,200,34,56,60.7,29,34,85.3,5,22,22.7,17,24,70.8,5,24,29,26,23,17,10,0,90,1
18943,441165,499_14_39,SLOVAK REPUBLIC,0,TOTALS,SLOVAK REPUBLIC,200,30,63,47.6,20,30,66.7,10,33,30.3,16,23,69.6,13,21,34,20,24,17,11,1,86,0
18944,441178,499_14_40,RUSSIA,0,TOTALS,RUSSIA,200,32,62,51.6,20,36,55.6,12,26,46.2,25,36,69.4,17,29,46,25,21,9,9,3,101,0
18945,441189,499_14_40,SWITZERLAND,0,TOTALS,SWITZERLAND,200,20,56,35.7,15,34,44.1,5,22,22.7,11,15,73.3,9,18,27,10,25,16,5,4,56,1
18946,441202,499_14_41,LUXEMBOURG,0,TOTALS,LUXEMBOURG,200,25,62,40.3,17,38,44.7,8,24,33.3,13,20,65.0,8,16,24,9,20,12,4,0,71,0
18947,441215,499_14_41,AUSTRIA,0,TOTALS,AUSTRIA,200,28,53,52.8,19,32,59.4,9,21,42.9,15,21,71.4,9,32,41,17,23,20,9,0,80,1
18948,441228,499_14_42,DENMARK,0,TOTALS,DENMARK,200,26,67,38.8,23,47,48.9,3,20,15.0,11,13,84.6,13,19,32,10,21,12,7,4,66,0
18949,441241,499_14_42,BELARUS,0,TOTALS,BELARUS,200,25,58,43.1,13,31,41.9,12,27,44.4,11,14,78.6,11,28,39,17,21,15,6,4,73,1
18950,441254,499_14_43,GREAT BRITAIN,0,TOTALS,GREAT BRITAIN,200,27,64,42.2,20,44,45.5,7,20,35.0,8,13,61.5,11,27,38,19,20,15,2,3,69,0
18951,441267,499_14_43,ICELAND,0,TOTALS,ICELAND,200,26,64,40.6,15,35,42.9,11,29,37.9,8,12,66.7,11,28,39,16,18,11,3,4,71,1
18952,441280,499_14_44,NETHERLANDS,0,TOTALS,NETHERLANDS,200,27,62,43.5,21,42,50.0,6,20,30.0,6,11,54.5,19,22,41,14,15,15,10,1,66,1
18953,441293,499_14_44,BULGARIA,0,TOTALS,BULGARIA,200,21,51,41.2,12,21,57.1,9,30,30.0,6,10,60.0,2,15,17,14,19,16,6,1,57,0
18954,441306,499_14_45,GERMANY,0,TOTALS,GERMANY,200,26,53,49.1,16,29,55.2,10,24,41.7,14,17,82.4,11,22,33,16,25,17,1,0,76,0
18955,441319,499_14_45,POLAND,0,TOTALS,POLAND,200,30,58,51.7,18,34,52.9,12,24,50.0,16,18,88.9,6,17,23,19,23,7,7,2,88,1
18956,441332,499_14_46,LATVIA,0,TOTALS,LATVIA,225,26,72,36.1,17,36,47.2,9,36,25.0,18,24,75.0,17,24,41,18,23,12,10,5,79,1
18957,441344,499_14_46,SWEDEN,0,TOTALS,SWEDEN,225,26,60,43.3,20,44,45.5,6,16,37.5,18,22,81.8,9,33,42,15,26,19,2,6,76,0
18958,441357,499_14_47,BELGIUM,0,TOTALS,BELGIUM,200,23,64,35.9,18,39,46.2,5,25,20.0,12,17,70.6,11,24,35,14,21,16,12,1,63,1
18959,441370,499_14_47,MKD,0,TOTALS,MKD,200,20,51,39.2,12,24,50.0,8,27,29.6,12,18,66.7,9,30,39,9,21,25,6,2,60,0
18960,441383,499_14_48,MONTENEGRO,0,TOTALS,MONTENEGRO,200,27,64,42.2,22,40,55.0,5,24,20.8,6,10,60.0,10,22,32,11,22,6,2,2,65,0
18961,441396,499_14_48,ISRAEL,0,TOTALS,ISRAEL,200,32,58,55.2,28,49,57.1,4,9,44.4,12,17,70.6,9,30,39,24,15,9,4,3,80,1
18962,441409,499_14_49,GERMANY,0,TOTALS,GERMANY,200,28,53,52.8,16,23,69.6,12,30,40.0,20,26,76.9,11,20,31,18,24,17,8,4,88,1
18963,441422,499_14_49,AUSTRIA,0,TOTALS,AUSTRIA,200,25,57,43.9,17,32,53.1,8,25,32.0,11,17,64.7,13,15,28,15,22,19,6,0,69,0
18964,441435,499_14_50,PORTUGAL,0,TOTALS,PORTUGAL,200,24,60,40.0,18,36,50.0,6,24,25.0,7,18,38.9,9,21,30,7,20,15,4,2,61,0
18965,441448,499_14_50,CZECH REPUBLIC,0,TOTALS,CZECH REPUBLIC,200,30,59,50.8,28,45,62.2,2,14,14.3,13,19,68.4,13,29,42,16,21,14,8,1,75,1
18966,441461,499_14_51,BELARUS,0,TOTALS,BELARUS,200,25,60,41.7,18,45,40.0,7,15,46.7,16,24,66.7,18,18,36,12,19,21,8,0,73,0
18967,441473,499_14_51,BELGIUM,0,TOTALS,BELGIUM,200,38,69,55.1,26,35,74.3,12,34,35.3,11,16,68.8,13,20,33,31,21,11,12,6,99,1
18968,441486,499_14_52,SWEDEN,0,TOTALS,SWEDEN,200,29,64,45.3,19,36,52.8,10,28,35.7,18,24,75.0,13,15,28,15,25,9,9,0,86,0
18969,441499,499_14_52,ROMANIA,0,TOTALS,ROMANIA,200,27,48,56.2,18,29,62.1,9,19,47.4,25,27,92.6,7,25,32,16,23,17,6,2,88,1
18970,441511,499_14_53,SLOVAK REPUBLIC,0,TOTALS,SLOVAK REPUBLIC,200,24,61,39.3,20,39,51.3,4,22,18.2,13,14,92.9,3,23,26,13,24,17,8,2,65,0
18971,441524,499_14_53,LATVIA,0,TOTALS,LATVIA,200,29,58,50.0,17,31,54.8,12,27,44.4,19,25,76.0,8,35,43,17,19,20,8,5,89,1
18972,441537,499_14_54,ISRAEL,0,TOTALS,ISRAEL,200,30,57,52.6,22,40,55.0,8,17,47.1,15,18,83.3,6,23,29,24,19,14,10,2,83,1
18973,441549,499_14_54,NETHERLANDS,0,TOTALS,NETHERLANDS,200,23,55,41.8,17,42,40.5,6,13,46.2,8,20,40.0,15,23,38,9,19,24,9,2,60,0
18974,441562,499_14_55,GEORGIA,0,TOTALS,GEORGIA,200,30,58,51.7,22,42,52.4,8,16,50.0,11,16,68.8,13,26,39,29,19,14,5,2,79,1
18975,441575,499_14_55,HUNGARY,0,TOTALS,HUNGARY,200,23,58,39.7,16,33,48.5,7,25,28.0,6,8,75.0,7,15,22,14,22,11,7,4,59,0
18976,441588,499_14_56,BOSNIA AND HERZEGOVINA,0,TOTALS,BOSNIA AND HERZEGOVINA,200,27,53,50.9,17,31,54.8,10,22,45.5,10,19,52.6,9,24,33,19,21,12,6,1,74,1
18977,441601,499_14_56,GREAT BRITAIN,0,TOTALS,GREAT BRITAIN,200,26,59,44.1,16,36,44.4,10,23,43.5,6,11,54.5,10,21,31,16,20,12,7,1,68,0
18978,441614,499_14_57,POLAND,0,TOTALS,POLAND,200,40,66,60.6,32,43,74.4,8,23,34.8,12,15,80.0,10,35,45,33,15,21,12,0,100,0
18979,441627,499_14_57,LUXEMBOURG,0,TOTALS,LUXEMBOURG,200,26,64,40.6,19,36,52.8,7,28,25.0,5,6,83.3,4,17,21,16,13,22,11,0,64,1
18980,441639,499_14_58,BULGARIA,0,TOTALS,BULGARIA,200,25,64,39.1,18,40,45.0,7,24,29.2,16,22,72.7,11,23,34,10,21,13,10,2,73,0
18981,441652,499_14_58,MONTENEGRO,0,TOTALS,MONTENEGRO,200,35,68,51.5,29,49,59.2,6,19,31.6,8,13,61.5,12,31,43,17,21,13,8,3,84,1
18982,441665,499_14_59,MKD,0,TOTALS,MKD,200,32,71,45.1,23,39,59.0,9,32,28.1,7,8,87.5,15,27,42,22,17,6,8,4,80,1
18983,441675,499_14_59,DENMARK,0,TOTALS,DENMARK,200,18,56,32.1,16,41,39.0,2,15,13.3,8,11,72.7,9,25,34,2,15,12,4,3,46,0
18984,441688,499_14_60,ITALY,0,TOTALS,ITALY,200,17,54,31.5,12,36,33.3,5,18,27.8,29,31,93.5,8,22,30,9,21,13,2,10,68,0
18985,441700,499_14_60,RUSSIA,0,TOTALS,RUSSIA,200,28,58,48.3,23,47,48.9,5,11,45.5,11,23,47.8,12,28,40,16,26,16,5,3,72,1
18986,441713,499_14_61,HUNGARY,0,TOTALS,HUNGARY,200,29,64,45.3,19,40,47.5,10,24,41.7,15,22,68.2,11,31,42,19,28,11,7,2,83,1
18987,441726,499_14_61,CZECH REPUBLIC,0,TOTALS,CZECH REPUBLIC,200,21,54,38.9,19,31,61.3,2,23,8.7,24,32,75.0,9,27,36,15,21,13,7,5,68,0
18988,441739,499_14_62,ISRAEL,0,TOTALS,ISRAEL,200,26,54,48.1,22,39,56.4,4,15,26.7,5,11,45.5,7,27,34,19,18,18,9,2,61,0
18989,441751,499_14_62,BULGARIA,0,TOTALS,BULGARIA,200,27,60,45.0,20,45,44.4,7,15,46.7,8,15,53.3,9,23,32,10,14,16,7,3,69,1
18990,441764,499_14_63,ROMANIA,0,TOTALS,ROMANIA,200,21,54,38.9,16,34,47.1,5,20,25.0,23,31,74.2,11,18,29,12,24,13,7,1,70,0
18991,441777,499_14_63,LATVIA,0,TOTALS,LATVIA,200,28,52,53.8,18,28,64.3,10,24,41.7,16,19,84.2,5,27,32,16,24,17,8,2,82,1
18992,441790,499_14_64,GEORGIA,0,TOTALS,GEORGIA,200,27,62,43.5,22,39,56.4,5,23,21.7,12,16,75.0,16,27,43,22,22,10,8,3,71,1
18993,441803,499_14_64,PORTUGAL,0,TOTALS,PORTUGAL,200,23,58,39.7,15,37,40.5,8,21,38.1,5,15,33.3,10,19,29,19,18,12,6,2,59,0
18994,441816,499_14_65,SWEDEN,0,TOTALS,SWEDEN,200,25,61,41.0,17,40,42.5,8,21,38.1,25,25,100.0,12,20,32,12,21,6,7,4,83,1
18995,441828,499_14_65,SLOVAK REPUBLIC,0,TOTALS,SLOVAK REPUBLIC,200,29,56,51.8,24,36,66.7,5,20,25.0,14,19,73.7,8,24,32,16,22,11,3,3,77,0
18996,441841,499_14_66,ICELAND,0,TOTALS,ICELAND,200,23,65,35.4,13,41,31.7,10,24,41.7,14,19,73.7,8,27,35,12,25,12,4,3,70,0
18997,441854,499_14_66,BOSNIA AND HERZEGOVINA,0,TOTALS,BOSNIA AND HERZEGOVINA,200,27,55,49.1,20,37,54.1,7,18,38.9,17,31,54.8,9,35,44,21,21,15,4,10,78,1
18998,441867,499_14_67,LUXEMBOURG,0,TOTALS,LUXEMBOURG,200,23,57,40.4,15,31,48.4,8,26,30.8,12,17,70.6,6,20,26,10,25,18,5,1,66,1
18999,441880,499_14_67,GERMANY,0,TOTALS,GERMANY,200,42,75,56.0,27,38,71.1,15,37,40.5,19,31,61.3,20,27,47,22,17,11,8,3,118,0
19000,441890,499_14_68,DENMARK,0,TOTALS,DENMARK,200,24,59,40.7,14,36,38.9,10,23,43.5,5,10,50.0,6,21,27,14,14,13,3,0,63,0
19001,441902,499_14_68,BELGIUM,0,TOTALS,BELGIUM,200,31,63,49.2,21,29,72.4,10,34,29.4,5,8,62.5,12,28,40,22,18,16,7,1,77,1
19002,441914,499_14_69,NETHERLANDS,0,TOTALS,NETHERLANDS,200,27,56,48.2,23,42,54.8,4,14,28.6,10,19,52.6,8,28,36,13,20,10,6,1,68,1
19003,441927,499_14_69,MONTENEGRO,0,TOTALS,MONTENEGRO,200,20,54,37.0,12,26,46.2,8,28,28.6,7,10,70.0,7,21,28,11,20,11,4,1,55,0
19004,441940,499_14_70,POLAND,0,TOTALS,POLAND,225,37,73,50.7,33,51,64.7,4,22,18.2,12,21,57.1,10,27,37,17,27,15,11,2,90,1
19005,441953,499_14_70,AUSTRIA,0,TOTALS,AUSTRIA,225,26,57,45.6,17,33,51.5,9,24,37.5,24,31,77.4,6,28,34,13,23,19,6,2,85,0
19006,441966,499_14_71,MKD,0,TOTALS,MKD,200,24,62,38.7,14,32,43.8,10,30,33.3,14,20,70.0,14,27,41,16,24,11,4,2,72,1
19007,441979,499_14_71,BELARUS,0,TOTALS,BELARUS,200,20,55,36.4,12,30,40.0,8,25,32.0,18,27,66.7,10,26,36,7,20,11,4,0,66,0
19008,441991,499_14_72,SWITZERLAND,0,TOTALS,SWITZERLAND,200,22,61,36.1,16,44,36.4,6,17,35.3,15,29,51.7,10,25,35,12,26,11,3,2,65,0
19009,442004,499_14_72,ITALY,0,TOTALS,ITALY,200,27,56,48.2,21,35,60.0,6,21,28.6,20,26,76.9,6,33,39,12,24,13,2,2,80,1
19010,445978,503_15_01,UKRAINE,0,TOTALS,UKRAINE,200,30,71,42.3,23,48,47.9,7,23,30.4,12,14,85.7,17,40,57,14,20,15,9,0,79,1
19011,445991,503_15_01,POLAND,0,TOTALS,POLAND,200,19,62,30.6,12,35,34.3,7,27,25.9,10,15,66.7,6,25,31,9,16,17,6,4,55,0
19012,446004,503_15_02,BULGARIA,0,TOTALS,BULGARIA,200,21,52,40.4,16,32,50.0,5,20,25.0,21,32,65.6,3,21,24,9,22,21,9,0,68,0
19013,446017,503_15_02,ISRAEL,0,TOTALS,ISRAEL,200,30,58,51.7,26,40,65.0,4,18,22.2,15,26,57.7,11,34,45,17,27,25,15,3,79,1
19014,446030,503_15_03,LATVIA,0,TOTALS,LATVIA,200,22,66,33.3,14,38,36.8,8,28,28.6,9,14,64.3,17,22,39,12,21,13,7,1,61,1
19015,446043,503_15_03,GREECE,0,TOTALS,GREECE,200,20,54,37.0,18,38,47.4,2,16,12.5,8,18,44.4,17,30,47,3,20,22,7,2,50,0
19016,446056,503_15_04,SPAIN,0,TOTALS,SPAIN,200,22,63,34.9,17,34,50.0,5,29,17.2,22,33,66.7,17,33,50,10,15,16,18,6,71,1
19017,446069,503_15_04,CZECH REPUBLIC,0,TOTALS,CZECH REPUBLIC,200,17,63,27.0,13,43,30.2,4,20,20.0,16,19,84.2,13,30,43,7,28,21,7,1,54,0
19018,446082,503_15_05,BOSNIA AND HERZEGOVINA,0,TOTALS,BOSNIA AND HERZEGOVINA,200,15,59,25.4,11,37,29.7,4,22,18.2,17,24,70.8,15,26,41,9,28,13,4,2,51,0
19019,446095,503_15_05,BELGIUM,0,TOTALS,BELGIUM,200,19,56,33.9,15,33,45.5,4,23,17.4,17,24,70.8,14,30,44,7,18,15,7,3,59,1
19020,446108,503_15_06,TURKEY,0,TOTALS,TURKEY,225,24,72,33.3,19,40,47.5,5,32,15.6,6,8,75.0,17,28,45,12,21,24,11,11,59,1
19021,446121,503_15_06,GREAT BRITAIN,0,TOTALS,GREAT BRITAIN,225,17,67,25.4,11,45,24.4,6,22,27.3,17,22,77.3,18,30,48,9,17,23,13,4,57,0
19022,446134,503_15_07,CROATIA,0,TOTALS,CROATIA,200,20,58,34.5,17,41,41.5,3,17,17.6,7,14,50.0,10,42,52,7,17,22,8,2,50,0
19023,446147,503_15_07,ITALY,0,TOTALS,ITALY,200,20,70,28.6,16,46,34.8,4,24,16.7,9,12,75.0,11,32,43,3,18,12,15,6,53,1
19024,446160,503_15_08,SLOVENIA,0,TOTALS,SLOVENIA,200,20,58,34.5,11,27,40.7,9,31,29.0,14,20,70.0,9,23,32,10,25,10,4,1,63,0
19025,446173,503_15_08,GERMANY,0,TOTALS,GERMANY,200,19,52,36.5,14,37,37.8,5,15,33.3,25,28,89.3,9,32,41,5,25,12,4,2,68,1
19026,446186,503_15_09,RUSSIA,0,TOTALS,RUSSIA,200,22,55,40.0,18,46,39.1,4,9,44.4,12,19,63.2,9,28,37,7,24,12,5,1,60,0
19027,446199,503_15_09,SPAIN,0,TOTALS,SPAIN,200,23,64,35.9,16,39,41.0,7,25,28.0,16,22,72.7,16,28,44,10,19,9,8,5,69,1
19028,446212,503_15_10,LITHUANIA,0,TOTALS,LITHUANIA,200,21,61,34.4,19,44,43.2,2,17,11.8,6,11,54.5,15,20,35,5,23,19,10,3,50,0
19029,446225,503_15_10,TURKEY,0,TOTALS,TURKEY,200,26,57,45.6,21,41,51.2,5,16,31.2,9,19,47.4,15,30,45,12,18,20,11,6,66,1
19030,446238,503_15_11,FRANCE,0,TOTALS,FRANCE,200,26,59,44.1,23,40,57.5,3,19,15.8,17,21,81.0,13,22,35,13,25,12,10,1,72,1
19031,446251,503_15_11,CROATIA,0,TOTALS,CROATIA,200,18,50,36.0,15,34,44.1,3,16,18.8,16,24,66.7,13,21,34,7,21,20,3,1,55,0
19032,446264,503_15_12,GREAT BRITAIN,0,TOTALS,GREAT BRITAIN,200,26,66,39.4,17,41,41.5,9,25,36.0,11,18,61.1,14,30,44,17,28,20,9,7,72,0
19033,446277,503_15_12,SLOVENIA,0,TOTALS,SLOVENIA,200,24,59,40.7,17,34,50.0,7,25,28.0,25,31,80.6,8,28,36,9,23,16,10,5,80,1
19034,446290,503_15_13,SERBIA,0,TOTALS,SERBIA,200,26,56,46.4,20,39,51.3,6,17,35.3,11,21,52.4,8,27,35,11,23,15,8,0,69,1
19035,446303,503_15_13,LATVIA,0,TOTALS,LATVIA,200,15,57,26.3,8,30,26.7,7,27,25.9,19,23,82.6,14,26,40,9,24,18,5,1,56,0
19036,446316,503_15_14,CZECH REPUBLIC,0,TOTALS,CZECH REPUBLIC,200,36,77,46.8,23,49,46.9,13,28,46.4,5,9,55.6,13,27,40,16,18,9,11,3,90,1
19037,446329,503_15_14,UKRAINE,0,TOTALS,UKRAINE,200,23,67,34.3,14,36,38.9,9,31,29.0,13,15,86.7,14,28,42,13,18,18,6,2,68,0
19038,446342,503_15_15,ITALY,0,TOTALS,ITALY,200,26,73,35.6,19,42,45.2,7,31,22.6,10,15,66.7,13,22,35,8,25,14,10,2,69,0
19039,446355,503_15_15,BOSNIA AND HERZEGOVINA,0,TOTALS,BOSNIA AND HERZEGOVINA,200,24,48,50.0,17,34,50.0,7,14,50.0,18,32,56.2,8,35,43,11,24,25,4,4,73,1
19040,446368,503_15_16,GREECE,0,TOTALS,GREECE,200,22,55,40.0,15,34,44.1,7,21,33.3,9,14,64.3,12,28,40,8,16,21,8,2,60,1
19041,446381,503_15_16,BULGARIA,0,TOTALS,BULGARIA,200,19,54,35.2,12,35,34.3,7,19,36.8,6,8,75.0,8,21,29,9,22,18,9,1,51,0
19042,446394,503_15_17,POLAND,0,TOTALS,POLAND,200,21,55,38.2,18,37,48.6,3,18,16.7,22,25,88.0,6,25,31,14,26,14,2,2,67,1
19043,446407,503_15_17,CZECH REPUBLIC,0,TOTALS,CZECH REPUBLIC,200,40,76,52.6,27,47,57.4,13,29,44.8,9,18,50.0,16,28,44,29,25,7,6,1,102,0
19044,446420,503_15_18,GERMANY,0,TOTALS,GERMANY,200,21,61,34.4,11,42,26.2,10,19,52.6,12,16,75.0,19,33,52,17,18,27,7,2,64,1
19045,446433,503_15_18,GREAT BRITAIN,0,TOTALS,GREAT BRITAIN,200,16,54,29.6,13,37,35.1,3,17,17.6,18,25,72.0,6,20,26,8,22,15,12,9,53,0
19046,446446,503_15_19,ISRAEL,0,TOTALS,ISRAEL,200,22,57,38.6,18,38,47.4,4,19,21.1,21,30,70.0,7,27,34,13,22,13,8,2,69,1
19047,446459,503_15_19,GREECE,0,TOTALS,GREECE,200,20,61,32.8,11,35,31.4,9,26,34.6,15,16,93.8,15,30,45,11,25,22,3,2,64,0
19048,446472,503_15_20,BULGARIA,0,TOTALS,BULGARIA,200,23,66,34.8,13,39,33.3,10,27,37.0,5,7,71.4,9,17,26,13,27,20,5,1,61,1
19049,446485,503_15_20,SERBIA,0,TOTALS,SERBIA,200,40,70,57.1,31,45,68.9,9,25,36.0,15,27,55.6,15,32,47,23,20,15,14,4,104,0
19050,446498,503_15_21,BOSNIA AND HERZEGOVINA,0,TOTALS,BOSNIA AND HERZEGOVINA,200,21,44,47.7,19,35,54.3,2,9,22.2,11,21,52.4,11,25,36,8,27,26,4,2,55,0
19051,446511,503_15_21,FRANCE,0,TOTALS,FRANCE,200,22,60,36.7,17,39,43.6,5,21,23.8,13,24,54.2,13,17,30,9,22,14,18,3,62,1
19052,446524,503_15_22,SLOVENIA,0,TOTALS,SLOVENIA,200,23,54,42.6,19,35,54.3,4,19,21.1,10,20,50.0,5,19,24,8,23,6,3,1,60,0
19053,446537,503_15_22,LITHUANIA,0,TOTALS,LITHUANIA,200,31,64,48.4,24,43,55.8,7,21,33.3,16,22,72.7,18,28,46,9,24,8,2,2,85,1
19054,446550,503_15_23,BELGIUM,0,TOTALS,BELGIUM,200,25,67,37.3,22,47,46.8,3,20,15.0,13,30,43.3,17,26,43,12,21,12,4,3,66,1
19055,446563,503_15_23,ITALY,0,TOTALS,ITALY,200,23,63,36.5,20,50,40.0,3,13,23.1,11,12,91.7,13,30,43,11,27,17,6,5,60,0
19056,446576,503_15_24,UKRAINE,0,TOTALS,UKRAINE,200,21,64,32.8,12,33,36.4,9,31,29.0,15,28,53.6,15,23,38,14,19,7,4,7,66,1
19057,446589,503_15_24,RUSSIA,0,TOTALS,RUSSIA,200,25,66,37.9,24,54,44.4,1,12,8.3,8,12,66.7,19,34,53,4,27,14,6,3,59,0
19058,446602,503_15_25,LATVIA,0,TOTALS,LATVIA,200,28,69,40.6,18,39,46.2,10,30,33.3,18,25,72.0,15,28,43,17,23,13,14,1,84,1
19059,446615,503_15_25,BULGARIA,0,TOTALS,BULGARIA,200,22,55,40.0,15,35,42.9,7,20,35.0,13,23,56.5,10,27,37,8,24,21,5,0,64,0
19060,446628,503_15_26,SERBIA,0,TOTALS,SERBIA,200,38,71,53.5,28,45,62.2,10,26,38.5,14,18,77.8,13,33,46,20,20,10,7,3,100,0
19061,446641,503_15_26,ISRAEL,0,TOTALS,ISRAEL,200,24,62,38.7,16,43,37.2,8,19,42.1,18,24,75.0,7,20,27,16,22,13,4,1,74,1
19062,446654,503_15_27,RUSSIA,0,TOTALS,RUSSIA,200,34,65,52.3,30,51,58.8,4,14,28.6,9,18,50.0,11,28,39,9,14,12,13,1,81,1
19063,446667,503_15_27,POLAND,0,TOTALS,POLAND,200,23,67,34.3,18,44,40.9,5,23,21.7,5,7,71.4,10,21,31,7,21,18,7,3,56,0
19064,446680,503_15_28,LITHUANIA,0,TOTALS,LITHUANIA,200,19,55,34.5,13,27,48.1,6,28,21.4,17,23,73.9,19,21,40,6,17,14,9,5,61,1
19065,446693,503_15_28,GERMANY,0,TOTALS,GERMANY,200,19,49,38.8,15,37,40.5,4,12,33.3,10,14,71.4,8,18,26,6,22,13,5,1,52,0
19066,446706,503_15_29,FRANCE,0,TOTALS,FRANCE,200,28,63,44.4,25,47,53.2,3,16,18.8,13,17,76.5,17,29,46,6,26,16,3,6,72,1
19067,446719,503_15_29,BELGIUM,0,TOTALS,BELGIUM,200,14,53,26.4,11,36,30.6,3,17,17.6,19,32,59.4,13,19,32,5,16,10,8,2,50,0
19068,446732,503_15_30,SPAIN,0,TOTALS,SPAIN,200,27,66,40.9,22,42,52.4,5,24,20.8,21,26,80.8,18,28,46,9,20,17,9,4,80,1
19069,446745,503_15_30,UKRAINE,0,TOTALS,UKRAINE,200,21,54,38.9,13,31,41.9,8,23,34.8,22,28,78.6,7,23,30,10,26,16,3,2,72,0
19070,446758,503_15_31,CROATIA,0,TOTALS,CROATIA,200,27,66,40.9,15,32,46.9,12,34,35.3,11,15,73.3,16,33,49,12,19,20,8,0,77,1
19071,446771,503_15_31,BOSNIA AND HERZEGOVINA,0,TOTALS,BOSNIA AND HERZEGOVINA,200,26,70,37.1,22,40,55.0,4,30,13.3,5,15,33.3,15,25,40,8,21,16,13,2,61,0
19072,446784,503_15_32,TURKEY,0,TOTALS,TURKEY,200,23,59,39.0,18,39,46.2,5,20,25.0,10,13,76.9,13,20,33,8,29,15,8,5,61,0
19073,446797,503_15_32,SLOVENIA,0,TOTALS,SLOVENIA,200,17,44,38.6,10,24,41.7,7,20,35.0,26,33,78.8,6,22,28,10,20,16,5,1,67,1
19074,446810,503_15_33,POLAND,0,TOTALS,POLAND,200,19,55,34.5,15,34,44.1,4,21,19.0,10,17,58.8,10,24,34,8,22,23,6,5,52,0
19075,446823,503_15_33,SPAIN,0,TOTALS,SPAIN,200,25,69,36.2,17,42,40.5,8,27,29.6,14,21,66.7,20,29,49,18,19,19,11,6,72,1
19076,446836,503_15_34,CZECH REPUBLIC,0,TOTALS,CZECH REPUBLIC,200,29,62,46.8,22,43,51.2,7,19,36.8,7,10,70.0,10,37,47,10,21,18,4,5,72,1
19077,446849,503_15_34,RUSSIA,0,TOTALS,RUSSIA,200,18,66,27.3,14,43,32.6,4,23,17.4,13,16,81.2,11,24,35,8,17,11,11,2,53,0
19078,446862,503_15_35,ISRAEL,0,TOTALS,ISRAEL,200,29,70,41.4,25,54,46.3,4,16,25.0,8,17,47.1,11,30,41,7,21,11,7,2,70,1
19079,446875,503_15_35,LATVIA,0,TOTALS,LATVIA,200,22,61,36.1,13,33,39.4,9,28,32.1,14,19,73.7,8,34,42,10,24,17,6,2,67,0
19080,446888,503_15_36,GREECE,0,TOTALS,GREECE,200,23,51,45.1,16,33,48.5,7,18,38.9,9,13,69.2,8,19,27,11,19,18,8,0,62,0
19081,446901,503_15_36,SERBIA,0,TOTALS,SERBIA,200,31,58,53.4,23,40,57.5,8,18,44.4,10,13,76.9,7,24,31,16,15,13,9,2,80,1
19082,446914,503_15_37,GERMANY,0,TOTALS,GERMANY,200,20,60,33.3,17,41,41.5,3,19,15.8,10,13,76.9,17,24,41,11,19,16,3,0,53,0
19083,446927,503_15_37,TURKEY,0,TOTALS,TURKEY,200,24,57,42.1,22,38,57.9,2,19,10.5,12,19,63.2,12,21,33,7,17,7,14,3,62,1
19084,446940,503_15_38,GREAT BRITAIN,0,TOTALS,GREAT BRITAIN,200,19,56,33.9,18,46,39.1,1,10,10.0,10,20,50.0,12,18,30,7,18,14,13,2,49,0
19085,446953,503_15_38,LITHUANIA,0,TOTALS,LITHUANIA,200,20,52,38.5,13,27,48.1,7,25,28.0,9,13,69.2,12,30,42,8,19,26,9,4,56,1
19086,446966,503_15_39,BELGIUM,0,TOTALS,BELGIUM,200,29,68,42.6,23,44,52.3,6,24,25.0,21,26,80.8,13,26,39,12,24,9,8,4,85,1
19087,446979,503_15_39,CROATIA,0,TOTALS,CROATIA,200,22,59,37.3,15,37,40.5,7,22,31.8,17,26,65.4,12,28,40,5,23,15,5,1,68,0
19088,446992,503_15_40,ITALY,0,TOTALS,ITALY,200,20,52,38.5,15,38,39.5,5,14,35.7,12,19,63.2,12,18,30,7,18,19,5,4,57,1
19089,447005,503_15_40,FRANCE,0,TOTALS,FRANCE,200,20,53,37.7,17,39,43.6,3,14,21.4,12,17,70.6,17,22,39,7,21,21,8,4,55,0
19090,447018,503_15_41,LITHUANIA,0,TOTALS,LITHUANIA,200,27,72,37.5,22,47,46.8,5,25,20.0,10,15,66.7,17,29,46,15,19,12,9,0,69,0
19091,447031,503_15_41,CZECH REPUBLIC,0,TOTALS,CZECH REPUBLIC,200,32,66,48.5,27,44,61.4,5,22,22.7,10,16,62.5,9,29,38,13,19,14,5,3,79,1
19092,447044,503_15_42,CROATIA,0,TOTALS,CROATIA,200,22,60,36.7,14,31,45.2,8,29,27.6,12,17,70.6,15,29,44,8,18,15,4,2,64,0
19093,447057,503_15_42,GREAT BRITAIN,0,TOTALS,GREAT BRITAIN,200,24,58,41.4,13,29,44.8,11,29,37.9,9,22,40.9,9,23,32,15,19,10,8,4,68,1
19094,447070,503_15_43,GERMANY,0,TOTALS,GERMANY,200,15,43,34.9,10,29,34.5,5,14,35.7,5,10,50.0,4,21,25,8,16,26,5,4,40,0
19095,447083,503_15_43,SPAIN,0,TOTALS,SPAIN,200,28,59,47.5,16,31,51.6,12,28,42.9,7,13,53.8,10,27,37,18,15,15,15,1,75,1
19096,447096,503_15_44,LATVIA,0,TOTALS,LATVIA,200,21,68,30.9,15,45,33.3,6,23,26.1,2,2,100.0,15,28,43,11,22,16,9,5,50,0
19097,447108,503_15_44,FRANCE,0,TOTALS,FRANCE,200,18,67,26.9,12,42,28.6,6,25,24.0,15,19,78.9,24,32,56,10,15,21,8,5,57,1
19098,447121,503_15_45,BOSNIA AND HERZEGOVINA,0,TOTALS,BOSNIA AND HERZEGOVINA,200,24,59,40.7,21,40,52.5,3,19,15.8,8,16,50.0,12,28,40,11,21,9,3,3,59,0
19099,447134,503_15_45,SLOVENIA,0,TOTALS,SLOVENIA,200,22,64,34.4,16,37,43.2,6,27,22.2,13,17,76.5,14,26,40,13,21,12,2,1,63,1
19100,447147,503_15_46,UKRAINE,0,TOTALS,UKRAINE,200,19,70,27.1,11,42,26.2,8,28,28.6,16,22,72.7,14,29,43,14,15,15,6,2,62,0
19101,447160,503_15_46,TURKEY,0,TOTALS,TURKEY,200,35,75,46.7,31,60,51.7,4,15,26.7,5,10,50.0,13,36,49,16,22,13,7,6,79,1
19102,447173,503_15_47,ISRAEL,0,TOTALS,ISRAEL,200,24,69,34.8,18,49,36.7,6,20,30.0,14,22,63.6,18,18,36,12,22,13,8,2,68,0
19103,447186,503_15_47,BELGIUM,0,TOTALS,BELGIUM,200,28,62,45.2,22,46,47.8,6,16,37.5,17,21,81.0,18,31,49,11,19,22,6,7,79,1
19104,447199,503_15_48,BULGARIA,0,TOTALS,BULGARIA,200,18,51,35.3,16,40,40.0,2,11,18.2,23,27,85.2,6,21,27,9,17,14,6,4,61,0
19105,447212,503_15_48,RUSSIA,0,TOTALS,RUSSIA,200,33,66,50.0,22,44,50.0,11,22,50.0,7,8,87.5,11,28,39,19,22,21,7,2,84,1
19106,447225,503_15_49,ITALY,0,TOTALS,ITALY,200,24,57,42.1,18,35,51.4,6,22,27.3,7,8,87.5,8,23,31,13,25,21,6,7,61,0
19107,447238,503_15_49,SERBIA,0,TOTALS,SERBIA,200,24,60,40.0,20,45,44.4,4,15,26.7,15,25,60.0,16,24,40,8,16,16,14,3,67,1
19108,447251,503_15_50,GREECE,0,TOTALS,GREECE,225,29,71,40.8,27,56,48.2,2,15,13.3,11,14,78.6,11,24,35,10,25,17,5,1,71,0
19109,447264,503_15_50,POLAND,0,TOTALS,POLAND,225,27,62,43.5,21,42,50.0,6,20,30.0,20,30,66.7,13,33,46,10,18,15,3,4,80,1
19110,447277,503_15_51,FRANCE,0,TOTALS,FRANCE,200,26,53,49.1,15,27,55.6,11,26,42.3,7,14,50.0,7,31,38,19,21,22,9,6,70,1
19111,447290,503_15_51,ISRAEL,0,TOTALS,ISRAEL,200,17,63,27.0,16,51,31.4,1,12,8.3,12,21,57.1,16,22,38,3,19,16,11,4,47,0
19112,447303,503_15_52,GREAT BRITAIN,0,TOTALS,GREAT BRITAIN,200,28,62,45.2,19,39,48.7,9,23,39.1,12,17,70.6,14,37,51,9,17,21,8,6,77,1
19113,447316,503_15_52,BULGARIA,0,TOTALS,BULGARIA,200,18,65,27.7,16,46,34.8,2,19,10.5,13,20,65.0,12,22,34,4,18,16,9,0,51,0
19114,447329,503_15_53,BELGIUM,0,TOTALS,BELGIUM,200,25,65,38.5,15,36,41.7,10,29,34.5,14,21,66.7,13,29,42,16,23,11,8,5,74,0
19115,447342,503_15_53,SERBIA,0,TOTALS,SERBIA,200,27,69,39.1,20,45,44.4,7,24,29.2,15,23,65.2,15,30,45,8,24,14,8,4,76,1
19116,447355,503_15_54,SPAIN,0,TOTALS,SPAIN,200,16,47,34.0,10,28,35.7,6,19,31.6,30,47,63.8,12,24,36,6,24,13,9,5,68,1
19117,447368,503_15_54,LITHUANIA,0,TOTALS,LITHUANIA,200,22,62,35.5,17,39,43.6,5,23,21.7,13,23,56.5,15,26,41,8,33,15,6,2,62,0
19118,447381,503_15_55,POLAND,0,TOTALS,POLAND,200,24,70,34.3,16,41,39.0,8,29,27.6,6,10,60.0,14,23,37,3,11,17,12,2,62,0
19119,447394,503_15_55,BOSNIA AND HERZEGOVINA,0,TOTALS,BOSNIA AND HERZEGOVINA,200,26,56,46.4,17,29,58.6,9,27,33.3,5,6,83.3,8,33,41,6,18,23,5,0,66,1
19120,447407,503_15_56,CZECH REPUBLIC,0,TOTALS,CZECH REPUBLIC,200,25,72,34.7,21,44,47.7,4,28,14.3,13,15,86.7,18,23,41,10,21,11,7,5,67,0
19121,447420,503_15_56,TURKEY,0,TOTALS,TURKEY,200,28,61,45.9,21,39,53.8,7,22,31.8,12,15,80.0,10,29,39,15,19,16,7,6,75,1
19122,447433,503_15_57,GERMANY,0,TOTALS,GERMANY,200,24,63,38.1,20,40,50.0,4,23,17.4,9,13,69.2,13,34,47,11,19,15,6,4,61,1
19123,447446,503_15_57,UKRAINE,0,TOTALS,UKRAINE,200,18,65,27.7,10,33,30.3,8,32,25.0,8,12,66.7,14,25,39,9,18,14,6,3,52,0
19124,447458,503_15_58,RUSSIA,0,TOTALS,RUSSIA,200,32,67,47.8,20,40,50.0,12,27,44.4,7,13,53.8,13,23,36,18,22,11,4,3,83,1
19125,447471,503_15_58,CROATIA,0,TOTALS,CROATIA,200,29,67,43.3,27,53,50.9,2,14,14.3,11,23,47.8,16,24,40,8,17,12,3,2,71,0
19126,447483,503_15_59,SLOVENIA,0,TOTALS,SLOVENIA,250,27,64,42.2,19,36,52.8,8,28,28.6,16,26,61.5,14,23,37,16,20,17,9,1,78,1
19127,447496,503_15_59,GREECE,0,TOTALS,GREECE,250,27,60,45.0,19,38,50.0,8,22,36.4,10,13,76.9,12,25,37,17,28,28,2,0,72,0
19128,447509,503_15_60,LATVIA,0,TOTALS,LATVIA,200,29,59,49.2,19,40,47.5,10,19,52.6,14,18,77.8,12,29,41,13,22,16,14,2,82,1
19129,447522,503_15_60,ITALY,0,TOTALS,ITALY,200,16,57,28.1,14,39,35.9,2,18,11.1,17,20,85.0,12,19,31,4,21,21,10,1,51,0
19130,447535,503_15_61,TURKEY,0,TOTALS,TURKEY,200,18,62,29.0,15,41,36.6,3,21,14.3,9,10,90.0,11,22,33,7,20,16,12,3,48,0
19131,447548,503_15_61,SPAIN,0,TOTALS,SPAIN,200,20,55,36.4,15,32,46.9,5,23,21.7,12,18,66.7,16,29,45,12,14,21,12,4,57,1
19132,447561,503_15_62,CROATIA,0,TOTALS,CROATIA,200,31,54,57.4,23,37,62.2,8,17,47.1,11,17,64.7,8,29,37,3,18,15,4,2,81,1
19133,447574,503_15_62,BULGARIA,0,TOTALS,BULGARIA,200,18,60,30.0,14,41,34.1,4,19,21.1,9,15,60.0,11,19,30,3,18,13,7,0,49,0
19134,447587,503_15_63,LITHUANIA,0,TOTALS,LITHUANIA,200,26,60,43.3,18,38,47.4,8,22,36.4,10,16,62.5,16,40,56,12,16,21,7,4,70,1
19135,447600,503_15_63,UKRAINE,0,TOTALS,UKRAINE,200,25,69,36.2,21,49,42.9,4,20,20.0,3,7,42.9,11,21,32,9,19,11,11,0,57,0
19136,447613,503_15_64,BELGIUM,0,TOTALS,BELGIUM,200,23,64,35.9,16,37,43.2,7,27,25.9,13,22,59.1,11,28,39,13,18,9,7,3,66,0
19137,447626,503_15_64,LATVIA,0,TOTALS,LATVIA,200,31,73,42.5,23,50,46.0,8,23,34.8,5,11,45.5,17,34,51,14,21,13,7,2,75,1
19138,447639,503_15_65,RUSSIA,0,TOTALS,RUSSIA,200,26,49,53.1,20,40,50.0,6,9,66.7,22,31,71.0,5,29,34,11,18,19,5,4,80,1
19139,447652,503_15_65,GREAT BRITAIN,0,TOTALS,GREAT BRITAIN,200,26,69,37.7,19,52,36.5,7,17,41.2,14,19,73.7,14,22,36,7,24,14,9,3,73,0
19140,447665,503_15_66,CZECH REPUBLIC,0,TOTALS,CZECH REPUBLIC,200,26,65,40.0,16,36,44.4,10,29,34.5,9,14,64.3,9,25,34,8,21,12,5,1,71,0
19141,447678,503_15_66,GERMANY,0,TOTALS,GERMANY,200,28,66,42.4,22,44,50.0,6,22,27.3,12,19,63.2,12,32,44,10,19,12,4,4,74,1
19142,447691,503_15_67,SERBIA,0,TOTALS,SERBIA,200,24,53,45.3,18,34,52.9,6,19,31.6,10,21,47.6,11,26,37,14,22,20,9,1,64,1
19143,447704,503_15_67,FRANCE,0,TOTALS,FRANCE,200,20,63,31.7,15,37,40.5,5,26,19.2,8,15,53.3,19,21,40,8,23,16,10,1,53,0
19144,447717,503_15_68,BOSNIA AND HERZEGOVINA,0,TOTALS,BOSNIA AND HERZEGOVINA,200,18,66,27.3,12,34,35.3,6,32,18.8,14,21,66.7,12,31,43,8,20,13,4,2,56,0
19145,447730,503_15_68,GREECE,0,TOTALS,GREECE,200,30,67,44.8,25,44,56.8,5,23,21.7,10,20,50.0,11,35,46,10,23,9,5,2,75,1
19146,447742,503_15_69,POLAND,0,TOTALS,POLAND,200,20,52,38.5,14,32,43.8,6,20,30.0,12,18,66.7,5,37,42,8,22,15,4,3,58,1
19147,447755,503_15_69,SLOVENIA,0,TOTALS,SLOVENIA,200,16,64,25.0,10,39,25.6,6,25,24.0,12,19,63.2,14,28,42,5,19,13,2,4,50,0
19148,447768,503_15_70,ISRAEL,0,TOTALS,ISRAEL,200,25,63,39.7,22,50,44.0,3,13,23.1,11,20,55.0,17,27,44,10,22,21,11,3,64,0
19149,447781,503_15_70,ITALY,0,TOTALS,ITALY,200,29,63,46.0,18,38,47.4,11,25,44.0,6,14,42.9,10,24,34,12,20,18,12,6,75,1
19150,447793,503_15_71,FRANCE,0,TOTALS,FRANCE,200,29,59,49.2,23,41,56.1,6,18,33.3,16,22,72.7,16,25,41,16,22,17,6,4,80,1
19151,447806,503_15_71,CZECH REPUBLIC,0,TOTALS,CZECH REPUBLIC,200,20,51,39.2,14,32,43.8,6,19,31.6,12,20,60.0,6,16,22,14,20,14,9,2,58,0
19152,447819,503_15_72,CROATIA,0,TOTALS,CROATIA,200,29,70,41.4,20,47,42.6,9,23,39.1,9,18,50.0,13,37,50,13,10,10,9,1,76,1
19153,447832,503_15_72,BOSNIA AND HERZEGOVINA,0,TOTALS,BOSNIA AND HERZEGOVINA,200,19,59,32.2,13,35,37.1,6,24,25.0,1,4,25.0,3,31,34,12,18,14,3,3,45,0
19154,447845,503_15_73,GERMANY,0,TOTALS,GERMANY,200,16,57,28.1,14,36,38.9,2,21,9.5,12,22,54.5,16,32,48,8,20,21,4,1,46,0
19155,447858,503_15_73,ISRAEL,0,TOTALS,ISRAEL,200,21,58,36.2,14,39,35.9,7,19,36.8,5,15,33.3,9,29,38,6,21,16,13,4,54,1
19156,447871,503_15_74,SPAIN,0,TOTALS,SPAIN,200,25,69,36.2,21,54,38.9,4,15,26.7,13,19,68.4,16,35,51,10,19,14,6,7,67,1
19157,447884,503_15_74,BELGIUM,0,TOTALS,BELGIUM,200,19,71,26.8,15,48,31.2,4,23,17.4,13,14,92.9,17,25,42,10,22,13,7,3,55,0
19158,447897,503_15_75,GREECE,0,TOTALS,GREECE,200,26,54,48.1,18,31,58.1,8,23,34.8,14,21,66.7,11,27,38,19,15,19,6,8,74,1
19159,447910,503_15_75,BULGARIA,0,TOTALS,BULGARIA,200,26,65,40.0,18,42,42.9,8,23,34.8,7,11,63.6,13,19,32,8,21,15,12,3,67,0
19160,447923,503_15_76,ITALY,0,TOTALS,ITALY,200,30,65,46.2,25,44,56.8,5,21,23.8,8,13,61.5,12,23,35,9,19,11,14,1,73,1
19161,447936,503_15_76,UKRAINE,0,TOTALS,UKRAINE,200,18,52,34.6,14,32,43.8,4,20,20.0,8,14,57.1,11,26,37,8,18,22,8,2,48,0
19162,447949,503_15_77,TURKEY,0,TOTALS,TURKEY,200,28,74,37.8,19,39,48.7,9,35,25.7,7,13,53.8,17,23,40,14,19,12,14,1,72,1
19163,447962,503_15_77,LATVIA,0,TOTALS,LATVIA,200,19,49,38.8,10,24,41.7,9,25,36.0,11,18,61.1,11,29,40,7,15,20,1,0,58,0
19164,447974,503_15_78,RUSSIA,0,TOTALS,RUSSIA,200,22,63,34.9,18,50,36.0,4,13,30.8,17,29,58.6,15,21,36,12,21,17,8,2,65,0
19165,447986,503_15_78,SLOVENIA,0,TOTALS,SLOVENIA,200,30,60,50.0,22,37,59.5,8,23,34.8,10,13,76.9,9,33,42,13,25,20,8,1,78,1
19166,447999,503_15_79,SERBIA,0,TOTALS,SERBIA,200,25,63,39.7,16,46,34.8,9,17,52.9,23,27,85.2,16,24,40,14,16,17,13,3,82,1
19167,448012,503_15_79,LITHUANIA,0,TOTALS,LITHUANIA,200,27,59,45.8,17,32,53.1,10,27,37.0,5,9,55.6,11,22,33,14,25,23,9,4,69,0
19168,448024,503_15_80,POLAND,0,TOTALS,POLAND,225,31,73,42.5,19,38,50.0,12,35,34.3,12,17,70.6,15,25,40,15,23,18,3,1,86,1
19169,448037,503_15_80,GREAT BRITAIN,0,TOTALS,GREAT BRITAIN,225,29,66,43.9,23,45,51.1,6,21,28.6,20,27,74.1,12,27,39,22,19,21,7,4,84,0
19170,448050,503_15_81,BELGIUM,0,TOTALS,BELGIUM,200,32,75,42.7,23,47,48.9,9,28,32.1,8,14,57.1,16,17,33,10,15,9,10,1,81,0
19171,448063,503_15_81,CZECH REPUBLIC,0,TOTALS,CZECH REPUBLIC,200,41,64,64.1,35,50,70.0,6,14,42.9,8,12,66.7,7,29,36,21,16,11,4,7,96,1
19172,448076,503_15_82,BOSNIA AND HERZEGOVINA,0,TOTALS,BOSNIA AND HERZEGOVINA,225,34,71,47.9,24,44,54.5,10,27,37.0,10,14,71.4,12,31,43,14,23,17,6,2,88,1
19173,448089,503_15_82,BULGARIA,0,TOTALS,BULGARIA,225,24,64,37.5,18,37,48.6,6,27,22.2,24,28,85.7,8,25,33,13,18,15,9,1,78,0
19174,448102,503_15_83,LITHUANIA,0,TOTALS,LITHUANIA,225,30,68,44.1,21,41,51.2,9,27,33.3,11,18,61.1,14,28,42,14,23,15,5,3,80,0
19175,448115,503_15_83,LATVIA,0,TOTALS,LATVIA,225,30,77,39.0,22,54,40.7,8,23,34.8,14,21,66.7,21,23,44,10,20,13,9,2,82,1
19176,448127,503_15_84,CROATIA,0,TOTALS,CROATIA,200,22,57,38.6,15,33,45.5,7,24,29.2,12,16,75.0,17,28,45,12,17,18,5,3,63,1
19177,448140,503_15_84,GREECE,0,TOTALS,GREECE,200,19,55,34.5,13,28,46.4,6,27,22.2,8,15,53.3,12,18,30,10,18,18,6,4,52,0
19178,448153,503_15_85,SPAIN,0,TOTALS,SPAIN,200,19,50,38.0,13,37,35.1,6,13,46.2,26,37,70.3,12,27,39,9,21,15,8,1,70,1
19179,448166,503_15_85,FRANCE,0,TOTALS,FRANCE,200,20,60,33.3,15,38,39.5,5,22,22.7,16,23,69.6,17,24,41,6,31,15,8,4,61,0
19180,448179,503_15_86,SERBIA,0,TOTALS,SERBIA,200,30,62,48.4,21,39,53.8,9,23,39.1,12,18,66.7,14,27,41,11,22,14,9,2,81,1
19181,448192,503_15_86,TURKEY,0,TOTALS,TURKEY,200,22,56,39.3,17,29,58.6,5,27,18.5,9,14,64.3,9,21,30,11,20,15,8,2,58,0
19182,448204,503_15_87,RUSSIA,0,TOTALS,RUSSIA,200,25,72,34.7,17,47,36.2,8,25,32.0,4,4,100.0,15,27,42,12,15,16,0,7,62,0
19183,448217,503_15_87,GREAT BRITAIN,0,TOTALS,GREAT BRITAIN,200,37,75,49.3,32,58,55.2,5,17,29.4,7,11,63.6,10,32,42,19,9,8,7,5,86,1
19184,448230,503_15_88,LITHUANIA,0,TOTALS,LITHUANIA,200,28,65,43.1,20,46,43.5,8,19,42.1,13,15,86.7,11,30,41,12,18,11,7,2,77,1
19185,448242,503_15_88,BELGIUM,0,TOTALS,BELGIUM,200,26,62,41.9,20,36,55.6,6,26,23.1,12,18,66.7,10,27,37,15,16,13,4,5,70,0
19186,448255,503_15_89,UKRAINE,0,TOTALS,UKRAINE,200,24,64,37.5,16,29,55.2,8,35,22.9,6,7,85.7,10,27,37,10,17,11,5,0,62,0
19187,448268,503_15_89,GERMANY,0,TOTALS,GERMANY,200,29,67,43.3,26,50,52.0,3,17,17.6,11,14,78.6,10,31,41,13,12,10,5,2,72,1
19188,448281,503_15_90,SLOVENIA,0,TOTALS,SLOVENIA,200,32,71,45.1,26,50,52.0,6,21,28.6,16,19,84.2,15,37,52,17,22,12,7,0,86,1
19189,448294,503_15_90,POLAND,0,TOTALS,POLAND,200,14,52,26.9,7,26,26.9,7,26,26.9,8,16,50.0,4,25,29,6,23,18,3,0,43,0
19190,448307,503_15_91,LATVIA,0,TOTALS,LATVIA,200,29,72,40.3,24,44,54.5,5,28,17.9,14,16,87.5,14,35,49,19,20,13,3,1,77,1
19191,448320,503_15_91,CZECH REPUBLIC,0,TOTALS,CZECH REPUBLIC,200,25,69,36.2,22,41,53.7,3,28,10.7,13,14,92.9,10,30,40,8,19,13,6,4,66,0
19192,448333,503_15_92,ITALY,0,TOTALS,ITALY,200,27,62,43.5,20,39,51.3,7,23,30.4,16,27,59.3,7,26,33,11,19,9,8,1,77,1
19193,448346,503_15_92,ISRAEL,0,TOTALS,ISRAEL,200,28,63,44.4,24,49,49.0,4,14,28.6,9,15,60.0,11,31,42,5,25,21,6,1,69,0
19194,448359,503_15_93,TURKEY,0,TOTALS,TURKEY,200,26,52,50.0,19,36,52.8,7,16,43.8,25,29,86.2,13,23,36,11,25,18,9,3,84,1
19195,448372,503_15_93,FRANCE,0,TOTALS,FRANCE,200,28,64,43.8,21,46,45.7,7,18,38.9,11,20,55.0,18,16,34,13,29,15,6,6,74,0
19196,448385,503_15_94,SERBIA,0,TOTALS,SERBIA,200,23,68,33.8,13,41,31.7,10,27,37.0,14,18,77.8,18,29,47,4,23,10,7,6,70,1
19197,448398,503_15_94,SPAIN,0,TOTALS,SPAIN,200,22,61,36.1,15,36,41.7,7,25,28.0,13,18,72.2,11,29,40,10,21,10,5,4,64,0
19198,448411,504_15_01,AUSTRIA,0,TOTALS,AUSTRIA,200,33,75,44.0,27,51,52.9,6,24,25.0,12,16,75.0,17,21,38,25,19,17,7,5,84,1
19199,448424,504_15_01,ROMANIA,0,TOTALS,ROMANIA,200,25,62,40.3,17,41,41.5,8,21,38.1,21,23,91.3,15,27,42,12,22,22,8,3,79,0
19200,448437,504_15_02,ARMENIA,0,TOTALS,ARMENIA,200,27,60,45.0,19,38,50.0,8,22,36.4,9,20,45.0,8,29,37,20,19,21,14,1,71,1
19201,448449,504_15_02,SWITZERLAND,0,TOTALS,SWITZERLAND,200,24,67,35.8,21,43,48.8,3,24,12.5,6,11,54.5,16,30,46,11,20,22,8,3,57,0
19202,448462,504_15_03,LUXEMBOURG,0,TOTALS,LUXEMBOURG,200,25,70,35.7,20,41,48.8,5,29,17.2,7,10,70.0,17,19,36,11,23,12,7,1,62,0
19203,448475,504_15_03,MONTENEGRO,0,TOTALS,MONTENEGRO,200,23,50,46.0,17,31,54.8,6,19,31.6,18,25,72.0,11,28,39,10,16,16,7,5,70,1
19204,448488,504_15_04,SLOVAK REPUBLIC,0,TOTALS,SLOVAK REPUBLIC,200,23,56,41.1,18,37,48.6,5,19,26.3,11,15,73.3,9,21,30,13,23,12,6,0,62,0
19205,448501,504_15_04,SWEDEN,0,TOTALS,SWEDEN,200,29,59,49.2,20,33,60.6,9,26,34.6,18,23,78.3,13,27,40,14,17,11,7,2,85,1
19206,448514,504_15_05,BELARUS,0,TOTALS,BELARUS,200,27,73,37.0,19,46,41.3,8,27,29.6,10,18,55.6,18,24,42,21,21,15,9,1,72,0
19207,448525,504_15_05,MKD,0,TOTALS,MKD,200,27,62,43.5,19,38,50.0,8,24,33.3,15,21,71.4,14,31,45,18,21,19,6,4,77,1
19208,448538,504_15_06,HUNGARY,0,TOTALS,HUNGARY,200,42,81,51.9,34,50,68.0,8,31,25.8,8,18,44.4,23,33,56,19,14,7,13,7,100,0
19209,448549,504_15_06,MOLDOVA,0,TOTALS,MOLDOVA,200,14,57,24.6,11,36,30.6,3,21,14.3,4,5,80.0,14,21,35,5,18,22,4,1,35,1
19210,448562,504_15_07,FINLAND,0,TOTALS,FINLAND,200,28,72,38.9,20,46,43.5,8,26,30.8,4,6,66.7,17,25,42,13,17,18,8,1,68,1
19211,448575,504_15_07,NETHERLANDS,0,TOTALS,NETHERLANDS,200,18,50,36.0,16,40,40.0,2,10,20.0,16,22,72.7,9,28,37,13,14,22,11,0,54,0
19212,448588,504_15_08,PORTUGAL,0,TOTALS,PORTUGAL,200,24,56,42.9,18,31,58.1,6,25,24.0,11,18,61.1,10,30,40,19,20,18,7,6,65,1
19213,448601,504_15_08,KOSOVO,0,TOTALS,KOSOVO,200,15,60,25.0,12,45,26.7,3,15,20.0,17,21,81.0,16,26,42,13,22,17,10,1,50,0
19214,448614,504_15_09,GEORGIA,0,TOTALS,GEORGIA,200,26,75,34.7,18,41,43.9,8,34,23.5,15,20,75.0,14,24,38,12,18,15,11,3,75,0
19215,448627,504_15_09,LUXEMBOURG,0,TOTALS,LUXEMBOURG,200,36,71,50.7,24,49,49.0,12,22,54.5,14,20,70.0,15,37,52,16,19,20,11,4,98,1
19216,448640,504_15_10,ALBANIA,0,TOTALS,ALBANIA,200,27,57,47.4,21,38,55.3,6,19,31.6,11,22,50.0,10,25,35,14,24,25,9,3,71,0
19217,448653,504_15_10,SLOVAK REPUBLIC,0,TOTALS,SLOVAK REPUBLIC,200,30,64,46.9,14,27,51.9,16,37,43.2,13,22,59.1,11,25,36,22,20,19,15,1,89,1
19218,448666,504_15_11,SWEDEN,0,TOTALS,SWEDEN,200,24,61,39.3,21,43,48.8,3,18,16.7,10,13,76.9,11,25,36,9,18,12,11,3,61,1
19219,448679,504_15_11,HUNGARY,0,TOTALS,HUNGARY,200,19,54,35.2,16,30,53.3,3,24,12.5,11,16,68.8,8,28,36,6,18,16,6,5,52,0
19220,448692,504_15_12,MONTENEGRO,0,TOTALS,MONTENEGRO,200,24,49,49.0,17,32,53.1,7,17,41.2,14,22,63.6,6,33,39,12,20,19,4,4,69,1
19221,448705,504_15_12,PORTUGAL,0,TOTALS,PORTUGAL,200,19,61,31.1,17,41,41.5,2,20,10.0,8,11,72.7,9,20,29,8,23,15,6,3,48,0
19222,448718,504_15_13,NETHERLANDS,0,TOTALS,NETHERLANDS,200,16,53,30.2,13,38,34.2,3,15,20.0,25,32,78.1,11,28,39,13,21,14,6,2,60,1
19223,448731,504_15_13,AUSTRIA,0,TOTALS,AUSTRIA,200,18,58,31.0,14,34,41.2,4,24,16.7,16,23,69.6,13,28,41,16,26,17,5,3,56,0
19224,448742,504_15_14,MKD,0,TOTALS,MKD,200,30,63,47.6,28,47,59.6,2,16,12.5,19,35,54.3,19,35,54,12,23,21,9,0,81,1
19225,448755,504_15_14,ARMENIA,0,TOTALS,ARMENIA,200,15,70,21.4,13,51,25.5,2,19,10.5,13,17,76.5,21,23,44,2,26,26,9,3,45,0
19226,448768,504_15_15,PORTUGAL,0,TOTALS,PORTUGAL,200,18,59,30.5,14,36,38.9,4,23,17.4,17,23,73.9,15,35,50,10,21,18,9,4,57,1
19227,448781,504_15_15,GEORGIA,0,TOTALS,GEORGIA,200,19,61,31.1,14,37,37.8,5,24,20.8,12,16,75.0,7,29,36,9,23,13,3,5,55,0
19228,448792,504_15_16,MOLDOVA,0,TOTALS,MOLDOVA,200,15,55,27.3,12,41,29.3,3,14,21.4,8,13,61.5,8,24,32,8,22,24,2,0,41,0
19229,448805,504_15_16,SWEDEN,0,TOTALS,SWEDEN,200,39,80,48.8,32,48,66.7,7,32,21.9,11,15,73.3,18,30,48,28,11,5,15,7,96,1
19230,448817,504_15_17,SWITZERLAND,0,TOTALS,SWITZERLAND,200,28,57,49.1,26,46,56.5,2,11,18.2,6,7,85.7,8,23,31,10,20,24,11,4,64,0
19231,448830,504_15_17,BELARUS,0,TOTALS,BELARUS,200,29,63,46.0,25,41,61.0,4,22,18.2,12,13,92.3,11,21,32,18,14,17,15,3,74,1
19232,448843,504_15_18,HUNGARY,0,TOTALS,HUNGARY,200,29,58,50.0,24,39,61.5,5,19,26.3,18,32,56.2,13,25,38,19,20,11,10,6,81,1
19233,448856,504_15_18,ALBANIA,0,TOTALS,ALBANIA,200,19,60,31.7,18,50,36.0,1,10,10.0,13,19,68.4,13,20,33,10,25,16,4,1,52,0
19234,448869,504_15_19,ROMANIA,0,TOTALS,ROMANIA,200,25,57,43.9,20,35,57.1,5,22,22.7,9,15,60.0,12,30,42,16,22,28,6,2,64,0
19235,448882,504_15_19,FINLAND,0,TOTALS,FINLAND,200,32,74,43.2,20,39,51.3,12,35,34.3,13,21,61.9,16,20,36,20,21,12,18,3,89,1
19236,448895,504_15_20,KOSOVO,0,TOTALS,KOSOVO,200,22,60,36.7,17,37,45.9,5,23,21.7,6,7,85.7,6,13,19,8,23,15,8,1,55,0
19237,448908,504_15_20,MONTENEGRO,0,TOTALS,MONTENEGRO,200,38,61,62.3,33,44,75.0,5,17,29.4,13,23,56.5,14,30,44,20,15,15,5,5,94,1
19238,448921,504_15_21,LUXEMBOURG,0,TOTALS,LUXEMBOURG,200,29,60,48.3,24,42,57.1,5,18,27.8,19,27,70.4,14,33,47,15,17,17,10,2,82,1
19239,448934,504_15_21,PORTUGAL,0,TOTALS,PORTUGAL,200,23,69,33.3,10,32,31.2,13,37,35.1,8,11,72.7,15,18,33,12,23,15,6,1,67,0
19240,448947,504_15_22,ALBANIA,0,TOTALS,ALBANIA,200,27,73,37.0,25,59,42.4,2,14,14.3,21,30,70.0,21,24,45,12,16,16,19,2,77,1
19241,448958,504_15_22,MOLDOVA,0,TOTALS,MOLDOVA,200,17,53,32.1,9,29,31.0,8,24,33.3,11,18,61.1,13,28,41,12,23,32,5,4,53,0
19242,448971,504_15_23,SLOVAK REPUBLIC,0,TOTALS,SLOVAK REPUBLIC,225,27,70,38.6,16,36,44.4,11,34,32.4,20,37,54.1,19,32,51,12,30,13,6,3,85,1
19243,448984,504_15_23,HUNGARY,0,TOTALS,HUNGARY,225,32,72,44.4,24,44,54.5,8,28,28.6,29,36,80.6,14,30,44,9,28,10,7,5,101,0
19244,448997,504_15_24,GEORGIA,0,TOTALS,GEORGIA,200,24,63,38.1,14,33,42.4,10,30,33.3,7,14,50.0,14,37,51,18,24,26,7,9,65,0
19245,449010,504_15_24,KOSOVO,0,TOTALS,KOSOVO,200,29,81,35.8,25,61,41.0,4,20,20.0,15,24,62.5,20,28,48,10,19,12,10,2,77,1
19246,449021,504_15_25,MOLDOVA,0,TOTALS,MOLDOVA,200,26,72,36.1,19,40,47.5,7,32,21.9,6,8,75.0,13,24,37,13,19,24,8,1,65,1
19247,449034,504_15_25,SLOVAK REPUBLIC,0,TOTALS,SLOVAK REPUBLIC,200,41,69,59.4,29,41,70.7,12,28,42.9,12,19,63.2,7,30,37,27,12,13,19,4,106,0
19248,449047,504_15_26,SWEDEN,0,TOTALS,SWEDEN,200,38,67,56.7,32,50,64.0,6,17,35.3,15,18,83.3,11,26,37,23,18,9,9,3,97,1
19249,449060,504_15_26,ALBANIA,0,TOTALS,ALBANIA,200,17,56,30.4,13,38,34.2,4,18,22.2,12,16,75.0,11,20,31,4,18,19,4,5,50,0
19250,449073,504_15_27,AUSTRIA,0,TOTALS,AUSTRIA,200,26,62,41.9,17,43,39.5,9,19,47.4,9,14,64.3,12,22,34,21,22,17,8,0,70,0
19251,449086,504_15_27,FINLAND,0,TOTALS,FINLAND,200,30,58,51.7,20,29,69.0,10,29,34.5,15,19,78.9,7,26,33,17,17,15,10,3,85,1
19252,449099,504_15_28,ARMENIA,0,TOTALS,ARMENIA,200,19,65,29.2,15,49,30.6,4,16,25.0,7,11,63.6,12,23,35,12,17,26,11,1,49,0
19253,449112,504_15_28,BELARUS,0,TOTALS,BELARUS,200,30,60,50.0,21,40,52.5,9,20,45.0,19,20,95.0,8,36,44,21,16,22,15,6,88,1
19254,449125,504_15_29,KOSOVO,0,TOTALS,KOSOVO,200,28,69,40.6,18,40,45.0,10,29,34.5,6,9,66.7,11,24,35,8,17,15,5,3,72,0
19255,449138,504_15_29,LUXEMBOURG,0,TOTALS,LUXEMBOURG,200,36,81,44.4,26,58,44.8,10,23,43.5,9,12,75.0,21,29,50,21,14,12,8,2,91,1
19256,449151,504_15_30,MONTENEGRO,0,TOTALS,MONTENEGRO,200,40,64,62.5,34,53,64.2,6,11,54.5,14,17,82.4,11,29,40,19,21,18,15,1,100,0
19257,449164,504_15_30,GEORGIA,0,TOTALS,GEORGIA,200,23,62,37.1,18,37,48.6,5,25,20.0,8,17,47.1,11,16,27,9,19,21,9,2,59,1
19258,449177,504_15_31,NETHERLANDS,0,TOTALS,NETHERLANDS,200,33,65,50.8,26,46,56.5,7,19,36.8,7,11,63.6,8,25,33,12,17,13,12,0,80,1
19259,449190,504_15_31,ROMANIA,0,TOTALS,ROMANIA,200,19,52,36.5,14,30,46.7,5,22,22.7,11,13,84.6,8,25,33,7,18,21,5,2,54,0
19260,449201,504_15_32,MKD,0,TOTALS,MKD,200,27,78,34.6,19,48,39.6,8,30,26.7,11,13,84.6,25,27,52,17,23,19,11,2,73,1
19261,449213,504_15_32,SWITZERLAND,0,TOTALS,SWITZERLAND,200,21,54,38.9,14,34,41.2,7,20,35.0,14,22,63.6,9,26,35,10,13,21,7,8,63,0
19262,449226,504_15_33,FINLAND,0,TOTALS,FINLAND,200,34,74,45.9,18,37,48.6,16,37,43.2,17,29,58.6,22,27,49,19,20,15,4,1,101,0
19263,449239,504_15_33,LUXEMBOURG,0,TOTALS,LUXEMBOURG,200,29,67,43.3,21,47,44.7,8,20,40.0,17,21,81.0,10,24,34,13,27,9,6,1,83,1
19264,449252,504_15_34,KOSOVO,0,TOTALS,KOSOVO,200,33,70,47.1,25,48,52.1,8,22,36.4,7,9,77.8,14,18,32,22,19,13,13,2,81,1
19265,449265,504_15_34,ROMANIA,0,TOTALS,ROMANIA,200,24,54,44.4,17,34,50.0,7,20,35.0,14,17,82.4,13,21,34,18,21,22,5,1,69,0
19266,449278,504_15_35,NETHERLANDS,0,TOTALS,NETHERLANDS,200,19,51,37.3,16,41,39.0,3,10,30.0,14,23,60.9,5,22,27,7,24,10,5,2,55,0
19267,449291,504_15_35,MONTENEGRO,0,TOTALS,MONTENEGRO,200,23,54,42.6,17,35,48.6,6,19,31.6,16,27,59.3,10,31,41,11,26,13,5,7,68,1
19268,449304,504_15_36,AUSTRIA,0,TOTALS,AUSTRIA,200,25,67,37.3,18,45,40.0,7,22,31.8,10,13,76.9,10,36,46,17,18,24,4,3,67,0
19269,449317,504_15_36,GEORGIA,0,TOTALS,GEORGIA,200,35,78,44.9,24,50,48.0,11,28,39.3,10,17,58.8,10,30,40,21,18,11,17,3,91,1
19270,449328,504_15_37,MKD,0,TOTALS,MKD,200,21,56,37.5,16,35,45.7,5,21,23.8,7,14,50.0,12,27,39,10,20,22,4,4,54,0
19271,449341,504_15_37,HUNGARY,0,TOTALS,HUNGARY,200,23,58,39.7,19,38,50.0,4,20,20.0,13,17,76.5,8,23,31,12,20,15,9,0,63,1
19272,449354,504_15_38,ALBANIA,0,TOTALS,ALBANIA,200,18,51,35.3,10,27,37.0,8,24,33.3,7,12,58.3,8,27,35,7,21,24,8,5,51,0
19273,449366,504_15_38,SWITZERLAND,0,TOTALS,SWITZERLAND,200,22,65,33.8,17,48,35.4,5,17,29.4,14,20,70.0,19,27,46,14,16,19,14,4,63,1
19274,449379,504_15_39,BELARUS,0,TOTALS,BELARUS,200,25,57,43.9,21,39,53.8,4,18,22.2,11,13,84.6,14,29,43,10,18,15,5,4,65,0
19275,449392,504_15_39,SWEDEN,0,TOTALS,SWEDEN,200,33,74,44.6,23,42,54.8,10,32,31.2,6,11,54.5,13,21,34,25,18,10,7,4,82,1
19276,449405,504_15_40,ARMENIA,0,TOTALS,ARMENIA,200,31,66,47.0,29,48,60.4,2,18,11.1,17,31,54.8,15,30,45,15,20,22,20,5,81,1
19277,449416,504_15_40,MOLDOVA,0,TOTALS,MOLDOVA,200,20,59,33.9,16,39,41.0,4,20,20.0,11,16,68.8,10,26,36,11,24,33,8,2,55,0
19278,449429,504_15_41,LUXEMBOURG,0,TOTALS,LUXEMBOURG,200,21,59,35.6,16,41,39.0,5,18,27.8,14,16,87.5,12,25,37,9,19,15,3,3,61,0
19279,449442,504_15_41,NETHERLANDS,0,TOTALS,NETHERLANDS,200,30,71,42.3,19,44,43.2,11,27,40.7,15,19,78.9,18,23,41,12,18,9,7,5,86,1
19280,449455,504_15_42,ROMANIA,0,TOTALS,ROMANIA,200,27,76,35.5,24,48,50.0,3,28,10.7,17,26,65.4,18,21,39,6,23,15,11,2,74,0
19281,449468,504_15_42,GEORGIA,0,TOTALS,GEORGIA,200,32,61,52.5,21,38,55.3,11,23,47.8,19,23,82.6,11,32,43,17,21,22,8,5,94,1
19282,449481,504_15_43,SWEDEN,0,TOTALS,SWEDEN,200,23,56,41.1,18,37,48.6,5,19,26.3,13,18,72.2,10,29,39,14,21,19,11,5,64,1
19283,449492,504_15_43,MKD,0,TOTALS,MKD,200,23,60,38.3,18,40,45.0,5,20,25.0,10,19,52.6,12,28,40,9,21,18,13,3,61,0
19284,449505,504_15_44,PORTUGAL,0,TOTALS,PORTUGAL,200,21,54,38.9,14,37,37.8,7,17,41.2,17,23,73.9,13,32,45,9,23,19,9,9,66,1
19285,449518,504_15_44,AUSTRIA,0,TOTALS,AUSTRIA,200,12,56,21.4,7,35,20.0,5,21,23.8,26,31,83.9,14,24,38,8,21,14,8,2,55,0
19286,449531,504_15_45,HUNGARY,0,TOTALS,HUNGARY,200,27,62,43.5,18,36,50.0,9,26,34.6,17,21,81.0,14,13,27,15,18,8,2,0,80,0
19287,449544,504_15_45,BELARUS,0,TOTALS,BELARUS,200,33,62,53.2,25,44,56.8,8,18,44.4,9,13,69.2,17,21,38,15,15,10,5,4,83,1
19288,449556,504_15_46,SWITZERLAND,0,TOTALS,SWITZERLAND,200,41,79,51.9,37,59,62.7,4,20,20.0,9,10,90.0,22,28,50,20,14,25,22,4,95,1
19289,449567,504_15_46,MOLDOVA,0,TOTALS,MOLDOVA,200,18,53,34.0,11,24,45.8,7,29,24.1,3,4,75.0,8,15,23,2,15,36,11,2,46,0
19290,449580,504_15_47,MONTENEGRO,0,TOTALS,MONTENEGRO,200,25,54,46.3,23,42,54.8,2,12,16.7,13,20,65.0,9,24,33,8,27,17,6,1,65,0
19291,449593,504_15_47,FINLAND,0,TOTALS,FINLAND,200,30,68,44.1,19,36,52.8,11,32,34.4,16,25,64.0,17,21,38,16,22,13,8,3,87,1
19292,449606,504_15_48,SLOVAK REPUBLIC,0,TOTALS,SLOVAK REPUBLIC,200,36,68,52.9,25,43,58.1,11,25,44.0,22,35,62.9,15,42,57,20,28,22,7,2,105,0
19293,449619,504_15_48,ARMENIA,0,TOTALS,ARMENIA,200,31,83,37.3,25,64,39.1,6,19,31.6,17,31,54.8,15,22,37,16,26,12,11,4,85,1
19294,449632,504_15_49,ARMENIA,0,TOTALS,ARMENIA,200,27,60,45.0,22,49,44.9,5,11,45.5,21,30,70.0,12,25,37,21,12,13,13,4,80,1
19295,449645,504_15_49,ALBANIA,0,TOTALS,ALBANIA,200,22,65,33.8,20,54,37.0,2,11,18.2,5,6,83.3,17,24,41,9,20,25,6,3,51,0
19296,449658,504_15_50,NETHERLANDS,0,TOTALS,NETHERLANDS,200,23,55,41.8,14,33,42.4,9,22,40.9,13,17,76.5,9,25,34,14,24,15,9,1,68,1
19297,449669,504_15_50,MKD,0,TOTALS,MKD,200,16,54,29.6,13,34,38.2,3,20,15.0,12,19,63.2,16,26,42,5,20,22,5,1,47,0
19298,449682,504_15_51,SLOVAK REPUBLIC,0,TOTALS,SLOVAK REPUBLIC,200,27,58,46.6,15,30,50.0,12,28,42.9,17,21,81.0,12,28,40,12,18,12,5,2,83,1
19299,449694,504_15_51,SWITZERLAND,0,TOTALS,SWITZERLAND,200,25,68,36.8,20,45,44.4,5,23,21.7,12,18,66.7,19,20,39,14,20,12,6,8,67,0
19300,449707,504_15_52,BELARUS,0,TOTALS,BELARUS,200,34,68,50.0,27,40,67.5,7,28,25.0,14,19,73.7,13,35,48,25,14,17,10,2,89,1
19301,449720,504_15_52,LUXEMBOURG,0,TOTALS,LUXEMBOURG,200,22,66,33.3,20,47,42.6,2,19,10.5,14,15,93.3,8,22,30,10,16,16,7,1,60,0
19302,449733,504_15_53,AUSTRIA,0,TOTALS,AUSTRIA,200,24,62,38.7,17,37,45.9,7,25,28.0,12,19,63.2,14,29,43,13,21,18,8,1,67,1
19303,449746,504_15_53,KOSOVO,0,TOTALS,KOSOVO,200,26,60,43.3,26,50,52.0,0,10,0.0,12,18,66.7,7,27,34,8,21,13,12,2,64,0
19304,449759,504_15_54,FINLAND,0,TOTALS,FINLAND,200,20,58,34.5,13,29,44.8,7,29,24.1,22,25,88.0,13,25,38,11,20,12,8,2,69,1
19305,449772,504_15_54,HUNGARY,0,TOTALS,HUNGARY,200,20,54,37.0,14,33,42.4,6,21,28.6,12,16,75.0,9,25,34,9,24,17,4,1,58,0
19306,449785,504_15_55,PORTUGAL,0,TOTALS,PORTUGAL,200,17,65,26.2,13,37,35.1,4,28,14.3,12,16,75.0,15,27,42,9,23,14,13,3,50,0
19307,449798,504_15_55,ROMANIA,0,TOTALS,ROMANIA,200,21,57,36.8,17,33,51.5,4,24,16.7,13,22,59.1,14,33,47,13,22,15,8,1,59,1
19308,449811,504_15_56,SWEDEN,0,TOTALS,SWEDEN,200,28,58,48.3,20,36,55.6,8,22,36.4,15,26,57.7,14,33,47,12,21,12,7,6,79,1
19309,449824,504_15_56,MONTENEGRO,0,TOTALS,MONTENEGRO,200,18,62,29.0,15,45,33.3,3,17,17.6,11,15,73.3,10,20,30,5,25,10,8,1,50,0
19310,449837,504_15_57,ROMANIA,0,TOTALS,ROMANIA,200,35,65,53.8,25,40,62.5,10,25,40.0,21,28,75.0,12,30,42,22,18,13,16,4,101,0
19311,449848,504_15_57,MOLDOVA,0,TOTALS,MOLDOVA,200,17,59,28.8,10,31,32.3,7,28,25.0,7,14,50.0,14,21,35,11,25,28,4,2,48,1
19312,449861,504_15_58,PORTUGAL,0,TOTALS,PORTUGAL,200,32,70,45.7,25,57,43.9,7,13,53.8,12,15,80.0,18,22,40,13,15,10,15,6,83,1
19313,449874,504_15_58,SLOVAK REPUBLIC,0,TOTALS,SLOVAK REPUBLIC,200,25,56,44.6,12,30,40.0,13,26,50.0,5,10,50.0,12,20,32,15,20,23,3,1,68,0
19314,449887,504_15_59,AUSTRIA,0,TOTALS,AUSTRIA,200,27,56,48.2,24,42,57.1,3,14,21.4,12,19,63.2,12,26,38,12,14,17,7,3,69,1
19315,449900,504_15_59,ALBANIA,0,TOTALS,ALBANIA,200,24,55,43.6,20,42,47.6,4,13,30.8,7,9,77.8,4,20,24,13,21,15,10,3,59,0
19316,449911,504_15_60,MKD,0,TOTALS,MKD,200,28,69,40.6,23,42,54.8,5,27,18.5,25,32,78.1,18,33,51,16,15,18,7,4,86,1
19317,449924,504_15_60,LUXEMBOURG,0,TOTALS,LUXEMBOURG,200,30,69,43.5,23,49,46.9,7,20,35.0,8,11,72.7,7,24,31,18,26,17,13,4,75,0
19318,449937,504_15_61,KOSOVO,0,TOTALS,KOSOVO,200,23,61,37.7,20,48,41.7,3,13,23.1,10,14,71.4,9,19,28,9,20,20,14,1,59,0
19319,449949,504_15_61,SWITZERLAND,0,TOTALS,SWITZERLAND,200,30,64,46.9,21,41,51.2,9,23,39.1,12,18,66.7,16,29,45,13,11,23,7,3,81,1
19320,449962,504_15_62,NETHERLANDS,0,TOTALS,NETHERLANDS,250,31,83,37.3,25,64,39.1,6,19,31.6,10,17,58.8,24,31,55,15,24,17,9,1,78,0
19321,449975,504_15_62,BELARUS,0,TOTALS,BELARUS,250,29,72,40.3,21,44,47.7,8,28,28.6,17,25,68.0,14,30,44,18,18,16,7,7,83,1
19322,449988,504_15_63,GEORGIA,0,TOTALS,GEORGIA,200,32,71,45.1,23,48,47.9,9,23,39.1,15,18,83.3,12,29,41,12,18,15,13,7,88,1
19323,450001,504_15_63,ARMENIA,0,TOTALS,ARMENIA,200,30,80,37.5,27,57,47.4,3,23,13.0,15,20,75.0,22,27,49,15,18,19,7,2,78,0
19324,450014,504_15_64,HUNGARY,0,TOTALS,HUNGARY,200,28,57,49.1,21,42,50.0,7,15,46.7,5,9,55.6,5,19,24,10,16,9,6,0,68,1
19325,450027,504_15_64,MONTENEGRO,0,TOTALS,MONTENEGRO,200,28,57,49.1,24,39,61.5,4,18,22.2,6,11,54.5,11,27,38,18,20,19,8,2,66,0
19326,450040,504_15_65,FINLAND,0,TOTALS,FINLAND,200,30,62,48.4,19,42,45.2,11,20,55.0,9,13,69.2,7,29,36,13,18,12,7,2,80,1
19327,450053,504_15_65,SWEDEN,0,TOTALS,SWEDEN,200,28,68,41.2,19,38,50.0,9,30,30.0,11,13,84.6,9,26,35,15,18,12,6,7,76,0
19328,453101,507_15_01,SPAIN,0,TOTALS,SPAIN,200,23,56,41.1,18,34,52.9,5,22,22.7,7,14,50.0,10,29,39,16,15,18,2,0,58,0
19329,453114,507_15_01,FRANCE,0,TOTALS,FRANCE,200,23,64,35.9,14,33,42.4,9,31,29.0,9,11,81.8,11,25,36,14,18,11,10,2,64,1
19330,453127,507_15_02,FINLAND,0,TOTALS,FINLAND,200,21,57,36.8,12,38,31.6,9,19,47.4,11,14,78.6,9,21,30,15,19,20,9,6,62,0
19331,453140,507_15_02,RUSSIA,0,TOTALS,RUSSIA,200,34,64,53.1,22,42,52.4,12,22,54.5,9,19,47.4,12,27,39,24,17,15,12,2,89,1
19332,453153,507_15_03,BOSNIA AND HERZEGOVINA,0,TOTALS,BOSNIA AND HERZEGOVINA,200,18,57,31.6,17,41,41.5,1,16,6.2,13,22,59.1,10,19,29,7,20,19,16,4,50,0
19333,453166,507_15_03,LITHUANIA,0,TOTALS,LITHUANIA,200,27,64,42.2,23,46,50.0,4,18,22.2,15,18,83.3,18,31,49,19,17,24,13,2,73,1
19334,453179,507_15_04,MONTENEGRO,0,TOTALS,MONTENEGRO,200,23,55,41.8,22,40,55.0,1,15,6.7,14,23,60.9,10,23,33,11,23,21,12,0,61,0
19335,453192,507_15_04,LATVIA,0,TOTALS,LATVIA,200,25,62,40.3,16,32,50.0,9,30,30.0,11,19,57.9,13,27,40,13,24,19,11,3,70,1
19336,453205,507_15_05,CZECH REPUBLIC,0,TOTALS,CZECH REPUBLIC,200,23,70,32.9,12,34,35.3,11,36,30.6,11,15,73.3,14,26,40,16,19,17,12,2,68,1
19337,453218,507_15_05,UKRAINE,0,TOTALS,UKRAINE,200,24,70,34.3,18,39,46.2,6,31,19.4,11,18,61.1,20,32,52,16,21,21,16,3,65,0
19338,453231,507_15_06,ITALY,0,TOTALS,ITALY,200,21,62,33.9,19,46,41.3,2,16,12.5,4,6,66.7,8,25,33,14,18,18,13,4,48,0
19339,453244,507_15_06,TURKEY,0,TOTALS,TURKEY,200,19,61,31.1,17,44,38.6,2,17,11.8,9,13,69.2,17,31,48,10,18,25,13,5,49,1
19340,453257,507_15_07,GREECE,0,TOTALS,GREECE,200,27,69,39.1,24,55,43.6,3,14,21.4,7,10,70.0,11,39,50,15,17,11,12,8,64,1
19341,453270,507_15_07,CROATIA,0,TOTALS,CROATIA,200,15,68,22.1,11,45,24.4,4,23,17.4,7,11,63.6,15,31,46,7,12,16,5,2,41,0
19342,453283,507_15_08,SERBIA,0,TOTALS,SERBIA,200,19,59,32.2,14,38,36.8,5,21,23.8,13,20,65.0,11,34,45,16,22,22,8,4,56,0
19343,453296,507_15_08,GERMANY,0,TOTALS,GERMANY,200,26,69,37.7,19,44,43.2,7,25,28.0,6,18,33.3,16,32,48,12,23,16,14,1,65,1
19344,453309,507_15_09,FRANCE,0,TOTALS,FRANCE,200,28,70,40.0,21,48,43.8,7,22,31.8,12,21,57.1,17,40,57,16,10,14,9,8,75,1
19345,453322,507_15_09,CZECH REPUBLIC,0,TOTALS,CZECH REPUBLIC,200,16,63,25.4,11,36,30.6,5,27,18.5,1,4,25.0,8,29,37,12,17,20,8,3,38,0
19346,453335,507_15_10,TURKEY,0,TOTALS,TURKEY,200,34,67,50.7,29,51,56.9,5,16,31.2,7,14,50.0,10,38,48,21,18,19,10,6,80,1
19347,453348,507_15_10,FINLAND,0,TOTALS,FINLAND,200,21,67,31.3,17,46,37.0,4,21,19.0,17,22,77.3,10,25,35,17,18,16,10,0,63,0
19348,453361,507_15_11,UKRAINE,0,TOTALS,UKRAINE,200,26,63,41.3,18,38,47.4,8,25,32.0,8,12,66.7,13,24,37,21,21,25,9,1,68,0
19349,453374,507_15_11,SPAIN,0,TOTALS,SPAIN,200,24,54,44.4,18,29,62.1,6,25,24.0,16,24,66.7,9,26,35,17,17,21,16,2,70,1
19350,453387,507_15_12,RUSSIA,0,TOTALS,RUSSIA,200,18,50,36.0,14,35,40.0,4,15,26.7,14,25,56.0,7,29,36,8,23,17,8,2,54,0
19351,453400,507_15_12,ITALY,0,TOTALS,ITALY,200,25,68,36.8,20,45,44.4,5,23,21.7,8,17,47.1,16,29,45,12,25,14,11,1,63,1
19352,453413,507_15_13,CROATIA,0,TOTALS,CROATIA,200,25,57,43.9,19,37,51.4,6,20,30.0,21,29,72.4,12,27,39,15,20,23,13,7,77,1
19353,453426,507_15_13,BOSNIA AND HERZEGOVINA,0,TOTALS,BOSNIA AND HERZEGOVINA,200,28,72,38.9,23,56,41.1,5,16,31.2,15,24,62.5,20,21,41,19,24,19,13,2,76,0
19354,453439,507_15_14,GERMANY,0,TOTALS,GERMANY,200,23,63,36.5,19,42,45.2,4,21,19.0,5,11,45.5,16,31,47,13,20,17,6,7,55,0
19355,453452,507_15_14,MONTENEGRO,0,TOTALS,MONTENEGRO,200,21,68,30.9,8,36,22.2,13,32,40.6,9,15,60.0,18,26,44,15,17,13,7,2,64,1
19356,453465,507_15_15,LITHUANIA,0,TOTALS,LITHUANIA,200,26,62,41.9,22,51,43.1,4,11,36.4,14,21,66.7,12,27,39,12,21,11,9,4,70,1
19357,453478,507_15_15,GREECE,0,TOTALS,GREECE,200,22,62,35.5,13,36,36.1,9,26,34.6,11,17,64.7,13,26,39,15,21,18,9,4,64,0
19358,453491,507_15_16,LATVIA,0,TOTALS,LATVIA,200,20,67,29.9,10,33,30.3,10,34,29.4,14,26,53.8,15,28,43,11,23,16,5,2,64,0
19359,453504,507_15_16,SERBIA,0,TOTALS,SERBIA,200,25,65,38.5,21,49,42.9,4,16,25.0,13,22,59.1,15,33,48,13,30,13,7,2,67,1
19360,453517,507_15_17,SPAIN,0,TOTALS,SPAIN,200,26,78,33.3,19,48,39.6,7,30,23.3,2,4,50.0,21,35,56,17,18,17,9,1,61,1
19361,453530,507_15_17,CZECH REPUBLIC,0,TOTALS,CZECH REPUBLIC,200,17,61,27.9,14,41,34.1,3,20,15.0,12,18,66.7,9,31,40,6,17,17,7,0,49,0
19362,453543,507_15_18,RUSSIA,0,TOTALS,RUSSIA,200,21,58,36.2,17,36,47.2,4,22,18.2,12,14,85.7,9,25,34,18,15,16,2,4,58,0
19363,453556,507_15_18,TURKEY,0,TOTALS,TURKEY,200,31,75,41.3,23,56,41.1,8,19,42.1,10,19,52.6,21,29,50,21,18,13,10,5,80,1
19364,453569,507_15_19,ITALY,0,TOTALS,ITALY,200,25,63,39.7,15,35,42.9,10,28,35.7,12,19,63.2,15,29,44,13,25,16,10,6,72,1
19365,453582,507_15_19,FINLAND,0,TOTALS,FINLAND,200,20,64,31.2,12,34,35.3,8,30,26.7,20,25,80.0,15,25,40,15,24,14,7,1,68,0
19366,453595,507_15_20,UKRAINE,0,TOTALS,UKRAINE,200,19,53,35.8,13,30,43.3,6,23,26.1,3,6,50.0,10,16,26,14,12,27,10,3,47,0
19367,453608,507_15_20,FRANCE,0,TOTALS,FRANCE,200,33,69,47.8,26,44,59.1,7,25,28.0,3,9,33.3,23,24,47,15,10,24,17,3,76,1
19368,453621,507_15_21,LITHUANIA,0,TOTALS,LITHUANIA,200,32,77,41.6,28,63,44.4,4,14,28.6,4,7,57.1,17,26,43,17,21,13,9,6,72,1
19369,453634,507_15_21,CROATIA,0,TOTALS,CROATIA,200,26,70,37.1,21,55,38.2,5,15,33.3,9,15,60.0,21,28,49,13,18,17,7,8,66,0
19370,453647,507_15_22,SERBIA,0,TOTALS,SERBIA,200,29,62,46.8,23,42,54.8,6,20,30.0,7,12,58.3,18,33,51,22,16,23,12,3,71,1
19371,453660,507_15_22,MONTENEGRO,0,TOTALS,MONTENEGRO,200,18,61,29.5,15,41,36.6,3,20,15.0,7,15,46.7,11,18,29,13,19,16,14,1,46,0
19372,453673,507_15_23,GREECE,0,TOTALS,GREECE,200,22,68,32.4,17,46,37.0,5,22,22.7,10,12,83.3,15,29,44,12,23,13,6,3,59,0
19373,453686,507_15_23,BOSNIA AND HERZEGOVINA,0,TOTALS,BOSNIA AND HERZEGOVINA,200,23,58,39.7,16,33,48.5,7,25,28.0,7,21,33.3,11,31,42,14,14,15,8,3,60,1
19374,453699,507_15_24,LATVIA,0,TOTALS,LATVIA,200,26,73,35.6,14,41,34.1,12,32,37.5,12,20,60.0,10,22,32,15,30,13,9,2,76,0
19375,453712,507_15_24,GERMANY,0,TOTALS,GERMANY,200,26,57,45.6,20,41,48.8,6,16,37.5,26,42,61.9,14,34,48,12,25,19,7,2,84,1
19376,453725,507_15_25,MONTENEGRO,0,TOTALS,MONTENEGRO,200,23,60,38.3,17,39,43.6,6,21,28.6,16,25,64.0,14,26,40,12,26,14,8,1,68,0
19377,453738,507_15_25,FINLAND,0,TOTALS,FINLAND,200,26,56,46.4,20,38,52.6,6,18,33.3,12,20,60.0,6,28,34,12,21,14,10,3,70,1
19378,453751,507_15_26,LATVIA,0,TOTALS,LATVIA,200,24,60,40.0,13,37,35.1,11,23,47.8,3,7,42.9,15,17,32,14,22,27,6,3,62,0
19379,453764,507_15_26,FRANCE,0,TOTALS,FRANCE,200,33,63,52.4,27,43,62.8,6,20,30.0,19,23,82.6,13,22,35,24,15,15,16,1,91,1
19380,453777,507_15_27,UKRAINE,0,TOTALS,UKRAINE,200,27,67,40.3,14,42,33.3,13,25,52.0,20,27,74.1,14,18,32,15,24,15,12,0,87,0
19381,453790,507_15_27,CROATIA,0,TOTALS,CROATIA,200,34,62,54.8,21,37,56.8,13,25,52.0,14,22,63.6,11,27,38,19,26,21,7,1,95,1
19382,453803,507_15_28,CZECH REPUBLIC,0,TOTALS,CZECH REPUBLIC,200,18,70,25.7,11,47,23.4,7,23,30.4,4,11,36.4,10,28,38,14,20,13,9,1,47,0
19383,453816,507_15_28,GERMANY,0,TOTALS,GERMANY,200,24,71,33.8,17,46,37.0,7,25,28.0,19,34,55.9,26,41,67,27,18,17,8,6,74,1
19384,453829,507_15_29,SERBIA,0,TOTALS,SERBIA,200,23,57,40.4,17,35,48.6,6,22,27.3,10,21,47.6,12,22,34,8,19,17,7,6,62,0
19385,453842,507_15_29,SPAIN,0,TOTALS,SPAIN,200,25,55,45.5,19,38,50.0,6,17,35.3,18,24,75.0,9,28,37,16,22,11,9,4,74,1
19386,453855,507_15_30,RUSSIA,0,TOTALS,RUSSIA,200,24,71,33.8,17,54,31.5,7,17,41.2,10,14,71.4,14,22,36,12,27,16,14,3,65,0
19387,453868,507_15_30,LITHUANIA,0,TOTALS,LITHUANIA,200,24,52,46.2,19,34,55.9,5,18,27.8,20,31,64.5,11,35,46,18,21,25,10,4,73,1
19388,453881,507_15_31,BOSNIA AND HERZEGOVINA,0,TOTALS,BOSNIA AND HERZEGOVINA,200,24,59,40.7,21,45,46.7,3,14,21.4,6,9,66.7,11,21,32,10,13,19,5,2,57,0
19389,453894,507_15_31,TURKEY,0,TOTALS,TURKEY,200,35,72,48.6,30,48,62.5,5,24,20.8,5,6,83.3,15,24,39,15,14,12,13,5,80,1
19390,453907,507_15_32,GREECE,0,TOTALS,GREECE,200,19,53,35.8,13,34,38.2,6,19,31.6,19,25,76.0,7,35,42,12,20,16,10,2,63,1
19391,453920,507_15_32,ITALY,0,TOTALS,ITALY,200,18,58,31.0,16,46,34.8,2,12,16.7,14,21,66.7,7,28,35,10,25,14,8,2,52,0
19392,453933,507_15_33,FINLAND,0,TOTALS,FINLAND,200,32,67,47.8,20,40,50.0,12,27,44.4,11,16,68.8,14,26,40,21,22,17,8,0,87,1
19393,453946,507_15_33,UKRAINE,0,TOTALS,UKRAINE,200,30,69,43.5,20,41,48.8,10,28,35.7,11,18,61.1,15,24,39,21,23,16,7,5,81,0
19394,453959,507_15_34,LATVIA,0,TOTALS,LATVIA,200,30,69,43.5,14,34,41.2,16,35,45.7,16,24,66.7,15,36,51,30,23,14,8,6,92,1
19395,453972,507_15_34,CZECH REPUBLIC,0,TOTALS,CZECH REPUBLIC,200,23,66,34.8,19,46,41.3,4,20,20.0,6,19,31.6,13,26,39,12,22,15,6,1,56,0
19396,453985,507_15_35,CROATIA,0,TOTALS,CROATIA,200,27,57,47.4,23,41,56.1,4,16,25.0,10,19,52.6,9,15,24,10,24,17,11,3,68,0
19397,453998,507_15_35,MONTENEGRO,0,TOTALS,MONTENEGRO,200,36,67,53.7,31,52,59.6,5,15,33.3,14,26,53.8,20,24,44,17,21,16,11,1,91,1
19398,454011,507_15_36,FRANCE,0,TOTALS,FRANCE,200,24,63,38.1,17,46,37.0,7,17,41.2,9,22,40.9,14,28,42,15,12,13,3,5,64,0
19399,454024,507_15_36,SERBIA,0,TOTALS,SERBIA,200,30,74,40.5,23,47,48.9,7,27,25.9,8,12,66.7,15,28,43,19,19,8,6,4,75,1
19400,454037,507_15_37,BOSNIA AND HERZEGOVINA,0,TOTALS,BOSNIA AND HERZEGOVINA,200,19,44,43.2,13,26,50.0,6,18,33.3,23,40,57.5,12,29,41,16,26,27,14,3,67,1
19401,454050,507_15_37,RUSSIA,0,TOTALS,RUSSIA,200,21,61,34.4,16,41,39.0,5,20,25.0,14,23,60.9,14,24,38,10,31,21,19,5,61,0
19402,454063,507_15_38,ITALY,0,TOTALS,ITALY,200,28,67,41.8,21,46,45.7,7,21,33.3,14,18,77.8,8,27,35,17,20,11,11,1,77,1
19403,454076,507_15_38,LITHUANIA,0,TOTALS,LITHUANIA,200,24,60,40.0,19,39,48.7,5,21,23.8,17,19,89.5,7,31,38,21,18,19,5,3,70,0
19404,454089,507_15_39,SPAIN,0,TOTALS,SPAIN,200,22,60,36.7,11,29,37.9,11,31,35.5,21,25,84.0,16,17,33,11,24,17,7,2,76,1
19405,454102,507_15_39,GERMANY,0,TOTALS,GERMANY,200,28,63,44.4,21,34,61.8,7,29,24.1,10,18,55.6,19,20,39,17,25,21,13,3,73,0
19406,454115,507_15_40,TURKEY,0,TOTALS,TURKEY,200,23,68,33.8,19,44,43.2,4,24,16.7,4,6,66.7,11,25,36,12,21,17,13,3,54,0
19407,454128,507_15_40,GREECE,0,TOTALS,GREECE,200,28,57,49.1,25,40,62.5,3,17,17.6,18,26,69.2,8,34,42,25,15,16,6,0,77,1
19408,454141,507_15_41,UKRAINE,0,TOTALS,UKRAINE,200,20,59,33.9,16,39,41.0,4,20,20.0,16,25,64.0,13,30,43,15,18,18,11,4,60,1
19409,454154,507_15_41,MONTENEGRO,0,TOTALS,MONTENEGRO,200,21,61,34.4,19,43,44.2,2,18,11.1,14,17,82.4,12,26,38,10,21,17,12,3,58,0
19410,454167,507_15_42,ITALY,0,TOTALS,ITALY,200,21,63,33.3,12,37,32.4,9,26,34.6,8,13,61.5,6,29,35,12,26,15,9,3,59,0
19411,454180,507_15_42,BOSNIA AND HERZEGOVINA,0,TOTALS,BOSNIA AND HERZEGOVINA,200,25,64,39.1,19,46,41.3,6,18,33.3,16,36,44.4,18,38,56,17,20,18,8,4,72,1
19412,454193,507_15_43,FINLAND,0,TOTALS,FINLAND,200,24,76,31.6,15,42,35.7,9,34,26.5,8,12,66.7,17,22,39,14,19,14,11,4,65,0
19413,454206,507_15_43,CROATIA,0,TOTALS,CROATIA,200,28,57,49.1,23,40,57.5,5,17,29.4,13,19,68.4,9,34,43,21,17,21,8,5,74,1
19414,454219,507_15_44,SPAIN,0,TOTALS,SPAIN,200,29,65,44.6,26,48,54.2,3,17,17.6,12,17,70.6,13,28,41,19,16,13,6,2,73,0
19415,454232,507_15_44,LATVIA,0,TOTALS,LATVIA,200,29,68,42.6,21,38,55.3,8,30,26.7,9,14,64.3,13,26,39,17,18,12,7,2,75,1
19416,454245,507_15_45,SERBIA,0,TOTALS,SERBIA,200,31,75,41.3,21,40,52.5,10,35,28.6,14,18,77.8,21,37,58,26,18,14,4,5,86,1
19417,454258,507_15_45,CZECH REPUBLIC,0,TOTALS,CZECH REPUBLIC,200,22,68,32.4,16,43,37.2,6,25,24.0,17,23,73.9,14,23,37,16,19,9,9,1,67,0
19418,454271,507_15_46,LITHUANIA,0,TOTALS,LITHUANIA,200,26,60,43.3,21,46,45.7,5,14,35.7,10,17,58.8,14,28,42,18,16,19,5,4,67,0
19419,454284,507_15_46,TURKEY,0,TOTALS,TURKEY,200,31,76,40.8,27,57,47.4,4,19,21.1,7,10,70.0,19,24,43,14,17,10,15,4,73,1
19420,454297,507_15_47,GERMANY,0,TOTALS,GERMANY,200,28,65,43.1,22,43,51.2,6,22,27.3,12,19,63.2,12,25,37,11,28,18,4,2,74,0
19421,454310,507_15_47,FRANCE,0,TOTALS,FRANCE,200,27,61,44.3,23,45,51.1,4,16,25.0,31,36,86.1,10,24,34,17,20,11,12,1,89,1
19422,454323,507_15_48,GREECE,0,TOTALS,GREECE,200,21,62,33.9,14,41,34.1,7,21,33.3,12,13,92.3,12,26,38,19,14,14,11,4,61,1
19423,454336,507_15_48,RUSSIA,0,TOTALS,RUSSIA,200,21,57,36.8,12,35,34.3,9,22,40.9,6,7,85.7,10,28,38,10,17,20,8,4,57,0
19424,454349,507_15_49,RUSSIA,0,TOTALS,RUSSIA,200,34,69,49.3,24,43,55.8,10,26,38.5,9,9,100.0,10,26,36,23,15,12,9,2,87,1
19425,454362,507_15_49,FINLAND,0,TOTALS,FINLAND,200,24,53,45.3,18,32,56.2,6,21,28.6,10,14,71.4,5,25,30,11,16,20,9,1,64,0
19426,454375,507_15_50,SPAIN,0,TOTALS,SPAIN,200,26,69,37.7,20,45,44.4,6,24,25.0,6,14,42.9,13,30,43,15,18,11,6,4,64,0
19427,454388,507_15_50,BOSNIA AND HERZEGOVINA,0,TOTALS,BOSNIA AND HERZEGOVINA,200,28,71,39.4,23,47,48.9,5,24,20.8,9,16,56.2,17,32,49,21,17,11,9,5,70,1
19428,454401,507_15_51,ITALY,0,TOTALS,ITALY,200,32,72,44.4,23,47,48.9,9,25,36.0,14,18,77.8,14,25,39,14,22,14,15,4,87,1
19429,454414,507_15_51,UKRAINE,0,TOTALS,UKRAINE,200,24,62,38.7,18,42,42.9,6,20,30.0,15,22,68.2,15,28,43,19,18,22,10,3,69,0
19430,454427,507_15_52,TURKEY,0,TOTALS,TURKEY,225,33,77,42.9,27,49,55.1,6,28,21.4,18,29,62.1,17,24,41,23,24,11,14,2,90,1
19431,454440,507_15_52,SERBIA,0,TOTALS,SERBIA,225,28,60,46.7,21,37,56.8,7,23,30.4,16,30,53.3,14,31,45,19,23,23,7,3,79,0
19432,454453,507_15_53,LATVIA,0,TOTALS,LATVIA,200,22,60,36.7,15,32,46.9,7,28,25.0,17,26,65.4,17,27,44,16,19,16,8,3,68,1
19433,454466,507_15_53,MONTENEGRO,0,TOTALS,MONTENEGRO,200,24,62,38.7,21,46,45.7,3,16,18.8,14,20,70.0,12,22,34,7,26,10,11,2,65,0
19434,454479,507_15_54,LITHUANIA,0,TOTALS,LITHUANIA,200,26,65,40.0,19,46,41.3,7,19,36.8,14,23,60.9,17,30,47,20,18,15,10,1,73,1
19435,454492,507_15_54,GERMANY,0,TOTALS,GERMANY,200,28,66,42.4,24,46,52.2,4,20,20.0,11,19,57.9,12,27,39,11,22,16,10,2,71,0
19436,454505,507_15_55,CZECH REPUBLIC,0,TOTALS,CZECH REPUBLIC,200,28,69,40.6,21,39,53.8,7,30,23.3,7,12,58.3,12,28,40,15,20,12,7,2,70,0
19437,454518,507_15_55,CROATIA,0,TOTALS,CROATIA,200,31,67,46.3,25,41,61.0,6,26,23.1,14,17,82.4,11,30,41,13,17,13,7,4,82,1
19438,454531,507_15_56,FRANCE,0,TOTALS,FRANCE,200,22,66,33.3,14,43,32.6,8,23,34.8,7,14,50.0,14,29,43,9,18,13,10,2,59,0
19439,454544,507_15_56,GREECE,0,TOTALS,GREECE,200,27,63,42.9,19,40,47.5,8,23,34.8,5,10,50.0,10,31,41,24,21,12,6,7,67,1
19440,454557,507_15_57,UKRAINE,0,TOTALS,UKRAINE,200,27,67,40.3,20,38,52.6,7,29,24.1,16,21,76.2,13,25,38,20,32,16,7,5,77,0
19441,454570,507_15_57,FINLAND,0,TOTALS,FINLAND,200,26,57,45.6,21,37,56.8,5,20,25.0,31,43,72.1,8,25,33,14,28,15,7,1,88,1
19442,454583,507_15_58,SERBIA,0,TOTALS,SERBIA,200,33,64,51.6,24,42,57.1,9,22,40.9,15,23,65.2,10,28,38,25,23,14,8,3,90,1
19443,454596,507_15_58,SPAIN,0,TOTALS,SPAIN,200,27,63,42.9,16,34,47.1,11,29,37.9,11,18,61.1,11,24,35,20,22,17,11,2,76,0
19444,454609,507_15_59,MONTENEGRO,0,TOTALS,MONTENEGRO,200,27,68,39.7,15,38,39.5,12,30,40.0,9,17,52.9,10,27,37,18,17,7,14,1,75,1
19445,454622,507_15_59,CZECH REPUBLIC,0,TOTALS,CZECH REPUBLIC,200,20,51,39.2,12,30,40.0,8,21,38.1,5,11,45.5,8,36,44,6,14,21,4,4,53,0
19446,454635,507_15_60,FRANCE,0,TOTALS,FRANCE,200,24,68,35.3,19,48,39.6,5,20,25.0,9,13,69.2,15,28,43,15,14,13,8,3,62,1
19447,454648,507_15_60,GERMANY,0,TOTALS,GERMANY,200,22,62,35.5,18,43,41.9,4,19,21.1,7,12,58.3,13,31,44,12,18,17,9,3,55,0
19448,454661,507_15_61,LATVIA,0,TOTALS,LATVIA,225,29,77,37.7,16,37,43.2,13,40,32.5,7,13,53.8,12,27,39,18,21,11,12,9,78,1
19449,454674,507_15_61,CROATIA,0,TOTALS,CROATIA,225,26,71,36.6,21,51,41.2,5,20,25.0,17,20,85.0,18,36,54,12,19,23,7,1,74,0
19450,454687,507_15_62,TURKEY,0,TOTALS,TURKEY,200,34,67,50.7,28,47,59.6,6,20,30.0,8,16,50.0,15,21,36,19,19,17,10,3,82,1
19451,454700,507_15_62,BOSNIA AND HERZEGOVINA,0,TOTALS,BOSNIA AND HERZEGOVINA,200,31,65,47.7,28,50,56.0,3,15,20.0,12,21,57.1,15,22,37,24,21,14,11,1,77,0
19452,454713,507_15_63,ITALY,0,TOTALS,ITALY,200,22,60,36.7,14,42,33.3,8,18,44.4,15,21,71.4,8,15,23,13,19,14,20,2,67,0
19453,454726,507_15_63,RUSSIA,0,TOTALS,RUSSIA,200,32,56,57.1,23,39,59.0,9,17,52.9,9,14,64.3,10,31,41,17,20,25,6,1,82,1
19454,454739,507_15_64,GREECE,0,TOTALS,GREECE,200,20,58,34.5,10,29,34.5,10,29,34.5,18,29,62.1,13,29,42,14,18,8,7,6,68,1
19455,454752,507_15_64,LITHUANIA,0,TOTALS,LITHUANIA,200,23,69,33.3,15,44,34.1,8,25,32.0,4,8,50.0,18,29,47,17,23,10,5,3,58,0
19456,454765,507_15_65,CZECH REPUBLIC,0,TOTALS,CZECH REPUBLIC,225,40,98,40.8,36,71,50.7,4,27,14.8,7,11,63.6,19,40,59,23,24,12,8,4,91,0
19457,454778,507_15_65,UKRAINE,0,TOTALS,UKRAINE,225,33,72,45.8,24,46,52.2,9,26,34.6,24,35,68.6,6,41,47,25,16,13,8,3,99,1
19458,454791,507_15_66,CROATIA,0,TOTALS,CROATIA,200,22,61,36.1,17,35,48.6,5,26,19.2,8,8,100.0,10,33,43,16,18,21,6,8,57,0
19459,454804,507_15_66,ITALY,0,TOTALS,ITALY,200,28,71,39.4,21,53,39.6,7,18,38.9,10,11,90.9,11,28,39,16,17,12,16,4,73,1
19460,454817,507_15_67,GERMANY,0,TOTALS,GERMANY,200,23,71,32.4,19,56,33.9,4,15,26.7,14,27,51.9,25,32,57,12,23,15,0,2,64,0
19461,454830,507_15_67,SPAIN,0,TOTALS,SPAIN,200,26,57,45.6,19,36,52.8,7,21,33.3,9,15,60.0,2,27,29,22,20,9,5,5,68,1
19462,454843,507_15_68,MONTENEGRO,0,TOTALS,MONTENEGRO,200,23,60,38.3,16,36,44.4,7,24,29.2,11,22,50.0,14,26,40,10,27,14,6,2,64,0
19463,454856,507_15_68,FINLAND,0,TOTALS,FINLAND,200,24,55,43.6,18,34,52.9,6,21,28.6,14,21,66.7,7,26,33,13,24,13,8,3,68,1
19464,454869,507_15_69,FRANCE,0,TOTALS,FRANCE,200,23,67,34.3,20,52,38.5,3,15,20.0,21,27,77.8,16,21,37,15,19,13,13,5,70,0
19465,454882,507_15_69,SERBIA,0,TOTALS,SERBIA,200,31,64,48.4,22,43,51.2,9,21,42.9,10,14,71.4,15,30,45,19,21,22,5,3,81,1
19466,454895,507_15_70,LATVIA,0,TOTALS,LATVIA,200,27,64,42.2,19,34,55.9,8,30,26.7,6,13,46.2,10,27,37,17,16,17,12,2,68,0
19467,454908,507_15_70,RUSSIA,0,TOTALS,RUSSIA,200,27,63,42.9,20,45,44.4,7,18,38.9,8,10,80.0,10,29,39,14,14,18,9,2,69,1
19468,454921,507_15_71,LITHUANIA,0,TOTALS,LITHUANIA,200,23,59,39.0,11,32,34.4,12,27,44.4,16,23,69.6,14,32,46,20,16,16,11,2,74,1
19469,454934,507_15_71,BOSNIA AND HERZEGOVINA,0,TOTALS,BOSNIA AND HERZEGOVINA,200,20,63,31.7,18,44,40.9,2,19,10.5,7,12,58.3,12,27,39,12,21,17,8,5,49,0
19470,454947,507_15_72,GREECE,0,TOTALS,GREECE,200,22,60,36.7,15,34,44.1,7,26,26.9,13,19,68.4,14,33,47,14,16,14,5,3,64,1
19471,454960,507_15_72,TURKEY,0,TOTALS,TURKEY,200,22,71,31.0,14,45,31.1,8,26,30.8,9,13,69.2,16,25,41,8,22,10,12,2,61,0
19472,454973,508_15_01,BULGARIA,0,TOTALS,BULGARIA,200,18,59,30.5,15,38,39.5,3,21,14.3,10,21,47.6,10,32,42,6,21,18,4,2,49,0
19473,454986,508_15_01,ESTONIA,0,TOTALS,ESTONIA,200,23,65,35.4,15,44,34.1,8,21,38.1,13,25,52.0,13,37,50,14,23,12,11,3,67,1
19474,454999,508_15_02,SLOVAK REPUBLIC,0,TOTALS,SLOVAK REPUBLIC,200,24,51,47.1,20,33,60.6,4,18,22.2,13,25,52.0,14,24,38,10,26,17,6,2,65,0
19475,455012,508_15_02,PORTUGAL,0,TOTALS,PORTUGAL,200,28,62,45.2,20,42,47.6,8,20,40.0,16,27,59.3,14,16,30,14,21,11,10,0,80,1
19476,455025,508_15_03,ICELAND,0,TOTALS,ICELAND,200,23,77,29.9,16,45,35.6,7,32,21.9,20,36,55.6,23,28,51,13,24,14,4,3,73,0
19477,455038,508_15_03,ISRAEL,0,TOTALS,ISRAEL,200,30,65,46.2,24,47,51.1,6,18,33.3,24,33,72.7,10,36,46,19,30,10,9,6,90,1
19478,455050,508_15_04,LUXEMBOURG,0,TOTALS,LUXEMBOURG,200,21,62,33.9,20,52,38.5,1,10,10.0,5,10,50.0,8,20,28,4,22,18,10,1,48,0
19479,455063,508_15_04,NETHERLANDS,0,TOTALS,NETHERLANDS,200,33,72,45.8,23,43,53.5,10,29,34.5,13,22,59.1,23,38,61,13,16,18,9,2,89,1
19480,455076,508_15_05,SWEDEN,0,TOTALS,SWEDEN,200,32,78,41.0,25,48,52.1,7,30,23.3,11,16,68.8,18,29,47,16,16,12,16,5,82,1
19481,455089,508_15_05,GEORGIA,0,TOTALS,GEORGIA,200,18,60,30.0,14,40,35.0,4,20,20.0,10,15,66.7,14,31,45,8,20,28,7,1,50,0
19482,455102,508_15_06,DENMARK,0,TOTALS,DENMARK,200,24,63,38.1,21,39,53.8,3,24,12.5,25,38,65.8,13,34,47,8,25,14,18,6,76,1
19483,455115,508_15_06,MKD,0,TOTALS,MKD,200,17,55,30.9,10,36,27.8,7,19,36.8,13,25,52.0,10,35,45,10,29,24,8,5,54,0
19484,455128,508_15_07,ALBANIA,0,TOTALS,ALBANIA,200,18,51,35.3,14,33,42.4,4,18,22.2,10,20,50.0,11,29,40,8,22,24,7,4,50,0
19485,455141,508_15_07,SWITZERLAND,0,TOTALS,SWITZERLAND,200,25,62,40.3,14,35,40.0,11,27,40.7,10,16,62.5,12,27,39,17,22,15,8,1,71,1
19486,455154,508_15_08,BELGIUM,0,TOTALS,BELGIUM,225,29,55,52.7,23,39,59.0,6,16,37.5,9,16,56.2,12,33,45,14,21,28,11,1,73,0
19487,455167,508_15_08,SLOVENIA,0,TOTALS,SLOVENIA,225,27,70,38.6,17,44,38.6,10,26,38.5,12,19,63.2,14,17,31,9,23,12,15,1,76,1
19488,455180,508_15_09,IRELAND,0,TOTALS,IRELAND,200,25,74,33.8,17,46,37.0,8,28,28.6,14,19,73.7,11,26,37,13,19,25,15,1,72,0
19489,455193,508_15_09,AUSTRIA,0,TOTALS,AUSTRIA,200,37,72,51.4,34,57,59.6,3,15,20.0,5,12,41.7,8,39,47,19,22,33,15,3,82,1
19490,455206,508_15_10,POLAND,0,TOTALS,POLAND,200,23,52,44.2,17,37,45.9,6,15,40.0,13,24,54.2,12,28,40,15,18,26,16,5,65,1
19491,455219,508_15_10,ENGLAND,0,TOTALS,ENGLAND,200,23,64,35.9,18,41,43.9,5,23,21.7,9,12,75.0,14,21,35,9,22,21,12,0,60,0
19492,457546,508_15_100,SLOVAK REPUBLIC,0,TOTALS,SLOVAK REPUBLIC,200,27,64,42.2,20,43,46.5,7,21,33.3,26,33,78.8,7,28,35,14,21,15,12,4,87,1
19493,457559,508_15_100,BELARUS,0,TOTALS,BELARUS,200,29,67,43.3,25,45,55.6,4,22,18.2,16,23,69.6,12,33,45,16,27,22,11,4,78,0
19494,457572,508_15_101,GEORGIA,0,TOTALS,GEORGIA,200,28,68,41.2,22,47,46.8,6,21,28.6,9,19,47.4,7,29,36,6,13,17,12,1,71,0
19495,457585,508_15_101,ENGLAND,0,TOTALS,ENGLAND,200,30,67,44.8,22,50,44.0,8,17,47.1,8,10,80.0,8,38,46,11,20,18,8,2,76,1
19496,457598,508_15_102,ALBANIA,0,TOTALS,ALBANIA,200,25,58,43.1,21,47,44.7,4,11,36.4,10,19,52.6,10,34,44,16,23,22,12,1,64,1
19497,457611,508_15_102,LUXEMBOURG,0,TOTALS,LUXEMBOURG,200,19,62,30.6,13,41,31.7,6,21,28.6,16,26,61.5,14,25,39,10,21,21,15,2,60,0
19498,457624,508_15_103,SWITZERLAND,0,TOTALS,SWITZERLAND,250,27,75,36.0,24,53,45.3,3,22,13.6,19,30,63.3,12,33,45,15,27,20,11,3,76,0
19499,457637,508_15_103,AUSTRIA,0,TOTALS,AUSTRIA,250,26,74,35.1,22,56,39.3,4,18,22.2,23,31,74.2,16,35,51,9,26,23,13,0,79,1
19500,457650,508_15_104,HUNGARY,0,TOTALS,HUNGARY,200,26,53,49.1,18,29,62.1,8,24,33.3,24,32,75.0,7,37,44,15,19,21,8,1,84,1
19501,457663,508_15_104,ICELAND,0,TOTALS,ICELAND,200,26,70,37.1,19,41,46.3,7,29,24.1,16,22,72.7,12,21,33,10,21,14,13,1,75,0
19502,457676,508_15_105,NETHERLANDS,0,TOTALS,NETHERLANDS,200,30,56,53.6,24,44,54.5,6,12,50.0,12,16,75.0,8,34,42,20,20,21,9,3,78,1
19503,457689,508_15_105,PORTUGAL,0,TOTALS,PORTUGAL,200,19,63,30.2,15,37,40.5,4,26,15.4,15,19,78.9,12,21,33,9,16,17,10,0,57,0
19504,457702,508_15_106,DENMARK,0,TOTALS,DENMARK,200,23,59,39.0,18,39,46.2,5,20,25.0,21,29,72.4,10,25,35,12,18,16,6,8,72,1
19505,457715,508_15_106,BELGIUM,0,TOTALS,BELGIUM,200,41,77,53.2,31,59,52.5,10,18,55.6,11,16,68.8,13,31,44,25,25,9,8,1,103,0
19506,457728,508_15_107,SLOVENIA,0,TOTALS,SLOVENIA,200,29,57,50.9,25,43,58.1,4,14,28.6,16,29,55.2,12,27,39,11,24,16,8,3,78,1
19507,457741,508_15_107,POLAND,0,TOTALS,POLAND,200,21,50,42.0,18,38,47.4,3,12,25.0,15,24,62.5,6,24,30,6,27,18,9,4,60,0
19508,457754,508_15_108,SWEDEN,0,TOTALS,SWEDEN,200,28,71,39.4,21,42,50.0,7,29,24.1,10,19,52.6,15,32,47,10,21,14,3,7,73,1
19509,457767,508_15_108,ISRAEL,0,TOTALS,ISRAEL,200,25,66,37.9,20,56,35.7,5,10,50.0,17,24,70.8,10,35,45,12,22,8,11,3,72,0
19510,455232,508_15_11,BELARUS,0,TOTALS,BELARUS,200,32,66,48.5,30,49,61.2,2,17,11.8,4,12,33.3,13,32,45,15,18,18,11,3,70,1
19511,455245,508_15_11,HUNGARY,0,TOTALS,HUNGARY,200,25,66,37.9,20,45,44.4,5,21,23.8,7,13,53.8,13,25,38,7,16,18,13,0,62,0
19512,455258,508_15_12,SCOTLAND,0,TOTALS,SCOTLAND,200,17,60,28.3,13,40,32.5,4,20,20.0,7,12,58.3,7,20,27,5,17,24,10,1,45,0
19513,455271,508_15_12,ROMANIA,0,TOTALS,ROMANIA,200,28,62,45.2,25,46,54.3,3,16,18.8,11,18,61.1,16,36,52,9,19,26,12,2,70,1
19514,455284,508_15_13,SWITZERLAND,0,TOTALS,SWITZERLAND,200,22,63,34.9,17,46,37.0,5,17,29.4,11,20,55.0,12,31,43,9,17,12,9,0,60,1
19515,455297,508_15_13,BULGARIA,0,TOTALS,BULGARIA,200,17,54,31.5,11,27,40.7,6,27,22.2,10,15,66.7,9,35,44,6,19,17,4,4,50,0
19516,455310,508_15_14,SLOVENIA,0,TOTALS,SLOVENIA,200,30,72,41.7,17,37,45.9,13,35,37.1,7,11,63.6,23,31,54,22,17,19,16,6,80,1
19517,455323,508_15_14,LUXEMBOURG,0,TOTALS,LUXEMBOURG,200,19,54,35.2,17,41,41.5,2,13,15.4,4,11,36.4,6,21,27,5,15,20,9,1,44,0
19518,455336,508_15_15,ISRAEL,0,TOTALS,ISRAEL,200,42,84,50.0,30,48,62.5,12,36,33.3,13,21,61.9,14,38,52,32,19,15,16,4,109,0
19519,455349,508_15_15,IRELAND,0,TOTALS,IRELAND,200,21,70,30.0,18,46,39.1,3,24,12.5,12,14,85.7,10,32,42,9,20,27,9,0,57,1
19520,455362,508_15_16,HUNGARY,0,TOTALS,HUNGARY,200,33,68,48.5,27,48,56.2,6,20,30.0,2,8,25.0,10,19,29,14,27,17,13,1,74,1
19521,455375,508_15_16,BELGIUM,0,TOTALS,BELGIUM,200,25,59,42.4,23,45,51.1,2,14,14.3,20,27,74.1,15,26,41,8,16,24,8,2,72,0
19522,455388,508_15_17,PORTUGAL,0,TOTALS,PORTUGAL,200,17,59,28.8,11,45,24.4,6,14,42.9,21,30,70.0,17,25,42,9,16,11,6,0,61,0
19523,455401,508_15_17,SWEDEN,0,TOTALS,SWEDEN,200,31,68,45.6,24,49,49.0,7,19,36.8,2,8,25.0,15,30,45,15,23,12,5,9,71,1
19524,455414,508_15_18,MKD,0,TOTALS,MKD,200,21,60,35.0,15,32,46.9,6,28,21.4,16,31,51.6,12,29,41,10,26,14,4,0,64,0
19525,455427,508_15_18,ICELAND,0,TOTALS,ICELAND,200,26,64,40.6,16,36,44.4,10,28,35.7,18,26,69.2,13,33,46,19,25,14,9,4,80,1
19526,455440,508_15_19,ESTONIA,0,TOTALS,ESTONIA,200,27,60,45.0,20,31,64.5,7,29,24.1,7,11,63.6,8,20,28,13,19,15,11,0,68,0
19527,455453,508_15_19,POLAND,0,TOTALS,POLAND,200,33,68,48.5,31,56,55.4,2,12,16.7,11,15,73.3,17,26,43,14,16,14,10,3,79,1
19528,455466,508_15_20,NETHERLANDS,0,TOTALS,NETHERLANDS,200,30,62,48.4,25,45,55.6,5,17,29.4,14,18,77.8,12,32,44,17,15,21,16,4,79,1
19529,455479,508_15_20,BELARUS,0,TOTALS,BELARUS,200,18,56,32.1,16,40,40.0,2,16,12.5,13,15,86.7,7,23,30,9,20,24,9,2,51,0
19530,455492,508_15_21,GEORGIA,0,TOTALS,GEORGIA,200,37,88,42.0,28,54,51.9,9,34,26.5,16,27,59.3,25,33,58,14,11,15,16,4,99,1
19531,455505,508_15_21,SCOTLAND,0,TOTALS,SCOTLAND,200,20,63,31.7,12,40,30.0,8,23,34.8,2,5,40.0,9,30,39,11,21,27,4,2,50,0
19532,455518,508_15_22,ENGLAND,0,TOTALS,ENGLAND,200,28,70,40.0,20,34,58.8,8,36,22.2,6,11,54.5,15,26,41,11,13,11,15,4,70,1
19533,455531,508_15_22,ALBANIA,0,TOTALS,ALBANIA,200,21,54,38.9,17,43,39.5,4,11,36.4,3,8,37.5,8,29,37,10,16,19,5,1,49,0
19534,455544,508_15_23,ROMANIA,0,TOTALS,ROMANIA,200,30,64,46.9,25,46,54.3,5,18,27.8,8,18,44.4,13,22,35,15,21,19,14,3,73,1
19535,455557,508_15_23,SLOVAK REPUBLIC,0,TOTALS,SLOVAK REPUBLIC,200,25,63,39.7,16,38,42.1,9,25,36.0,7,19,36.8,18,26,44,15,18,25,8,2,66,0
19536,455570,508_15_24,AUSTRIA,0,TOTALS,AUSTRIA,200,26,63,41.3,23,49,46.9,3,14,21.4,10,19,52.6,18,25,43,12,24,20,6,0,65,0
19537,455583,508_15_24,DENMARK,0,TOTALS,DENMARK,200,24,56,42.9,14,32,43.8,10,24,41.7,19,30,63.3,13,22,35,19,21,12,16,1,77,1
19538,455596,508_15_25,SWITZERLAND,0,TOTALS,SWITZERLAND,200,27,57,47.4,21,42,50.0,6,15,40.0,5,14,35.7,9,26,35,11,12,12,7,1,65,1
19539,455609,508_15_25,ESTONIA,0,TOTALS,ESTONIA,200,23,57,40.4,14,32,43.8,9,25,36.0,4,6,66.7,9,22,31,11,17,13,2,3,59,0
19540,455622,508_15_26,BELARUS,0,TOTALS,BELARUS,200,18,48,37.5,14,33,42.4,4,15,26.7,20,27,74.1,8,19,27,6,20,19,7,0,60,0
19541,455635,508_15_26,SLOVENIA,0,TOTALS,SLOVENIA,200,38,68,55.9,30,47,63.8,8,21,38.1,12,20,60.0,14,23,37,23,25,10,13,2,96,1
19542,455648,508_15_27,SCOTLAND,0,TOTALS,SCOTLAND,200,15,54,27.8,12,41,29.3,3,13,23.1,12,21,57.1,8,23,31,5,20,17,10,1,45,0
19543,455661,508_15_27,SWEDEN,0,TOTALS,SWEDEN,200,31,74,41.9,23,46,50.0,8,28,28.6,9,17,52.9,22,32,54,17,16,14,8,6,79,1
19544,455674,508_15_28,ALBANIA,0,TOTALS,ALBANIA,200,19,61,31.1,17,46,37.0,2,15,13.3,11,16,68.8,16,19,35,9,25,31,12,1,51,0
19545,455687,508_15_28,POLAND,0,TOTALS,POLAND,200,33,75,44.0,29,56,51.8,4,19,21.1,28,37,75.7,25,29,54,17,15,21,18,4,98,1
19546,455700,508_15_29,LUXEMBOURG,0,TOTALS,LUXEMBOURG,200,22,56,39.3,18,44,40.9,4,12,33.3,8,19,42.1,11,25,36,14,14,26,8,1,56,0
19547,455713,508_15_29,BELGIUM,0,TOTALS,BELGIUM,200,41,75,54.7,30,50,60.0,11,25,44.0,4,9,44.4,12,27,39,26,14,15,17,2,97,1
19548,455726,508_15_30,SLOVAK REPUBLIC,0,TOTALS,SLOVAK REPUBLIC,200,26,65,40.0,20,44,45.5,6,21,28.6,11,19,57.9,11,33,44,15,20,17,4,2,69,0
19549,455739,508_15_30,GEORGIA,0,TOTALS,GEORGIA,200,23,70,32.9,13,34,38.2,10,36,27.8,14,18,77.8,15,32,47,14,15,16,8,3,70,1
19550,455752,508_15_31,BULGARIA,0,TOTALS,BULGARIA,200,19,58,32.8,14,35,40.0,5,23,21.7,11,14,78.6,5,35,40,8,14,23,7,3,54,0
19551,455765,508_15_31,ENGLAND,0,TOTALS,ENGLAND,200,30,74,40.5,23,50,46.0,7,24,29.2,6,9,66.7,11,32,43,14,16,15,15,2,73,1
19552,455778,508_15_32,NETHERLANDS,0,TOTALS,NETHERLANDS,200,21,63,33.3,16,43,37.2,5,20,25.0,14,21,66.7,19,32,51,8,23,23,5,5,61,0
19553,455791,508_15_32,HUNGARY,0,TOTALS,HUNGARY,200,22,57,38.6,8,24,33.3,14,33,42.4,12,16,75.0,5,26,31,16,21,13,14,2,70,1
19554,455804,508_15_33,IRELAND,0,TOTALS,IRELAND,200,25,64,39.1,16,30,53.3,9,34,26.5,15,27,55.6,6,31,37,13,21,14,12,3,74,1
19555,455817,508_15_33,MKD,0,TOTALS,MKD,200,23,69,33.3,12,29,41.4,11,40,27.5,14,17,82.4,14,41,55,12,22,26,6,2,71,0
19556,455830,508_15_34,ROMANIA,0,TOTALS,ROMANIA,225,28,66,42.4,22,40,55.0,6,26,23.1,11,17,64.7,13,37,50,14,25,22,7,0,73,0
19557,455843,508_15_34,PORTUGAL,0,TOTALS,PORTUGAL,225,27,69,39.1,21,41,51.2,6,28,21.4,15,27,55.6,13,26,39,14,22,13,10,2,75,1
19558,455856,508_15_35,ISRAEL,0,TOTALS,ISRAEL,200,33,70,47.1,26,46,56.5,7,24,29.2,9,17,52.9,14,23,37,14,23,21,27,2,82,1
19559,455869,508_15_35,AUSTRIA,0,TOTALS,AUSTRIA,200,24,57,42.1,20,42,47.6,4,15,26.7,5,12,41.7,15,26,41,8,18,40,9,1,57,0
19560,455882,508_15_36,ICELAND,0,TOTALS,ICELAND,200,30,75,40.0,23,52,44.2,7,23,30.4,12,17,70.6,9,31,40,16,17,7,11,5,79,1
19561,455895,508_15_36,DENMARK,0,TOTALS,DENMARK,200,21,65,32.3,15,34,44.1,6,31,19.4,6,9,66.7,12,37,49,7,22,21,4,5,54,0
19562,455908,508_15_37,ESTONIA,0,TOTALS,ESTONIA,200,30,64,46.9,21,36,58.3,9,28,32.1,18,32,56.2,7,24,31,23,22,14,13,5,87,1
19563,455921,508_15_37,ALBANIA,0,TOTALS,ALBANIA,200,16,50,32.0,14,42,33.3,2,8,25.0,15,19,78.9,11,32,43,7,26,33,7,2,49,0
19564,455934,508_15_38,HUNGARY,0,TOTALS,HUNGARY,200,22,57,38.6,19,40,47.5,3,17,17.6,17,27,63.0,10,28,38,12,18,17,10,1,64,1
19565,455947,508_15_38,LUXEMBOURG,0,TOTALS,LUXEMBOURG,200,18,59,30.5,16,41,39.0,2,18,11.1,9,17,52.9,9,27,36,8,23,21,7,2,47,0
19566,455960,508_15_39,SWEDEN,0,TOTALS,SWEDEN,200,36,72,50.0,23,44,52.3,13,28,46.4,6,12,50.0,19,22,41,24,12,12,9,8,91,1
19567,455973,508_15_39,SLOVAK REPUBLIC,0,TOTALS,SLOVAK REPUBLIC,200,16,46,34.8,14,37,37.8,2,9,22.2,13,17,76.5,6,17,23,7,13,21,3,3,47,0
19568,455986,508_15_40,ENGLAND,0,TOTALS,ENGLAND,200,27,63,42.9,20,39,51.3,7,24,29.2,17,23,73.9,13,29,42,9,11,8,6,2,78,1
19569,455999,508_15_40,SWITZERLAND,0,TOTALS,SWITZERLAND,200,25,60,41.7,17,41,41.5,8,19,42.1,2,5,40.0,6,26,32,9,19,17,5,1,60,0
19570,456012,508_15_41,BELGIUM,0,TOTALS,BELGIUM,200,38,68,55.9,33,55,60.0,5,13,38.5,15,20,75.0,10,35,45,15,15,17,8,5,96,1
19571,456025,508_15_41,BELARUS,0,TOTALS,BELARUS,200,25,73,34.2,18,52,34.6,7,21,33.3,5,9,55.6,13,20,33,18,20,20,7,2,62,0
19572,456038,508_15_42,GEORGIA,0,TOTALS,GEORGIA,200,32,66,48.5,24,41,58.5,8,25,32.0,8,10,80.0,11,24,35,15,29,16,8,1,80,1
19573,456051,508_15_42,ROMANIA,0,TOTALS,ROMANIA,200,22,51,43.1,20,37,54.1,2,14,14.3,20,36,55.6,9,22,31,7,21,18,9,3,66,0
19574,456064,508_15_43,POLAND,0,TOTALS,POLAND,200,36,79,45.6,31,56,55.4,5,23,21.7,6,14,42.9,20,17,37,18,15,14,22,0,83,1
19575,456077,508_15_43,BULGARIA,0,TOTALS,BULGARIA,200,27,50,54.0,19,30,63.3,8,20,40.0,9,11,81.8,7,25,32,17,18,28,6,3,71,0
19576,456090,508_15_44,PORTUGAL,0,TOTALS,PORTUGAL,200,26,62,41.9,18,39,46.2,8,23,34.8,7,18,38.9,11,27,38,15,19,21,14,3,67,1
19577,456103,508_15_44,SCOTLAND,0,TOTALS,SCOTLAND,200,21,56,37.5,15,34,44.1,6,22,27.3,10,20,50.0,12,31,43,12,21,29,8,1,58,0
19578,456116,508_15_45,MKD,0,TOTALS,MKD,200,22,61,36.1,18,43,41.9,4,18,22.2,15,20,75.0,9,30,39,7,17,24,7,0,63,0
19579,456129,508_15_45,ISRAEL,0,TOTALS,ISRAEL,200,39,74,52.7,32,54,59.3,7,20,35.0,9,14,64.3,7,30,37,14,18,13,19,5,94,1
19580,456142,508_15_46,SLOVENIA,0,TOTALS,SLOVENIA,200,23,59,39.0,13,25,52.0,10,34,29.4,16,22,72.7,15,25,40,15,23,22,9,10,72,1
19581,456155,508_15_46,NETHERLANDS,0,TOTALS,NETHERLANDS,200,21,57,36.8,16,43,37.2,5,14,35.7,17,24,70.8,11,20,31,12,21,22,11,1,64,0
19582,456168,508_15_47,AUSTRIA,0,TOTALS,AUSTRIA,200,31,65,47.7,28,50,56.0,3,15,20.0,1,7,14.3,12,23,35,16,20,26,11,0,66,0
19583,456181,508_15_47,ICELAND,0,TOTALS,ICELAND,200,34,62,54.8,25,35,71.4,9,27,33.3,6,11,54.5,7,26,33,18,13,22,18,2,83,1
19584,456194,508_15_48,DENMARK,0,TOTALS,DENMARK,200,26,62,41.9,14,29,48.3,12,33,36.4,21,28,75.0,15,28,43,19,13,19,6,4,85,1
19585,456207,508_15_48,IRELAND,0,TOTALS,IRELAND,200,29,71,40.8,18,45,40.0,11,26,42.3,6,6,100.0,13,22,35,17,25,16,13,3,75,0
19586,456220,508_15_49,BULGARIA,0,TOTALS,BULGARIA,200,18,49,36.7,15,28,53.6,3,21,14.3,23,28,82.1,4,36,40,12,15,13,9,5,62,1
19587,456233,508_15_49,ALBANIA,0,TOTALS,ALBANIA,200,19,65,29.2,16,49,32.7,3,16,18.8,6,11,54.5,13,31,44,9,25,15,1,0,47,0
19588,456246,508_15_50,BELARUS,0,TOTALS,BELARUS,200,31,63,49.2,26,49,53.1,5,14,35.7,5,10,50.0,15,31,46,18,23,25,8,7,72,1
19589,456259,508_15_50,LUXEMBOURG,0,TOTALS,LUXEMBOURG,200,24,66,36.4,16,54,29.6,8,12,66.7,15,27,55.6,14,20,34,12,18,16,12,4,71,0
19590,456272,508_15_51,ROMANIA,0,TOTALS,ROMANIA,200,19,55,34.5,17,48,35.4,2,7,28.6,11,19,57.9,9,22,31,9,15,25,11,3,51,0
19591,456285,508_15_51,SWEDEN,0,TOTALS,SWEDEN,200,36,74,48.6,27,53,50.9,9,21,42.9,4,4,100.0,13,32,45,24,16,18,18,7,85,1
19592,456298,508_15_52,ENGLAND,0,TOTALS,ENGLAND,200,25,70,35.7,20,59,33.9,5,11,45.5,10,15,66.7,12,27,39,13,19,9,11,9,65,1
19593,456311,508_15_52,ESTONIA,0,TOTALS,ESTONIA,200,14,63,22.2,13,44,29.5,1,19,5.3,17,19,89.5,17,34,51,5,24,21,3,5,46,0
19594,456324,508_15_53,SWITZERLAND,0,TOTALS,SWITZERLAND,200,12,46,26.1,9,36,25.0,3,10,30.0,24,32,75.0,7,22,29,7,16,24,10,2,51,0
19595,456337,508_15_53,POLAND,0,TOTALS,POLAND,200,34,62,54.8,29,47,61.7,5,15,33.3,8,12,66.7,9,28,37,19,27,19,15,4,81,1
19596,456350,508_15_54,NETHERLANDS,0,TOTALS,NETHERLANDS,200,18,61,29.5,14,41,34.1,4,20,20.0,11,16,68.8,20,28,48,6,21,20,5,5,51,0
19597,456363,508_15_54,BELGIUM,0,TOTALS,BELGIUM,200,22,59,37.3,17,46,37.0,5,13,38.5,17,26,65.4,12,23,35,8,16,15,15,5,66,1
19598,456376,508_15_55,GEORGIA,0,TOTALS,GEORGIA,200,20,58,34.5,14,40,35.0,6,18,33.3,16,22,72.7,11,29,40,12,16,22,11,1,62,1
19599,456389,508_15_55,PORTUGAL,0,TOTALS,PORTUGAL,200,23,60,38.3,17,36,47.2,6,24,25.0,8,14,57.1,9,32,41,16,13,23,12,2,60,0
19600,456402,508_15_56,MKD,0,TOTALS,MKD,200,24,52,46.2,17,32,53.1,7,20,35.0,12,18,66.7,5,22,27,10,22,21,5,1,67,0
19601,456415,508_15_56,AUSTRIA,0,TOTALS,AUSTRIA,200,30,69,43.5,26,54,48.1,4,15,26.7,18,24,75.0,17,26,43,6,20,17,10,3,82,1
19602,456428,508_15_57,IRELAND,0,TOTALS,IRELAND,200,24,68,35.3,19,39,48.7,5,29,17.2,2,6,33.3,11,23,34,8,13,19,9,4,55,0
19603,456441,508_15_57,ICELAND,0,TOTALS,ICELAND,200,33,70,47.1,26,36,72.2,7,34,20.6,11,15,73.3,12,35,47,16,13,13,8,7,84,1
19604,456454,508_15_58,SLOVENIA,0,TOTALS,SLOVENIA,200,33,62,53.2,25,36,69.4,8,26,30.8,11,18,61.1,14,27,41,16,20,17,11,4,85,1
19605,456467,508_15_58,HUNGARY,0,TOTALS,HUNGARY,200,18,53,34.0,12,30,40.0,6,23,26.1,6,13,46.2,6,19,25,7,23,22,5,0,48,0
19606,456480,508_15_59,SLOVAK REPUBLIC,0,TOTALS,SLOVAK REPUBLIC,200,22,60,36.7,16,30,53.3,6,30,20.0,10,15,66.7,16,22,38,10,22,25,8,2,60,0
19607,456493,508_15_59,SCOTLAND,0,TOTALS,SCOTLAND,200,25,60,41.7,15,37,40.5,10,23,43.5,6,9,66.7,14,21,35,20,18,26,11,1,66,1
19608,456506,508_15_60,ISRAEL,0,TOTALS,ISRAEL,200,30,79,38.0,27,61,44.3,3,18,16.7,5,10,50.0,13,31,44,13,19,8,6,5,68,0
19609,456519,508_15_60,DENMARK,0,TOTALS,DENMARK,200,33,74,44.6,26,50,52.0,7,24,29.2,8,15,53.3,13,39,52,17,18,13,5,2,81,1
19610,456532,508_15_61,BULGARIA,0,TOTALS,BULGARIA,200,32,69,46.4,24,47,51.1,8,22,36.4,3,7,42.9,8,33,41,19,17,17,6,9,75,1
19611,456545,508_15_61,LUXEMBOURG,0,TOTALS,LUXEMBOURG,200,24,66,36.4,18,51,35.3,6,15,40.0,9,16,56.2,10,30,40,11,16,16,10,3,63,0
19612,456558,508_15_62,SCOTLAND,0,TOTALS,SCOTLAND,200,31,71,43.7,21,42,50.0,10,29,34.5,8,15,53.3,11,15,26,10,28,13,9,0,80,0
19613,456571,508_15_62,MKD,0,TOTALS,MKD,200,27,54,50.0,21,35,60.0,6,19,31.6,28,42,66.7,16,26,42,8,20,22,6,0,88,1
19614,456584,508_15_63,SLOVAK REPUBLIC,0,TOTALS,SLOVAK REPUBLIC,200,30,67,44.8,19,38,50.0,11,29,37.9,14,17,82.4,13,36,49,28,25,23,7,0,85,1
19615,456597,508_15_63,IRELAND,0,TOTALS,IRELAND,200,18,68,26.5,13,41,31.7,5,27,18.5,13,22,59.1,18,22,40,10,18,19,15,2,54,0
19616,456610,508_15_64,ESTONIA,0,TOTALS,ESTONIA,200,26,63,41.3,22,45,48.9,4,18,22.2,11,18,61.1,9,24,33,8,20,13,3,0,67,0
19617,456623,508_15_64,BELGIUM,0,TOTALS,BELGIUM,200,35,69,50.7,31,60,51.7,4,9,44.4,11,19,57.9,9,22,31,11,17,5,9,2,85,1
19618,456636,508_15_65,PORTUGAL,0,TOTALS,PORTUGAL,225,27,64,42.2,19,38,50.0,8,26,30.8,16,26,61.5,12,23,35,17,28,24,13,2,78,1
19619,456649,508_15_65,AUSTRIA,0,TOTALS,AUSTRIA,225,24,58,41.4,22,44,50.0,2,14,14.3,25,32,78.1,12,30,42,8,30,27,9,2,75,0
19620,456662,508_15_66,ALBANIA,0,TOTALS,ALBANIA,200,24,64,37.5,21,51,41.2,3,13,23.1,8,14,57.1,7,15,22,15,21,17,15,2,59,0
19621,456675,508_15_66,BELARUS,0,TOTALS,BELARUS,200,30,63,47.6,24,38,63.2,6,25,24.0,15,19,78.9,16,36,52,18,14,26,14,7,81,1
19622,456688,508_15_67,SWEDEN,0,TOTALS,SWEDEN,200,30,65,46.2,20,34,58.8,10,31,32.3,10,15,66.7,10,33,43,17,26,14,2,5,80,0
19623,456701,508_15_67,ISRAEL,0,TOTALS,ISRAEL,200,26,62,41.9,18,43,41.9,8,19,42.1,23,34,67.6,8,25,33,14,20,7,7,1,83,1
19624,456714,508_15_68,SWITZERLAND,0,TOTALS,SWITZERLAND,200,21,56,37.5,12,30,40.0,9,26,34.6,5,9,55.6,10,21,31,14,13,21,9,1,56,0
19625,456727,508_15_68,NETHERLANDS,0,TOTALS,NETHERLANDS,200,25,54,46.3,21,35,60.0,4,19,21.1,9,13,69.2,8,26,34,15,16,18,10,2,63,1
19626,456740,508_15_69,ROMANIA,0,TOTALS,ROMANIA,200,36,71,50.7,31,54,57.4,5,17,29.4,6,9,66.7,10,22,32,22,24,13,13,4,83,1
19627,456753,508_15_69,DENMARK,0,TOTALS,DENMARK,200,30,61,49.2,25,48,52.1,5,13,38.5,13,21,61.9,13,26,39,13,16,21,10,1,78,0
19628,456766,508_15_70,POLAND,0,TOTALS,POLAND,200,30,61,49.2,25,44,56.8,5,17,29.4,13,24,54.2,13,32,45,19,16,17,9,4,78,1
19629,456779,508_15_70,HUNGARY,0,TOTALS,HUNGARY,200,16,55,29.1,12,36,33.3,4,19,21.1,7,11,63.6,8,21,29,7,25,23,7,0,43,0
19630,456792,508_15_71,ENGLAND,0,TOTALS,ENGLAND,200,22,60,36.7,20,46,43.5,2,14,14.3,9,16,56.2,10,21,31,7,18,18,8,3,55,0
19631,456805,508_15_71,SLOVENIA,0,TOTALS,SLOVENIA,200,30,59,50.8,24,42,57.1,6,17,35.3,10,12,83.3,7,31,38,15,21,18,9,1,76,1
19632,456818,508_15_72,GEORGIA,0,TOTALS,GEORGIA,200,31,61,50.8,14,26,53.8,17,35,48.6,8,12,66.7,8,27,35,26,14,16,4,5,87,1
19633,456831,508_15_72,ICELAND,0,TOTALS,ICELAND,200,32,68,47.1,20,39,51.3,12,29,41.4,9,11,81.8,8,24,32,12,15,11,7,5,85,0
19634,456844,508_15_73,BELARUS,0,TOTALS,BELARUS,200,29,75,38.7,25,61,41.0,4,14,28.6,12,20,60.0,20,31,51,17,23,16,7,2,74,0
19635,456857,508_15_73,BULGARIA,0,TOTALS,BULGARIA,200,27,66,40.9,23,46,50.0,4,20,20.0,17,26,65.4,11,29,40,13,22,14,9,3,75,1
19636,456870,508_15_74,LUXEMBOURG,0,TOTALS,LUXEMBOURG,200,11,51,21.6,10,40,25.0,1,11,9.1,14,32,43.8,13,20,33,3,18,19,9,1,37,0
19637,456883,508_15_74,ALBANIA,0,TOTALS,ALBANIA,200,24,61,39.3,21,45,46.7,3,16,18.8,11,13,84.6,16,35,51,15,28,21,9,1,62,1
19638,456896,508_15_75,MKD,0,TOTALS,MKD,200,27,59,45.8,23,42,54.8,4,17,23.5,11,22,50.0,7,23,30,11,19,15,9,1,69,0
19639,456909,508_15_75,SLOVAK REPUBLIC,0,TOTALS,SLOVAK REPUBLIC,200,29,75,38.7,16,34,47.1,13,41,31.7,8,15,53.3,22,26,48,17,21,18,6,3,79,1
19640,456922,508_15_76,NETHERLANDS,0,TOTALS,NETHERLANDS,200,29,79,36.7,26,65,40.0,3,14,21.4,8,15,53.3,23,23,46,19,25,12,14,3,69,1
19641,456935,508_15_76,ESTONIA,0,TOTALS,ESTONIA,200,16,50,32.0,10,31,32.3,6,19,31.6,19,23,82.6,12,30,42,10,18,25,4,5,57,0
19642,456948,508_15_77,AUSTRIA,0,TOTALS,AUSTRIA,200,22,63,34.9,18,48,37.5,4,15,26.7,15,17,88.2,15,25,40,9,21,17,7,1,63,1
19643,456961,508_15_77,ROMANIA,0,TOTALS,ROMANIA,200,21,54,38.9,18,35,51.4,3,19,15.8,13,22,59.1,9,24,33,8,22,20,9,0,58,0
19644,456974,508_15_78,IRELAND,0,TOTALS,IRELAND,200,33,68,48.5,26,44,59.1,7,24,29.2,5,13,38.5,15,33,48,18,22,22,5,7,78,0
19645,456987,508_15_78,SCOTLAND,0,TOTALS,SCOTLAND,200,30,76,39.5,23,59,39.0,7,17,41.2,15,28,53.6,17,25,42,14,20,12,17,2,82,1
19646,457000,508_15_79,HUNGARY,0,TOTALS,HUNGARY,200,24,60,40.0,15,32,46.9,9,28,32.1,15,19,78.9,5,28,33,9,20,13,8,3,72,1
19647,457013,508_15_79,ENGLAND,0,TOTALS,ENGLAND,200,25,56,44.6,21,40,52.5,4,16,25.0,17,23,73.9,7,31,38,8,17,16,4,0,71,0
19648,457026,508_15_80,ISRAEL,0,TOTALS,ISRAEL,200,46,87,52.9,38,63,60.3,8,24,33.3,7,10,70.0,15,34,49,28,24,12,17,4,107,0
19649,457039,508_15_80,GEORGIA,0,TOTALS,GEORGIA,200,21,57,36.8,16,37,43.2,5,20,25.0,20,35,57.1,10,27,37,13,14,24,8,0,67,1
19650,457052,508_15_81,BELGIUM,0,TOTALS,BELGIUM,200,36,54,66.7,30,39,76.9,6,15,40.0,7,11,63.6,5,25,30,20,13,18,12,3,85,1
19651,457065,508_15_81,SWITZERLAND,0,TOTALS,SWITZERLAND,200,21,52,40.4,17,33,51.5,4,19,21.1,8,13,61.5,8,15,23,6,10,22,9,2,54,0
19652,457078,508_15_82,SLOVENIA,0,TOTALS,SLOVENIA,200,30,60,50.0,23,41,56.1,7,19,36.8,13,18,72.2,15,18,33,14,20,18,5,5,80,1
19653,457091,508_15_82,POLAND,0,TOTALS,POLAND,200,29,52,55.8,24,40,60.0,5,12,41.7,7,14,50.0,7,17,24,9,22,18,10,4,70,0
19654,457104,508_15_83,ICELAND,0,TOTALS,ICELAND,200,26,67,38.8,23,45,51.1,3,22,13.6,10,13,76.9,10,28,38,10,17,11,9,0,65,1
19655,457117,508_15_83,SWEDEN,0,TOTALS,SWEDEN,200,24,60,40.0,16,40,40.0,8,20,40.0,7,14,50.0,10,31,41,10,21,19,2,7,63,0
19656,457130,508_15_84,DENMARK,0,TOTALS,DENMARK,200,33,59,55.9,28,41,68.3,5,18,27.8,11,26,42.3,10,34,44,13,22,18,5,4,82,1
19657,457143,508_15_84,PORTUGAL,0,TOTALS,PORTUGAL,200,24,72,33.3,16,37,43.2,8,35,22.9,21,25,84.0,15,23,38,11,24,11,7,2,77,0
19658,457156,508_15_85,ALBANIA,0,TOTALS,ALBANIA,200,23,71,32.4,15,43,34.9,8,28,28.6,17,22,77.3,15,24,39,10,31,11,8,5,71,0
19659,457169,508_15_85,MKD,0,TOTALS,MKD,200,23,53,43.4,20,36,55.6,3,17,17.6,25,37,67.6,10,33,43,13,19,16,3,10,74,1
19660,457182,508_15_86,IRELAND,0,TOTALS,IRELAND,200,30,78,38.5,20,48,41.7,10,30,33.3,7,22,31.8,18,39,57,21,19,20,10,3,77,1
19661,457195,508_15_86,LUXEMBOURG,0,TOTALS,LUXEMBOURG,200,28,75,37.3,23,54,42.6,5,21,23.8,6,13,46.2,10,35,45,21,19,20,7,2,67,0
19662,457208,508_15_87,SWITZERLAND,0,TOTALS,SWITZERLAND,200,21,59,35.6,16,42,38.1,5,17,29.4,9,12,75.0,9,35,44,10,14,22,11,3,56,1
19663,457221,508_15_87,ROMANIA,0,TOTALS,ROMANIA,200,20,63,31.7,18,41,43.9,2,22,9.1,9,13,69.2,12,28,40,5,19,18,14,1,51,0
19664,457234,508_15_88,BULGARIA,0,TOTALS,BULGARIA,200,19,53,35.8,12,34,35.3,7,19,36.8,6,20,30.0,10,34,44,7,12,24,6,5,51,0
19665,457247,508_15_88,SLOVAK REPUBLIC,0,TOTALS,SLOVAK REPUBLIC,200,29,79,36.7,21,48,43.8,8,31,25.8,6,11,54.5,19,29,48,12,20,10,16,3,72,1
19666,457260,508_15_89,SCOTLAND,0,TOTALS,SCOTLAND,200,25,63,39.7,18,42,42.9,7,21,33.3,15,21,71.4,6,19,25,15,25,18,12,2,72,0
19667,457273,508_15_89,BELARUS,0,TOTALS,BELARUS,200,29,51,56.9,23,38,60.5,6,13,46.2,18,32,56.2,11,31,42,19,19,23,8,3,82,1
19668,457286,508_15_90,AUSTRIA,0,TOTALS,AUSTRIA,200,24,64,37.5,21,53,39.6,3,11,27.3,15,28,53.6,14,28,42,9,24,14,10,4,66,1
19669,457299,508_15_90,ESTONIA,0,TOTALS,ESTONIA,200,22,63,34.9,17,41,41.5,5,22,22.7,13,22,59.1,17,31,48,14,26,19,5,7,62,0
19670,457312,508_15_91,DENMARK,0,TOTALS,DENMARK,200,19,57,33.3,12,31,38.7,7,26,26.9,11,19,57.9,6,33,39,11,15,16,10,2,56,1
19671,457325,508_15_91,NETHERLANDS,0,TOTALS,NETHERLANDS,200,22,68,32.4,21,48,43.8,1,20,5.0,7,12,58.3,14,31,45,12,20,17,4,5,52,0
19672,457338,508_15_92,HUNGARY,0,TOTALS,HUNGARY,200,23,55,41.8,16,34,47.1,7,21,33.3,22,30,73.3,10,31,41,13,27,18,15,1,75,1
19673,457351,508_15_92,GEORGIA,0,TOTALS,GEORGIA,200,23,63,36.5,18,35,51.4,5,28,17.9,19,28,67.9,12,26,38,11,24,18,6,0,70,0
19674,457364,508_15_93,ISRAEL,0,TOTALS,ISRAEL,200,31,77,40.3,23,53,43.4,8,24,33.3,8,13,61.5,15,33,48,15,18,13,8,4,78,1
19675,457377,508_15_93,POLAND,0,TOTALS,POLAND,200,23,64,35.9,14,34,41.2,9,30,30.0,7,13,53.8,10,33,43,13,17,21,6,8,62,0
19676,457390,508_15_94,BELGIUM,0,TOTALS,BELGIUM,200,27,58,46.6,23,44,52.3,4,14,28.6,9,15,60.0,11,28,39,18,18,21,14,7,67,1
19677,457403,508_15_94,PORTUGAL,0,TOTALS,PORTUGAL,200,22,60,36.7,19,35,54.3,3,25,12.0,14,21,66.7,13,25,38,13,17,19,9,1,61,0
19678,457416,508_15_95,ICELAND,0,TOTALS,ICELAND,200,27,63,42.9,21,41,51.2,6,22,27.3,11,15,73.3,11,36,47,13,16,25,8,3,71,1
19679,457429,508_15_95,ENGLAND,0,TOTALS,ENGLAND,200,25,76,32.9,21,63,33.3,4,13,30.8,13,16,81.2,16,26,42,5,20,14,11,2,67,0
19680,457442,508_15_96,SLOVENIA,0,TOTALS,SLOVENIA,200,30,70,42.9,24,48,50.0,6,22,27.3,5,13,38.5,12,16,28,11,28,9,6,7,71,0
19681,457455,508_15_96,SWEDEN,0,TOTALS,SWEDEN,200,24,47,51.1,17,32,53.1,7,15,46.7,23,33,69.7,7,29,36,11,20,17,4,7,78,1
19682,457468,508_15_97,BULGARIA,0,TOTALS,BULGARIA,200,28,72,38.9,26,51,51.0,2,21,9.5,15,32,46.9,13,40,53,13,23,14,8,2,73,1
19683,457481,508_15_97,SCOTLAND,0,TOTALS,SCOTLAND,200,22,73,30.1,18,45,40.0,4,28,14.3,14,26,53.8,17,42,59,7,28,20,9,2,62,0
19684,457494,508_15_98,ROMANIA,0,TOTALS,ROMANIA,200,24,65,36.9,19,47,40.4,5,18,27.8,4,6,66.7,15,21,36,11,23,20,10,3,57,0
19685,457507,508_15_98,ESTONIA,0,TOTALS,ESTONIA,200,33,60,55.0,28,44,63.6,5,16,31.2,6,19,31.6,14,27,41,16,15,17,10,8,77,1
19686,457520,508_15_99,MKD,0,TOTALS,MKD,200,34,68,50.0,31,52,59.6,3,16,18.8,13,19,68.4,8,34,42,15,19,20,13,5,84,1
19687,457533,508_15_99,IRELAND,0,TOTALS,IRELAND,200,27,70,38.6,21,47,44.7,6,23,26.1,10,15,66.7,10,29,39,18,19,21,12,1,70,0
19688,457779,509_15_01,AZERBAIJAN,0,TOTALS,AZERBAIJAN,200,25,57,43.9,24,44,54.5,1,13,7.7,10,25,40.0,10,39,49,9,19,20,6,10,61,1
19689,457792,509_15_01,ANDORRA,0,TOTALS,ANDORRA,200,19,69,27.5,14,45,31.1,5,24,20.8,12,22,54.5,16,27,43,9,23,16,14,1,55,0
19690,457805,509_15_02,MALTA,0,TOTALS,MALTA,200,21,81,25.9,20,65,30.8,1,16,6.2,5,15,33.3,23,45,68,3,23,25,14,7,48,0
19691,457818,509_15_02,GIBRALTAR,0,TOTALS,GIBRALTAR,200,20,88,22.7,18,67,26.9,2,21,9.5,8,21,38.1,29,40,69,4,18,22,11,6,50,1
19692,457831,509_15_03,ANDORRA,0,TOTALS,ANDORRA,200,31,83,37.3,29,59,49.2,2,24,8.3,11,21,52.4,26,39,65,6,19,19,11,5,75,1
19693,457844,509_15_03,WALES,0,TOTALS,WALES,200,25,75,33.3,19,49,38.8,6,26,23.1,7,18,38.9,16,31,47,6,19,17,9,3,63,0
19694,457857,509_15_04,GIBRALTAR,0,TOTALS,GIBRALTAR,200,20,70,28.6,19,53,35.8,1,17,5.9,10,20,50.0,19,31,50,3,15,18,9,0,51,0
19695,457870,509_15_04,SAN MARINO,0,TOTALS,SAN MARINO,200,31,63,49.2,22,40,55.0,9,23,39.1,5,14,35.7,4,35,39,7,21,17,11,2,76,1
19696,457883,509_15_05,SAN MARINO,0,TOTALS,SAN MARINO,200,14,65,21.5,8,47,17.0,6,18,33.3,6,22,27.3,9,35,44,3,22,26,13,3,40,0
19697,457896,509_15_05,MALTA,0,TOTALS,MALTA,200,29,75,38.7,27,61,44.3,2,14,14.3,12,25,48.0,17,52,69,10,25,24,17,1,72,1
19698,457909,509_15_06,WALES,0,TOTALS,WALES,200,28,92,30.4,21,57,36.8,7,35,20.0,11,19,57.9,22,31,53,11,15,14,14,1,74,0
19699,457921,509_15_06,AZERBAIJAN,0,TOTALS,AZERBAIJAN,200,33,72,45.8,25,47,53.2,8,25,32.0,13,22,59.1,15,42,57,18,15,26,7,12,87,1
19700,457934,509_15_07,ANDORRA,0,TOTALS,ANDORRA,200,31,75,41.3,23,48,47.9,8,27,29.6,16,39,41.0,20,33,53,9,16,10,14,3,86,1
19701,457947,509_15_07,GIBRALTAR,0,TOTALS,GIBRALTAR,200,20,65,30.8,20,56,35.7,0,9,0.0,8,15,53.3,19,35,54,4,28,28,2,5,48,0
19702,457960,509_15_08,SAN MARINO,0,TOTALS,SAN MARINO,200,25,73,34.2,21,49,42.9,4,24,16.7,9,14,64.3,9,31,40,8,21,22,18,4,63,0
19703,457973,509_15_08,WALES,0,TOTALS,WALES,200,23,77,29.9,16,48,33.3,7,29,24.1,21,37,56.8,29,43,72,7,15,25,12,2,74,1
19704,457985,509_15_09,AZERBAIJAN,0,TOTALS,AZERBAIJAN,200,26,72,36.1,19,53,35.8,7,19,36.8,13,19,68.4,14,44,58,14,14,25,10,17,72,1
19705,457998,509_15_09,WALES,0,TOTALS,WALES,200,23,90,25.6,19,62,30.6,4,28,14.3,11,16,68.8,22,31,53,7,14,18,14,1,61,0
19706,458011,509_15_10,MALTA,0,TOTALS,MALTA,200,19,68,27.9,15,55,27.3,4,13,30.8,10,23,43.5,16,33,49,8,18,20,2,1,52,0
19707,458024,509_15_10,ANDORRA,0,TOTALS,ANDORRA,200,26,70,37.1,15,40,37.5,11,30,36.7,17,24,70.8,13,38,51,15,21,16,14,4,80,1
19708,458037,509_15_11,GIBRALTAR,0,TOTALS,GIBRALTAR,200,19,57,33.3,17,42,40.5,2,15,13.3,19,32,59.4,17,28,45,4,17,19,5,1,59,0
19709,458050,509_15_11,SAN MARINO,0,TOTALS,SAN MARINO,200,24,61,39.3,14,36,38.9,10,25,40.0,4,8,50.0,8,26,34,7,20,21,9,1,62,1
19710,458063,509_15_12,WALES,0,TOTALS,WALES,200,28,77,36.4,20,52,38.5,8,25,32.0,18,36,50.0,18,36,54,9,18,13,13,0,82,1
19711,458076,509_15_12,MALTA,0,TOTALS,MALTA,200,26,78,33.3,22,59,37.3,4,19,21.1,8,17,47.1,17,42,59,4,24,22,7,4,64,0
19712,458088,509_15_13,AZERBAIJAN,0,TOTALS,AZERBAIJAN,200,25,70,35.7,18,42,42.9,7,28,25.0,9,10,90.0,14,30,44,6,18,17,8,9,66,0
19713,458101,509_15_13,ANDORRA,0,TOTALS,ANDORRA,200,29,82,35.4,21,63,33.3,8,19,42.1,14,23,60.9,29,31,60,4,13,13,7,2,80,1
19714,462272,513_15_01,SERBIA,0,TOTALS,SERBIA,200,24,67,35.8,19,52,36.5,5,15,33.3,3,10,30.0,13,33,46,15,18,21,5,4,56,0
19715,462285,513_15_01,BOSNIA AND HERZEGOVINA,0,TOTALS,BOSNIA AND HERZEGOVINA,200,34,75,45.3,32,67,47.8,2,8,25.0,6,13,46.2,12,33,45,15,14,11,11,7,76,1
19716,462298,513_15_02,ITALY,0,TOTALS,ITALY,200,20,61,32.8,15,40,37.5,5,21,23.8,23,35,65.7,15,30,45,13,20,17,9,3,68,1
19717,462311,513_15_02,FINLAND,0,TOTALS,FINLAND,200,22,58,37.9,14,39,35.9,8,19,42.1,13,24,54.2,9,30,39,15,25,19,9,4,65,0
19718,462324,513_15_03,FRANCE,0,TOTALS,FRANCE,200,27,68,39.7,21,38,55.3,6,30,20.0,6,17,35.3,22,22,44,18,18,15,13,4,66,1
19719,462337,513_15_03,CROATIA,0,TOTALS,CROATIA,200,21,49,42.9,15,33,45.5,6,16,37.5,13,17,76.5,9,24,33,9,20,23,7,2,61,0
19720,462350,513_15_04,GERMANY,0,TOTALS,GERMANY,200,24,61,39.3,22,47,46.8,2,14,14.3,11,16,68.8,12,30,42,8,15,28,17,2,61,1
19721,462363,513_15_04,ENGLAND,0,TOTALS,ENGLAND,200,22,69,31.9,14,42,33.3,8,27,29.6,4,10,40.0,17,27,44,13,19,28,11,7,56,0
19722,462376,513_15_05,SPAIN,0,TOTALS,SPAIN,200,20,59,33.9,19,44,43.2,1,15,6.7,20,37,54.1,8,33,41,11,26,18,15,4,61,0
19723,462389,513_15_05,LITHUANIA,0,TOTALS,LITHUANIA,200,24,67,35.8,17,39,43.6,7,28,25.0,11,33,33.3,19,38,57,16,30,21,10,5,66,1
19724,462402,513_15_06,GREECE,0,TOTALS,GREECE,200,26,66,39.4,15,31,48.4,11,35,31.4,17,34,50.0,16,38,54,21,24,19,13,3,80,1
19725,462415,513_15_06,ISRAEL,0,TOTALS,ISRAEL,200,23,64,35.9,18,37,48.6,5,27,18.5,14,26,53.8,8,30,38,13,29,17,13,2,65,0
19726,462428,513_15_07,LATVIA,0,TOTALS,LATVIA,200,17,62,27.4,12,36,33.3,5,26,19.2,8,12,66.7,15,29,44,7,23,21,5,5,47,0
19727,462441,513_15_07,MONTENEGRO,0,TOTALS,MONTENEGRO,200,22,64,34.4,18,51,35.3,4,13,30.8,16,25,64.0,13,29,42,12,19,13,12,3,64,1
19728,462454,513_15_08,BOSNIA AND HERZEGOVINA,0,TOTALS,BOSNIA AND HERZEGOVINA,200,31,71,43.7,27,61,44.3,4,10,40.0,11,20,55.0,25,45,70,19,13,33,6,5,77,1
19729,462467,513_15_08,ITALY,0,TOTALS,ITALY,200,25,84,29.8,19,51,37.3,6,33,18.2,9,14,64.3,15,18,33,16,18,13,23,11,65,0
19730,462480,513_15_09,ENGLAND,0,TOTALS,ENGLAND,200,29,77,37.7,22,58,37.9,7,19,36.8,12,24,50.0,16,26,42,17,21,22,13,2,77,0
19731,462493,513_15_09,TURKEY,0,TOTALS,TURKEY,200,34,80,42.5,32,62,51.6,2,18,11.1,21,28,75.0,21,36,57,15,20,23,16,9,91,1
19732,462506,513_15_10,FINLAND,0,TOTALS,FINLAND,200,25,83,30.1,20,55,36.4,5,28,17.9,15,20,75.0,17,25,42,14,26,15,16,5,70,1
19733,462519,513_15_10,SERBIA,0,TOTALS,SERBIA,200,20,54,37.0,17,41,41.5,3,13,23.1,22,29,75.9,10,40,50,13,19,32,6,3,65,0
19734,462532,513_15_11,LITHUANIA,0,TOTALS,LITHUANIA,200,21,58,36.2,14,33,42.4,7,25,28.0,20,31,64.5,14,33,47,16,19,16,11,5,69,1
19735,462545,513_15_11,GREECE,0,TOTALS,GREECE,200,19,65,29.2,14,40,35.0,5,25,20.0,8,12,66.7,13,25,38,8,28,19,9,2,51,0
19736,462558,513_15_12,CROATIA,0,TOTALS,CROATIA,200,30,78,38.5,25,56,44.6,5,22,22.7,12,15,80.0,15,35,50,21,21,16,12,3,77,1
19737,462571,513_15_12,LATVIA,0,TOTALS,LATVIA,200,23,65,35.4,17,39,43.6,6,26,23.1,12,20,60.0,11,33,44,14,16,20,9,3,64,0
19738,462584,513_15_13,ISRAEL,0,TOTALS,ISRAEL,200,29,72,40.3,16,36,44.4,13,36,36.1,6,9,66.7,10,27,37,17,28,20,5,3,77,0
19739,462597,513_15_13,SPAIN,0,TOTALS,SPAIN,200,29,68,42.6,20,43,46.5,9,25,36.0,17,30,56.7,16,34,50,23,14,18,11,3,84,1
19740,462610,513_15_14,MONTENEGRO,0,TOTALS,MONTENEGRO,200,21,47,44.7,15,28,53.6,6,19,31.6,14,23,60.9,8,23,31,11,20,18,10,1,62,0
19741,462623,513_15_14,FRANCE,0,TOTALS,FRANCE,200,26,57,45.6,21,38,55.3,5,19,26.3,7,12,58.3,11,21,32,16,22,14,8,1,64,1
19742,462636,513_15_15,TURKEY,0,TOTALS,TURKEY,200,30,68,44.1,27,54,50.0,3,14,21.4,11,17,64.7,15,36,51,5,19,22,14,9,74,1
19743,462649,513_15_15,GERMANY,0,TOTALS,GERMANY,200,18,70,25.7,17,54,31.5,1,16,6.2,8,11,72.7,17,26,43,9,21,22,8,4,45,0
19744,462662,513_15_16,ISRAEL,0,TOTALS,ISRAEL,200,23,60,38.3,18,40,45.0,5,20,25.0,19,33,57.6,13,30,43,14,26,19,8,3,70,0
19745,462675,513_15_16,LITHUANIA,0,TOTALS,LITHUANIA,200,35,77,45.5,20,34,58.8,15,43,34.9,11,26,42.3,21,28,49,24,23,14,9,2,96,1
19746,462688,513_15_17,SERBIA,0,TOTALS,SERBIA,200,28,63,44.4,20,53,37.7,8,10,80.0,15,22,68.2,14,28,42,14,21,19,7,6,79,1
19747,462701,513_15_17,ITALY,0,TOTALS,ITALY,200,28,69,40.6,24,55,43.6,4,14,28.6,17,22,77.3,12,23,35,10,22,12,13,10,77,0
19748,462714,513_15_18,FINLAND,0,TOTALS,FINLAND,200,27,70,38.6,20,44,45.5,7,26,26.9,21,36,58.3,7,31,38,19,30,18,12,4,82,1
19749,462727,513_15_18,BOSNIA AND HERZEGOVINA,0,TOTALS,BOSNIA AND HERZEGOVINA,200,22,63,34.9,17,39,43.6,5,24,20.8,29,40,72.5,11,44,55,17,32,24,9,3,78,0
19750,462740,513_15_19,MONTENEGRO,0,TOTALS,MONTENEGRO,200,26,75,34.7,22,50,44.0,4,25,16.0,4,10,40.0,13,31,44,5,19,15,12,4,60,1
19751,462753,513_15_19,CROATIA,0,TOTALS,CROATIA,200,21,60,35.0,17,42,40.5,4,18,22.2,13,18,72.2,10,37,47,8,18,24,5,8,59,0
19752,462766,513_15_20,SPAIN,0,TOTALS,SPAIN,200,27,69,39.1,22,46,47.8,5,23,21.7,13,29,44.8,20,32,52,21,18,17,14,6,72,1
19753,462779,513_15_20,GREECE,0,TOTALS,GREECE,200,21,63,33.3,14,45,31.1,7,18,38.9,9,13,69.2,10,28,38,13,21,23,11,5,58,0
19754,462792,513_15_21,FRANCE,0,TOTALS,FRANCE,200,17,58,29.3,12,32,37.5,5,26,19.2,8,18,44.4,15,34,49,13,19,19,10,3,47,1
19755,462805,513_15_21,LATVIA,0,TOTALS,LATVIA,200,15,56,26.8,15,41,36.6,0,15,0.0,5,11,45.5,10,28,38,3,20,18,4,2,35,0
19756,462818,513_15_22,SERBIA,0,TOTALS,SERBIA,200,31,65,47.7,28,52,53.8,3,13,23.1,4,9,44.4,12,30,42,14,16,13,5,2,69,1
19757,462831,513_15_22,FRANCE,0,TOTALS,FRANCE,200,26,69,37.7,20,49,40.8,6,20,30.0,4,8,50.0,13,25,38,11,15,11,6,3,62,0
19758,462844,513_15_23,ISRAEL,0,TOTALS,ISRAEL,200,26,71,36.6,18,49,36.7,8,22,36.4,13,21,61.9,16,31,47,19,25,17,4,2,73,0
19759,462857,513_15_23,ITALY,0,TOTALS,ITALY,200,30,61,49.2,21,37,56.8,9,24,37.5,15,29,51.7,6,34,40,23,19,11,12,10,84,1
19760,462870,513_15_24,CROATIA,0,TOTALS,CROATIA,200,24,64,37.5,19,47,40.4,5,17,29.4,22,35,62.9,18,37,55,8,23,23,7,1,75,0
19761,462883,513_15_24,FINLAND,0,TOTALS,FINLAND,200,29,78,37.2,19,44,43.2,10,34,29.4,16,22,72.7,13,25,38,15,28,11,12,4,84,1
19762,462896,513_15_25,GREECE,0,TOTALS,GREECE,200,22,67,32.8,16,39,41.0,6,28,21.4,13,21,61.9,10,22,32,12,26,23,12,4,63,0
19763,462909,513_15_25,TURKEY,0,TOTALS,TURKEY,200,26,70,37.1,19,45,42.2,7,25,28.0,28,36,77.8,22,36,58,22,23,22,12,3,87,1
19764,462922,513_15_26,ENGLAND,0,TOTALS,ENGLAND,200,25,64,39.1,20,47,42.6,5,17,29.4,12,19,63.2,9,22,31,11,23,26,8,3,67,1
19765,462935,513_15_26,LITHUANIA,0,TOTALS,LITHUANIA,200,40,80,50.0,30,59,50.8,10,21,47.6,12,20,60.0,22,29,51,24,23,20,11,8,102,0
19766,462948,513_15_27,SPAIN,0,TOTALS,SPAIN,200,31,68,45.6,23,46,50.0,8,22,36.4,6,13,46.2,17,29,46,14,16,12,8,3,76,1
19767,462961,513_15_27,GERMANY,0,TOTALS,GERMANY,200,21,59,35.6,15,37,40.5,6,22,27.3,6,9,66.7,8,24,32,14,16,15,7,2,54,0
19768,462974,513_15_28,MONTENEGRO,0,TOTALS,MONTENEGRO,200,29,71,40.8,24,51,47.1,5,20,25.0,14,18,77.8,15,25,40,17,19,12,13,1,77,1
19769,462987,513_15_28,BOSNIA AND HERZEGOVINA,0,TOTALS,BOSNIA AND HERZEGOVINA,200,29,66,43.9,25,47,53.2,4,19,21.1,11,26,42.3,19,26,45,15,18,19,8,5,73,0
19770,463000,513_15_29,CROATIA,0,TOTALS,CROATIA,200,29,77,37.7,22,58,37.9,7,19,36.8,6,12,50.0,16,26,42,12,20,16,8,4,71,0
19771,463013,513_15_29,SERBIA,0,TOTALS,SERBIA,200,29,63,46.0,26,47,55.3,3,16,18.8,14,19,73.7,8,33,41,16,19,16,8,4,75,1
19772,463026,513_15_30,LATVIA,0,TOTALS,LATVIA,200,22,56,39.3,15,36,41.7,7,20,35.0,17,30,56.7,9,34,43,15,17,27,10,5,68,0
19773,463039,513_15_30,ISRAEL,0,TOTALS,ISRAEL,200,26,76,34.2,15,38,39.5,11,38,28.9,14,19,73.7,16,31,47,15,30,22,16,7,77,1
19774,463052,513_15_31,GREECE,0,TOTALS,GREECE,200,19,80,23.8,17,53,32.1,2,27,7.4,10,18,55.6,14,33,47,6,18,11,19,6,50,0
19775,463065,513_15_31,ENGLAND,0,TOTALS,ENGLAND,200,22,69,31.9,14,39,35.9,8,30,26.7,8,12,66.7,15,50,65,14,21,25,4,8,60,1
19776,463078,513_15_32,GERMANY,0,TOTALS,GERMANY,200,27,59,45.8,19,44,43.2,8,15,53.3,15,23,65.2,12,27,39,19,19,19,13,1,77,1
19777,463091,513_15_32,LITHUANIA,0,TOTALS,LITHUANIA,200,24,57,42.1,16,30,53.3,8,27,29.6,14,23,60.9,10,23,33,14,22,20,8,4,70,0
19778,463104,513_15_33,BOSNIA AND HERZEGOVINA,0,TOTALS,BOSNIA AND HERZEGOVINA,200,25,55,45.5,18,35,51.4,7,20,35.0,7,13,53.8,8,33,41,19,17,21,5,2,64,1
19779,463117,513_15_33,FRANCE,0,TOTALS,FRANCE,200,22,69,31.9,15,41,36.6,7,28,25.0,6,13,46.2,18,25,43,13,15,17,10,6,57,0
19780,463130,513_15_34,TURKEY,0,TOTALS,TURKEY,200,28,69,40.6,25,53,47.2,3,16,18.8,5,9,55.6,17,26,43,11,17,21,9,7,64,0
19781,463143,513_15_34,SPAIN,0,TOTALS,SPAIN,200,29,71,40.8,15,41,36.6,14,30,46.7,3,6,50.0,16,23,39,21,19,19,12,4,75,1
19782,463156,513_15_35,FINLAND,0,TOTALS,FINLAND,200,23,74,31.1,13,44,29.5,10,30,33.3,2,8,25.0,16,29,45,15,18,11,9,5,58,1
19783,463169,513_15_35,MONTENEGRO,0,TOTALS,MONTENEGRO,200,20,63,31.7,18,46,39.1,2,17,11.8,14,18,77.8,16,39,55,13,16,16,7,3,56,0
19784,463182,513_15_36,GERMANY,0,TOTALS,GERMANY,200,29,65,44.6,20,43,46.5,9,22,40.9,10,15,66.7,21,27,48,16,20,22,9,2,77,1
19785,463195,513_15_36,GREECE,0,TOTALS,GREECE,200,21,52,40.4,13,31,41.9,8,21,38.1,9,19,47.4,7,17,24,10,18,20,12,7,59,0
19786,463208,513_15_37,ITALY,0,TOTALS,ITALY,200,20,63,31.7,17,42,40.5,3,21,14.3,15,20,75.0,16,29,45,9,22,26,23,11,58,1
19787,463220,513_15_37,LATVIA,0,TOTALS,LATVIA,200,18,66,27.3,15,44,34.1,3,22,13.6,10,16,62.5,22,29,51,4,21,31,12,3,49,0
19788,463233,513_15_38,LITHUANIA,0,TOTALS,LITHUANIA,200,23,67,34.3,17,36,47.2,6,31,19.4,12,20,60.0,12,36,48,15,24,19,5,3,64,0
19789,463246,513_15_38,TURKEY,0,TOTALS,TURKEY,200,23,75,30.7,16,51,31.4,7,24,29.2,14,28,50.0,21,36,57,12,21,16,14,7,67,1
19790,463259,513_15_39,SPAIN,0,TOTALS,SPAIN,200,31,69,44.9,31,56,55.4,0,13,0.0,13,22,59.1,17,28,45,16,15,19,15,4,75,1
19791,463272,513_15_39,ENGLAND,0,TOTALS,ENGLAND,200,25,60,41.7,16,34,47.1,9,26,34.6,5,11,45.5,11,24,35,11,19,27,6,2,64,0
19792,463285,513_15_40,MONTENEGRO,0,TOTALS,MONTENEGRO,200,23,56,41.1,17,38,44.7,6,18,33.3,12,18,66.7,11,22,33,9,24,15,4,3,64,0
19793,463298,513_15_40,SERBIA,0,TOTALS,SERBIA,200,27,62,43.5,17,38,44.7,10,24,41.7,14,15,93.3,12,24,36,14,17,13,8,4,78,1
19794,463311,513_15_41,FRANCE,0,TOTALS,FRANCE,200,21,57,36.8,15,35,42.9,6,22,27.3,9,13,69.2,11,32,43,14,13,18,10,4,57,1
19795,463324,513_15_41,FINLAND,0,TOTALS,FINLAND,200,14,51,27.5,12,37,32.4,2,14,14.3,8,14,57.1,8,25,33,4,16,20,12,3,38,0
19796,463337,513_15_42,BOSNIA AND HERZEGOVINA,0,TOTALS,BOSNIA AND HERZEGOVINA,200,32,75,42.7,27,54,50.0,5,21,23.8,17,27,63.0,19,33,52,24,20,14,13,9,86,1
19797,463350,513_15_42,CROATIA,0,TOTALS,CROATIA,200,19,65,29.2,16,48,33.3,3,17,17.6,18,25,72.0,14,27,41,9,27,18,8,4,59,0
19798,463363,513_15_43,GREECE,0,TOTALS,GREECE,200,18,55,32.7,15,37,40.5,3,18,16.7,6,19,31.6,4,31,35,14,18,21,12,6,45,0
19799,463376,513_15_43,ITALY,0,TOTALS,ITALY,200,23,60,38.3,17,34,50.0,6,26,23.1,10,18,55.6,10,40,50,18,17,21,12,3,62,1
19800,463389,513_15_44,SPAIN,0,TOTALS,SPAIN,200,28,67,41.8,21,45,46.7,7,22,31.8,9,19,47.4,16,28,44,13,17,11,5,6,72,1
19801,463402,513_15_44,FRANCE,0,TOTALS,FRANCE,200,24,67,35.8,20,46,43.5,4,21,19.0,11,21,52.4,17,26,43,14,19,11,6,1,63,0
19802,463415,513_15_45,ENGLAND,0,TOTALS,ENGLAND,200,26,67,38.8,20,43,46.5,6,24,25.0,7,15,46.7,12,28,40,15,21,20,13,9,65,0
19803,463427,513_15_45,LATVIA,0,TOTALS,LATVIA,200,25,74,33.8,19,52,36.5,6,22,27.3,10,18,55.6,22,29,51,16,18,21,8,2,66,1
19804,463440,513_15_46,BOSNIA AND HERZEGOVINA,0,TOTALS,BOSNIA AND HERZEGOVINA,200,27,67,40.3,20,52,38.5,7,15,46.7,9,17,52.9,13,38,51,14,18,19,11,3,70,1
19805,463453,513_15_46,GERMANY,0,TOTALS,GERMANY,200,19,74,25.7,14,51,27.5,5,23,21.7,11,15,73.3,18,30,48,10,18,19,6,3,54,0
19806,463466,513_15_47,CROATIA,0,TOTALS,CROATIA,200,30,65,46.2,25,43,58.1,5,22,22.7,19,30,63.3,13,38,51,21,21,23,7,4,84,1
19807,463479,513_15_47,ISRAEL,0,TOTALS,ISRAEL,200,24,76,31.6,14,34,41.2,10,42,23.8,24,26,92.3,14,23,37,14,28,15,12,1,82,0
19808,463492,513_15_48,FINLAND,0,TOTALS,FINLAND,200,25,62,40.3,16,40,40.0,9,22,40.9,15,22,68.2,7,19,26,13,24,17,12,3,74,0
19809,463505,513_15_48,LITHUANIA,0,TOTALS,LITHUANIA,200,35,67,52.2,23,41,56.1,12,26,46.2,11,20,55.0,16,32,48,20,23,26,8,4,93,1
19810,463518,513_15_49,TURKEY,0,TOTALS,TURKEY,200,35,70,50.0,31,51,60.8,4,19,21.1,13,26,50.0,21,36,57,12,19,15,5,3,87,1
19811,463531,513_15_49,SERBIA,0,TOTALS,SERBIA,200,24,66,36.4,18,48,37.5,6,18,33.3,12,15,80.0,7,19,26,12,24,11,5,1,66,0
19812,463544,513_15_50,ENGLAND,0,TOTALS,ENGLAND,200,28,73,38.4,22,51,43.1,6,22,27.3,15,29,51.7,13,36,49,12,24,13,10,6,77,1
19813,463557,513_15_50,ISRAEL,0,TOTALS,ISRAEL,200,25,71,35.2,16,42,38.1,9,29,31.0,17,26,65.4,14,39,53,12,25,18,4,3,76,0
19814,463570,513_15_51,FRANCE,0,TOTALS,FRANCE,200,23,70,32.9,20,53,37.7,3,17,17.6,8,14,57.1,16,28,44,9,17,11,9,5,57,1
19815,463583,513_15_51,GERMANY,0,TOTALS,GERMANY,200,20,69,29.0,17,49,34.7,3,20,15.0,12,15,80.0,21,35,56,11,17,16,4,5,55,0
19816,463596,513_15_52,MONTENEGRO,0,TOTALS,MONTENEGRO,200,21,53,39.6,16,33,48.5,5,20,25.0,18,32,56.2,10,31,41,9,24,20,4,0,65,0
19817,463609,513_15_52,ITALY,0,TOTALS,ITALY,200,27,69,39.1,20,40,50.0,7,29,24.1,12,20,60.0,13,27,40,15,28,11,10,4,73,1
19818,463622,513_15_53,FINLAND,0,TOTALS,FINLAND,200,24,67,35.8,18,46,39.1,6,21,28.6,14,22,63.6,13,33,46,12,19,16,12,8,68,1
19819,463635,513_15_53,SERBIA,0,TOTALS,SERBIA,200,24,71,33.8,22,56,39.3,2,15,13.3,13,16,81.2,14,34,48,10,21,17,8,4,63,0
19820,463647,513_15_54,LATVIA,0,TOTALS,LATVIA,200,23,73,31.5,13,34,38.2,10,39,25.6,14,20,70.0,16,26,42,12,25,15,6,2,70,0
19821,463660,513_15_54,CROATIA,0,TOTALS,CROATIA,200,24,64,37.5,20,52,38.5,4,12,33.3,26,30,86.7,15,35,50,19,25,18,11,2,78,1
19822,463673,513_15_55,LITHUANIA,0,TOTALS,LITHUANIA,200,24,64,37.5,14,36,38.9,10,28,35.7,15,20,75.0,12,27,39,13,26,17,9,7,73,1
19823,463686,513_15_55,TURKEY,0,TOTALS,TURKEY,200,24,65,36.9,17,48,35.4,7,17,41.2,16,26,61.5,14,30,44,10,20,19,11,6,71,0
19824,463699,513_15_56,SPAIN,0,TOTALS,SPAIN,250,25,79,31.6,17,42,40.5,8,37,21.6,20,27,74.1,19,39,58,12,22,22,9,5,78,0
19825,463712,513_15_56,BOSNIA AND HERZEGOVINA,0,TOTALS,BOSNIA AND HERZEGOVINA,250,29,89,32.6,21,60,35.0,8,29,27.6,20,30,66.7,24,37,61,11,20,18,15,6,86,1
19826,463725,513_15_57,GREECE,0,TOTALS,GREECE,200,30,61,49.2,25,43,58.1,5,18,27.8,12,16,75.0,8,31,39,26,22,18,16,5,77,1
19827,463737,513_15_57,ENGLAND,0,TOTALS,ENGLAND,200,18,63,28.6,14,38,36.8,4,25,16.0,12,23,52.2,18,24,42,10,19,23,8,4,52,0
19828,463750,513_15_58,GERMANY,0,TOTALS,GERMANY,200,38,75,50.7,29,59,49.2,9,16,56.2,6,8,75.0,14,30,44,23,7,10,8,4,91,1
19829,463763,513_15_58,SERBIA,0,TOTALS,SERBIA,200,29,66,43.9,25,52,48.1,4,14,28.6,2,2,100.0,6,22,28,16,12,15,6,7,64,0
19830,463775,513_15_59,MONTENEGRO,0,TOTALS,MONTENEGRO,200,19,59,32.2,15,40,37.5,4,19,21.1,15,23,65.2,13,30,43,17,23,21,3,3,57,0
19831,463787,513_15_59,LATVIA,0,TOTALS,LATVIA,200,21,55,38.2,19,40,47.5,2,15,13.3,16,26,61.5,9,29,38,16,26,17,10,1,60,1
19832,463800,513_15_60,FRANCE,0,TOTALS,FRANCE,200,29,66,43.9,18,42,42.9,11,24,45.8,6,9,66.7,11,37,48,17,10,15,4,3,75,1
19833,463813,513_15_60,FINLAND,0,TOTALS,FINLAND,200,20,60,33.3,16,35,45.7,4,25,16.0,2,6,33.3,5,24,29,10,17,14,7,7,46,0
19834,463826,513_15_61,ITALY,0,TOTALS,ITALY,200,25,73,34.2,15,34,44.1,10,39,25.6,8,14,57.1,14,31,45,18,23,11,6,8,68,0
19835,463839,513_15_61,CROATIA,0,TOTALS,CROATIA,200,27,65,41.5,20,51,39.2,7,14,50.0,15,21,71.4,10,37,47,19,19,13,3,2,76,1
19836,463852,513_15_62,SPAIN,0,TOTALS,SPAIN,200,24,73,32.9,18,47,38.3,6,26,23.1,18,31,58.1,18,29,47,15,17,11,8,2,72,0
19837,463865,513_15_62,TURKEY,0,TOTALS,TURKEY,200,33,71,46.5,21,46,45.7,12,25,48.0,5,9,55.6,11,34,45,19,25,17,6,7,83,1
19838,463878,513_15_63,BOSNIA AND HERZEGOVINA,0,TOTALS,BOSNIA AND HERZEGOVINA,200,31,65,47.7,24,50,48.0,7,15,46.7,16,25,64.0,12,37,49,13,23,18,6,5,85,1
19839,463891,513_15_63,LITHUANIA,0,TOTALS,LITHUANIA,200,33,82,40.2,26,57,45.6,7,25,28.0,10,15,66.7,15,28,43,15,23,9,11,3,83,0
19840,463904,514_15_01,ROMANIA,0,TOTALS,ROMANIA,200,20,68,29.4,11,39,28.2,9,29,31.0,6,11,54.5,8,39,47,10,24,19,9,2,55,0
19841,463917,514_15_01,POLAND,0,TOTALS,POLAND,200,24,73,32.9,20,57,35.1,4,16,25.0,11,24,45.8,16,43,59,16,18,16,11,4,63,1
19842,463930,514_15_02,IRELAND,0,TOTALS,IRELAND,200,22,62,35.5,17,43,39.5,5,19,26.3,16,22,72.7,12,25,37,12,18,17,8,3,65,0
19843,463943,514_15_02,AUSTRIA,0,TOTALS,AUSTRIA,200,26,66,39.4,17,33,51.5,9,33,27.3,13,22,59.1,19,29,48,16,24,20,6,1,74,1
19844,463956,514_15_03,GEORGIA,0,TOTALS,GEORGIA,200,21,54,38.9,19,38,50.0,2,16,12.5,2,10,20.0,5,30,35,12,17,19,3,6,46,0
19845,463969,514_15_03,BELGIUM,0,TOTALS,BELGIUM,200,21,60,35.0,17,43,39.5,4,17,23.5,14,18,77.8,11,31,42,10,16,11,10,1,60,1
19846,463982,514_15_04,SLOVAK REPUBLIC,0,TOTALS,SLOVAK REPUBLIC,200,25,59,42.4,16,32,50.0,9,27,33.3,5,14,35.7,10,31,41,13,19,24,17,2,64,1
19847,463995,514_15_04,DENMARK,0,TOTALS,DENMARK,200,16,55,29.1,13,37,35.1,3,18,16.7,12,22,54.5,11,28,39,8,19,24,15,3,47,0
19848,464008,514_15_05,NETHERLANDS,0,TOTALS,NETHERLANDS,200,20,65,30.8,14,38,36.8,6,27,22.2,4,15,26.7,13,36,49,10,23,19,9,3,50,0
19849,464021,514_15_05,SLOVENIA,0,TOTALS,SLOVENIA,200,19,59,32.2,14,42,33.3,5,17,29.4,16,26,61.5,10,38,48,8,16,19,9,2,59,1
19850,464034,514_15_06,ESTONIA,0,TOTALS,ESTONIA,200,27,61,44.3,19,36,52.8,8,25,32.0,9,13,69.2,13,31,44,11,20,18,10,7,71,1
19851,464047,514_15_06,SWEDEN,0,TOTALS,SWEDEN,200,19,63,30.2,15,47,31.9,4,16,25.0,7,14,50.0,16,23,39,8,17,20,7,2,49,0
19852,464060,514_15_07,SCOTLAND,0,TOTALS,SCOTLAND,200,13,57,22.8,12,44,27.3,1,13,7.7,5,10,50.0,9,32,41,9,16,42,20,4,32,0
19853,464073,514_15_07,BULGARIA,0,TOTALS,BULGARIA,200,37,78,47.4,29,53,54.7,8,25,32.0,8,21,38.1,16,37,53,19,8,26,26,3,90,1
19854,464086,514_15_08,LUXEMBOURG,0,TOTALS,LUXEMBOURG,200,24,59,40.7,20,45,44.4,4,14,28.6,16,26,61.5,5,37,42,11,21,22,12,1,68,0
19855,464099,514_15_08,SWITZERLAND,0,TOTALS,SWITZERLAND,200,27,75,36.0,19,53,35.8,8,22,36.4,10,18,55.6,14,35,49,18,23,17,16,3,72,1
19856,464112,514_15_09,ICELAND,0,TOTALS,ICELAND,200,16,55,29.1,10,36,27.8,6,19,31.6,14,22,63.6,12,23,35,9,16,24,6,3,52,0
19857,464125,514_15_09,PORTUGAL,0,TOTALS,PORTUGAL,200,27,63,42.9,21,40,52.5,6,23,26.1,6,19,31.6,19,31,50,11,24,21,14,6,66,1
19858,464138,514_15_10,NORWAY,0,TOTALS,NORWAY,200,13,63,20.6,12,43,27.9,1,20,5.0,10,13,76.9,14,27,41,4,15,31,20,1,37,0
19859,464151,514_15_10,CZECH REPUBLIC,0,TOTALS,CZECH REPUBLIC,200,25,60,41.7,18,43,41.9,7,17,41.2,4,9,44.4,9,35,44,9,15,29,21,1,61,1
19860,466477,514_15_100,SLOVENIA,0,TOTALS,SLOVENIA,200,25,59,42.4,17,37,45.9,8,22,36.4,11,13,84.6,11,26,37,16,15,19,13,0,69,1
19861,466490,514_15_100,NETHERLANDS,0,TOTALS,NETHERLANDS,200,22,56,39.3,16,33,48.5,6,23,26.1,8,10,80.0,8,23,31,16,18,21,12,2,58,0
19862,466503,514_15_101,LUXEMBOURG,0,TOTALS,LUXEMBOURG,225,30,77,39.0,25,54,46.3,5,23,21.7,19,34,55.9,17,35,52,20,22,22,17,2,84,0
19863,466516,514_15_101,IRELAND,0,TOTALS,IRELAND,225,34,68,50.0,29,53,54.7,5,15,33.3,15,26,57.7,7,37,44,16,20,24,6,1,88,1
19864,466529,514_15_102,DENMARK,0,TOTALS,DENMARK,200,18,52,34.6,14,33,42.4,4,19,21.1,5,10,50.0,5,25,30,11,21,17,9,1,45,1
19865,466542,514_15_102,PORTUGAL,0,TOTALS,PORTUGAL,200,13,48,27.1,11,32,34.4,2,16,12.5,9,18,50.0,15,29,44,11,13,26,11,2,37,0
19866,466555,514_15_103,GEORGIA,0,TOTALS,GEORGIA,200,23,49,46.9,19,36,52.8,4,13,30.8,10,19,52.6,7,28,35,17,17,20,12,6,60,1
19867,466568,514_15_103,BELGIUM,0,TOTALS,BELGIUM,200,16,54,29.6,11,40,27.5,5,14,35.7,6,14,42.9,12,21,33,10,15,23,7,1,43,0
19868,466581,514_15_104,BELARUS,0,TOTALS,BELARUS,200,30,75,40.0,25,52,48.1,5,23,21.7,6,8,75.0,17,26,43,16,17,24,11,4,71,0
19869,466594,514_15_104,SCOTLAND,0,TOTALS,SCOTLAND,200,28,69,40.6,19,42,45.2,9,27,33.3,14,24,58.3,19,29,48,18,12,26,12,7,79,1
19870,466607,514_15_105,ROMANIA,0,TOTALS,ROMANIA,200,29,52,55.8,23,39,59.0,6,13,46.2,15,29,51.7,12,31,43,21,19,29,15,3,79,1
19871,466620,514_15_105,ICELAND,0,TOTALS,ICELAND,200,26,66,39.4,17,39,43.6,9,27,33.3,11,18,61.1,13,17,30,12,25,18,21,1,72,0
19872,466633,514_15_106,UKRAINE,0,TOTALS,UKRAINE,200,22,65,33.8,20,51,39.2,2,14,14.3,12,20,60.0,16,25,41,11,23,19,13,3,58,0
19873,466646,514_15_106,BULGARIA,0,TOTALS,BULGARIA,200,27,61,44.3,23,44,52.3,4,17,23.5,15,27,55.6,14,31,45,21,22,21,11,0,73,1
19874,466659,514_15_107,SWEDEN,0,TOTALS,SWEDEN,200,21,74,28.4,14,42,33.3,7,32,21.9,8,15,53.3,18,40,58,9,14,15,10,2,57,1
19875,466672,514_15_107,SLOVAK REPUBLIC,0,TOTALS,SLOVAK REPUBLIC,200,23,73,31.5,19,53,35.8,4,20,20.0,6,14,42.9,12,38,50,10,20,13,12,2,56,0
19876,466685,514_15_108,POLAND,0,TOTALS,POLAND,200,21,70,30.0,20,53,37.7,1,17,5.9,13,22,59.1,16,32,48,7,18,14,9,1,56,0
19877,466698,514_15_108,ESTONIA,0,TOTALS,ESTONIA,200,23,67,34.3,18,41,43.9,5,26,19.2,13,15,86.7,11,37,48,12,21,22,7,5,64,1
19878,464164,514_15_11,BELARUS,0,TOTALS,BELARUS,200,24,69,34.8,21,50,42.0,3,19,15.8,2,5,40.0,11,31,42,4,21,14,8,2,53,0
19879,464177,514_15_11,HUNGARY,0,TOTALS,HUNGARY,200,22,67,32.8,16,43,37.2,6,24,25.0,12,24,50.0,18,36,54,13,12,14,6,2,62,1
19880,464190,514_15_12,MKD,0,TOTALS,MKD,200,24,69,34.8,22,46,47.8,2,23,8.7,14,20,70.0,10,26,36,10,25,17,10,7,64,0
19881,464203,514_15_12,UKRAINE,0,TOTALS,UKRAINE,200,28,70,40.0,23,51,45.1,5,19,26.3,25,32,78.1,17,39,56,14,21,16,5,3,86,1
19882,464216,514_15_13,DENMARK,0,TOTALS,DENMARK,200,36,79,45.6,27,54,50.0,9,25,36.0,7,13,53.8,21,28,49,25,24,20,20,1,88,1
19883,464229,514_15_13,SCOTLAND,0,TOTALS,SCOTLAND,200,15,50,30.0,9,22,40.9,6,28,21.4,8,20,40.0,11,25,36,11,20,33,9,4,44,0
19884,464242,514_15_14,AUSTRIA,0,TOTALS,AUSTRIA,200,19,52,36.5,15,29,51.7,4,23,17.4,16,25,64.0,6,28,34,7,19,21,6,2,58,0
19885,464255,514_15_14,NETHERLANDS,0,TOTALS,NETHERLANDS,200,31,79,39.2,18,31,58.1,13,48,27.1,9,13,69.2,19,30,49,22,22,16,10,0,84,1
19886,464268,514_15_15,SWEDEN,0,TOTALS,SWEDEN,200,33,69,47.8,26,47,55.3,7,22,31.8,9,15,60.0,10,35,45,19,16,16,16,3,82,1
19887,464281,514_15_15,ICELAND,0,TOTALS,ICELAND,200,17,62,27.4,13,35,37.1,4,27,14.8,4,9,44.4,13,26,39,8,18,28,6,1,42,0
19888,464294,514_15_16,POLAND,0,TOTALS,POLAND,200,31,69,44.9,22,46,47.8,9,23,39.1,8,17,47.1,16,36,52,20,21,12,7,4,79,1
19889,464307,514_15_16,SLOVAK REPUBLIC,0,TOTALS,SLOVAK REPUBLIC,200,21,74,28.4,16,48,33.3,5,26,19.2,4,10,40.0,18,27,45,9,21,12,7,2,51,0
19890,464320,514_15_17,SLOVENIA,0,TOTALS,SLOVENIA,200,32,64,50.0,26,50,52.0,6,14,42.9,12,23,52.2,16,32,48,18,18,17,9,4,82,1
19891,464333,514_15_17,NORWAY,0,TOTALS,NORWAY,200,19,66,28.8,13,47,27.7,6,19,31.6,14,20,70.0,16,23,39,5,19,19,9,8,58,0
19892,464346,514_15_18,SWITZERLAND,0,TOTALS,SWITZERLAND,200,20,58,34.5,15,36,41.7,5,22,22.7,2,7,28.6,8,20,28,12,20,29,15,2,47,0
19893,464359,514_15_18,GEORGIA,0,TOTALS,GEORGIA,200,35,69,50.7,30,50,60.0,5,19,26.3,8,17,47.1,20,32,52,18,11,26,19,4,83,1
19894,464372,514_15_19,BULGARIA,0,TOTALS,BULGARIA,200,24,77,31.2,22,61,36.1,2,16,12.5,8,16,50.0,27,33,60,18,19,33,20,4,58,1
19895,464385,514_15_19,ROMANIA,0,TOTALS,ROMANIA,200,19,64,29.7,15,47,31.9,4,17,23.5,8,11,72.7,13,30,43,10,21,34,20,6,50,0
19896,464398,514_15_20,HUNGARY,0,TOTALS,HUNGARY,200,27,58,46.6,19,41,46.3,8,17,47.1,15,23,65.2,9,24,33,15,16,16,8,1,77,1
19897,464411,514_15_20,LUXEMBOURG,0,TOTALS,LUXEMBOURG,200,26,57,45.6,22,41,53.7,4,16,25.0,14,17,82.4,9,25,34,19,21,18,10,1,70,0
19898,464424,514_15_21,UKRAINE,0,TOTALS,UKRAINE,200,25,76,32.9,22,62,35.5,3,14,21.4,11,21,52.4,16,21,37,12,19,18,13,2,64,0
19899,464437,514_15_21,ESTONIA,0,TOTALS,ESTONIA,200,35,64,54.7,22,40,55.0,13,24,54.2,12,19,63.2,10,37,47,25,21,25,9,7,95,1
19900,464450,514_15_22,CZECH REPUBLIC,0,TOTALS,CZECH REPUBLIC,200,32,80,40.0,21,51,41.2,11,29,37.9,18,29,62.1,23,28,51,18,24,14,10,2,93,1
19901,464463,514_15_22,IRELAND,0,TOTALS,IRELAND,200,29,70,41.4,22,50,44.0,7,20,35.0,18,30,60.0,16,31,47,12,24,15,4,4,83,0
19902,464476,514_15_23,BELGIUM,0,TOTALS,BELGIUM,200,31,63,49.2,27,52,51.9,4,11,36.4,15,21,71.4,19,36,55,19,14,26,9,2,81,1
19903,464489,514_15_23,BELARUS,0,TOTALS,BELARUS,200,15,56,26.8,12,44,27.3,3,12,25.0,4,13,30.8,10,13,23,9,18,25,13,3,37,0
19904,464502,514_15_24,PORTUGAL,0,TOTALS,PORTUGAL,200,13,70,18.6,12,53,22.6,1,17,5.9,13,19,68.4,23,26,49,7,25,12,6,2,40,0
19905,464515,514_15_24,MKD,0,TOTALS,MKD,200,16,51,31.4,13,38,34.2,3,13,23.1,16,23,69.6,13,36,49,7,24,16,2,6,51,1
19906,464528,514_15_25,POLAND,0,TOTALS,POLAND,200,28,64,43.8,22,49,44.9,6,15,40.0,19,33,57.6,17,32,49,11,22,21,13,5,81,1
19907,464541,514_15_25,DENMARK,0,TOTALS,DENMARK,200,25,64,39.1,22,46,47.8,3,18,16.7,9,17,52.9,11,23,34,9,26,22,7,3,62,0
19908,464554,514_15_26,NORWAY,0,TOTALS,NORWAY,200,26,63,41.3,18,39,46.2,8,24,33.3,15,25,60.0,13,25,38,7,25,15,13,4,75,1
19909,464567,514_15_26,AUSTRIA,0,TOTALS,AUSTRIA,200,23,56,41.1,13,33,39.4,10,23,43.5,14,26,53.8,14,30,44,10,20,22,7,1,70,0
19910,464580,514_15_27,GEORGIA,0,TOTALS,GEORGIA,200,30,59,50.8,25,45,55.6,5,14,35.7,12,16,75.0,13,40,53,18,24,26,9,7,77,1
19911,464593,514_15_27,LUXEMBOURG,0,TOTALS,LUXEMBOURG,200,12,56,21.4,5,32,15.6,7,24,29.2,12,24,50.0,8,17,25,10,15,23,15,2,43,0
19912,464606,514_15_28,ROMANIA,0,TOTALS,ROMANIA,200,41,81,50.6,28,54,51.9,13,27,48.1,4,9,44.4,15,36,51,20,20,23,23,3,99,1
19913,464619,514_15_28,SCOTLAND,0,TOTALS,SCOTLAND,200,14,62,22.6,12,37,32.4,2,25,8.0,7,24,29.2,18,27,45,3,11,36,14,6,37,0
19914,464632,514_15_29,NETHERLANDS,0,TOTALS,NETHERLANDS,200,28,72,38.9,21,44,47.7,7,28,25.0,11,24,45.8,14,38,52,18,17,18,16,2,74,1
19915,464645,514_15_29,IRELAND,0,TOTALS,IRELAND,200,12,60,20.0,10,40,25.0,2,20,10.0,6,12,50.0,9,32,41,7,20,28,5,3,32,0
19916,464658,514_15_30,UKRAINE,0,TOTALS,UKRAINE,200,22,66,33.3,20,47,42.6,2,19,10.5,9,21,42.9,19,31,50,8,20,18,4,2,55,0
19917,464671,514_15_30,SWEDEN,0,TOTALS,SWEDEN,200,24,68,35.3,11,30,36.7,13,38,34.2,5,18,27.8,19,29,48,15,21,14,8,2,66,1
19918,464684,514_15_31,SLOVAK REPUBLIC,0,TOTALS,SLOVAK REPUBLIC,200,28,61,45.9,21,38,55.3,7,23,30.4,13,21,61.9,16,30,46,12,22,24,14,3,76,1
19919,464697,514_15_31,BULGARIA,0,TOTALS,BULGARIA,200,22,66,33.3,18,43,41.9,4,23,17.4,14,23,60.9,17,21,38,15,20,20,13,2,62,0
19920,464710,514_15_32,BELGIUM,0,TOTALS,BELGIUM,200,25,72,34.7,24,62,38.7,1,10,10.0,6,13,46.2,22,27,49,7,19,14,12,1,57,1
19921,464723,514_15_32,HUNGARY,0,TOTALS,HUNGARY,200,19,51,37.3,16,35,45.7,3,16,18.8,11,23,47.8,9,26,35,12,17,17,7,0,52,0
19922,464736,514_15_33,MKD,0,TOTALS,MKD,200,22,64,34.4,19,49,38.8,3,15,20.0,12,22,54.5,11,29,40,11,31,16,9,2,59,0
19923,464749,514_15_33,ICELAND,0,TOTALS,ICELAND,200,23,54,42.6,11,25,44.0,12,29,41.4,16,30,53.3,10,34,44,18,21,22,5,8,74,1
19924,464762,514_15_34,SLOVENIA,0,TOTALS,SLOVENIA,225,25,64,39.1,22,45,48.9,3,19,15.8,22,32,68.8,21,31,52,12,24,28,10,1,75,1
19925,464775,514_15_34,CZECH REPUBLIC,0,TOTALS,CZECH REPUBLIC,225,23,69,33.3,16,39,41.0,7,30,23.3,17,29,58.6,21,20,41,13,29,22,14,1,70,0
19926,464788,514_15_35,BELARUS,0,TOTALS,BELARUS,200,24,57,42.1,21,44,47.7,3,13,23.1,9,17,52.9,7,36,43,7,23,28,11,3,60,0
19927,464801,514_15_35,SWITZERLAND,0,TOTALS,SWITZERLAND,200,23,74,31.1,20,57,35.1,3,17,17.6,13,26,50.0,18,29,47,12,20,18,20,0,62,1
19928,464814,514_15_36,ESTONIA,0,TOTALS,ESTONIA,200,36,74,48.6,29,56,51.8,7,18,38.9,15,27,55.6,17,33,50,20,18,12,12,2,94,1
19929,464827,514_15_36,PORTUGAL,0,TOTALS,PORTUGAL,200,17,58,29.3,16,43,37.2,1,15,6.7,5,8,62.5,9,25,34,8,26,25,5,1,40,0
19930,464840,514_15_37,SCOTLAND,0,TOTALS,SCOTLAND,200,12,52,23.1,8,26,30.8,4,26,15.4,3,8,37.5,9,31,40,8,16,33,7,4,31,0
19931,464853,514_15_37,SLOVAK REPUBLIC,0,TOTALS,SLOVAK REPUBLIC,200,35,83,42.2,23,50,46.0,12,33,36.4,9,20,45.0,22,33,55,25,11,10,22,2,91,1
19932,464866,514_15_38,IRELAND,0,TOTALS,IRELAND,200,23,72,31.9,19,49,38.8,4,23,17.4,16,26,61.5,21,30,51,12,21,14,6,4,66,1
19933,464879,514_15_38,NORWAY,0,TOTALS,NORWAY,200,20,67,29.9,15,47,31.9,5,20,25.0,18,28,64.3,20,31,51,10,24,16,7,1,63,0
19934,464892,514_15_39,SWEDEN,0,TOTALS,SWEDEN,200,37,75,49.3,30,54,55.6,7,21,33.3,11,17,64.7,12,36,48,26,11,9,14,3,92,1
19935,464905,514_15_39,MKD,0,TOTALS,MKD,200,20,64,31.2,14,38,36.8,6,26,23.1,9,12,75.0,10,29,39,13,22,22,6,4,55,0
19936,464918,514_15_40,DENMARK,0,TOTALS,DENMARK,200,21,57,36.8,16,44,36.4,5,13,38.5,16,31,51.6,16,25,41,11,25,14,15,2,63,1
19937,464931,514_15_40,ROMANIA,0,TOTALS,ROMANIA,200,20,57,35.1,14,39,35.9,6,18,33.3,13,22,59.1,17,27,44,11,23,22,8,5,59,0
19938,464944,514_15_41,AUSTRIA,0,TOTALS,AUSTRIA,200,13,64,20.3,9,28,32.1,4,36,11.1,9,13,69.2,18,30,48,6,18,20,3,4,39,0
19939,464957,514_15_41,SLOVENIA,0,TOTALS,SLOVENIA,200,27,76,35.5,20,44,45.5,7,32,21.9,12,24,50.0,24,34,58,12,13,9,13,4,73,1
19940,464970,514_15_42,LUXEMBOURG,0,TOTALS,LUXEMBOURG,200,30,63,47.6,26,48,54.2,4,15,26.7,21,32,65.6,11,36,47,13,19,21,14,0,85,1
19941,464983,514_15_42,BELARUS,0,TOTALS,BELARUS,200,25,66,37.9,21,45,46.7,4,21,19.0,15,21,71.4,10,29,39,8,26,22,14,3,69,0
19942,464996,514_15_43,BULGARIA,0,TOTALS,BULGARIA,200,24,71,33.8,15,43,34.9,9,28,32.1,9,20,45.0,12,26,38,16,16,18,21,7,66,0
19943,465009,514_15_43,POLAND,0,TOTALS,POLAND,200,27,61,44.3,19,41,46.3,8,20,40.0,6,13,46.2,12,38,50,19,23,30,12,2,68,1
19944,465022,514_15_44,HUNGARY,0,TOTALS,HUNGARY,200,21,69,30.4,16,44,36.4,5,25,20.0,4,7,57.1,16,24,40,13,15,21,10,3,51,0
19945,465035,514_15_44,GEORGIA,0,TOTALS,GEORGIA,200,23,67,34.3,19,53,35.8,4,14,28.6,5,8,62.5,18,30,48,13,14,24,12,10,55,1
19946,465048,514_15_45,PORTUGAL,0,TOTALS,PORTUGAL,200,32,64,50.0,23,46,50.0,9,18,50.0,12,18,66.7,14,24,38,18,15,12,11,4,85,1
19947,465061,514_15_45,UKRAINE,0,TOTALS,UKRAINE,200,20,55,36.4,14,31,45.2,6,24,25.0,10,16,62.5,14,22,36,10,19,20,7,6,56,0
19948,465074,514_15_46,CZECH REPUBLIC,0,TOTALS,CZECH REPUBLIC,200,20,66,30.3,15,42,35.7,5,24,20.8,12,15,80.0,13,35,48,8,21,17,10,1,57,0
19949,465087,514_15_46,NETHERLANDS,0,TOTALS,NETHERLANDS,200,25,74,33.8,21,46,45.7,4,28,14.3,5,15,33.3,18,33,51,12,19,16,11,3,59,1
19950,465100,514_15_47,SWITZERLAND,0,TOTALS,SWITZERLAND,200,18,57,31.6,15,43,34.9,3,14,21.4,7,11,63.6,8,22,30,13,20,23,18,0,46,0
19951,465113,514_15_47,BELGIUM,0,TOTALS,BELGIUM,200,29,61,47.5,26,49,53.1,3,12,25.0,14,26,53.8,16,30,46,19,15,22,13,7,75,1
19952,465126,514_15_48,ICELAND,0,TOTALS,ICELAND,200,18,56,32.1,14,38,36.8,4,18,22.2,16,36,44.4,14,22,36,9,24,32,10,3,56,0
19953,465139,514_15_48,ESTONIA,0,TOTALS,ESTONIA,200,30,61,49.2,25,39,64.1,5,22,22.7,25,34,73.5,11,27,38,17,24,19,19,4,90,1
19954,465152,514_15_49,SLOVAK REPUBLIC,0,TOTALS,SLOVAK REPUBLIC,200,23,67,34.3,18,44,40.9,5,23,21.7,9,22,40.9,19,32,51,13,18,18,11,3,60,0
19955,465165,514_15_49,ROMANIA,0,TOTALS,ROMANIA,200,26,67,38.8,21,45,46.7,5,22,22.7,7,18,38.9,13,32,45,14,21,18,11,4,64,1
19956,465178,514_15_50,SLOVENIA,0,TOTALS,SLOVENIA,200,38,80,47.5,29,56,51.8,9,24,37.5,7,12,58.3,21,29,50,23,8,18,14,1,92,1
19957,465191,514_15_50,IRELAND,0,TOTALS,IRELAND,200,25,62,40.3,19,41,46.3,6,21,28.6,5,6,83.3,7,23,30,19,12,22,10,4,61,0
19958,465204,514_15_51,PORTUGAL,0,TOTALS,PORTUGAL,200,22,44,50.0,18,32,56.2,4,12,33.3,5,11,45.5,4,23,27,9,17,24,6,1,53,0
19959,465217,514_15_51,SWEDEN,0,TOTALS,SWEDEN,200,24,64,37.5,16,39,41.0,8,25,32.0,14,17,82.4,16,22,38,16,13,14,13,2,70,1
19960,465230,514_15_52,POLAND,0,TOTALS,POLAND,200,35,87,40.2,29,69,42.0,6,18,33.3,15,20,75.0,29,47,76,17,11,26,20,4,91,1
19961,465243,514_15_52,SCOTLAND,0,TOTALS,SCOTLAND,200,15,68,22.1,12,51,23.5,3,17,17.6,6,15,40.0,9,24,33,10,15,29,13,2,39,0
19962,465256,514_15_53,AUSTRIA,0,TOTALS,AUSTRIA,200,29,62,46.8,14,34,41.2,15,28,53.6,8,13,61.5,9,25,34,16,18,16,11,1,81,1
19963,465269,514_15_53,CZECH REPUBLIC,0,TOTALS,CZECH REPUBLIC,200,29,70,41.4,22,41,53.7,7,29,24.1,9,14,64.3,19,25,44,21,19,20,9,1,74,0
19964,465282,514_15_54,BELGIUM,0,TOTALS,BELGIUM,200,34,74,45.9,27,56,48.2,7,18,38.9,9,12,75.0,15,31,46,19,21,11,17,2,84,1
19965,465295,514_15_54,LUXEMBOURG,0,TOTALS,LUXEMBOURG,200,17,51,33.3,15,39,38.5,2,12,16.7,11,19,57.9,9,23,32,9,15,25,4,1,47,0
19966,465308,514_15_55,BULGARIA,0,TOTALS,BULGARIA,225,19,66,28.8,14,34,41.2,5,32,15.6,20,32,62.5,21,32,53,17,23,34,20,5,63,0
19967,465321,514_15_55,DENMARK,0,TOTALS,DENMARK,225,26,65,40.0,21,46,45.7,5,19,26.3,11,18,61.1,10,29,39,15,26,32,21,3,68,1
19968,465334,514_15_56,SWITZERLAND,0,TOTALS,SWITZERLAND,200,26,64,40.6,21,42,50.0,5,22,22.7,7,13,53.8,11,22,33,7,23,12,9,2,64,0
19969,465347,514_15_56,HUNGARY,0,TOTALS,HUNGARY,200,26,55,47.3,22,41,53.7,4,14,28.6,14,21,66.7,10,28,38,18,12,16,8,2,70,1
19970,465360,514_15_57,ESTONIA,0,TOTALS,ESTONIA,200,35,88,39.8,21,49,42.9,14,39,35.9,10,17,58.8,28,28,56,25,22,9,14,4,94,1
19971,465373,514_15_57,MKD,0,TOTALS,MKD,200,21,57,36.8,20,38,52.6,1,19,5.3,10,19,52.6,11,28,39,7,23,24,5,1,53,0
19972,465386,514_15_58,NORWAY,0,TOTALS,NORWAY,200,18,70,25.7,15,47,31.9,3,23,13.0,4,8,50.0,14,28,42,6,4,15,10,4,43,0
19973,465399,514_15_58,NETHERLANDS,0,TOTALS,NETHERLANDS,200,25,73,34.2,18,46,39.1,7,27,25.9,2,4,50.0,20,40,60,13,12,19,8,4,59,1
19974,465412,514_15_59,BELARUS,0,TOTALS,BELARUS,200,25,71,35.2,20,52,38.5,5,19,26.3,3,8,37.5,9,20,29,11,25,19,7,3,58,0
19975,465425,514_15_59,GEORGIA,0,TOTALS,GEORGIA,200,28,67,41.8,23,49,46.9,5,18,27.8,24,36,66.7,22,39,61,23,11,20,12,2,85,1
19976,465438,514_15_60,UKRAINE,0,TOTALS,UKRAINE,200,30,62,48.4,24,42,57.1,6,20,30.0,16,28,57.1,15,37,52,22,20,22,10,2,82,1
19977,465451,514_15_60,ICELAND,0,TOTALS,ICELAND,200,22,72,30.6,15,44,34.1,7,28,25.0,10,20,50.0,17,21,38,6,21,16,8,1,61,0
19978,465464,514_15_61,GEORGIA,0,TOTALS,GEORGIA,200,24,63,38.1,18,42,42.9,6,21,28.6,9,19,47.4,12,32,44,9,22,15,8,2,63,0
19979,465477,514_15_61,ESTONIA,0,TOTALS,ESTONIA,200,26,65,40.0,15,30,50.0,11,35,31.4,9,17,52.9,10,33,43,18,21,11,5,3,72,1
19980,465490,514_15_62,SWITZERLAND,0,TOTALS,SWITZERLAND,200,15,56,26.8,14,40,35.0,1,16,6.2,5,17,29.4,5,27,32,4,18,20,9,3,36,0
19981,465503,514_15_62,PORTUGAL,0,TOTALS,PORTUGAL,200,21,60,35.0,19,41,46.3,2,19,10.5,14,23,60.9,16,40,56,10,18,20,13,4,58,1
19982,465516,514_15_63,BELARUS,0,TOTALS,BELARUS,200,20,67,29.9,16,49,32.7,4,18,22.2,16,22,72.7,14,26,40,10,16,16,11,9,60,0
19983,465529,514_15_63,ICELAND,0,TOTALS,ICELAND,200,26,67,38.8,19,45,42.2,7,22,31.8,10,14,71.4,16,34,50,22,17,21,9,2,69,1
19984,465542,514_15_64,BELGIUM,0,TOTALS,BELGIUM,200,19,59,32.2,19,45,42.2,0,14,0.0,12,17,70.6,13,21,34,9,18,18,6,1,50,0
19985,465555,514_15_64,SWEDEN,0,TOTALS,SWEDEN,200,27,59,45.8,15,31,48.4,12,28,42.9,12,19,63.2,12,28,40,16,18,16,5,0,78,1
19986,465568,514_15_65,HUNGARY,0,TOTALS,HUNGARY,225,25,71,35.2,22,51,43.1,3,20,15.0,18,23,78.3,13,35,48,16,18,17,8,3,71,0
19987,465581,514_15_65,UKRAINE,0,TOTALS,UKRAINE,225,28,78,35.9,22,58,37.9,6,20,30.0,13,21,61.9,20,35,55,9,19,16,10,6,75,1
19988,465594,514_15_66,LUXEMBOURG,0,TOTALS,LUXEMBOURG,200,25,51,49.0,23,43,53.5,2,8,25.0,18,28,64.3,9,36,45,12,15,22,10,2,70,1
19989,465607,514_15_66,MKD,0,TOTALS,MKD,200,26,72,36.1,20,46,43.5,6,26,23.1,9,14,64.3,11,23,34,11,26,14,16,8,67,0
19990,465620,514_15_67,SLOVAK REPUBLIC,0,TOTALS,SLOVAK REPUBLIC,200,25,62,40.3,17,33,51.5,8,29,27.6,14,24,58.3,11,20,31,13,21,14,12,6,72,1
19991,465633,514_15_67,SLOVENIA,0,TOTALS,SLOVENIA,200,23,55,41.8,18,40,45.0,5,15,33.3,17,27,63.0,16,30,46,10,20,25,7,1,68,0
19992,465646,514_15_68,BULGARIA,0,TOTALS,BULGARIA,200,25,63,39.7,21,42,50.0,4,21,19.0,15,22,68.2,15,30,45,17,16,15,9,3,69,1
19993,465659,514_15_68,AUSTRIA,0,TOTALS,AUSTRIA,200,20,64,31.2,14,35,40.0,6,29,20.7,5,10,50.0,16,27,43,10,20,19,8,3,51,0
19994,465672,514_15_69,SCOTLAND,0,TOTALS,SCOTLAND,200,26,79,32.9,19,54,35.2,7,25,28.0,19,41,46.3,26,39,65,13,28,22,6,5,78,0
19995,465685,514_15_69,IRELAND,0,TOTALS,IRELAND,200,32,81,39.5,27,57,47.4,5,24,20.8,22,34,64.7,17,35,52,18,31,14,13,5,91,1
19996,465698,514_15_70,POLAND,0,TOTALS,POLAND,200,21,61,34.4,20,44,45.5,1,17,5.9,12,18,66.7,12,38,50,9,15,21,8,5,55,1
19997,465710,514_15_70,NETHERLANDS,0,TOTALS,NETHERLANDS,200,16,73,21.9,11,46,23.9,5,27,18.5,10,14,71.4,20,28,48,9,17,19,9,1,47,0
19998,465723,514_15_71,DENMARK,0,TOTALS,DENMARK,200,23,60,38.3,16,43,37.2,7,17,41.2,13,17,76.5,17,30,47,11,14,21,7,10,66,1
19999,465736,514_15_71,CZECH REPUBLIC,0,TOTALS,CZECH REPUBLIC,200,23,74,31.1,14,44,31.8,9,30,30.0,5,9,55.6,21,20,41,12,19,14,13,3,60,0
20000,465749,514_15_72,ROMANIA,0,TOTALS,ROMANIA,200,25,56,44.6,19,37,51.4,6,19,31.6,5,9,55.6,8,34,42,9,20,28,15,1,61,1
20001,465762,514_15_72,NORWAY,0,TOTALS,NORWAY,200,15,53,28.3,10,30,33.3,5,23,21.7,15,22,68.2,4,26,30,4,13,26,13,3,50,0
20002,465775,514_15_73,SWEDEN,0,TOTALS,SWEDEN,200,29,68,42.6,22,42,52.4,7,26,26.9,15,18,83.3,13,26,39,17,14,11,12,1,80,1
20003,465788,514_15_73,GEORGIA,0,TOTALS,GEORGIA,200,29,67,43.3,25,43,58.1,4,24,16.7,4,5,80.0,12,26,38,17,16,18,6,3,66,0
20004,465801,514_15_74,UKRAINE,0,TOTALS,UKRAINE,200,28,55,50.9,25,43,58.1,3,12,25.0,12,28,42.9,11,45,56,18,20,30,11,7,71,1
20005,465814,514_15_74,SWITZERLAND,0,TOTALS,SWITZERLAND,200,25,78,32.1,24,61,39.3,1,17,5.9,14,21,66.7,12,25,37,13,23,17,14,2,65,0
20006,465827,514_15_75,MKD,0,TOTALS,MKD,200,25,53,47.2,21,39,53.8,4,14,28.6,20,33,60.6,12,23,35,10,20,13,9,1,74,1
20007,465840,514_15_75,BELARUS,0,TOTALS,BELARUS,200,24,57,42.1,18,37,48.6,6,20,30.0,19,27,70.4,12,22,34,15,28,14,7,5,73,0
20008,465853,514_15_76,NETHERLANDS,0,TOTALS,NETHERLANDS,200,19,63,30.2,15,40,37.5,4,23,17.4,8,15,53.3,11,36,47,13,20,16,8,1,50,0
20009,465866,514_15_76,SLOVAK REPUBLIC,0,TOTALS,SLOVAK REPUBLIC,200,20,68,29.4,12,40,30.0,8,28,28.6,10,17,58.8,15,33,48,9,18,15,9,5,58,1
20010,465879,514_15_77,NORWAY,0,TOTALS,NORWAY,200,43,84,51.2,38,68,55.9,5,16,31.2,12,19,63.2,17,37,54,21,19,17,23,3,103,0
20011,465892,514_15_77,SCOTLAND,0,TOTALS,SCOTLAND,200,17,55,30.9,13,33,39.4,4,22,18.2,9,18,50.0,7,25,32,9,16,33,2,4,47,1
20012,465905,514_15_78,PORTUGAL,0,TOTALS,PORTUGAL,200,29,62,46.8,24,46,52.2,5,16,31.2,3,7,42.9,11,27,38,16,20,17,11,1,66,1
20013,465918,514_15_78,HUNGARY,0,TOTALS,HUNGARY,200,17,48,35.4,16,39,41.0,1,9,11.1,12,23,52.2,6,24,30,9,8,22,7,2,47,0
20014,465931,514_15_79,ESTONIA,0,TOTALS,ESTONIA,200,21,63,33.3,15,38,39.5,6,25,24.0,3,4,75.0,13,27,40,9,19,16,10,5,51,1
20015,465944,514_15_79,BELGIUM,0,TOTALS,BELGIUM,200,13,50,26.0,9,38,23.7,4,12,33.3,9,18,50.0,14,28,42,9,14,21,6,3,39,0
20016,465957,514_15_80,ICELAND,0,TOTALS,ICELAND,200,29,72,40.3,18,42,42.9,11,30,36.7,3,5,60.0,13,36,49,17,23,13,3,4,72,1
20017,465970,514_15_80,LUXEMBOURG,0,TOTALS,LUXEMBOURG,200,17,51,33.3,15,38,39.5,2,13,15.4,18,28,64.3,4,29,33,9,11,15,4,2,54,0
20018,465983,514_15_81,CZECH REPUBLIC,0,TOTALS,CZECH REPUBLIC,225,32,73,43.8,26,54,48.1,6,19,31.6,4,15,26.7,15,28,43,15,28,31,15,0,74,0
20019,465996,514_15_81,BULGARIA,0,TOTALS,BULGARIA,225,29,64,45.3,27,46,58.7,2,18,11.1,26,37,70.3,11,30,41,20,20,24,18,8,86,1
20020,466009,514_15_82,SLOVENIA,0,TOTALS,SLOVENIA,200,23,64,35.9,17,44,38.6,6,20,30.0,12,23,52.2,16,30,46,10,23,19,5,6,64,0
20021,466022,514_15_82,POLAND,0,TOTALS,POLAND,200,23,67,34.3,17,50,34.0,6,17,35.3,18,29,62.1,18,25,43,14,21,12,9,6,70,1
20022,466035,514_15_83,AUSTRIA,0,TOTALS,AUSTRIA,200,19,60,31.7,11,31,35.5,8,29,27.6,8,11,72.7,12,35,47,9,18,14,6,6,54,0
20023,466048,514_15_83,DENMARK,0,TOTALS,DENMARK,200,19,68,27.9,9,41,22.0,10,27,37.0,8,15,53.3,16,28,44,12,14,9,8,1,56,1
20024,466061,514_15_84,IRELAND,0,TOTALS,IRELAND,200,20,63,31.7,18,43,41.9,2,20,10.0,12,17,70.6,10,30,40,10,21,28,14,1,54,0
20025,466074,514_15_84,ROMANIA,0,TOTALS,ROMANIA,200,30,68,44.1,24,43,55.8,6,25,24.0,13,21,61.9,11,33,44,24,21,26,12,5,79,1
20026,466087,514_15_85,NORWAY,0,TOTALS,NORWAY,200,23,69,33.3,17,39,43.6,6,30,20.0,35,47,74.5,19,29,48,15,28,16,20,2,87,1
20027,466100,514_15_85,BELARUS,0,TOTALS,BELARUS,200,16,53,30.2,13,38,34.2,3,15,20.0,19,29,65.5,13,32,45,7,35,32,9,5,54,0
20028,466113,514_15_86,AUSTRIA,0,TOTALS,AUSTRIA,200,31,62,50.0,21,37,56.8,10,25,40.0,17,23,73.9,9,34,43,13,17,14,14,6,89,1
20029,466126,514_15_86,SWITZERLAND,0,TOTALS,SWITZERLAND,200,16,60,26.7,12,43,27.9,4,17,23.5,5,8,62.5,12,23,35,9,22,21,5,2,41,0
20030,466139,514_15_87,SLOVENIA,0,TOTALS,SLOVENIA,200,21,63,33.3,17,45,37.8,4,18,22.2,18,25,72.0,14,27,41,11,24,15,13,1,64,0
20031,466152,514_15_87,GEORGIA,0,TOTALS,GEORGIA,200,26,62,41.9,18,39,46.2,8,23,34.8,11,20,55.0,12,30,42,20,20,18,9,12,71,1
20032,466165,514_15_88,MKD,0,TOTALS,MKD,200,29,78,37.2,21,51,41.2,8,27,29.6,10,15,66.7,16,27,43,14,18,13,19,2,76,1
20033,466178,514_15_88,SCOTLAND,0,TOTALS,SCOTLAND,200,22,64,34.4,17,42,40.5,5,22,22.7,6,14,42.9,19,35,54,14,12,30,8,3,55,0
20034,466191,514_15_89,HUNGARY,0,TOTALS,HUNGARY,200,20,59,33.9,19,43,44.2,1,16,6.2,14,20,70.0,14,21,35,11,16,20,15,2,55,1
20035,466204,514_15_89,CZECH REPUBLIC,0,TOTALS,CZECH REPUBLIC,200,20,61,32.8,14,41,34.1,6,20,30.0,8,15,53.3,20,27,47,17,19,26,7,1,54,0
20036,466217,514_15_90,BELGIUM,0,TOTALS,BELGIUM,200,28,59,47.5,22,40,55.0,6,19,31.6,9,20,45.0,13,32,45,16,25,23,9,2,71,1
20037,466230,514_15_90,NETHERLANDS,0,TOTALS,NETHERLANDS,200,16,46,34.8,11,25,44.0,5,21,23.8,11,36,30.6,10,22,32,10,21,24,10,2,48,0
20038,466243,514_15_91,ROMANIA,0,TOTALS,ROMANIA,200,34,67,50.7,26,48,54.2,8,19,42.1,3,6,50.0,14,42,56,24,17,26,11,3,79,1
20039,466256,514_15_91,LUXEMBOURG,0,TOTALS,LUXEMBOURG,200,16,61,26.2,14,43,32.6,2,18,11.1,12,21,57.1,8,20,28,10,15,16,19,1,46,0
20040,466269,514_15_92,POLAND,0,TOTALS,POLAND,200,26,54,48.1,20,37,54.1,6,17,35.3,12,23,52.2,7,39,46,18,18,20,6,3,70,1
20041,466282,514_15_92,SWEDEN,0,TOTALS,SWEDEN,200,22,75,29.3,19,49,38.8,3,26,11.5,16,18,88.9,14,25,39,15,16,9,11,2,63,0
20042,466295,514_15_93,PORTUGAL,0,TOTALS,PORTUGAL,200,22,61,36.1,18,49,36.7,4,12,33.3,10,14,71.4,12,26,38,12,22,22,15,4,58,0
20043,466308,514_15_93,BULGARIA,0,TOTALS,BULGARIA,200,24,58,41.4,20,33,60.6,4,25,16.0,15,26,57.7,14,29,43,17,19,25,11,1,67,1
20044,466321,514_15_94,ICELAND,0,TOTALS,ICELAND,200,30,72,41.7,19,43,44.2,11,29,37.9,16,24,66.7,9,34,43,19,24,13,12,3,87,1
20045,466334,514_15_94,IRELAND,0,TOTALS,IRELAND,200,24,74,32.4,20,53,37.7,4,21,19.0,23,33,69.7,19,36,55,12,18,17,6,1,75,0
20046,466347,514_15_95,ESTONIA,0,TOTALS,ESTONIA,200,26,63,41.3,19,41,46.3,7,22,31.8,9,19,47.4,15,30,45,15,20,23,13,2,68,1
20047,466360,514_15_95,SLOVAK REPUBLIC,0,TOTALS,SLOVAK REPUBLIC,200,18,68,26.5,15,49,30.6,3,19,15.8,7,14,50.0,19,27,46,9,25,25,10,3,46,0
20048,466373,514_15_96,DENMARK,0,TOTALS,DENMARK,200,20,62,32.3,13,36,36.1,7,26,26.9,17,34,50.0,23,17,40,14,27,20,7,2,64,0
20049,466386,514_15_96,UKRAINE,0,TOTALS,UKRAINE,200,28,63,44.4,25,46,54.3,3,17,17.6,18,34,52.9,24,28,52,13,25,25,13,6,77,1
20050,466399,514_15_97,SWITZERLAND,0,TOTALS,SWITZERLAND,200,19,62,30.6,16,46,34.8,3,16,18.8,14,22,63.6,15,34,49,6,18,24,16,3,55,1
20051,466412,514_15_97,CZECH REPUBLIC,0,TOTALS,CZECH REPUBLIC,200,15,58,25.9,11,37,29.7,4,21,19.0,9,22,40.9,15,31,46,5,20,29,14,4,43,0
20052,466425,514_15_98,NORWAY,0,TOTALS,NORWAY,200,28,60,46.7,22,39,56.4,6,21,28.6,14,24,58.3,12,28,40,13,19,12,7,1,76,1
20053,466438,514_15_98,MKD,0,TOTALS,MKD,200,23,60,38.3,16,38,42.1,7,22,31.8,10,15,66.7,11,26,37,14,24,16,6,1,63,0
20054,466451,514_15_99,AUSTRIA,0,TOTALS,AUSTRIA,200,26,65,40.0,21,38,55.3,5,27,18.5,8,12,66.7,7,30,37,7,21,13,5,2,65,0
20055,466464,514_15_99,HUNGARY,0,TOTALS,HUNGARY,200,25,65,38.5,21,50,42.0,4,15,26.7,18,23,78.3,12,34,46,10,15,10,6,1,72,1
20056,466708,515_15_01,PRINCIPALITY OF MONACO,0,TOTALS,PRINCIPALITY OF MONACO,200,23,80,28.7,22,68,32.4,1,12,8.3,5,11,45.5,23,29,52,7,12,35,17,3,52,0
20057,466721,515_15_01,WALES,0,TOTALS,WALES,200,21,69,30.4,14,44,31.8,7,25,28.0,7,12,58.3,22,32,54,9,15,34,8,4,56,1
20058,466734,515_15_02,GIBRALTAR,0,TOTALS,GIBRALTAR,200,11,50,22.0,10,40,25.0,1,10,10.0,4,18,22.2,11,22,33,4,20,29,3,1,27,0
20059,466747,515_15_02,KOSOVO,0,TOTALS,KOSOVO,200,32,75,42.7,28,61,45.9,4,14,28.6,16,32,50.0,30,34,64,10,23,26,17,5,84,1
20060,466760,515_15_03,ANDORRA,0,TOTALS,ANDORRA,225,28,76,36.8,28,69,40.6,0,7,0.0,18,30,60.0,16,28,44,13,20,30,16,4,74,0
20061,466773,515_15_03,MALTA,0,TOTALS,MALTA,225,31,72,43.1,27,55,49.1,4,17,23.5,15,20,75.0,12,35,47,12,21,34,7,7,81,1
20062,466786,515_15_04,ALBANIA,0,TOTALS,ALBANIA,200,24,73,32.9,20,54,37.0,4,19,21.1,5,10,50.0,12,34,46,10,28,19,9,2,57,0
20063,466799,515_15_04,SAN MARINO,0,TOTALS,SAN MARINO,200,19,50,38.0,10,28,35.7,9,22,40.9,15,30,50.0,5,34,39,9,15,21,6,3,62,1
20064,466812,515_15_05,WALES,0,TOTALS,WALES,200,31,80,38.8,27,63,42.9,4,17,23.5,14,27,51.9,23,35,58,7,25,29,14,2,80,1
20065,466825,515_15_05,GIBRALTAR,0,TOTALS,GIBRALTAR,200,18,57,31.6,16,47,34.0,2,10,20.0,9,22,40.9,11,28,39,6,22,37,11,2,47,0
20066,466838,515_15_06,KOSOVO,0,TOTALS,KOSOVO,200,37,77,48.1,36,66,54.5,1,11,9.1,21,32,65.6,23,34,57,10,19,24,20,4,96,1
20067,466848,515_15_06,PRINCIPALITY OF MONACO,0,TOTALS,PRINCIPALITY OF MONACO,200,18,56,32.1,13,37,35.1,5,19,26.3,15,24,62.5,8,21,29,7,20,31,14,0,56,0
20068,466861,515_15_07,MALTA,0,TOTALS,MALTA,200,18,44,40.9,16,34,47.1,2,10,20.0,20,41,48.8,5,41,46,6,14,33,11,2,58,1
20069,466874,515_15_07,ALBANIA,0,TOTALS,ALBANIA,200,20,73,27.4,15,37,40.5,5,36,13.9,3,10,30.0,13,29,42,9,26,28,14,1,48,0
20070,466887,515_15_08,SAN MARINO,0,TOTALS,SAN MARINO,200,22,62,35.5,14,38,36.8,8,24,33.3,14,24,58.3,9,37,46,9,29,23,8,6,66,1
20071,466900,515_15_08,ANDORRA,0,TOTALS,ANDORRA,200,21,67,31.3,19,52,36.5,2,15,13.3,15,32,46.9,16,33,49,7,24,21,14,2,59,0
20072,466913,515_15_09,GIBRALTAR,0,TOTALS,GIBRALTAR,225,20,63,31.7,18,47,38.3,2,16,12.5,5,19,26.3,16,18,34,6,18,25,13,1,47,0
20073,466923,515_15_09,PRINCIPALITY OF MONACO,0,TOTALS,PRINCIPALITY OF MONACO,225,30,66,45.5,26,54,48.1,4,12,33.3,13,22,59.1,20,34,54,6,16,25,15,3,77,1
20074,466936,515_15_10,WALES,0,TOTALS,WALES,200,11,54,20.4,10,41,24.4,1,13,7.7,12,22,54.5,13,24,37,2,17,25,9,3,35,0
20075,466949,515_15_10,KOSOVO,0,TOTALS,KOSOVO,200,28,70,40.0,25,59,42.4,3,11,27.3,15,17,88.2,16,30,46,8,22,20,14,8,74,1
20076,466962,515_15_11,ALBANIA,0,TOTALS,ALBANIA,200,23,58,39.7,20,42,47.6,3,16,18.8,9,21,42.9,14,29,43,18,23,27,6,4,58,0
20077,466975,515_15_11,ANDORRA,0,TOTALS,ANDORRA,200,19,61,31.1,19,52,36.5,0,9,0.0,26,36,72.2,13,25,38,4,19,21,15,2,64,1
20078,466988,515_15_12,MALTA,0,TOTALS,MALTA,200,19,52,36.5,19,42,45.2,0,10,0.0,10,22,45.5,13,34,47,7,15,34,8,3,48,0
20079,467001,515_15_12,SAN MARINO,0,TOTALS,SAN MARINO,200,28,68,41.2,18,42,42.9,10,26,38.5,11,21,52.4,11,24,35,9,23,15,23,2,77,1
20080,467011,515_15_13,PRINCIPALITY OF MONACO,0,TOTALS,PRINCIPALITY OF MONACO,200,15,60,25.0,10,44,22.7,5,16,31.2,5,9,55.6,6,25,31,3,12,23,6,4,40,0
20081,467024,515_15_13,ALBANIA,0,TOTALS,ALBANIA,200,31,82,37.8,22,59,37.3,9,23,39.1,7,11,63.6,21,40,61,11,12,21,12,1,78,1
20082,467037,515_15_14,ANDORRA,0,TOTALS,ANDORRA,200,36,85,42.4,33,76,43.4,3,9,33.3,28,42,66.7,25,41,66,15,24,26,26,1,103,0
20083,467050,515_15_14,GIBRALTAR,0,TOTALS,GIBRALTAR,200,18,58,31.0,17,49,34.7,1,9,11.1,5,23,21.7,8,25,33,5,29,35,13,2,42,1
20084,467063,515_15_15,KOSOVO,0,TOTALS,KOSOVO,200,23,69,33.3,17,52,32.7,6,17,35.3,13,16,81.2,16,35,51,10,26,15,8,0,65,1
20085,467076,515_15_15,MALTA,0,TOTALS,MALTA,200,14,54,25.9,12,39,30.8,2,15,13.3,15,29,51.7,10,28,38,5,16,19,5,4,45,0
20086,467089,515_15_16,SAN MARINO,0,TOTALS,SAN MARINO,200,33,73,45.2,23,53,43.4,10,20,50.0,16,23,69.6,12,44,56,19,16,18,18,3,92,1
20087,467102,515_15_16,WALES,0,TOTALS,WALES,200,15,64,23.4,12,51,23.5,3,13,23.1,5,17,29.4,14,30,44,3,17,29,9,3,38,0
20088,467115,515_15_17,GIBRALTAR,0,TOTALS,GIBRALTAR,200,13,70,18.6,12,47,25.5,1,23,4.3,5,18,27.8,12,45,57,5,18,25,9,3,32,0
20089,467125,515_15_17,PRINCIPALITY OF MONACO,0,TOTALS,PRINCIPALITY OF MONACO,200,23,78,29.5,19,54,35.2,4,24,16.7,12,21,57.1,14,53,67,14,19,20,20,4,62,1
20090,467138,515_15_18,ANDORRA,0,TOTALS,ANDORRA,200,14,56,25.0,9,41,22.0,5,15,33.3,22,31,71.0,16,24,40,10,16,26,14,2,55,0
20091,467151,515_15_18,ALBANIA,0,TOTALS,ALBANIA,200,33,62,53.2,25,45,55.6,8,17,47.1,3,14,21.4,10,29,39,22,24,23,14,4,77,1
20092,467164,515_15_19,WALES,0,TOTALS,WALES,200,17,71,23.9,10,45,22.2,7,26,26.9,3,12,25.0,14,43,57,8,27,23,7,1,44,0
20093,467177,515_15_19,MALTA,0,TOTALS,MALTA,200,16,76,21.1,15,63,23.8,1,13,7.7,22,37,59.5,24,44,68,6,15,18,12,6,55,1
20094,467190,515_15_20,SAN MARINO,0,TOTALS,SAN MARINO,200,28,63,44.4,21,41,51.2,7,22,31.8,13,27,48.1,13,31,44,18,18,17,13,4,76,1
20095,467203,515_15_20,KOSOVO,0,TOTALS,KOSOVO,200,24,75,32.0,22,63,34.9,2,12,16.7,9,14,64.3,21,30,51,8,25,18,8,3,59,0
20096,471423,519_15_01,AUSTRALIA,0,TOTALS,AUSTRALIA,200,27,60,45.0,20,41,48.8,7,19,36.8,10,11,90.9,8,30,38,13,10,10,1,1,71,1
20097,471436,519_15_01,NEW ZEALAND,0,TOTALS,NEW ZEALAND,200,24,64,37.5,17,37,45.9,7,27,25.9,4,5,80.0,6,22,28,13,15,7,0,1,59,0
20098,471449,519_15_02,NEW ZEALAND,0,TOTALS,NEW ZEALAND,200,30,75,40.0,19,47,40.4,11,28,39.3,8,11,72.7,12,16,28,17,19,9,6,2,79,0
20099,471461,519_15_02,AUSTRALIA,0,TOTALS,AUSTRALIA,200,31,59,52.5,25,44,56.8,6,15,40.0,21,24,87.5,11,34,45,16,18,17,3,6,89,1
20100,471526,521_15_01,NEW CALEDONIA,0,TOTALS,NEW CALEDONIA,200,15,67,22.4,10,45,22.2,5,22,22.7,1,4,25.0,10,17,27,4,22,35,8,0,36,1
20101,471539,521_15_01,NEW ZEALAND,0,TOTALS,NEW ZEALAND,200,58,102,56.9,50,80,62.5,8,22,36.4,21,37,56.8,33,42,75,36,13,17,21,2,145,0
20102,471552,521_15_02,AUSTRALIA,0,TOTALS,AUSTRALIA,200,47,91,51.6,46,81,56.8,1,10,10.0,13,23,56.5,29,51,80,24,12,25,17,6,108,0
20103,471565,521_15_02,TAHITI,0,TOTALS,TAHITI,200,11,65,16.9,6,37,16.2,5,28,17.9,6,8,75.0,3,20,23,4,16,28,7,7,33,1
20104,471578,521_15_03,NEW ZEALAND,0,TOTALS,NEW ZEALAND,200,30,68,44.1,28,56,50.0,2,12,16.7,19,32,59.4,18,39,57,11,21,25,10,5,81,1
20105,471591,521_15_03,AUSTRALIA,0,TOTALS,AUSTRALIA,200,22,69,31.9,18,51,35.3,4,18,22.2,14,21,66.7,11,28,39,8,25,21,10,5,62,0
20106,471604,521_15_04,TAHITI,0,TOTALS,TAHITI,200,23,98,23.5,18,57,31.6,5,41,12.2,5,15,33.3,27,27,54,6,20,29,25,4,56,0
20107,471617,521_15_04,NEW CALEDONIA,0,TOTALS,NEW CALEDONIA,200,24,60,40.0,24,53,45.3,0,7,0.0,14,23,60.9,16,54,70,12,19,50,15,3,62,1
20108,471630,521_15_05,NEW CALEDONIA,0,TOTALS,NEW CALEDONIA,200,12,53,22.6,9,38,23.7,3,15,20.0,2,12,16.7,6,15,21,5,19,45,7,2,29,1
20109,471643,521_15_05,AUSTRALIA,0,TOTALS,AUSTRALIA,200,59,107,55.1,54,87,62.1,5,20,25.0,18,28,64.3,36,39,75,44,11,17,32,5,141,0
20110,471656,521_15_06,NEW ZEALAND,0,TOTALS,NEW ZEALAND,200,54,87,62.1,49,76,64.5,5,11,45.5,9,14,64.3,27,55,82,31,4,19,12,2,122,0
20111,471669,521_15_06,TAHITI,0,TOTALS,TAHITI,200,14,73,19.2,5,34,14.7,9,39,23.1,1,2,50.0,5,10,15,6,11,16,11,4,38,1
20112,471682,521_15_07,NEW CALEDONIA,0,TOTALS,NEW CALEDONIA,200,18,74,24.3,13,51,25.5,5,23,21.7,15,28,53.6,25,48,73,8,27,41,12,2,56,0
20113,471695,521_15_07,TAHITI,0,TOTALS,TAHITI,200,29,94,30.9,22,62,35.5,7,32,21.9,14,34,41.2,29,33,62,14,24,26,35,4,79,1
20114,471708,521_15_08,NEW ZEALAND,0,TOTALS,NEW ZEALAND,200,25,66,37.9,18,45,40.0,7,21,33.3,29,40,72.5,18,30,48,9,26,21,11,1,86,0
20115,471721,521_15_08,AUSTRALIA,0,TOTALS,AUSTRALIA,200,30,67,44.8,19,39,48.7,11,28,39.3,20,28,71.4,10,27,37,15,27,19,12,3,91,1
20116,471942,523_16_01,AUSTRALIA,0,TOTALS,AUSTRALIA,200,35,70,50.0,28,48,58.3,7,22,31.8,10,15,66.7,9,28,37,29,22,7,11,2,87,1
20117,471955,523_16_01,FRANCE,0,TOTALS,FRANCE,200,24,57,42.1,20,43,46.5,4,14,28.6,14,16,87.5,5,27,32,12,20,17,6,5,66,0
20118,471968,523_16_02,CHINA,0,TOTALS,CHINA,200,20,56,35.7,15,39,38.5,5,17,29.4,17,24,70.8,7,22,29,16,34,24,7,2,62,1
20119,471981,523_16_02,USA,0,TOTALS,USA,200,38,74,51.4,28,47,59.6,10,27,37.0,33,45,73.3,19,33,52,31,19,9,15,3,119,0
20120,471994,523_16_03,VENEZUELA,0,TOTALS,VENEZUELA,200,23,63,36.5,19,41,46.3,4,22,18.2,12,17,70.6,13,13,26,15,22,13,8,1,62,0
20121,472007,523_16_03,SERBIA,0,TOTALS,SERBIA,200,32,56,57.1,26,39,66.7,6,17,35.3,16,21,76.2,13,27,40,22,22,16,7,3,86,1
20122,472020,523_16_04,BRAZIL,0,TOTALS,BRAZIL,200,26,56,46.4,24,42,57.1,2,14,14.3,22,35,62.9,10,23,33,12,23,13,8,2,76,0
20123,472033,523_16_04,LITHUANIA,0,TOTALS,LITHUANIA,200,29,58,50.0,20,34,58.8,9,24,37.5,15,18,83.3,7,26,33,23,29,17,6,3,82,1
20124,472046,523_16_05,CROATIA,0,TOTALS,CROATIA,200,23,56,41.1,17,32,53.1,6,24,25.0,20,25,80.0,10,31,41,16,21,14,3,3,72,1
20125,472059,523_16_05,SPAIN,0,TOTALS,SPAIN,200,25,63,39.7,14,31,45.2,11,32,34.4,9,12,75.0,7,23,30,17,22,10,8,0,70,0
20126,472072,523_16_06,NIGERIA,0,TOTALS,NIGERIA,200,24,62,38.7,20,37,54.1,4,25,16.0,14,17,82.4,8,30,38,12,22,21,5,5,66,0
20127,472085,523_16_06,ARGENTINA,0,TOTALS,ARGENTINA,200,33,72,45.8,18,38,47.4,15,34,44.1,13,19,68.4,13,31,44,18,20,15,11,4,94,1
20128,472098,523_16_07,SERBIA,0,TOTALS,SERBIA,200,27,69,39.1,22,47,46.8,5,22,22.7,21,26,80.8,12,22,34,23,23,9,6,0,80,0
20129,472111,523_16_07,AUSTRALIA,0,TOTALS,AUSTRALIA,200,30,61,49.2,21,36,58.3,9,25,36.0,26,31,83.9,9,29,38,25,24,13,4,3,95,1
20130,472124,523_16_08,USA,0,TOTALS,USA,200,36,66,54.5,27,44,61.4,9,22,40.9,32,38,84.2,14,28,42,24,23,11,6,1,113,0
20131,472137,523_16_08,VENEZUELA,0,TOTALS,VENEZUELA,200,22,64,34.4,17,46,37.0,5,18,27.8,20,25,80.0,13,19,32,15,29,18,8,2,69,1
20132,472150,523_16_09,FRANCE,0,TOTALS,FRANCE,200,29,48,60.4,23,35,65.7,6,13,46.2,24,31,77.4,11,31,42,21,21,23,5,8,88,1
20133,472163,523_16_09,CHINA,0,TOTALS,CHINA,200,23,60,38.3,19,41,46.3,4,19,21.1,10,15,66.7,7,13,20,14,32,13,14,3,60,0
20134,472176,523_16_10,SPAIN,0,TOTALS,SPAIN,200,19,52,36.5,14,33,42.4,5,19,26.3,22,33,66.7,12,30,42,12,23,13,6,5,65,0
20135,472189,523_16_10,BRAZIL,0,TOTALS,BRAZIL,200,23,60,38.3,19,45,42.2,4,15,26.7,16,21,76.2,9,26,35,19,31,10,3,1,66,1
20136,472202,523_16_11,LITHUANIA,0,TOTALS,LITHUANIA,200,32,65,49.2,24,45,53.3,8,20,40.0,17,20,85.0,14,24,38,23,16,14,8,6,89,1
20137,472215,523_16_11,NIGERIA,0,TOTALS,NIGERIA,200,31,65,47.7,21,42,50.0,10,23,43.5,8,10,80.0,8,21,29,16,22,15,6,4,80,0
20138,472228,523_16_12,ARGENTINA,0,TOTALS,ARGENTINA,200,31,70,44.3,19,38,50.0,12,32,37.5,16,24,66.7,11,28,39,17,21,14,5,4,90,1
20139,472241,523_16_12,CROATIA,0,TOTALS,CROATIA,200,30,70,42.9,21,39,53.8,9,31,29.0,13,21,61.9,12,31,43,24,24,14,5,3,82,0
20140,472254,523_16_13,SERBIA,0,TOTALS,SERBIA,200,28,60,46.7,19,36,52.8,9,24,37.5,10,14,71.4,8,24,32,22,24,16,8,3,75,0
20141,472267,523_16_13,FRANCE,0,TOTALS,FRANCE,200,25,54,46.3,18,38,47.4,7,16,43.8,19,24,79.2,7,24,31,20,19,14,11,2,76,1
20142,472280,523_16_14,AUSTRALIA,0,TOTALS,AUSTRALIA,200,33,66,50.0,26,45,57.8,7,21,33.3,15,18,83.3,8,32,40,23,25,17,4,4,88,0
20143,472293,523_16_14,USA,0,TOTALS,USA,200,34,87,39.1,17,48,35.4,17,39,43.6,13,18,72.2,21,26,47,17,24,9,7,4,98,1
20144,472306,523_16_15,VENEZUELA,0,TOTALS,VENEZUELA,200,24,53,45.3,18,36,50.0,6,17,35.3,18,21,85.7,12,14,26,21,27,16,8,1,72,1
20145,472319,523_16_15,CHINA,0,TOTALS,CHINA,200,22,45,48.9,20,34,58.8,2,11,18.2,22,33,66.7,9,17,26,9,20,16,7,3,68,0
20146,472332,523_16_16,BRAZIL,0,TOTALS,BRAZIL,200,28,68,41.2,18,42,42.9,10,26,38.5,10,13,76.9,13,17,30,22,20,9,7,0,76,0
20147,472345,523_16_16,CROATIA,0,TOTALS,CROATIA,200,27,52,51.9,16,30,53.3,11,22,50.0,15,17,88.2,8,27,35,18,17,17,4,1,80,1
20148,472358,523_16_17,NIGERIA,0,TOTALS,NIGERIA,200,29,63,46.0,16,28,57.1,13,35,37.1,16,21,76.2,7,26,33,20,24,14,5,6,87,0
20149,472371,523_16_17,SPAIN,0,TOTALS,SPAIN,200,33,68,48.5,24,42,57.1,9,26,34.6,21,26,80.8,13,30,43,23,22,11,5,2,96,1
20150,472384,523_16_18,LITHUANIA,0,TOTALS,LITHUANIA,200,29,65,44.6,22,41,53.7,7,24,29.2,16,19,84.2,11,40,51,12,25,16,5,2,81,1
20151,472397,523_16_18,ARGENTINA,0,TOTALS,ARGENTINA,200,25,66,37.9,18,40,45.0,7,26,26.9,16,28,57.1,6,23,29,11,23,6,8,3,73,0
20152,472410,523_16_19,CHINA,0,TOTALS,CHINA,200,22,45,48.9,19,34,55.9,3,11,27.3,21,27,77.8,5,16,21,19,22,18,4,3,68,0
20153,472423,523_16_19,AUSTRALIA,0,TOTALS,AUSTRALIA,200,37,66,56.1,30,48,62.5,7,18,38.9,12,18,66.7,15,20,35,34,25,10,10,1,93,1
20154,472436,523_16_20,USA,0,TOTALS,USA,200,27,55,49.1,20,35,57.1,7,20,35.0,33,42,78.6,9,24,33,28,25,12,8,1,94,1
20155,472449,523_16_20,SERBIA,0,TOTALS,SERBIA,200,31,60,51.7,21,35,60.0,10,25,40.0,19,25,76.0,8,23,31,23,32,16,5,1,91,0
20156,472462,523_16_21,FRANCE,0,TOTALS,FRANCE,200,41,67,61.2,36,52,69.2,5,15,33.3,9,11,81.8,9,33,42,25,15,5,4,2,96,1
20157,472475,523_16_21,VENEZUELA,0,TOTALS,VENEZUELA,200,22,63,34.9,18,40,45.0,4,23,17.4,8,11,72.7,8,18,26,17,18,8,3,0,56,0
20158,472488,523_16_22,ARGENTINA,0,TOTALS,ARGENTINA,250,36,79,45.6,19,37,51.4,17,42,40.5,22,34,64.7,9,34,43,19,25,15,11,2,111,1
20159,472501,523_16_22,BRAZIL,0,TOTALS,BRAZIL,250,38,83,45.8,29,57,50.9,9,26,34.6,22,27,81.5,11,38,49,16,31,19,6,2,107,0
20160,472514,523_16_23,SPAIN,0,TOTALS,SPAIN,200,39,68,57.4,23,36,63.9,16,32,50.0,15,18,83.3,15,26,41,31,16,9,10,5,109,0
20161,472527,523_16_23,LITHUANIA,0,TOTALS,LITHUANIA,200,24,60,40.0,18,37,48.6,6,23,26.1,5,9,55.6,11,14,25,13,23,15,4,4,59,1
20162,472540,523_16_24,CROATIA,0,TOTALS,CROATIA,200,26,65,40.0,20,37,54.1,6,28,21.4,18,26,69.2,12,22,34,13,17,11,8,1,76,0
20163,472553,523_16_24,NIGERIA,0,TOTALS,NIGERIA,200,30,68,44.1,13,32,40.6,17,36,47.2,13,19,68.4,17,28,45,26,25,14,5,6,90,1
20164,472566,523_16_25,USA,0,TOTALS,USA,200,35,63,55.6,25,36,69.4,10,27,37.0,20,27,74.1,8,21,29,32,17,13,8,1,100,0
20165,472579,523_16_25,FRANCE,0,TOTALS,FRANCE,200,41,73,56.2,36,54,66.7,5,19,26.3,10,13,76.9,11,24,35,28,23,13,6,2,97,1
20166,472592,523_16_26,AUSTRALIA,0,TOTALS,AUSTRALIA,200,31,59,52.5,23,40,57.5,8,19,42.1,11,16,68.8,16,29,45,19,17,15,4,0,81,1
20167,472605,523_16_26,VENEZUELA,0,TOTALS,VENEZUELA,200,21,60,35.0,16,38,42.1,5,22,22.7,9,14,64.3,10,15,25,15,24,11,12,3,56,0
20168,472618,523_16_27,SERBIA,0,TOTALS,SERBIA,200,32,64,50.0,20,37,54.1,12,27,44.4,18,23,78.3,13,27,40,24,20,12,11,4,94,1
20169,472631,523_16_27,CHINA,0,TOTALS,CHINA,200,23,58,39.7,18,39,46.2,5,19,26.3,9,13,69.2,9,20,29,15,25,19,6,1,60,0
20170,472644,523_16_28,NIGERIA,0,TOTALS,NIGERIA,200,24,58,41.4,17,38,44.7,7,20,35.0,14,19,73.7,10,23,33,11,16,18,3,4,69,0
20171,472657,523_16_28,BRAZIL,0,TOTALS,BRAZIL,200,34,75,45.3,27,48,56.2,7,27,25.9,11,15,73.3,20,24,44,27,16,11,10,2,86,1
20172,472670,523_16_29,SPAIN,0,TOTALS,SPAIN,200,32,66,48.5,23,44,52.3,9,22,40.9,19,26,73.1,8,36,44,22,24,17,8,5,92,1
20173,472683,523_16_29,ARGENTINA,0,TOTALS,ARGENTINA,200,23,64,35.9,14,36,38.9,9,28,32.1,18,21,85.7,4,27,31,9,27,15,11,2,73,0
20174,472696,523_16_30,LITHUANIA,0,TOTALS,LITHUANIA,200,32,67,47.8,21,39,53.8,11,28,39.3,6,8,75.0,5,22,27,22,20,11,8,2,81,0
20175,472709,523_16_30,CROATIA,0,TOTALS,CROATIA,200,32,60,53.3,21,41,51.2,11,19,57.9,15,18,83.3,6,31,37,17,14,15,6,0,90,1
20176,472722,523_16_31,AUSTRALIA,0,TOTALS,AUSTRALIA,200,33,63,52.4,23,38,60.5,10,25,40.0,14,17,82.4,6,25,31,30,18,9,8,1,90,1
20177,472735,523_16_31,LITHUANIA,0,TOTALS,LITHUANIA,200,28,58,48.3,24,43,55.8,4,15,26.7,4,12,33.3,9,23,32,14,22,17,4,4,64,0
20178,472748,523_16_32,SPAIN,0,TOTALS,SPAIN,200,35,67,52.2,25,39,64.1,10,28,35.7,12,16,75.0,8,27,35,25,21,11,8,3,92,1
20179,472761,523_16_32,FRANCE,0,TOTALS,FRANCE,200,24,62,38.7,18,48,37.5,6,14,42.9,13,16,81.2,12,25,37,21,21,16,6,2,67,0
20180,472774,523_16_33,USA,0,TOTALS,USA,200,41,89,46.1,30,56,53.6,11,33,33.3,12,17,70.6,17,37,54,21,20,11,8,6,105,0
20181,472787,523_16_33,ARGENTINA,0,TOTALS,ARGENTINA,200,30,79,38.0,22,47,46.8,8,32,25.0,10,12,83.3,11,32,43,23,15,16,6,2,78,1
20182,472800,523_16_34,CROATIA,0,TOTALS,CROATIA,200,23,51,45.1,16,32,50.0,7,19,36.8,30,38,78.9,10,29,39,16,28,18,3,0,83,0
20183,472813,523_16_34,SERBIA,0,TOTALS,SERBIA,200,29,71,40.8,21,48,43.8,8,23,34.8,20,25,80.0,14,21,35,22,31,10,10,2,86,1
20184,472826,523_16_35,SPAIN,0,TOTALS,SPAIN,200,28,72,38.9,20,46,43.5,8,26,30.8,12,16,75.0,14,27,41,14,21,11,8,1,76,0
20185,472839,523_16_35,USA,0,TOTALS,USA,200,33,79,41.8,24,53,45.3,9,26,34.6,7,14,50.0,21,32,53,15,20,13,6,6,82,1
20186,472852,523_16_36,AUSTRALIA,0,TOTALS,AUSTRALIA,200,22,66,33.3,18,35,51.4,4,31,12.9,13,19,68.4,13,17,30,14,22,16,6,4,61,0
20187,472865,523_16_36,SERBIA,0,TOTALS,SERBIA,200,32,60,53.3,27,44,61.4,5,16,31.2,18,23,78.3,10,33,43,23,22,18,9,1,87,1
20188,472878,523_16_37,AUSTRALIA,0,TOTALS,AUSTRALIA,200,34,65,52.3,27,48,56.2,7,17,41.2,13,15,86.7,11,29,40,20,22,15,4,3,88,0
20189,472891,523_16_37,SPAIN,0,TOTALS,SPAIN,200,32,70,45.7,22,43,51.2,10,27,37.0,15,22,68.2,11,19,30,20,22,7,8,3,89,1
20190,472904,523_16_38,SERBIA,0,TOTALS,SERBIA,200,26,68,38.2,22,44,50.0,4,24,16.7,10,14,71.4,9,24,33,18,23,18,11,2,66,0
20191,472917,523_16_38,USA,0,TOTALS,USA,200,34,77,44.2,24,46,52.2,10,31,32.3,18,23,78.3,20,34,54,24,23,16,12,6,96,1
20192,473918,525_16_01,GREECE,0,TOTALS,GREECE,200,30,60,50.0,21,36,58.3,9,24,37.5,9,15,60.0,8,23,31,21,15,15,17,7,78,1
20193,473931,525_16_01,IRAN,0,TOTALS,IRAN,200,20,52,38.5,11,29,37.9,9,23,39.1,4,6,66.7,7,23,30,15,20,27,6,1,53,0
20194,473944,525_16_02,TUNISIA,0,TOTALS,TUNISIA,200,13,56,23.2,8,36,22.2,5,20,25.0,10,16,62.5,3,21,24,9,20,11,9,1,41,0
20195,473957,525_16_02,ITALY,0,TOTALS,ITALY,200,25,52,48.1,19,38,50.0,6,14,42.9,12,15,80.0,5,44,49,17,19,17,7,3,68,1
20196,473970,525_16_03,IRAN,0,TOTALS,IRAN,200,23,50,46.0,15,33,45.5,8,17,47.1,16,27,59.3,6,30,36,15,25,20,3,3,70,0
20197,473983,525_16_03,MEXICO,0,TOTALS,MEXICO,200,25,68,36.8,18,43,41.9,7,25,28.0,18,23,78.3,14,26,40,15,22,12,12,5,75,1
20198,473996,525_16_04,ITALY,0,TOTALS,ITALY,200,24,71,33.8,20,55,36.4,4,16,25.0,15,21,71.4,15,29,44,11,21,6,6,4,67,1
20199,474009,525_16_04,CROATIA,0,TOTALS,CROATIA,200,22,61,36.1,16,39,41.0,6,22,27.3,10,17,58.8,11,34,45,11,25,13,0,1,60,0
20200,474022,525_16_05,MEXICO,0,TOTALS,MEXICO,200,24,64,37.5,12,35,34.3,12,29,41.4,10,13,76.9,13,19,32,15,25,11,5,2,70,0
20201,474035,525_16_05,GREECE,0,TOTALS,GREECE,200,27,57,47.4,20,39,51.3,7,18,38.9,25,32,78.1,11,28,39,18,18,7,4,5,86,1
20202,474048,525_16_06,CROATIA,0,TOTALS,CROATIA,200,22,52,42.3,16,30,53.3,6,22,27.3,22,26,84.6,8,29,37,17,21,16,6,2,72,1
20203,474061,525_16_06,TUNISIA,0,TOTALS,TUNISIA,200,17,55,30.9,13,35,37.1,4,20,20.0,14,17,82.4,8,23,31,11,25,19,6,3,52,0
20204,474074,525_16_07,GREECE,0,TOTALS,GREECE,200,21,64,32.8,13,30,43.3,8,34,23.5,11,14,78.6,11,31,42,12,29,12,4,6,61,0
20205,474087,525_16_07,CROATIA,0,TOTALS,CROATIA,200,21,59,35.6,16,36,44.4,5,23,21.7,19,30,63.3,11,31,42,12,24,7,2,2,66,1
20206,474100,525_16_08,ITALY,0,TOTALS,ITALY,200,27,53,50.9,20,39,51.3,7,14,50.0,18,29,62.1,6,33,39,20,16,11,9,1,79,1
20207,474113,525_16_08,MEXICO,0,TOTALS,MEXICO,200,22,61,36.1,17,42,40.5,5,19,26.3,5,9,55.6,6,23,29,12,27,17,8,2,54,0
20208,474126,525_16_09,CROATIA,0,TOTALS,CROATIA,225,25,66,37.9,16,40,40.0,9,26,34.6,25,33,75.8,12,34,46,11,21,15,7,2,84,1
20209,474139,525_16_09,ITALY,0,TOTALS,ITALY,225,28,73,38.4,23,52,44.2,5,21,23.8,17,19,89.5,10,29,39,17,30,12,5,7,78,0
20210,474152,526_16_01,TURKEY,0,TOTALS,TURKEY,200,22,61,36.1,16,35,45.7,6,26,23.1,19,34,55.9,12,28,40,11,25,11,6,1,69,0
20211,474165,526_16_01,CANADA,0,TOTALS,CANADA,200,25,59,42.4,18,40,45.0,7,19,36.8,20,24,83.3,6,32,38,17,27,11,6,3,77,1
20212,474178,526_16_02,FRANCE,0,TOTALS,FRANCE,200,36,67,53.7,31,47,66.0,5,20,25.0,16,18,88.9,14,24,38,18,19,15,8,0,93,1
20213,474191,526_16_02,PHILIPPINES,0,TOTALS,PHILIPPINES,200,29,70,41.4,18,42,42.9,11,28,39.3,15,18,83.3,19,17,36,11,21,18,5,2,84,0
20214,474204,526_16_03,CANADA,0,TOTALS,CANADA,200,21,65,32.3,19,48,39.6,2,17,11.8,14,23,60.9,15,31,46,10,16,12,1,4,58,1
20215,474217,526_16_03,SENEGAL,0,TOTALS,SENEGAL,200,19,69,27.5,10,40,25.0,9,29,31.0,8,12,66.7,18,35,53,12,24,16,3,8,55,0
20216,474230,526_16_04,PHILIPPINES,0,TOTALS,PHILIPPINES,200,26,64,40.6,15,37,40.5,11,27,40.7,17,21,81.0,14,22,36,10,26,14,3,2,80,0
20217,474243,526_16_04,NEW ZEALAND,0,TOTALS,NEW ZEALAND,200,30,62,48.4,22,38,57.9,8,24,33.3,21,26,80.8,11,25,36,12,21,11,7,5,89,1
20218,474256,526_16_05,SENEGAL,0,TOTALS,SENEGAL,200,23,62,37.1,15,35,42.9,8,27,29.6,8,11,72.7,15,36,51,12,29,19,4,2,62,0
20219,474269,526_16_05,TURKEY,0,TOTALS,TURKEY,200,21,64,32.8,12,35,34.3,9,29,31.0,17,30,56.7,15,25,40,13,19,11,7,1,68,1
20220,474282,526_16_06,NEW ZEALAND,0,TOTALS,NEW ZEALAND,200,20,66,30.3,9,39,23.1,11,27,40.7,8,12,66.7,20,27,47,12,20,18,3,2,59,0
20221,474295,526_16_06,FRANCE,0,TOTALS,FRANCE,200,25,60,41.7,22,43,51.2,3,17,17.6,13,17,76.5,8,28,36,11,18,10,8,0,66,1
20222,474308,526_16_07,CANADA,0,TOTALS,CANADA,200,30,69,43.5,26,49,53.1,4,20,20.0,14,25,56.0,18,29,47,10,14,12,4,4,78,1
20223,474321,526_16_07,NEW ZEALAND,0,TOTALS,NEW ZEALAND,200,28,71,39.4,17,42,40.5,11,29,37.9,5,7,71.4,14,28,42,18,27,13,5,2,72,0
20224,474334,526_16_08,FRANCE,0,TOTALS,FRANCE,200,30,58,51.7,23,35,65.7,7,23,30.4,8,9,88.9,10,19,29,18,22,13,9,3,75,1
20225,474347,526_16_08,TURKEY,0,TOTALS,TURKEY,200,22,53,41.5,19,33,57.6,3,20,15.0,16,21,76.2,14,19,33,18,17,16,5,0,63,0
20226,474360,526_16_09,CANADA,0,TOTALS,CANADA,200,31,61,50.8,24,42,57.1,7,19,36.8,5,8,62.5,13,22,35,14,17,21,4,2,74,0
20227,474373,526_16_09,FRANCE,0,TOTALS,FRANCE,200,30,61,49.2,21,34,61.8,9,27,33.3,14,17,82.4,8,18,26,14,18,16,9,2,83,1
20228,474386,527_16_01,JAPAN,0,TOTALS,JAPAN,200,18,63,28.6,15,43,34.9,3,20,15.0,9,10,90.0,9,20,29,10,20,14,5,1,48,0
20229,474399,527_16_01,LATVIA,0,TOTALS,LATVIA,200,33,64,51.6,21,33,63.6,12,31,38.7,10,17,58.8,14,34,48,23,13,13,10,9,88,1
20230,474412,527_16_02,SERBIA,0,TOTALS,SERBIA,200,35,69,50.7,26,42,61.9,9,27,33.3,8,18,44.4,11,23,34,25,29,15,9,0,87,1
20231,474425,527_16_02,PUERTO RICO,0,TOTALS,PUERTO RICO,200,27,61,44.3,18,34,52.9,9,27,33.3,18,27,66.7,13,27,40,11,23,21,13,1,81,0
20232,474438,527_16_03,PUERTO RICO,0,TOTALS,PUERTO RICO,200,26,55,47.3,15,32,46.9,11,23,47.8,28,35,80.0,7,28,35,22,26,19,6,6,91,1
20233,474451,527_16_03,ANGOLA,0,TOTALS,ANGOLA,200,30,73,41.1,23,47,48.9,7,26,26.9,14,24,58.3,19,23,42,11,26,16,7,0,81,0
20234,474464,527_16_04,LATVIA,0,TOTALS,LATVIA,200,22,61,36.1,17,34,50.0,5,27,18.5,22,26,84.6,9,33,42,13,26,14,10,1,71,1
20235,474477,527_16_04,CZECH REPUBLIC,0,TOTALS,CZECH REPUBLIC,200,23,61,37.7,21,46,45.7,2,15,13.3,11,23,47.8,12,29,41,19,27,16,6,3,59,0
20236,474490,527_16_05,ANGOLA,0,TOTALS,ANGOLA,200,23,63,36.5,13,35,37.1,10,28,35.7,4,10,40.0,16,21,37,9,26,21,6,3,60,0
20237,474503,527_16_05,SERBIA,0,TOTALS,SERBIA,200,30,55,54.5,20,33,60.6,10,22,45.5,13,20,65.0,4,27,31,24,20,16,8,5,83,1
20238,474516,527_16_06,CZECH REPUBLIC,0,TOTALS,CZECH REPUBLIC,200,37,75,49.3,28,47,59.6,9,28,32.1,4,12,33.3,13,30,43,29,16,6,4,6,87,1
20239,474529,527_16_06,JAPAN,0,TOTALS,JAPAN,200,26,62,41.9,17,39,43.6,9,23,39.1,10,14,71.4,7,28,35,14,19,10,4,3,71,0
20240,474542,527_16_07,LATVIA,0,TOTALS,LATVIA,200,28,70,40.0,25,44,56.8,3,26,11.5,11,18,61.1,10,32,42,19,16,7,2,4,70,0
20241,474555,527_16_07,PUERTO RICO,0,TOTALS,PUERTO RICO,200,31,73,42.5,24,51,47.1,7,22,31.8,8,15,53.3,12,35,47,12,19,5,5,1,77,1
20242,474568,527_16_08,SERBIA,0,TOTALS,SERBIA,200,35,64,54.7,24,39,61.5,11,25,44.0,15,16,93.8,11,24,35,28,19,8,10,0,96,1
20243,474581,527_16_08,CZECH REPUBLIC,0,TOTALS,CZECH REPUBLIC,200,29,60,48.3,19,36,52.8,10,24,41.7,4,10,40.0,10,18,28,23,18,15,6,4,72,0
20244,474594,527_16_09,SERBIA,0,TOTALS,SERBIA,200,37,63,58.7,25,38,65.8,12,25,48.0,22,26,84.6,9,29,38,37,22,15,9,2,108,0
20245,474607,527_16_09,PUERTO RICO,0,TOTALS,PUERTO RICO,200,24,63,38.1,13,38,34.2,11,25,44.0,18,20,90.0,11,17,28,16,24,18,10,0,77,1
20246,475114,529_16_01,KOREA,0,TOTALS,KOREA,225,35,82,42.7,23,51,45.1,12,31,38.7,8,14,57.1,17,27,44,24,16,15,14,1,90,1
20247,475127,529_16_01,FRANCE,0,TOTALS,FRANCE,225,34,85,40.0,28,56,50.0,6,29,20.7,10,14,71.4,21,32,53,13,17,18,9,2,84,0
20248,475140,529_16_02,FINLAND,0,TOTALS,FINLAND,200,26,63,41.3,18,42,42.9,8,21,38.1,5,7,71.4,11,30,41,16,22,26,14,5,65,1
20249,475153,529_16_02,CHINA,0,TOTALS,CHINA,200,22,68,32.4,19,44,43.2,3,24,12.5,11,23,47.8,21,28,49,11,15,26,11,2,58,0
20250,475166,529_16_03,BOSNIA AND HERZEGOVINA,0,TOTALS,BOSNIA AND HERZEGOVINA,200,33,83,39.8,29,69,42.0,4,14,28.6,14,25,56.0,31,32,63,18,22,24,7,3,84,1
20251,475179,529_16_03,DOMINICAN REPUBLIC,0,TOTALS,DOMINICAN REPUBLIC,200,24,63,38.1,22,47,46.8,2,16,12.5,9,20,45.0,11,23,34,7,25,26,9,3,59,0
20252,475192,529_16_04,AUSTRALIA,0,TOTALS,AUSTRALIA,200,26,57,45.6,15,33,45.5,11,24,45.8,15,30,50.0,7,37,44,20,26,25,3,3,78,0
20253,475205,529_16_04,CANADA,0,TOTALS,CANADA,200,31,75,41.3,25,49,51.0,6,26,23.1,13,28,46.4,15,28,43,12,25,15,12,3,81,1
20254,475218,529_16_05,SPAIN,0,TOTALS,SPAIN,200,29,75,38.7,17,39,43.6,12,36,33.3,16,32,50.0,27,47,74,18,15,31,8,2,86,1
20255,475231,529_16_05,MALI,0,TOTALS,MALI,200,24,79,30.4,22,63,34.9,2,16,12.5,5,14,35.7,10,24,34,7,23,17,16,7,55,0
20256,475244,529_16_06,ARGENTINA,0,TOTALS,ARGENTINA,200,17,53,32.1,14,39,35.9,3,14,21.4,20,33,60.6,9,31,40,4,22,23,9,2,57,0
20257,475257,529_16_06,LITHUANIA,0,TOTALS,LITHUANIA,200,30,74,40.5,22,41,53.7,8,33,24.2,6,12,50.0,15,33,48,15,32,19,12,2,74,1
20258,475270,529_16_07,USA,0,TOTALS,USA,200,44,82,53.7,39,63,61.9,5,19,26.3,26,36,72.2,24,33,57,14,16,15,20,9,119,0
20259,475283,529_16_07,CHINESE TAIPEI,0,TOTALS,CHINESE TAIPEI,200,17,60,28.3,15,42,35.7,2,18,11.1,9,12,75.0,9,19,28,7,27,29,8,2,45,1
20260,475296,529_16_08,EGYPT,0,TOTALS,EGYPT,200,26,66,39.4,23,51,45.1,3,15,20.0,6,15,40.0,19,33,52,13,14,28,9,8,61,0
20261,475309,529_16_08,TURKEY,0,TOTALS,TURKEY,200,30,89,33.7,24,62,38.7,6,27,22.2,5,11,45.5,28,27,55,17,17,18,21,5,71,1
20262,475322,529_16_09,MALI,0,TOTALS,MALI,200,20,71,28.2,19,52,36.5,1,19,5.3,15,24,62.5,19,31,50,9,20,14,11,1,56,1
20263,475335,529_16_09,ARGENTINA,0,TOTALS,ARGENTINA,200,15,59,25.4,7,33,21.2,8,26,30.8,9,19,47.4,15,37,52,10,18,25,9,2,47,0
20264,475348,529_16_10,LITHUANIA,0,TOTALS,LITHUANIA,200,19,70,27.1,13,46,28.3,6,24,25.0,17,30,56.7,22,27,49,7,25,19,12,0,61,0
20265,475361,529_16_10,SPAIN,0,TOTALS,SPAIN,200,21,52,40.4,16,34,47.1,5,18,27.8,18,27,66.7,7,35,42,10,25,24,11,6,65,1
20266,475374,529_16_11,CHINESE TAIPEI,0,TOTALS,CHINESE TAIPEI,200,26,73,35.6,13,38,34.2,13,35,37.1,6,13,46.2,11,20,31,14,25,17,16,0,71,0
20267,475387,529_16_11,EGYPT,0,TOTALS,EGYPT,200,33,65,50.8,28,53,52.8,5,12,41.7,17,30,56.7,21,39,60,15,15,31,5,3,88,1
20268,475400,529_16_12,TURKEY,0,TOTALS,TURKEY,200,26,58,44.8,19,41,46.3,7,17,41.2,7,12,58.3,6,24,30,13,26,23,7,1,66,0
20269,475413,529_16_12,USA,0,TOTALS,USA,200,31,72,43.1,27,59,45.8,4,13,30.8,18,30,60.0,20,29,49,11,17,17,13,3,84,1
20270,475426,529_16_13,CHINA,0,TOTALS,CHINA,200,33,60,55.0,28,44,63.6,5,16,31.2,19,26,73.1,10,26,36,13,30,18,7,4,90,1
20271,475439,529_16_13,AUSTRALIA,0,TOTALS,AUSTRALIA,200,26,63,41.3,21,49,42.9,5,14,35.7,15,29,51.7,17,23,40,10,24,20,8,5,72,0
20272,475452,529_16_14,DOMINICAN REPUBLIC,0,TOTALS,DOMINICAN REPUBLIC,200,28,80,35.0,25,58,43.1,3,22,13.6,12,18,66.7,27,31,58,14,21,16,3,4,71,0
20273,475465,529_16_14,KOREA,0,TOTALS,KOREA,200,24,65,36.9,18,40,45.0,6,25,24.0,23,26,88.5,11,27,38,15,14,11,8,2,77,1
20274,475478,529_16_15,CANADA,0,TOTALS,CANADA,200,29,68,42.6,18,43,41.9,11,25,44.0,23,37,62.2,22,29,51,20,19,16,10,5,92,1
20275,475491,529_16_15,FINLAND,0,TOTALS,FINLAND,200,27,72,37.5,20,46,43.5,7,26,26.9,7,13,53.8,17,22,39,11,26,16,8,3,68,0
20276,475504,529_16_16,FRANCE,0,TOTALS,FRANCE,200,30,72,41.7,24,50,48.0,6,22,27.3,18,28,64.3,17,30,47,13,23,14,10,5,84,1
20277,475517,529_16_16,BOSNIA AND HERZEGOVINA,0,TOTALS,BOSNIA AND HERZEGOVINA,200,23,61,37.7,18,40,45.0,5,21,23.8,14,25,56.0,13,31,44,13,23,23,4,2,65,0
20278,475530,529_16_17,USA,0,TOTALS,USA,200,44,84,52.4,36,61,59.0,8,23,34.8,8,18,44.4,23,40,63,23,18,15,13,4,104,0
20279,475543,529_16_17,EGYPT,0,TOTALS,EGYPT,200,20,71,28.2,13,55,23.6,7,16,43.8,10,17,58.8,12,22,34,17,17,20,8,2,57,1
20280,475556,529_16_18,TURKEY,0,TOTALS,TURKEY,200,31,74,41.9,28,58,48.3,3,16,18.8,11,24,45.8,26,45,71,19,28,26,8,3,76,1
20281,475569,529_16_18,CHINESE TAIPEI,0,TOTALS,CHINESE TAIPEI,200,21,71,29.6,17,50,34.0,4,21,19.0,10,23,43.5,10,24,34,8,21,17,16,1,56,0
20282,475582,529_16_19,ARGENTINA,0,TOTALS,ARGENTINA,200,20,62,32.3,17,38,44.7,3,24,12.5,6,17,35.3,12,27,39,8,29,20,10,3,49,0
20283,475595,529_16_19,SPAIN,0,TOTALS,SPAIN,200,18,55,32.7,15,38,39.5,3,17,17.6,20,29,69.0,13,36,49,13,20,22,8,2,59,1
20284,475608,529_16_20,MALI,0,TOTALS,MALI,200,24,70,34.3,19,50,38.0,5,20,25.0,20,36,55.6,16,29,45,4,23,18,11,1,73,0
20285,475621,529_16_20,LITHUANIA,0,TOTALS,LITHUANIA,200,34,79,43.0,24,38,63.2,10,41,24.4,18,22,81.8,19,36,55,26,31,19,10,0,96,1
20286,475634,529_16_21,AUSTRALIA,0,TOTALS,AUSTRALIA,200,24,52,46.2,18,31,58.1,6,21,28.6,23,34,67.6,10,37,47,11,16,25,9,2,77,1
20287,475647,529_16_21,FINLAND,0,TOTALS,FINLAND,200,23,69,33.3,18,45,40.0,5,24,20.8,11,15,73.3,10,25,35,7,25,19,12,4,62,0
20288,475660,529_16_22,CHINA,0,TOTALS,CHINA,200,19,74,25.7,12,45,26.7,7,29,24.1,9,10,90.0,17,24,41,10,25,25,8,2,54,1
20289,475673,529_16_22,CANADA,0,TOTALS,CANADA,200,38,76,50.0,30,53,56.6,8,23,34.8,21,34,61.8,18,38,56,21,14,14,16,8,105,0
20290,475686,529_16_23,BOSNIA AND HERZEGOVINA,0,TOTALS,BOSNIA AND HERZEGOVINA,200,37,67,55.2,28,44,63.6,9,23,39.1,22,28,78.6,19,30,49,24,18,13,3,4,105,0
20291,475699,529_16_23,KOREA,0,TOTALS,KOREA,200,28,64,43.8,18,33,54.5,10,31,32.3,19,23,82.6,5,9,14,15,25,7,6,0,85,1
20292,475712,529_16_24,FRANCE,0,TOTALS,FRANCE,200,30,59,50.8,23,36,63.9,7,23,30.4,11,18,61.1,14,31,45,17,15,19,10,1,78,1
20293,475725,529_16_24,DOMINICAN REPUBLIC,0,TOTALS,DOMINICAN REPUBLIC,200,18,55,32.7,16,39,41.0,2,16,12.5,10,18,55.6,10,20,30,9,18,17,9,4,48,0
20294,475738,529_16_25,EGYPT,0,TOTALS,EGYPT,200,26,68,38.2,26,62,41.9,0,6,0.0,13,21,61.9,14,40,54,9,17,19,3,9,65,0
20295,475751,529_16_25,LITHUANIA,0,TOTALS,LITHUANIA,200,29,84,34.5,14,41,34.1,15,43,34.9,7,16,43.8,20,32,52,16,22,11,14,2,80,1
20296,475764,529_16_26,FINLAND,0,TOTALS,FINLAND,200,16,69,23.2,13,45,28.9,3,24,12.5,3,8,37.5,19,21,40,6,21,20,5,2,38,0
20297,475777,529_16_26,FRANCE,0,TOTALS,FRANCE,200,20,57,35.1,16,39,41.0,4,18,22.2,16,21,76.2,16,34,50,11,15,22,6,10,60,1
20298,475790,529_16_27,CANADA,0,TOTALS,CANADA,200,29,80,36.2,26,58,44.8,3,22,13.6,18,40,45.0,24,40,64,13,17,23,14,7,79,1
20299,475803,529_16_27,DOMINICAN REPUBLIC,0,TOTALS,DOMINICAN REPUBLIC,200,19,64,29.7,16,45,35.6,3,19,15.8,11,20,55.0,11,39,50,10,28,34,11,3,52,0
20300,475816,529_16_28,TURKEY,0,TOTALS,TURKEY,200,30,71,42.3,25,51,49.0,5,20,25.0,12,34,35.3,22,52,74,22,22,21,9,2,77,1
20301,475829,529_16_28,MALI,0,TOTALS,MALI,200,24,86,27.9,21,64,32.8,3,22,13.6,7,19,36.8,16,29,45,13,27,12,11,4,58,0
20302,475842,529_16_29,AUSTRALIA,0,TOTALS,AUSTRALIA,200,30,75,40.0,22,47,46.8,8,28,28.6,7,15,46.7,18,32,50,13,26,16,6,9,75,1
20303,475855,529_16_29,BOSNIA AND HERZEGOVINA,0,TOTALS,BOSNIA AND HERZEGOVINA,200,21,68,30.9,14,46,30.4,7,22,31.8,23,35,65.7,21,29,50,9,20,15,8,6,72,0
20304,475868,529_16_30,CHINESE TAIPEI,0,TOTALS,CHINESE TAIPEI,200,22,58,37.9,16,40,40.0,6,18,33.3,10,16,62.5,5,22,27,14,24,28,2,0,60,1
20305,475881,529_16_30,SPAIN,0,TOTALS,SPAIN,200,44,74,59.5,39,62,62.9,5,12,41.7,19,35,54.3,16,34,50,25,20,15,19,3,112,0
20306,475894,529_16_31,USA,0,TOTALS,USA,200,37,87,42.5,30,65,46.2,7,22,31.8,28,37,75.7,31,35,66,19,19,13,11,6,109,0
20307,475907,529_16_31,ARGENTINA,0,TOTALS,ARGENTINA,200,16,65,24.6,13,43,30.2,3,22,13.6,21,27,77.8,18,23,41,6,29,23,3,3,56,1
20308,475920,529_16_32,CHINA,0,TOTALS,CHINA,200,28,71,39.4,23,49,46.9,5,22,22.7,9,16,56.2,19,27,46,15,20,15,5,3,70,0
20309,475933,529_16_32,KOREA,0,TOTALS,KOREA,200,27,59,45.8,20,30,66.7,7,29,24.1,14,18,77.8,6,29,35,11,15,16,8,2,75,1
20310,475946,529_16_33,EGYPT,0,TOTALS,EGYPT,200,28,58,48.3,25,44,56.8,3,14,21.4,14,23,60.9,9,29,38,16,15,18,8,6,73,0
20311,475959,529_16_33,FINLAND,0,TOTALS,FINLAND,200,31,67,46.3,12,28,42.9,19,39,48.7,3,4,75.0,8,23,31,27,23,16,9,2,84,1
20312,475972,529_16_34,MALI,0,TOTALS,MALI,200,25,73,34.2,18,51,35.3,7,22,31.8,13,23,56.5,12,34,46,12,18,12,5,5,70,0
20313,475985,529_16_34,DOMINICAN REPUBLIC,0,TOTALS,DOMINICAN REPUBLIC,200,28,66,42.4,21,46,45.7,7,20,35.0,11,23,47.8,10,40,50,16,18,17,7,3,74,1
20314,475998,529_16_35,CHINESE TAIPEI,0,TOTALS,CHINESE TAIPEI,200,29,75,38.7,24,50,48.0,5,25,20.0,12,18,66.7,16,26,42,9,22,25,7,7,75,1
20315,476011,529_16_35,BOSNIA AND HERZEGOVINA,0,TOTALS,BOSNIA AND HERZEGOVINA,200,41,85,48.2,35,70,50.0,6,15,40.0,17,27,63.0,23,30,53,23,20,19,15,4,105,0
20316,476024,529_16_36,ARGENTINA,0,TOTALS,ARGENTINA,200,27,62,43.5,21,47,44.7,6,15,40.0,14,29,48.3,16,26,42,7,22,15,3,3,74,0
20317,476037,529_16_36,CHINA,0,TOTALS,CHINA,200,28,72,38.9,26,53,49.1,2,19,10.5,22,26,84.6,21,26,47,11,26,11,8,0,80,1
20318,476050,529_16_37,MALI,0,TOTALS,MALI,200,26,68,38.2,25,52,48.1,1,16,6.2,8,11,72.7,12,25,37,16,20,17,14,1,61,0
20319,476063,529_16_37,CHINESE TAIPEI,0,TOTALS,CHINESE TAIPEI,200,26,65,40.0,16,34,47.1,10,31,32.3,15,20,75.0,16,32,48,16,17,21,8,1,77,1
20320,476076,529_16_38,ARGENTINA,0,TOTALS,ARGENTINA,275,27,94,28.7,15,51,29.4,12,43,27.9,10,16,62.5,17,36,53,22,28,23,17,3,76,1
20321,476089,529_16_38,EGYPT,0,TOTALS,EGYPT,275,25,76,32.9,24,61,39.3,1,15,6.7,22,42,52.4,22,51,73,14,16,33,11,8,73,0
20322,476102,529_16_39,DOMINICAN REPUBLIC,0,TOTALS,DOMINICAN REPUBLIC,200,25,71,35.2,22,54,40.7,3,17,17.6,20,35,57.1,21,26,47,21,25,24,12,3,73,0
20323,476115,529_16_39,BOSNIA AND HERZEGOVINA,0,TOTALS,BOSNIA AND HERZEGOVINA,200,36,85,42.4,32,68,47.1,4,17,23.5,20,29,69.0,28,30,58,23,29,20,14,6,96,1
20324,476128,529_16_40,TURKEY,0,TOTALS,TURKEY,200,26,68,38.2,24,54,44.4,2,14,14.3,26,43,60.5,23,44,67,10,23,21,3,3,80,1
20325,476141,529_16_40,CANADA,0,TOTALS,CANADA,200,25,79,31.6,15,50,30.0,10,29,34.5,14,28,50.0,16,24,40,11,29,12,10,0,74,0
20326,476154,529_16_41,CHINA,0,TOTALS,CHINA,200,24,48,50.0,16,29,55.2,8,19,42.1,21,28,75.0,7,32,39,17,20,16,6,5,77,1
20327,476167,529_16_41,FINLAND,0,TOTALS,FINLAND,200,22,61,36.1,17,41,41.5,5,20,25.0,8,13,61.5,9,20,29,11,24,12,3,1,57,0
20328,476180,529_16_42,LITHUANIA,0,TOTALS,LITHUANIA,225,26,75,34.7,16,44,36.4,10,31,32.3,11,15,73.3,19,25,44,12,18,13,4,0,73,1
20329,476193,529_16_42,FRANCE,0,TOTALS,FRANCE,225,26,64,40.6,20,41,48.8,6,23,26.1,14,21,66.7,14,30,44,13,25,18,4,6,72,0
20330,476206,529_16_43,SPAIN,0,TOTALS,SPAIN,200,29,64,45.3,26,48,54.2,3,16,18.8,13,23,56.5,5,27,32,9,19,13,15,3,74,1
20331,476219,529_16_43,AUSTRALIA,0,TOTALS,AUSTRALIA,200,23,67,34.3,19,50,38.0,4,17,23.5,13,22,59.1,19,37,56,9,21,24,8,5,63,0
20332,476232,529_16_44,USA,0,TOTALS,USA,200,54,86,62.8,45,64,70.3,9,22,40.9,16,22,72.7,22,40,62,26,15,26,13,7,133,0
20333,476245,529_16_44,KOREA,0,TOTALS,KOREA,200,33,83,39.8,26,54,48.1,7,29,24.1,8,13,61.5,10,12,22,13,20,19,13,1,81,1
20334,476258,529_16_45,CANADA,0,TOTALS,CANADA,200,36,71,50.7,27,54,50.0,9,17,52.9,15,25,60.0,11,35,46,17,15,21,16,2,96,1
20335,476271,529_16_45,AUSTRALIA,0,TOTALS,AUSTRALIA,200,21,65,32.3,16,38,42.1,5,27,18.5,11,17,64.7,12,28,40,15,21,29,10,2,58,0
20336,476284,529_16_46,TURKEY,0,TOTALS,TURKEY,225,32,78,41.0,29,62,46.8,3,16,18.8,16,32,50.0,19,29,48,9,31,15,14,0,83,1
20337,476297,529_16_46,SPAIN,0,TOTALS,SPAIN,225,25,55,45.5,19,33,57.6,6,22,27.3,23,39,59.0,8,34,42,15,25,22,6,1,79,0
20338,476310,529_16_47,KOREA,0,TOTALS,KOREA,200,24,62,38.7,18,39,46.2,6,23,26.1,7,11,63.6,5,23,28,13,19,18,3,5,61,1
20339,476323,529_16_47,FRANCE,0,TOTALS,FRANCE,200,46,96,47.9,34,63,54.0,12,33,36.4,15,23,65.2,33,34,67,22,14,8,13,6,119,0
20340,476336,529_16_48,USA,0,TOTALS,USA,200,34,81,42.0,28,61,45.9,6,20,30.0,24,40,60.0,28,27,55,15,24,16,13,3,98,1
20341,476349,529_16_48,LITHUANIA,0,TOTALS,LITHUANIA,200,21,56,37.5,14,26,53.8,7,30,23.3,21,29,72.4,11,26,37,13,32,26,6,1,70,0
20342,476362,529_16_49,EGYPT,0,TOTALS,EGYPT,200,18,58,31.0,18,46,39.1,0,12,0.0,2,7,28.6,11,34,45,8,13,23,3,6,38,0
20343,476375,529_16_49,MALI,0,TOTALS,MALI,200,25,85,29.4,21,63,33.3,4,22,18.2,7,19,36.8,32,31,63,10,14,8,15,4,61,1
20344,476388,529_16_50,ARGENTINA,0,TOTALS,ARGENTINA,200,29,72,40.3,24,47,51.1,5,25,20.0,4,8,50.0,14,28,42,17,19,13,10,2,67,1
20345,476401,529_16_50,CHINESE TAIPEI,0,TOTALS,CHINESE TAIPEI,200,20,47,42.6,11,25,44.0,9,22,40.9,15,22,68.2,4,30,34,16,14,21,6,2,64,0
20346,476414,529_16_51,FINLAND,0,TOTALS,FINLAND,200,20,58,34.5,14,32,43.8,6,26,23.1,10,13,76.9,13,30,43,12,30,23,5,5,56,0
20347,476427,529_16_51,DOMINICAN REPUBLIC,0,TOTALS,DOMINICAN REPUBLIC,200,21,64,32.8,15,44,34.1,6,20,30.0,17,34,50.0,21,27,48,13,17,16,13,3,65,1
20348,476440,529_16_52,CHINA,0,TOTALS,CHINA,200,31,69,44.9,23,44,52.3,8,25,32.0,14,20,70.0,14,21,35,25,24,14,7,4,84,0
20349,476453,529_16_52,BOSNIA AND HERZEGOVINA,0,TOTALS,BOSNIA AND HERZEGOVINA,200,35,75,46.7,32,57,56.1,3,18,16.7,15,20,75.0,18,24,42,16,18,12,7,3,88,1
20350,476466,529_16_53,KOREA,0,TOTALS,KOREA,200,28,75,37.3,19,49,38.8,9,26,34.6,11,13,84.6,8,25,33,16,19,11,10,0,76,0
20351,476479,529_16_53,AUSTRALIA,0,TOTALS,AUSTRALIA,200,27,59,45.8,17,27,63.0,10,32,31.2,19,27,70.4,12,40,52,17,14,22,7,4,83,1
20352,476492,529_16_54,FRANCE,0,TOTALS,FRANCE,200,26,75,34.7,20,51,39.2,6,24,25.0,10,16,62.5,24,22,46,19,20,29,8,7,68,0
20353,476505,529_16_54,CANADA,0,TOTALS,CANADA,200,37,74,50.0,27,53,50.9,10,21,47.6,15,22,68.2,17,26,43,20,16,20,17,9,99,1
20354,476518,529_16_55,LITHUANIA,0,TOTALS,LITHUANIA,200,30,67,44.8,20,35,57.1,10,32,31.2,11,25,44.0,14,42,56,15,31,16,9,2,81,1
20355,476531,529_16_55,SPAIN,0,TOTALS,SPAIN,200,20,62,32.3,15,42,35.7,5,20,25.0,18,38,47.4,9,30,39,12,22,10,9,0,63,0
20356,476544,529_16_56,USA,0,TOTALS,USA,200,36,75,48.0,29,51,56.9,7,24,29.2,17,26,65.4,17,34,51,20,16,17,20,3,96,1
20357,476557,529_16_56,TURKEY,0,TOTALS,TURKEY,200,23,73,31.5,21,58,36.2,2,15,13.3,8,12,66.7,15,24,39,8,24,24,7,5,56,0
20358,477843,531_16_01,DEM.REP. OF CONGO,0,TOTALS,DEM.REP. OF CONGO,200,34,96,35.4,32,71,45.1,2,25,8.0,9,18,50.0,21,35,56,19,26,17,17,2,79,1
20359,477856,531_16_01,UGANDA,0,TOTALS,UGANDA,200,22,59,37.3,19,44,43.2,3,15,20.0,14,33,42.4,9,42,51,11,20,31,8,1,61,0
20360,477869,531_16_02,ANGOLA,0,TOTALS,ANGOLA,200,25,62,40.3,21,44,47.7,4,18,22.2,12,24,50.0,11,26,37,7,20,13,6,1,66,1
20361,477882,531_16_02,TUNISIA,0,TOTALS,TUNISIA,200,24,54,44.4,20,39,51.3,4,15,26.7,4,10,40.0,5,24,29,5,17,10,5,3,56,0
20362,477892,531_16_03,COTE D'IVOIRE,0,TOTALS,COTE D'IVOIRE,200,18,45,40.0,18,40,45.0,0,5,0.0,8,15,53.3,4,24,28,4,15,9,2,1,44,0
20363,477905,531_16_03,MALI,0,TOTALS,MALI,200,25,58,43.1,17,31,54.8,8,27,29.6,5,20,25.0,15,21,36,11,15,15,3,1,63,1
20364,477918,531_16_04,GABON,0,TOTALS,GABON,200,25,48,52.1,19,30,63.3,6,18,33.3,8,15,53.3,5,19,24,8,18,4,1,1,64,0
20365,477931,531_16_04,RWANDA,0,TOTALS,RWANDA,200,36,67,53.7,31,47,66.0,5,20,25.0,17,24,70.8,9,14,23,20,22,8,1,0,94,1
20366,477944,531_16_05,REPUBLIC OF BENIN,0,TOTALS,REPUBLIC OF BENIN,200,12,77,15.6,11,56,19.6,1,21,4.8,0,4,0.0,16,16,32,3,17,35,10,2,25,1
20367,477957,531_16_05,EGYPT,0,TOTALS,EGYPT,200,64,97,66.0,61,79,77.2,3,18,16.7,10,21,47.6,25,49,74,42,9,17,20,10,141,0
20368,477970,531_16_06,GABON,0,TOTALS,GABON,200,13,39,33.3,8,18,44.4,5,21,23.8,21,31,67.7,4,7,11,1,13,7,0,0,52,0
20369,477983,531_16_06,ALGERIA,0,TOTALS,ALGERIA,200,32,61,52.5,22,36,61.1,10,25,40.0,10,20,50.0,11,17,28,16,26,7,1,0,84,1
20370,477996,531_16_07,EGYPT,0,TOTALS,EGYPT,200,31,73,42.5,21,42,50.0,10,31,32.3,15,26,57.7,18,26,44,12,24,15,7,4,87,1
20371,478009,531_16_07,UGANDA,0,TOTALS,UGANDA,200,16,54,29.6,14,40,35.0,2,14,14.3,14,23,60.9,10,22,32,5,20,13,7,1,48,0
20372,478022,531_16_08,REPUBLIC OF BENIN,0,TOTALS,REPUBLIC OF BENIN,200,14,44,31.8,14,34,41.2,0,10,0.0,1,4,25.0,3,7,10,4,17,22,1,0,29,1
20373,478035,531_16_08,ANGOLA,0,TOTALS,ANGOLA,200,52,81,64.2,45,56,80.4,7,25,28.0,16,24,66.7,9,8,17,11,10,7,5,2,127,0
20374,478048,531_16_09,RWANDA,0,TOTALS,RWANDA,200,27,50,54.0,19,26,73.1,8,24,33.3,12,16,75.0,5,21,26,11,24,12,1,1,74,1
20375,478059,531_16_09,COTE D'IVOIRE,0,TOTALS,COTE D'IVOIRE,200,18,49,36.7,9,22,40.9,9,27,33.3,20,34,58.8,6,12,18,5,11,10,3,0,65,0
20376,478072,531_16_10,TUNISIA,0,TOTALS,TUNISIA,200,19,40,47.5,17,33,51.5,2,7,28.6,30,45,66.7,8,23,31,3,23,15,1,0,70,1
20377,478084,531_16_10,DEM.REP. OF CONGO,0,TOTALS,DEM.REP. OF CONGO,200,27,54,50.0,21,45,46.7,6,9,66.7,7,17,41.2,5,19,24,6,29,20,3,0,67,0
20378,478097,531_16_11,UGANDA,0,TOTALS,UGANDA,200,26,66,39.4,24,54,44.4,2,12,16.7,5,11,45.5,11,31,42,11,24,31,13,1,59,1
20379,478110,531_16_11,ANGOLA,0,TOTALS,ANGOLA,200,34,72,47.2,23,42,54.8,11,30,36.7,26,35,74.3,7,21,28,18,11,18,18,8,105,0
20380,478123,531_16_12,TUNISIA,0,TOTALS,TUNISIA,200,32,58,55.2,25,40,62.5,7,18,38.9,15,22,68.2,9,24,33,14,15,8,3,1,86,1
20381,478136,531_16_12,REPUBLIC OF BENIN,0,TOTALS,REPUBLIC OF BENIN,200,11,39,28.2,6,23,26.1,5,16,31.2,6,12,50.0,3,15,18,5,20,12,1,2,33,0
20382,478148,531_16_13,DEM.REP. OF CONGO,0,TOTALS,DEM.REP. OF CONGO,200,18,42,42.9,14,34,41.2,4,8,50.0,28,51,54.9,2,11,13,4,21,16,0,0,68,0
20383,478161,531_16_13,EGYPT,0,TOTALS,EGYPT,200,37,49,75.5,31,40,77.5,6,9,66.7,15,25,60.0,2,26,28,8,30,20,0,0,95,1
20384,478174,531_16_14,MALI,0,TOTALS,MALI,200,24,64,37.5,23,44,52.3,1,20,5.0,12,16,75.0,6,28,34,5,17,10,11,1,61,1
20385,478187,531_16_14,RWANDA,0,TOTALS,RWANDA,200,14,45,31.1,11,28,39.3,3,17,17.6,9,20,45.0,6,30,36,7,21,22,1,1,40,0
20386,478198,531_16_15,COTE D'IVOIRE,0,TOTALS,COTE D'IVOIRE,200,14,51,27.5,12,35,34.3,2,16,12.5,15,47,31.9,14,20,34,5,27,8,3,4,45,0
20387,478211,531_16_15,ALGERIA,0,TOTALS,ALGERIA,200,15,51,29.4,11,25,44.0,4,26,15.4,24,37,64.9,16,32,48,8,36,18,4,4,58,1
20388,478224,531_16_16,ANGOLA,0,TOTALS,ANGOLA,200,23,42,54.8,21,36,58.3,2,6,33.3,35,52,67.3,9,26,35,9,23,21,6,0,83,1
20389,478236,531_16_16,DEM.REP. OF CONGO,0,TOTALS,DEM.REP. OF CONGO,200,26,53,49.1,17,35,48.6,9,18,50.0,14,28,50.0,7,16,23,8,35,19,4,0,75,0
20390,478249,531_16_17,REPUBLIC OF BENIN,0,TOTALS,REPUBLIC OF BENIN,200,20,39,51.3,17,29,58.6,3,10,30.0,14,25,56.0,4,11,15,18,16,27,13,0,57,0
20391,478262,531_16_17,UGANDA,0,TOTALS,UGANDA,200,31,46,67.4,23,30,76.7,8,16,50.0,13,24,54.2,7,14,21,17,20,28,16,1,83,1
20392,478275,531_16_18,GABON,0,TOTALS,GABON,200,17,54,31.5,12,33,36.4,5,21,23.8,29,54,53.7,16,21,37,8,29,21,4,6,68,0
20393,478286,531_16_18,COTE D'IVOIRE,0,TOTALS,COTE D'IVOIRE,200,28,62,45.2,23,49,46.9,5,13,38.5,16,38,42.1,14,21,35,19,37,25,3,1,77,1
20394,478299,531_16_19,ALGERIA,0,TOTALS,ALGERIA,200,24,64,37.5,16,43,37.2,8,21,38.1,12,21,57.1,11,29,40,13,26,17,4,2,68,0
20395,478312,531_16_19,MALI,0,TOTALS,MALI,200,23,63,36.5,20,33,60.6,3,30,10.0,23,34,67.6,14,28,42,12,25,15,13,2,72,1
20396,478325,531_16_20,EGYPT,0,TOTALS,EGYPT,200,27,65,41.5,19,34,55.9,8,31,25.8,11,13,84.6,13,33,46,8,17,16,7,5,73,1
20397,478338,531_16_20,TUNISIA,0,TOTALS,TUNISIA,200,20,60,33.3,18,44,40.9,2,16,12.5,10,16,62.5,5,22,27,6,20,15,5,1,52,0
20398,478351,531_16_21,MALI,0,TOTALS,MALI,200,34,74,45.9,31,47,66.0,3,27,11.1,20,32,62.5,19,24,43,12,23,5,7,1,91,1
20399,478364,531_16_21,GABON,0,TOTALS,GABON,200,11,41,26.8,10,30,33.3,1,11,9.1,16,20,80.0,6,21,27,2,24,13,1,2,39,0
20400,478377,531_16_22,UGANDA,0,TOTALS,UGANDA,200,23,40,57.5,18,28,64.3,5,12,41.7,22,35,62.9,3,23,26,4,29,14,2,1,73,0
20401,478390,531_16_22,TUNISIA,0,TOTALS,TUNISIA,200,27,55,49.1,20,30,66.7,7,25,28.0,28,47,59.6,8,16,24,10,26,9,4,2,89,1
20402,478402,531_16_23,DEM.REP. OF CONGO,0,TOTALS,DEM.REP. OF CONGO,200,50,81,61.7,46,61,75.4,4,20,20.0,16,29,55.2,19,21,40,21,16,13,15,5,120,0
20403,478415,531_16_23,REPUBLIC OF BENIN,0,TOTALS,REPUBLIC OF BENIN,200,26,58,44.8,20,40,50.0,6,18,33.3,7,11,63.6,5,17,22,10,27,25,5,2,65,1
20404,478428,531_16_24,RWANDA,0,TOTALS,RWANDA,200,19,54,35.2,15,40,37.5,4,14,28.6,11,27,40.7,13,34,47,12,23,22,10,2,53,1
20405,478441,531_16_24,ALGERIA,0,TOTALS,ALGERIA,200,15,52,28.8,14,28,50.0,1,24,4.2,9,26,34.6,10,26,36,5,25,23,14,4,40,0
20406,478454,531_16_25,EGYPT,0,TOTALS,EGYPT,200,23,58,39.7,12,33,36.4,11,25,44.0,8,20,40.0,11,23,34,11,28,13,9,6,65,0
20407,478467,531_16_25,ANGOLA,0,TOTALS,ANGOLA,200,27,62,43.5,16,31,51.6,11,31,35.5,19,35,54.3,14,31,45,12,22,19,7,3,84,1
20408,478480,531_16_26,REPUBLIC OF BENIN,0,TOTALS,REPUBLIC OF BENIN,200,23,64,35.9,17,46,37.0,6,18,33.3,5,11,45.5,7,21,28,10,17,24,14,3,57,0
20409,478493,531_16_26,GABON,0,TOTALS,GABON,200,29,67,43.3,27,50,54.0,2,17,11.8,14,22,63.6,16,27,43,5,12,25,17,7,74,1
20410,478504,531_16_27,COTE D'IVOIRE,0,TOTALS,COTE D'IVOIRE,200,14,54,25.9,11,42,26.2,3,12,25.0,16,27,59.3,8,24,32,6,34,30,12,1,47,0
20411,478517,531_16_27,ANGOLA,0,TOTALS,ANGOLA,200,25,61,41.0,19,38,50.0,6,23,26.1,29,43,67.4,19,29,48,14,23,27,21,9,85,1
20412,478530,531_16_28,ALGERIA,0,TOTALS,ALGERIA,200,25,63,39.7,16,42,38.1,9,21,42.9,15,33,45.5,18,29,47,11,25,19,4,1,74,0
20413,478543,531_16_28,EGYPT,0,TOTALS,EGYPT,200,33,65,50.8,30,48,62.5,3,17,17.6,13,29,44.8,10,30,40,17,23,17,3,1,82,1
20414,478556,531_16_29,TUNISIA,0,TOTALS,TUNISIA,200,21,53,39.6,14,35,40.0,7,18,38.9,19,27,70.4,10,33,43,7,12,12,4,2,68,1
20415,478569,531_16_29,RWANDA,0,TOTALS,RWANDA,200,22,65,33.8,16,35,45.7,6,30,20.0,1,7,14.3,11,23,34,12,22,13,5,2,51,0
20416,478581,531_16_30,DEM.REP. OF CONGO,0,TOTALS,DEM.REP. OF CONGO,200,24,68,35.3,20,47,42.6,4,21,19.0,6,12,50.0,18,21,39,13,33,15,5,2,58,0
20417,478594,531_16_30,MALI,0,TOTALS,MALI,200,30,62,48.4,22,44,50.0,8,18,44.4,17,41,41.5,18,25,43,8,16,14,3,7,85,1
20418,478607,531_16_31,UGANDA,0,TOTALS,UGANDA,200,28,59,47.5,27,44,61.4,1,15,6.7,13,19,68.4,7,35,42,16,21,32,3,2,70,1
20419,478620,531_16_31,GABON,0,TOTALS,GABON,200,24,75,32.0,20,51,39.2,4,24,16.7,14,31,45.2,18,23,41,9,17,21,3,5,66,0
20420,478632,531_16_32,DEM.REP. OF CONGO,0,TOTALS,DEM.REP. OF CONGO,200,31,70,44.3,26,53,49.1,5,17,29.4,10,18,55.6,12,31,43,15,13,19,3,3,77,1
20421,478645,531_16_32,ALGERIA,0,TOTALS,ALGERIA,200,24,70,34.3,17,45,37.8,7,25,28.0,11,16,68.8,13,24,37,10,16,26,4,5,66,0
20422,478656,531_16_33,COTE D'IVOIRE,0,TOTALS,COTE D'IVOIRE,200,27,67,40.3,23,48,47.9,4,19,21.1,16,32,50.0,10,33,43,6,35,14,5,1,74,0
20423,478669,531_16_33,RWANDA,0,TOTALS,RWANDA,200,22,60,36.7,17,42,40.5,5,18,27.8,27,52,51.9,13,30,43,7,29,17,9,3,76,1
20424,478682,531_16_34,ANGOLA,0,TOTALS,ANGOLA,200,34,53,64.2,23,31,74.2,11,22,50.0,13,30,43.3,10,26,36,14,21,13,7,5,92,1
20425,478695,531_16_34,TUNISIA,0,TOTALS,TUNISIA,200,19,55,34.5,16,35,45.7,3,20,15.0,17,24,70.8,4,15,19,6,21,10,3,0,58,0
20426,478708,531_16_35,MALI,0,TOTALS,MALI,200,27,67,40.3,20,44,45.5,7,23,30.4,13,25,52.0,15,26,41,11,20,18,12,2,74,0
20427,478721,531_16_35,EGYPT,0,TOTALS,EGYPT,200,30,63,47.6,28,48,58.3,2,15,13.3,15,26,57.7,12,27,39,10,19,18,5,6,77,1
20428,478734,531_16_36,ALGERIA,0,TOTALS,ALGERIA,200,21,54,38.9,15,29,51.7,6,25,24.0,7,10,70.0,3,23,26,12,16,23,12,3,55,1
20429,478745,531_16_36,COTE D'IVOIRE,0,TOTALS,COTE D'IVOIRE,200,22,59,37.3,19,42,45.2,3,17,17.6,7,12,58.3,15,28,43,10,10,24,8,3,54,0
20430,478757,531_16_37,DEM.REP. OF CONGO,0,TOTALS,DEM.REP. OF CONGO,200,30,64,46.9,25,46,54.3,5,18,27.8,8,16,50.0,6,20,26,9,17,10,0,5,73,0
20431,478770,531_16_37,RWANDA,0,TOTALS,RWANDA,200,31,65,47.7,25,46,54.3,6,19,31.6,9,13,69.2,5,24,29,13,14,12,2,2,77,1
20432,478783,531_16_38,MALI,0,TOTALS,MALI,200,20,65,30.8,14,38,36.8,6,27,22.2,13,25,52.0,24,33,57,6,17,12,2,4,59,1
20433,478796,531_16_38,TUNISIA,0,TOTALS,TUNISIA,200,18,57,31.6,13,40,32.5,5,17,29.4,11,18,61.1,6,25,31,6,19,9,1,1,52,0
20434,478809,531_16_39,EGYPT,0,TOTALS,EGYPT,225,30,66,45.5,23,43,53.5,7,23,30.4,15,24,62.5,10,28,38,16,21,9,4,2,82,0
20435,478822,531_16_39,ANGOLA,0,TOTALS,ANGOLA,225,29,70,41.4,18,43,41.9,11,27,40.7,17,27,63.0,18,27,45,14,21,16,3,1,86,1
20436,479429,535_16_01,JAPAN,0,TOTALS,JAPAN,200,30,66,45.5,21,49,42.9,9,17,52.9,4,11,36.4,15,21,36,15,23,14,6,3,73,0
20437,479442,535_16_01,KOREA,0,TOTALS,KOREA,200,29,56,51.8,21,32,65.6,8,24,33.3,14,20,70.0,7,24,31,16,22,13,9,5,80,1
20438,479455,535_16_02,IRAN,0,TOTALS,IRAN,200,32,66,48.5,22,37,59.5,10,29,34.5,7,10,70.0,14,36,50,19,18,13,6,2,81,1
20439,479468,535_16_02,QATAR,0,TOTALS,QATAR,200,17,57,29.8,9,32,28.1,8,25,32.0,7,9,77.8,4,21,25,11,18,12,7,2,49,0
20440,479481,535_16_03,CHINA,0,TOTALS,CHINA,200,28,56,50.0,18,35,51.4,10,21,47.6,28,35,80.0,9,25,34,16,32,19,4,2,94,1
20441,479494,535_16_03,JORDAN,0,TOTALS,JORDAN,200,24,60,40.0,21,40,52.5,3,20,15.0,25,34,73.5,14,17,31,9,32,16,6,2,76,0
20442,479507,535_16_04,PHILIPPINES,0,TOTALS,PHILIPPINES,200,29,86,33.7,18,56,32.1,11,30,36.7,14,24,58.3,21,26,47,11,31,14,11,1,83,0
20443,479520,535_16_04,INDIA,0,TOTALS,INDIA,200,31,67,46.3,25,47,53.2,6,20,30.0,23,33,69.7,13,42,55,12,22,21,7,1,91,1
20444,479533,535_16_05,KOREA,0,TOTALS,KOREA,200,31,71,43.7,17,36,47.2,14,35,40.0,8,11,72.7,14,32,46,24,26,12,10,3,84,1
20445,479546,535_16_05,THAILAND,0,TOTALS,THAILAND,200,15,54,27.8,12,33,36.4,3,21,14.3,10,18,55.6,10,27,37,6,12,19,2,1,43,0
20446,479559,535_16_06,INDIA,0,TOTALS,INDIA,200,25,72,34.7,18,46,39.1,7,26,26.9,9,11,81.8,14,20,34,8,15,11,6,3,66,0
20447,479572,535_16_06,CHINESE TAIPEI,0,TOTALS,CHINESE TAIPEI,200,36,72,50.0,25,47,53.2,11,25,44.0,7,14,50.0,19,34,53,23,15,14,7,3,90,1
20448,479585,535_16_07,QATAR,0,TOTALS,QATAR,200,17,55,30.9,9,25,36.0,8,30,26.7,12,17,70.6,8,33,41,10,20,20,8,0,54,0
20449,479598,535_16_07,IRAQ,0,TOTALS,IRAQ,200,27,70,38.6,19,44,43.2,8,26,30.8,9,17,52.9,14,31,45,11,22,11,12,5,71,1
20450,479611,535_16_08,JORDAN,0,TOTALS,JORDAN,200,32,62,51.6,27,44,61.4,5,18,27.8,20,32,62.5,7,33,40,16,18,13,5,3,89,1
20451,479624,535_16_08,KAZAKHSTAN,0,TOTALS,KAZAKHSTAN,200,29,75,38.7,24,47,51.1,5,28,17.9,8,16,50.0,16,26,42,12,24,14,4,1,71,0
20452,479637,535_16_09,THAILAND,0,TOTALS,THAILAND,200,24,58,41.4,21,39,53.8,3,19,15.8,16,25,64.0,13,24,37,4,14,24,4,0,67,0
20453,479650,535_16_09,JAPAN,0,TOTALS,JAPAN,200,36,76,47.4,25,42,59.5,11,34,32.4,13,19,68.4,17,25,42,22,28,16,14,0,96,1
20454,479663,535_16_10,CHINESE TAIPEI,0,TOTALS,CHINESE TAIPEI,200,27,59,45.8,23,43,53.5,4,16,25.0,29,46,63.0,16,41,57,11,18,19,4,2,87,1
20455,479676,535_16_10,PHILIPPINES,0,TOTALS,PHILIPPINES,200,33,89,37.1,30,66,45.5,3,23,13.0,7,13,53.8,18,22,40,8,31,10,8,3,76,0
20456,479689,535_16_11,IRAQ,0,TOTALS,IRAQ,200,19,66,28.8,16,43,37.2,3,23,13.0,10,20,50.0,15,23,38,9,18,22,5,3,51,0
20457,479702,535_16_11,IRAN,0,TOTALS,IRAN,200,35,68,51.5,24,39,61.5,11,29,37.9,13,18,72.2,10,35,45,17,22,18,12,4,94,1
20458,479715,535_16_12,KAZAKHSTAN,0,TOTALS,KAZAKHSTAN,200,30,65,46.2,21,42,50.0,9,23,39.1,16,20,80.0,12,20,32,9,25,20,7,0,85,1
20459,479728,535_16_12,CHINA,0,TOTALS,CHINA,200,35,63,55.6,24,39,61.5,11,24,45.8,25,30,83.3,10,23,33,17,25,19,8,2,106,0
20460,479741,535_16_13,JORDAN,0,TOTALS,JORDAN,200,46,83,55.4,28,49,57.1,18,34,52.9,11,15,73.3,15,41,56,29,16,18,10,1,121,0
20461,479754,535_16_13,INDIA,0,TOTALS,INDIA,200,24,76,31.6,20,45,44.4,4,31,12.9,13,18,72.2,12,23,35,8,15,20,13,4,65,1
20462,479767,535_16_14,CHINA,0,TOTALS,CHINA,200,22,62,35.5,16,37,43.2,6,25,24.0,25,31,80.6,11,36,47,12,20,14,4,3,75,1
20463,479780,535_16_14,PHILIPPINES,0,TOTALS,PHILIPPINES,200,26,71,36.6,22,49,44.9,4,22,18.2,9,15,60.0,8,27,35,14,26,14,2,4,65,0
20464,479793,535_16_15,KAZAKHSTAN,0,TOTALS,KAZAKHSTAN,200,29,68,42.6,23,47,48.9,6,21,28.6,13,17,76.5,15,18,33,14,27,22,10,2,77,0
20465,479806,535_16_15,CHINESE TAIPEI,0,TOTALS,CHINESE TAIPEI,200,32,63,50.8,26,48,54.2,6,15,40.0,22,27,81.5,12,27,39,17,21,23,12,4,92,1
20466,479819,535_16_16,IRAQ,0,TOTALS,IRAQ,200,22,66,33.3,12,29,41.4,10,37,27.0,11,15,73.3,15,24,39,11,21,12,8,4,65,0
20467,479832,535_16_16,JAPAN,0,TOTALS,JAPAN,200,21,58,36.2,14,31,45.2,7,27,25.9,18,23,78.3,13,31,44,8,18,16,5,1,67,1
20468,479845,535_16_17,IRAN,0,TOTALS,IRAN,200,40,69,58.0,24,34,70.6,16,35,45.7,18,27,66.7,16,35,51,32,9,12,15,1,114,0
20469,479858,535_16_17,THAILAND,0,TOTALS,THAILAND,200,18,58,31.0,13,29,44.8,5,29,17.2,0,0,0.0,5,18,23,9,19,25,3,0,41,1
20470,479871,535_16_18,QATAR,0,TOTALS,QATAR,200,23,68,33.8,15,40,37.5,8,28,28.6,6,8,75.0,13,22,35,6,14,15,4,1,60,0
20471,479884,535_16_18,KOREA,0,TOTALS,KOREA,200,33,65,50.8,18,34,52.9,15,31,48.4,5,8,62.5,9,32,41,21,15,15,7,3,86,1
20472,479897,535_16_19,PHILIPPINES,0,TOTALS,PHILIPPINES,200,33,73,45.2,24,51,47.1,9,22,40.9,23,37,62.2,18,26,44,15,30,16,12,1,98,1
20473,479910,535_16_19,KAZAKHSTAN,0,TOTALS,KAZAKHSTAN,200,31,72,43.1,30,53,56.6,1,19,5.3,23,39,59.0,22,27,49,8,28,21,4,3,86,0
20474,479923,535_16_20,INDIA,0,TOTALS,INDIA,200,28,75,37.3,27,58,46.6,1,17,5.9,13,20,65.0,19,26,45,12,22,16,11,4,70,1
20475,479936,535_16_20,CHINA,0,TOTALS,CHINA,200,20,52,38.5,14,33,42.4,6,19,31.6,18,27,66.7,9,28,37,12,20,22,6,1,64,0
20476,479949,535_16_21,THAILAND,0,TOTALS,THAILAND,200,24,61,39.3,15,30,50.0,9,31,29.0,5,6,83.3,11,27,38,11,19,16,4,3,62,0
20477,479962,535_16_21,QATAR,0,TOTALS,QATAR,200,23,61,37.7,15,32,46.9,8,29,27.6,10,15,66.7,13,25,38,15,13,13,7,5,64,1
20478,479975,535_16_22,CHINESE TAIPEI,0,TOTALS,CHINESE TAIPEI,200,31,75,41.3,28,43,65.1,3,32,9.4,18,23,78.3,10,25,35,15,22,18,4,4,83,1
20479,479988,535_16_22,JORDAN,0,TOTALS,JORDAN,200,43,83,51.8,35,59,59.3,8,24,33.3,15,26,57.7,20,32,52,10,21,14,8,3,109,0
20480,480001,535_16_23,JAPAN,0,TOTALS,JAPAN,200,25,64,39.1,22,52,42.3,3,12,25.0,4,6,66.7,15,27,42,7,24,16,3,2,57,0
20481,480014,535_16_23,IRAN,0,TOTALS,IRAN,200,23,65,35.4,15,32,46.9,8,33,24.2,14,24,58.3,20,26,46,10,16,14,7,3,68,1
20482,480027,535_16_24,KOREA,0,TOTALS,KOREA,200,34,64,53.1,14,26,53.8,20,38,52.6,14,17,82.4,11,24,35,17,23,13,9,5,102,0
20483,480040,535_16_24,IRAQ,0,TOTALS,IRAQ,200,29,67,43.3,19,47,40.4,10,20,50.0,12,25,48.0,18,20,38,12,14,14,6,5,80,1
20484,480053,535_16_25,JORDAN,0,TOTALS,JORDAN,200,36,74,48.6,24,45,53.3,12,29,41.4,35,48,72.9,15,40,55,13,23,18,6,6,119,1
20485,480066,535_16_25,PHILIPPINES,0,TOTALS,PHILIPPINES,200,37,90,41.1,24,56,42.9,13,34,38.2,18,26,69.2,13,26,39,12,34,13,11,2,105,0
20486,480079,535_16_26,CHINA,0,TOTALS,CHINA,200,33,72,45.8,26,44,59.1,7,28,25.0,20,21,95.2,15,25,40,10,24,21,8,4,93,1
20487,480092,535_16_26,CHINESE TAIPEI,0,TOTALS,CHINESE TAIPEI,200,34,69,49.3,31,59,52.5,3,10,30.0,17,21,81.0,10,24,34,7,20,21,8,1,88,0
20488,480105,535_16_27,IRAQ,0,TOTALS,IRAQ,200,46,86,53.5,42,65,64.6,4,21,19.0,6,11,54.5,20,37,57,20,16,13,10,13,102,0
20489,480118,535_16_27,THAILAND,0,TOTALS,THAILAND,200,27,70,38.6,16,42,38.1,11,28,39.3,4,12,33.3,11,23,34,12,18,20,5,3,69,1
20490,480131,535_16_28,KAZAKHSTAN,0,TOTALS,KAZAKHSTAN,200,35,75,46.7,23,48,47.9,12,27,44.4,8,13,61.5,9,21,30,17,21,18,6,2,90,1
20491,480144,535_16_28,INDIA,0,TOTALS,INDIA,200,37,71,52.1,31,52,59.6,6,19,31.6,20,26,76.9,14,32,46,26,21,19,12,2,100,0
20492,480157,535_16_29,IRAN,0,TOTALS,IRAN,200,31,58,53.4,23,33,69.7,8,25,32.0,15,17,88.2,9,37,46,11,21,15,5,2,85,1
20493,480170,535_16_29,KOREA,0,TOTALS,KOREA,200,14,58,24.1,9,37,24.3,5,21,23.8,14,17,82.4,9,18,27,11,19,14,10,1,47,0
20494,480183,535_16_30,QATAR,0,TOTALS,QATAR,200,24,62,38.7,13,23,56.5,11,39,28.2,6,8,75.0,9,17,26,13,20,12,5,0,65,0
20495,480196,535_16_30,JAPAN,0,TOTALS,JAPAN,200,31,50,62.0,24,33,72.7,7,17,41.2,10,14,71.4,4,29,33,15,17,17,7,1,79,1
20496,480209,535_16_31,KOREA,0,TOTALS,KOREA,200,24,69,34.8,19,41,46.3,5,28,17.9,17,18,94.4,13,28,41,21,23,12,7,2,70,1
20497,480222,535_16_31,CHINESE TAIPEI,0,TOTALS,CHINESE TAIPEI,200,25,56,44.6,19,41,46.3,6,15,40.0,13,17,76.5,5,32,37,9,21,17,4,2,69,0
20498,480235,535_16_32,IRAQ,0,TOTALS,IRAQ,200,34,75,45.3,26,59,44.1,8,16,50.0,9,25,36.0,25,22,47,15,13,13,8,7,85,1
20499,480248,535_16_32,CHINA,0,TOTALS,CHINA,200,27,63,42.9,8,26,30.8,19,37,51.4,6,10,60.0,12,24,36,19,26,21,3,1,79,0
20500,480261,535_16_33,INDIA,0,TOTALS,INDIA,200,17,73,23.3,13,48,27.1,4,25,16.0,9,11,81.8,9,27,36,8,20,11,8,2,47,0
20501,480274,535_16_33,IRAN,0,TOTALS,IRAN,200,27,72,37.5,19,45,42.2,8,27,29.6,15,21,71.4,19,47,66,18,17,17,6,3,77,1
20502,480287,535_16_34,JORDAN,0,TOTALS,JORDAN,200,27,66,40.9,16,35,45.7,11,31,35.5,22,29,75.9,14,27,41,14,18,11,10,2,87,1
20503,480300,535_16_34,JAPAN,0,TOTALS,JAPAN,200,30,69,43.5,21,41,51.2,9,28,32.1,11,15,73.3,13,24,37,15,22,13,5,0,80,0
20504,480313,535_16_35,CHINESE TAIPEI,0,TOTALS,CHINESE TAIPEI,200,24,65,36.9,21,48,43.8,3,17,17.6,15,20,75.0,9,19,28,9,15,6,4,5,66,0
20505,480326,535_16_35,CHINA,0,TOTALS,CHINA,200,34,68,50.0,24,48,50.0,10,20,50.0,10,14,71.4,16,35,51,10,18,16,1,2,88,1
20506,480339,535_16_36,JAPAN,0,TOTALS,JAPAN,200,30,65,46.2,24,45,53.3,6,20,30.0,11,16,68.8,13,31,44,17,18,14,8,0,77,1
20507,480352,535_16_36,INDIA,0,TOTALS,INDIA,200,25,68,36.8,20,41,48.8,5,27,18.5,11,18,61.1,16,25,41,10,15,12,5,1,66,0
20508,480365,535_16_37,JORDAN,0,TOTALS,JORDAN,200,24,72,33.3,18,53,34.0,6,19,31.6,9,14,64.3,19,28,47,6,24,16,6,5,63,0
20509,480378,535_16_37,IRAN,0,TOTALS,IRAN,200,25,60,41.7,18,39,46.2,7,21,33.3,17,32,53.1,15,31,46,12,20,14,5,7,74,1
20510,480391,535_16_38,KOREA,0,TOTALS,KOREA,200,29,65,44.6,21,40,52.5,8,25,32.0,12,17,70.6,10,25,35,18,22,17,6,4,78,1
20511,480404,535_16_38,IRAQ,0,TOTALS,IRAQ,200,29,68,42.6,25,57,43.9,4,11,36.4,10,16,62.5,16,29,45,12,20,17,7,2,72,0
20512,480417,535_16_39,CHINESE TAIPEI,0,TOTALS,CHINESE TAIPEI,200,23,63,36.5,20,46,43.5,3,17,17.6,19,26,73.1,9,38,47,7,18,18,6,4,68,0
20513,480430,535_16_39,INDIA,0,TOTALS,INDIA,200,32,76,42.1,29,62,46.8,3,14,21.4,13,26,50.0,13,34,47,10,28,8,9,2,80,1
20514,480443,535_16_40,CHINA,0,TOTALS,CHINA,200,26,59,44.1,19,43,44.2,7,16,43.8,16,20,80.0,17,27,44,7,18,16,0,4,75,1
20515,480456,535_16_40,JAPAN,0,TOTALS,JAPAN,200,23,61,37.7,17,42,40.5,6,19,31.6,15,16,93.8,8,19,27,12,20,10,4,1,67,0
20516,480469,535_16_41,JORDAN,0,TOTALS,JORDAN,200,35,64,54.7,29,46,63.0,6,18,33.3,18,24,75.0,8,35,43,15,19,14,10,8,94,1
20517,480482,535_16_41,IRAQ,0,TOTALS,IRAQ,200,28,84,33.3,23,60,38.3,5,24,20.8,11,22,50.0,28,22,50,9,20,18,8,1,72,0
20518,480495,535_16_42,IRAN,0,TOTALS,IRAN,200,26,77,33.8,18,50,36.0,8,27,29.6,17,22,77.3,34,30,64,15,18,11,8,4,77,1
20519,480508,535_16_42,KOREA,0,TOTALS,KOREA,200,19,58,32.8,14,39,35.9,5,19,26.3,4,5,80.0,8,19,27,11,23,15,4,0,47,0
20520,480521,536_16_01,KAZAKHSTAN,0,TOTALS,KAZAKHSTAN,200,12,64,18.8,7,34,20.6,5,30,16.7,8,25,32.0,16,28,44,6,21,28,9,3,37,0
20521,480534,536_16_01,LEBANON,0,TOTALS,LEBANON,200,38,92,41.3,30,58,51.7,8,34,23.5,13,18,72.2,27,45,72,18,23,14,19,3,97,1
20522,480547,536_16_02,IRAQ,0,TOTALS,IRAQ,206,11,59,18.6,8,38,21.1,3,21,14.3,3,12,25.0,5,19,24,0,21,24,10,3,28,0
20523,480560,536_16_02,CHINA,0,TOTALS,CHINA,200,37,74,50.0,32,52,61.5,5,22,22.7,14,27,51.9,22,47,69,14,19,20,13,3,93,1
20524,480573,536_16_03,JAPAN,0,TOTALS,JAPAN,200,27,77,35.1,23,50,46.0,4,27,14.8,14,26,53.8,15,26,41,13,26,16,12,7,72,0
20525,480586,536_16_03,KOREA,0,TOTALS,KOREA,200,32,78,41.0,24,49,49.0,8,29,27.6,20,30,66.7,21,42,63,16,24,23,9,4,92,1
20526,480599,536_16_04,INDIA,0,TOTALS,INDIA,200,38,73,52.1,32,57,56.1,6,16,37.5,18,27,66.7,15,30,45,10,17,15,3,4,100,0
20527,480612,536_16_04,THAILAND,0,TOTALS,THAILAND,200,38,83,45.8,27,53,50.9,11,30,36.7,6,9,66.7,12,19,31,15,20,12,9,3,93,1
20528,480623,536_16_05,INDONESIA,0,TOTALS,INDONESIA,200,18,66,27.3,14,39,35.9,4,27,14.8,0,0,0.0,13,30,43,5,18,29,8,1,40,1
20529,480636,536_16_05,IRAN,0,TOTALS,IRAN,200,40,92,43.5,28,53,52.8,12,39,30.8,14,25,56.0,29,34,63,18,6,9,21,4,106,0
20530,480649,536_16_06,PHILIPPINES,0,TOTALS,PHILIPPINES,200,30,77,39.0,25,59,42.4,5,18,27.8,9,15,60.0,21,22,43,15,22,24,6,5,74,0
20531,480662,536_16_06,CHINESE TAIPEI,0,TOTALS,CHINESE TAIPEI,200,31,62,50.0,21,40,52.5,10,22,45.5,16,29,55.2,12,27,39,16,21,22,9,7,88,1
20532,480673,536_16_07,INDONESIA,0,TOTALS,INDONESIA,200,15,65,23.1,7,33,21.2,8,32,25.0,16,28,57.1,17,30,47,8,20,26,5,2,54,1
20533,480686,536_16_07,JAPAN,0,TOTALS,JAPAN,200,45,87,51.7,37,56,66.1,8,31,25.8,15,26,57.7,20,36,56,25,26,8,16,7,113,0
20534,480699,536_16_08,CHINA,0,TOTALS,CHINA,200,46,77,59.7,42,61,68.9,4,16,25.0,10,17,58.8,17,38,55,16,18,14,9,7,106,0
20535,480712,536_16_08,INDIA,0,TOTALS,INDIA,200,25,72,34.7,14,35,40.0,11,37,29.7,5,12,41.7,10,18,28,8,16,13,2,3,66,1
20536,480725,536_16_09,LEBANON,0,TOTALS,LEBANON,200,31,84,36.9,26,60,43.3,5,24,20.8,13,22,59.1,27,27,54,14,22,17,20,1,80,1
20537,480738,536_16_09,KOREA,0,TOTALS,KOREA,200,25,64,39.1,20,38,52.6,5,26,19.2,12,21,57.1,16,27,43,12,23,24,6,2,67,0
20538,480751,536_16_10,IRAQ,0,TOTALS,IRAQ,200,28,74,37.8,27,59,45.8,1,15,6.7,22,38,57.9,21,29,50,5,17,22,11,5,79,0
20539,480764,536_16_10,PHILIPPINES,0,TOTALS,PHILIPPINES,200,39,85,45.9,30,57,52.6,9,28,32.1,9,16,56.2,19,33,52,21,31,19,15,3,96,1
20540,480777,536_16_11,IRAN,0,TOTALS,IRAN,200,31,75,41.3,21,48,43.8,10,27,37.0,18,27,66.7,20,22,42,11,23,17,23,5,90,1
20541,480790,536_16_11,KAZAKHSTAN,0,TOTALS,KAZAKHSTAN,200,19,64,29.7,14,43,32.6,5,21,23.8,16,24,66.7,24,26,50,12,26,33,6,4,59,0
20542,480803,536_16_12,THAILAND,0,TOTALS,THAILAND,200,21,67,31.3,13,28,46.4,8,39,20.5,16,23,69.6,14,31,45,12,12,19,6,0,66,0
20543,480816,536_16_12,CHINESE TAIPEI,0,TOTALS,CHINESE TAIPEI,200,31,72,43.1,22,50,44.0,9,22,40.9,6,12,50.0,11,33,44,12,18,18,5,3,77,1
20544,480829,536_16_13,KOREA,0,TOTALS,KOREA,200,42,94,44.7,32,76,42.1,10,18,55.6,11,13,84.6,29,37,66,29,24,23,13,2,105,0
20545,480842,536_16_13,KAZAKHSTAN,0,TOTALS,KAZAKHSTAN,200,26,80,32.5,24,55,43.6,2,25,8.0,12,24,50.0,20,23,43,10,22,19,9,8,66,1
20546,480855,536_16_14,PHILIPPINES,0,TOTALS,PHILIPPINES,200,27,74,36.5,21,56,37.5,6,18,33.3,6,11,54.5,9,17,26,10,22,15,11,5,66,0
20547,480868,536_16_14,CHINA,0,TOTALS,CHINA,200,32,69,46.4,18,35,51.4,14,34,41.2,17,27,63.0,23,38,61,21,16,22,10,5,95,1
20548,480881,536_16_15,LEBANON,0,TOTALS,LEBANON,200,43,89,48.3,36,57,63.2,7,32,21.9,10,17,58.8,28,42,70,23,17,14,18,3,103,0
20549,480892,536_16_15,INDONESIA,0,TOTALS,INDONESIA,200,11,64,17.2,5,31,16.1,6,33,18.2,7,11,63.6,13,20,33,6,18,22,4,2,35,1
20550,480905,536_16_16,CHINESE TAIPEI,0,TOTALS,CHINESE TAIPEI,200,39,79,49.4,32,58,55.2,7,21,33.3,8,12,66.7,11,39,50,6,25,19,11,8,93,1
20551,480918,536_16_16,INDIA,0,TOTALS,INDIA,200,29,78,37.2,23,58,39.7,6,20,30.0,15,23,65.2,15,31,46,6,14,16,6,1,79,0
20552,480931,536_16_17,JAPAN,0,TOTALS,JAPAN,200,28,73,38.4,20,45,44.4,8,28,28.6,17,28,60.7,13,27,40,15,23,16,12,2,81,1
20553,480944,536_16_17,IRAN,0,TOTALS,IRAN,200,27,75,36.0,23,47,48.9,4,28,14.3,19,27,70.4,21,36,57,7,25,22,11,7,77,0
20554,480957,536_16_18,THAILAND,0,TOTALS,THAILAND,200,31,76,40.8,24,39,61.5,7,37,18.9,7,10,70.0,11,21,32,14,17,18,14,2,76,0
20555,480970,536_16_18,IRAQ,0,TOTALS,IRAQ,200,42,83,50.6,40,75,53.3,2,8,25.0,6,11,54.5,20,35,55,15,13,23,4,5,92,1
20556,480983,536_16_19,JAPAN,0,TOTALS,JAPAN,200,15,59,25.4,6,29,20.7,9,30,30.0,12,20,60.0,12,26,38,9,12,12,3,5,51,0
20557,480996,536_16_19,LEBANON,0,TOTALS,LEBANON,200,29,75,38.7,18,43,41.9,11,32,34.4,4,8,50.0,18,36,54,16,22,10,6,3,73,1
20558,481009,536_16_20,CHINA,0,TOTALS,CHINA,200,28,66,42.4,23,48,47.9,5,18,27.8,13,20,65.0,23,34,57,13,18,27,5,4,74,1
20559,481022,536_16_20,CHINESE TAIPEI,0,TOTALS,CHINESE TAIPEI,200,31,82,37.8,25,61,41.0,6,21,28.6,3,5,60.0,16,17,33,10,25,11,15,3,71,0
20560,481035,536_16_21,KAZAKHSTAN,0,TOTALS,KAZAKHSTAN,200,33,89,37.1,27,66,40.9,6,23,26.1,8,22,36.4,31,37,68,13,20,18,12,4,80,1
20561,481046,536_16_21,INDONESIA,0,TOTALS,INDONESIA,200,21,72,29.2,13,40,32.5,8,32,25.0,11,19,57.9,17,31,48,11,21,24,11,5,61,0
20562,481059,536_16_22,PHILIPPINES,0,TOTALS,PHILIPPINES,200,28,73,38.4,24,62,38.7,4,11,36.4,11,19,57.9,12,27,39,10,24,14,15,2,71,0
20563,481072,536_16_22,THAILAND,0,TOTALS,THAILAND,200,25,57,43.9,17,30,56.7,8,27,29.6,16,20,80.0,8,37,45,14,17,26,2,4,74,1
20564,481085,536_16_23,IRAN,0,TOTALS,IRAN,200,29,77,37.7,22,47,46.8,7,30,23.3,18,33,54.5,26,28,54,7,23,25,15,7,83,0
20565,481098,536_16_23,KOREA,0,TOTALS,KOREA,200,32,65,49.2,21,47,44.7,11,18,61.1,11,22,50.0,12,28,40,11,27,27,13,7,86,1
20566,481111,536_16_24,INDIA,0,TOTALS,INDIA,225,33,79,41.8,28,54,51.9,5,25,20.0,22,32,68.8,22,32,54,12,16,15,10,4,93,1
20567,481124,536_16_24,IRAQ,0,TOTALS,IRAQ,225,32,74,43.2,20,41,48.8,12,33,36.4,7,16,43.8,13,28,41,15,26,21,7,4,83,0
20568,481137,536_16_25,JAPAN,0,TOTALS,JAPAN,200,37,70,52.9,26,50,52.0,11,20,55.0,13,17,76.5,3,29,32,19,21,15,14,1,98,1
20569,481150,536_16_25,KAZAKHSTAN,0,TOTALS,KAZAKHSTAN,200,30,71,42.3,22,39,56.4,8,32,25.0,10,15,66.7,14,31,45,14,20,25,7,1,78,0
20570,481163,536_16_26,CHINA,0,TOTALS,CHINA,200,40,74,54.1,25,36,69.4,15,38,39.5,3,5,60.0,18,46,64,17,22,21,3,3,98,1
20571,481176,536_16_26,THAILAND,0,TOTALS,THAILAND,200,15,68,22.1,8,30,26.7,7,38,18.4,14,17,82.4,8,17,25,7,12,10,8,0,51,0
20572,481189,536_16_27,KOREA,0,TOTALS,KOREA,200,47,90,52.2,39,62,62.9,8,28,28.6,5,6,83.3,20,35,55,25,17,10,10,4,107,0
20573,481200,536_16_27,INDONESIA,0,TOTALS,INDONESIA,200,22,73,30.1,17,48,35.4,5,25,20.0,7,13,53.8,13,20,33,5,8,20,4,2,56,1
20574,481213,536_16_28,CHINESE TAIPEI,0,TOTALS,CHINESE TAIPEI,200,40,87,46.0,31,60,51.7,9,27,33.3,10,15,66.7,16,34,50,23,22,15,17,4,99,1
20575,481226,536_16_28,IRAQ,0,TOTALS,IRAQ,200,20,69,29.0,17,55,30.9,3,14,21.4,18,30,60.0,20,29,49,10,18,26,7,4,61,0
20576,481239,536_16_29,IRAN,0,TOTALS,IRAN,200,24,58,41.4,16,27,59.3,8,31,25.8,20,24,83.3,11,33,44,12,18,16,10,6,76,1
20577,481252,536_16_29,LEBANON,0,TOTALS,LEBANON,200,19,68,27.9,15,49,30.6,4,19,21.1,12,17,70.6,18,24,42,10,24,17,8,4,54,0
20578,481265,536_16_30,PHILIPPINES,0,TOTALS,PHILIPPINES,200,41,85,48.2,30,60,50.0,11,25,44.0,12,16,75.0,14,35,49,20,20,10,9,6,105,0
20579,481278,536_16_30,INDIA,0,TOTALS,INDIA,200,31,77,40.3,25,57,43.9,6,20,30.0,14,24,58.3,18,28,46,12,11,15,4,0,82,1
20580,481291,536_16_31,KOREA,0,TOTALS,KOREA,200,36,78,46.2,31,57,54.4,5,21,23.8,16,24,66.7,20,28,48,15,19,23,11,5,93,1
20581,481304,536_16_31,PHILIPPINES,0,TOTALS,PHILIPPINES,200,35,85,41.2,32,72,44.4,3,13,23.1,12,16,75.0,19,26,45,16,21,18,15,12,85,0
20582,481317,536_16_32,CHINESE TAIPEI,0,TOTALS,CHINESE TAIPEI,200,24,70,34.3,17,51,33.3,7,19,36.8,16,23,69.6,12,30,42,9,17,10,7,4,71,0
20583,481330,536_16_32,JAPAN,0,TOTALS,JAPAN,200,30,71,42.3,23,46,50.0,7,25,28.0,10,13,76.9,13,36,49,9,23,13,6,7,77,1
20584,481343,536_16_33,LEBANON,0,TOTALS,LEBANON,200,42,80,52.5,33,51,64.7,9,29,31.0,5,8,62.5,21,32,53,14,22,21,15,0,98,1
20585,481356,536_16_33,INDIA,0,TOTALS,INDIA,200,27,67,40.3,24,46,52.2,3,21,14.3,10,19,52.6,11,17,28,8,9,20,13,0,67,0
20586,481369,536_16_34,CHINA,0,TOTALS,CHINA,200,20,65,30.8,9,30,30.0,11,35,31.4,8,13,61.5,21,33,54,11,22,18,4,4,59,0
20587,481382,536_16_34,IRAN,0,TOTALS,IRAN,200,22,61,36.1,15,36,41.7,7,25,28.0,11,23,47.8,12,25,37,7,19,8,9,7,62,1
20588,481395,536_16_35,PHILIPPINES,0,TOTALS,PHILIPPINES,200,20,71,28.2,15,47,31.9,5,24,20.8,10,20,50.0,16,20,36,10,27,24,12,2,55,0
20589,481408,536_16_35,CHINA,0,TOTALS,CHINA,200,26,65,40.0,19,36,52.8,7,29,24.1,26,32,81.2,20,42,62,17,22,28,8,4,85,1
20590,481421,536_16_36,CHINESE TAIPEI,0,TOTALS,CHINESE TAIPEI,200,39,79,49.4,28,53,52.8,11,26,42.3,8,8,100.0,17,30,47,21,12,17,9,1,97,1
20591,481434,536_16_36,INDIA,0,TOTALS,INDIA,200,30,74,40.5,30,62,48.4,0,12,0.0,6,11,54.5,15,21,36,7,9,18,13,7,66,0
20592,481447,536_16_37,JAPAN,0,TOTALS,JAPAN,200,25,64,39.1,19,43,44.2,6,21,28.6,19,30,63.3,16,24,40,11,13,11,9,0,75,1
20593,481460,536_16_37,LEBANON,0,TOTALS,LEBANON,200,24,70,34.3,17,40,42.5,7,30,23.3,4,9,44.4,20,27,47,10,24,18,5,2,59,0
20594,481473,536_16_38,KOREA,0,TOTALS,KOREA,200,25,66,37.9,18,32,56.2,7,34,20.6,8,14,57.1,6,18,24,17,23,17,10,2,65,0
20595,481486,536_16_38,IRAN,0,TOTALS,IRAN,200,35,68,51.5,28,50,56.0,7,18,38.9,10,18,55.6,19,36,55,16,17,24,7,3,87,1
20596,481499,536_16_39,PHILIPPINES,0,TOTALS,PHILIPPINES,200,29,76,38.2,27,64,42.2,2,12,16.7,7,9,77.8,14,27,41,12,27,17,12,6,67,1
20597,481512,536_16_39,INDIA,0,TOTALS,INDIA,200,22,56,39.3,20,46,43.5,2,10,20.0,18,28,64.3,11,35,46,7,10,25,9,1,64,0
20598,481525,536_16_40,CHINA,0,TOTALS,CHINA,200,27,63,42.9,22,39,56.4,5,24,20.8,17,21,81.0,15,32,47,11,19,21,8,3,76,1
20599,481538,536_16_40,CHINESE TAIPEI,0,TOTALS,CHINESE TAIPEI,200,24,62,38.7,15,38,39.5,9,24,37.5,13,19,68.4,7,19,26,11,22,15,12,3,70,0
20600,481551,536_16_41,LEBANON,0,TOTALS,LEBANON,200,23,77,29.9,18,51,35.3,5,26,19.2,12,16,75.0,25,26,51,9,27,23,11,2,63,0
20601,481564,536_16_41,KOREA,0,TOTALS,KOREA,200,28,67,41.8,18,35,51.4,10,32,31.2,20,33,60.6,17,31,48,18,18,18,10,5,86,1
20602,481577,536_16_42,JAPAN,0,TOTALS,JAPAN,200,27,74,36.5,26,58,44.8,1,16,6.2,10,17,58.8,19,21,40,4,20,11,13,1,65,0
20603,481590,536_16_42,IRAN,0,TOTALS,IRAN,200,25,61,41.0,13,26,50.0,12,35,34.3,9,12,75.0,14,33,47,16,16,21,3,8,71,1
20604,482533,538_16_01,PERU,0,TOTALS,PERU,200,20,68,29.4,12,40,30.0,8,28,28.6,11,16,68.8,11,23,34,15,17,7,4,3,59,0
20605,482546,538_16_01,CHILE,0,TOTALS,CHILE,200,29,59,49.2,22,41,53.7,7,18,38.9,13,18,72.2,7,40,47,28,15,17,4,0,78,1
20606,482559,538_16_02,PARAGUAY,0,TOTALS,PARAGUAY,200,27,57,47.4,23,46,50.0,4,11,36.4,16,28,57.1,12,33,45,12,18,15,11,1,74,1
20607,482572,538_16_02,BOLIVIA,0,TOTALS,BOLIVIA,200,20,66,30.3,12,38,31.6,8,28,28.6,7,16,43.8,13,25,38,14,22,18,7,2,55,0
20608,482585,538_16_03,URUGUAY,0,TOTALS,URUGUAY,200,19,55,34.5,12,39,30.8,7,16,43.8,15,21,71.4,11,37,48,16,14,18,0,6,60,1
20609,482598,538_16_03,COLOMBIA,0,TOTALS,COLOMBIA,200,21,81,25.9,15,52,28.8,6,29,20.7,6,12,50.0,17,26,43,15,23,9,8,5,54,0
20610,482611,538_16_04,ECUADOR,0,TOTALS,ECUADOR,200,14,47,29.8,13,29,44.8,1,18,5.6,5,10,50.0,5,25,30,6,22,27,3,4,34,0
20611,482624,538_16_04,VENEZUELA,0,TOTALS,VENEZUELA,200,34,77,44.2,24,49,49.0,10,28,35.7,19,26,73.1,21,29,50,26,13,7,18,4,97,1
20612,482637,538_16_05,COLOMBIA,0,TOTALS,COLOMBIA,200,28,56,50.0,15,30,50.0,13,26,50.0,12,18,66.7,10,32,42,22,8,13,14,1,81,1
20613,482650,538_16_05,PERU,0,TOTALS,PERU,200,17,51,33.3,8,25,32.0,9,26,34.6,3,4,75.0,3,20,23,14,20,16,4,1,46,0
20614,482663,538_16_06,BRAZIL,0,TOTALS,BRAZIL,200,39,76,51.3,32,50,64.0,7,26,26.9,22,30,73.3,19,33,52,23,18,14,16,2,107,0
20615,482676,538_16_06,ECUADOR,0,TOTALS,ECUADOR,200,24,59,40.7,15,34,44.1,9,25,36.0,8,20,40.0,9,20,29,14,25,26,7,0,65,1
20616,482689,538_16_07,ARGENTINA,0,TOTALS,ARGENTINA,200,32,72,44.4,20,44,45.5,12,28,42.9,6,14,42.9,10,32,42,26,17,11,7,2,82,1
20617,482702,538_16_07,URUGUAY,0,TOTALS,URUGUAY,200,22,62,35.5,19,45,42.2,3,17,17.6,11,18,61.1,10,32,42,14,15,17,6,6,58,0
20618,482715,538_16_08,VENEZUELA,0,TOTALS,VENEZUELA,200,24,55,43.6,18,29,62.1,6,26,23.1,23,31,74.2,10,32,42,22,18,11,9,6,77,1
20619,482728,538_16_08,PARAGUAY,0,TOTALS,PARAGUAY,200,18,57,31.6,11,34,32.4,7,23,30.4,5,10,50.0,7,25,32,12,26,17,3,1,48,0
20620,482741,538_16_09,PERU,0,TOTALS,PERU,200,17,64,26.6,13,41,31.7,4,23,17.4,5,9,55.6,6,25,31,6,15,13,2,0,43,1
20621,482754,538_16_09,ARGENTINA,0,TOTALS,ARGENTINA,200,38,71,53.5,23,37,62.2,15,34,44.1,14,15,93.3,7,41,48,36,11,5,10,4,105,0
20622,482767,538_16_10,CHILE,0,TOTALS,CHILE,200,27,57,47.4,18,36,50.0,9,21,42.9,11,17,64.7,7,23,30,17,24,12,1,3,74,0
20623,482780,538_16_10,COLOMBIA,0,TOTALS,COLOMBIA,200,28,64,43.8,23,47,48.9,5,17,29.4,19,31,61.3,16,24,40,16,20,8,7,2,80,1
20624,482793,538_16_11,PARAGUAY,0,TOTALS,PARAGUAY,200,23,62,37.1,19,46,41.3,4,16,25.0,13,20,65.0,5,24,29,8,27,16,7,1,63,1
20625,482806,538_16_11,BRAZIL,0,TOTALS,BRAZIL,200,33,68,48.5,22,41,53.7,11,27,40.7,24,32,75.0,14,34,48,25,21,11,9,3,101,0
20626,482819,538_16_12,BOLIVIA,0,TOTALS,BOLIVIA,200,13,46,28.3,7,24,29.2,6,22,27.3,5,7,71.4,13,14,27,11,14,34,7,1,37,0
20627,482832,538_16_12,VENEZUELA,0,TOTALS,VENEZUELA,200,35,64,54.7,20,31,64.5,15,33,45.5,12,14,85.7,13,20,33,31,11,11,18,6,97,1
20628,482845,538_16_13,ECUADOR,0,TOTALS,ECUADOR,200,17,64,26.6,12,40,30.0,5,24,20.8,18,25,72.0,14,30,44,11,16,18,9,3,57,0
20629,482858,538_16_13,PARAGUAY,0,TOTALS,PARAGUAY,200,25,61,41.0,15,36,41.7,10,25,40.0,11,14,78.6,6,37,43,19,23,18,13,8,71,1
20630,482871,538_16_14,BRAZIL,0,TOTALS,BRAZIL,200,43,69,62.3,25,38,65.8,18,31,58.1,10,15,66.7,13,35,48,30,3,9,16,2,114,0
20631,482884,538_16_14,BOLIVIA,0,TOTALS,BOLIVIA,200,13,55,23.6,7,31,22.6,6,24,25.0,1,3,33.3,7,15,22,4,14,21,6,2,33,1
20632,482897,538_16_15,URUGUAY,0,TOTALS,URUGUAY,200,33,66,50.0,24,40,60.0,9,26,34.6,20,29,69.0,14,43,57,25,10,14,11,2,95,1
20633,482910,538_16_15,PERU,0,TOTALS,PERU,200,21,73,28.8,14,33,42.4,7,40,17.5,1,4,25.0,9,22,31,13,22,15,8,1,50,0
20634,482923,538_16_16,ARGENTINA,0,TOTALS,ARGENTINA,200,43,71,60.6,30,47,63.8,13,24,54.2,13,17,76.5,10,30,40,37,19,9,9,3,112,0
20635,482936,538_16_16,CHILE,0,TOTALS,CHILE,200,24,60,40.0,16,38,42.1,8,22,36.4,15,18,83.3,6,20,26,19,17,14,5,1,71,1
20636,482949,538_16_17,BOLIVIA,0,TOTALS,BOLIVIA,225,29,77,37.7,23,47,48.9,6,30,20.0,11,17,64.7,20,25,45,18,27,23,14,6,75,1
20637,482962,538_16_17,ECUADOR,0,TOTALS,ECUADOR,225,24,59,40.7,16,41,39.0,8,18,44.4,18,31,58.1,13,27,40,21,13,26,14,1,74,0
20638,482975,538_16_18,CHILE,0,TOTALS,CHILE,200,20,72,27.8,16,50,32.0,4,22,18.2,12,18,66.7,19,23,42,12,14,15,5,2,56,0
20639,482988,538_16_18,URUGUAY,0,TOTALS,URUGUAY,200,33,66,50.0,24,47,51.1,9,19,47.4,13,16,81.2,9,34,43,23,17,14,11,7,88,1
20640,483001,538_16_19,COLOMBIA,0,TOTALS,COLOMBIA,200,23,66,34.8,16,44,36.4,7,22,31.8,16,25,64.0,18,17,35,10,22,11,6,2,69,0
20641,483014,538_16_19,ARGENTINA,0,TOTALS,ARGENTINA,200,34,58,58.6,17,32,53.1,17,26,65.4,12,18,66.7,7,25,32,31,21,11,6,3,97,1
20642,483027,538_16_20,VENEZUELA,0,TOTALS,VENEZUELA,200,24,48,50.0,15,25,60.0,9,23,39.1,13,20,65.0,7,24,31,13,23,18,3,3,70,1
20643,483040,538_16_20,BRAZIL,0,TOTALS,BRAZIL,200,21,50,42.0,17,35,48.6,4,15,26.7,14,21,66.7,9,20,29,15,22,17,8,4,60,0
20644,483053,538_16_21,BOLIVIA,0,TOTALS,BOLIVIA,200,22,71,31.0,17,42,40.5,5,29,17.2,6,11,54.5,13,28,41,10,20,10,7,6,55,0
20645,483066,538_16_21,CHILE,0,TOTALS,CHILE,200,27,67,40.3,25,57,43.9,2,10,20.0,14,18,77.8,12,37,49,19,13,11,3,4,70,1
20646,483079,538_16_22,PARAGUAY,0,TOTALS,PARAGUAY,200,22,61,36.1,15,31,48.4,7,30,23.3,7,12,58.3,10,11,21,15,20,10,7,3,58,0
20647,483092,538_16_22,COLOMBIA,0,TOTALS,COLOMBIA,200,31,58,53.4,24,43,55.8,7,15,46.7,13,17,76.5,19,30,49,18,21,20,6,2,82,1
20648,483105,538_16_23,ARGENTINA,0,TOTALS,ARGENTINA,200,27,62,43.5,19,35,54.3,8,27,29.6,20,23,87.0,12,22,34,16,28,15,5,0,82,0
20649,483118,538_16_23,BRAZIL,0,TOTALS,BRAZIL,200,26,51,51.0,20,38,52.6,6,13,46.2,30,37,81.1,3,23,26,16,25,12,10,2,88,1
20650,483131,538_16_24,VENEZUELA,0,TOTALS,VENEZUELA,200,27,67,40.3,14,37,37.8,13,30,43.3,7,11,63.6,16,28,44,20,20,8,4,3,74,1
20651,483144,538_16_24,URUGUAY,0,TOTALS,URUGUAY,200,22,62,35.5,14,46,30.4,8,16,50.0,10,12,83.3,10,26,36,17,17,9,6,5,62,0
20652,483157,538_16_25,URUGUAY,0,TOTALS,URUGUAY,200,33,68,48.5,26,50,52.0,7,18,38.9,14,27,51.9,14,21,35,13,17,11,10,3,87,1
20653,483170,538_16_25,ARGENTINA,0,TOTALS,ARGENTINA,200,31,60,51.7,19,35,54.3,12,25,48.0,9,12,75.0,10,24,34,18,26,19,5,3,83,0
20654,483183,538_16_26,VENEZUELA,0,TOTALS,VENEZUELA,200,25,67,37.3,19,38,50.0,6,29,20.7,8,10,80.0,15,21,36,13,22,12,13,2,64,1
20655,483196,538_16_26,BRAZIL,0,TOTALS,BRAZIL,200,23,52,44.2,19,39,48.7,4,13,30.8,8,11,72.7,10,23,33,15,20,17,7,1,58,0
20656,483751,540_16_01,NICARAGUA,0,TOTALS,NICARAGUA,200,21,69,30.4,20,59,33.9,1,10,10.0,7,10,70.0,9,27,36,15,15,12,4,4,50,0
20657,483764,540_16_01,CUBA,0,TOTALS,CUBA,200,40,82,48.8,31,65,47.7,9,17,52.9,9,15,60.0,16,38,54,28,14,10,7,7,98,1
20658,483774,540_16_02,VIRGIN ISLANDS,0,TOTALS,VIRGIN ISLANDS,200,22,63,34.9,16,40,40.0,6,23,26.1,32,38,84.2,10,32,42,11,26,23,5,3,82,1
20659,483787,540_16_02,BAHAMAS,0,TOTALS,BAHAMAS,200,22,73,30.1,18,53,34.0,4,20,20.0,26,36,72.2,22,34,56,19,26,16,11,4,74,0
20660,483801,540_16_03,COSTA RICA,0,TOTALS,COSTA RICA,200,20,57,35.1,12,39,30.8,8,18,44.4,10,23,43.5,7,23,30,13,23,17,7,4,58,0
20661,483814,540_16_03,DOMINICAN REPUBLIC,0,TOTALS,DOMINICAN REPUBLIC,200,29,63,46.0,24,45,53.3,5,18,27.8,17,30,56.7,15,35,50,18,21,21,11,2,80,1
20662,483827,540_16_04,PANAMA,0,TOTALS,PANAMA,200,37,82,45.1,28,52,53.8,9,30,30.0,20,34,58.8,26,38,64,23,19,7,14,5,103,0
20663,483840,540_16_04,ANTIGUA,0,TOTALS,ANTIGUA,200,17,57,29.8,13,35,37.1,4,22,18.2,10,21,47.6,7,23,30,9,29,20,3,0,48,1
20664,483853,540_16_05,BAHAMAS,0,TOTALS,BAHAMAS,200,30,69,43.5,26,47,55.3,4,22,18.2,18,35,51.4,20,39,59,22,23,21,14,8,82,1
20665,483866,540_16_05,COSTA RICA,0,TOTALS,COSTA RICA,200,20,73,27.4,16,50,32.0,4,23,17.4,14,18,77.8,11,26,37,15,25,18,8,0,58,0
20666,483879,540_16_06,ANTIGUA,0,TOTALS,ANTIGUA,200,22,86,25.6,19,66,28.8,3,20,15.0,15,24,62.5,24,36,60,12,21,10,3,1,62,0
20667,483892,540_16_06,NICARAGUA,0,TOTALS,NICARAGUA,200,25,66,37.9,16,47,34.0,9,19,47.4,15,29,51.7,10,42,52,18,18,9,7,9,74,1
20668,483905,540_16_07,MEXICO,0,TOTALS,MEXICO,225,29,69,42.0,19,39,48.7,10,30,33.3,23,39,59.0,8,41,49,21,26,12,2,3,91,1
20669,483915,540_16_07,VIRGIN ISLANDS,0,TOTALS,VIRGIN ISLANDS,225,27,72,37.5,21,46,45.7,6,26,23.1,23,34,67.6,7,32,39,18,28,8,7,1,83,0
20670,483928,540_16_08,PUERTO RICO,0,TOTALS,PUERTO RICO,200,22,60,36.7,21,46,45.7,1,14,7.1,19,29,65.5,12,24,36,9,22,11,2,2,64,0
20671,483941,540_16_08,PANAMA,0,TOTALS,PANAMA,200,31,71,43.7,21,48,43.8,10,23,43.5,15,24,62.5,13,27,40,22,28,10,8,5,87,1
20672,483954,540_16_09,COSTA RICA,0,TOTALS,COSTA RICA,200,15,59,25.4,11,38,28.9,4,21,19.0,12,17,70.6,13,19,32,7,20,19,8,1,46,0
20673,483967,540_16_09,MEXICO,0,TOTALS,MEXICO,200,28,60,46.7,22,36,61.1,6,24,25.0,15,18,83.3,13,32,45,18,19,16,10,6,77,1
20674,483980,540_16_10,CUBA,0,TOTALS,CUBA,200,38,77,49.4,32,62,51.6,6,15,40.0,6,21,28.6,17,29,46,20,18,14,11,4,88,1
20675,483993,540_16_10,ANTIGUA,0,TOTALS,ANTIGUA,200,24,65,36.9,22,50,44.0,2,15,13.3,16,28,57.1,14,29,43,14,23,21,10,2,66,0
20676,484006,540_16_11,DOMINICAN REPUBLIC,0,TOTALS,DOMINICAN REPUBLIC,200,26,61,42.6,19,43,44.2,7,18,38.9,28,43,65.1,9,25,34,18,24,18,13,4,87,1
20677,484019,540_16_11,BAHAMAS,0,TOTALS,BAHAMAS,200,32,67,47.8,28,53,52.8,4,14,28.6,12,25,48.0,13,30,43,16,34,25,8,4,80,0
20678,484032,540_16_12,NICARAGUA,0,TOTALS,NICARAGUA,200,21,70,30.0,14,50,28.0,7,20,35.0,8,12,66.7,10,27,37,10,22,11,5,1,57,0
20679,484045,540_16_12,PUERTO RICO,0,TOTALS,PUERTO RICO,200,36,68,52.9,23,38,60.5,13,30,43.3,13,21,61.9,10,43,53,27,10,11,5,5,98,1
20680,484055,540_16_13,VIRGIN ISLANDS,0,TOTALS,VIRGIN ISLANDS,200,24,64,37.5,20,45,44.4,4,19,21.1,23,30,76.7,14,27,41,13,20,11,12,0,75,1
20681,484068,540_16_13,COSTA RICA,0,TOTALS,COSTA RICA,200,24,67,35.8,21,43,48.8,3,24,12.5,17,25,68.0,16,28,44,11,22,19,7,3,68,0
20682,484081,540_16_14,MEXICO,0,TOTALS,MEXICO,200,22,58,37.9,16,38,42.1,6,20,30.0,19,24,79.2,7,21,28,13,18,10,7,1,69,0
20683,484094,540_16_14,DOMINICAN REPUBLIC,0,TOTALS,DOMINICAN REPUBLIC,200,31,63,49.2,26,47,55.3,5,16,31.2,15,18,83.3,11,29,40,20,23,9,4,1,82,1
20684,484107,540_16_15,PUERTO RICO,0,TOTALS,PUERTO RICO,200,35,66,53.0,26,45,57.8,9,21,42.9,22,28,78.6,11,30,41,22,22,9,4,2,101,0
20685,484120,540_16_15,CUBA,0,TOTALS,CUBA,200,26,68,38.2,20,49,40.8,6,19,31.6,11,18,61.1,14,22,36,14,28,11,1,2,69,1
20686,484133,540_16_16,PANAMA,0,TOTALS,PANAMA,200,37,68,54.4,30,41,73.2,7,27,25.9,18,32,56.2,13,22,35,26,16,13,17,2,99,1
20687,484146,540_16_16,NICARAGUA,0,TOTALS,NICARAGUA,200,22,47,46.8,14,32,43.8,8,15,53.3,8,14,57.1,5,21,26,10,26,29,8,4,60,0
20688,484159,540_16_17,BAHAMAS,0,TOTALS,BAHAMAS,200,32,69,46.4,30,59,50.8,2,10,20.0,15,19,78.9,9,33,42,16,21,11,4,7,81,0
20689,484172,540_16_17,MEXICO,0,TOTALS,MEXICO,200,27,78,34.6,13,40,32.5,14,38,36.8,16,21,76.2,15,29,44,20,20,7,3,2,84,1
20690,484185,540_16_18,DOMINICAN REPUBLIC,0,TOTALS,DOMINICAN REPUBLIC,200,24,68,35.3,20,49,40.8,4,19,21.1,23,29,79.3,18,26,44,11,22,15,7,3,75,1
20691,484195,540_16_18,VIRGIN ISLANDS,0,TOTALS,VIRGIN ISLANDS,200,24,58,41.4,18,41,43.9,6,17,35.3,15,21,71.4,8,28,36,13,27,14,8,0,69,0
20692,484208,540_16_19,ANTIGUA,0,TOTALS,ANTIGUA,200,26,75,34.7,18,50,36.0,8,25,32.0,6,14,42.9,17,28,45,11,18,17,3,1,66,1
20693,484221,540_16_19,PUERTO RICO,0,TOTALS,PUERTO RICO,200,45,83,54.2,31,49,63.3,14,34,41.2,13,16,81.2,11,32,43,37,12,6,8,7,117,0
20694,484234,540_16_20,CUBA,0,TOTALS,CUBA,200,25,58,43.1,20,48,41.7,5,10,50.0,16,26,61.5,8,20,28,9,23,14,8,3,71,0
20695,484247,540_16_20,PANAMA,0,TOTALS,PANAMA,200,30,63,47.6,27,48,56.2,3,15,20.0,13,20,65.0,15,28,43,21,26,15,6,5,76,1
20696,484260,540_16_21,NICARAGUA,0,TOTALS,NICARAGUA,200,28,83,33.7,23,59,39.0,5,24,20.8,16,23,69.6,20,28,48,10,25,19,2,6,77,1
20697,484273,540_16_21,BAHAMAS,0,TOTALS,BAHAMAS,200,47,90,52.2,42,72,58.3,5,18,27.8,21,34,61.8,17,36,53,23,21,7,13,6,120,0
20698,484286,540_16_22,CUBA,0,TOTALS,CUBA,200,29,69,42.0,22,40,55.0,7,29,24.1,5,11,45.5,9,29,38,18,22,16,5,0,70,0
20699,484296,540_16_22,VIRGIN ISLANDS,0,TOTALS,VIRGIN ISLANDS,200,30,62,48.4,24,41,58.5,6,21,28.6,29,35,82.9,5,33,38,17,15,11,8,1,95,1
20700,484309,540_16_23,DOMINICAN REPUBLIC,0,TOTALS,DOMINICAN REPUBLIC,200,23,68,33.8,20,49,40.8,3,19,15.8,20,29,69.0,13,23,36,12,22,7,5,3,69,0
20701,484322,540_16_23,PUERTO RICO,0,TOTALS,PUERTO RICO,200,28,62,45.2,19,36,52.8,9,26,34.6,9,19,47.4,10,29,39,18,27,15,2,3,74,1
20702,484335,540_16_24,PANAMA,0,TOTALS,PANAMA,200,19,59,32.2,16,40,40.0,3,19,15.8,11,17,64.7,15,27,42,12,25,23,7,6,52,0
20703,484348,540_16_24,MEXICO,0,TOTALS,MEXICO,200,22,50,44.0,17,31,54.8,5,19,26.3,10,25,40.0,5,20,25,16,22,18,8,7,59,1
20704,484361,540_16_25,PANAMA,0,TOTALS,PANAMA,200,16,53,30.2,12,36,33.3,4,17,23.5,12,15,80.0,16,28,44,13,23,16,4,2,48,0
20705,484374,540_16_25,DOMINICAN REPUBLIC,0,TOTALS,DOMINICAN REPUBLIC,200,23,62,37.1,17,42,40.5,6,20,30.0,12,14,85.7,11,22,33,11,15,8,5,4,64,1
20706,484387,540_16_26,MEXICO,0,TOTALS,MEXICO,200,30,69,43.5,23,48,47.9,7,21,33.3,16,17,94.1,15,21,36,16,24,11,8,5,83,0
20707,484400,540_16_26,PUERTO RICO,0,TOTALS,PUERTO RICO,200,25,59,42.4,17,41,41.5,8,18,44.4,26,32,81.2,12,21,33,17,18,14,6,2,84,1
20708,484413,541_16_01,PUERTO RICO,0,TOTALS,PUERTO RICO,200,26,73,35.6,22,49,44.9,4,24,16.7,14,19,73.7,15,25,40,18,18,26,8,2,70,1
20709,484426,541_16_01,USA,0,TOTALS,USA,200,42,80,52.5,41,72,56.9,1,8,12.5,18,27,66.7,15,34,49,25,19,17,15,4,103,0
20710,484439,541_16_02,ARGENTINA,0,TOTALS,ARGENTINA,200,18,58,31.0,11,44,25.0,7,14,50.0,15,24,62.5,7,30,37,16,24,25,8,2,58,0
20711,484452,541_16_02,CANADA,0,TOTALS,CANADA,200,30,69,43.5,18,37,48.6,12,32,37.5,20,33,60.6,15,36,51,16,27,19,17,4,92,1
20712,484464,541_16_03,DOMINICAN REPUBLIC,0,TOTALS,DOMINICAN REPUBLIC,200,19,65,29.2,14,49,28.6,5,16,31.2,15,21,71.4,10,29,39,10,19,15,7,4,58,0
20713,484477,541_16_03,BRAZIL,0,TOTALS,BRAZIL,200,28,71,39.4,25,48,52.1,3,23,13.0,15,18,83.3,16,38,54,23,20,16,5,6,74,1
20714,484490,541_16_04,CHILE,0,TOTALS,CHILE,200,23,64,35.9,17,40,42.5,6,24,25.0,16,27,59.3,13,35,48,20,14,13,8,5,68,1
20715,484502,541_16_04,VIRGIN ISLANDS,0,TOTALS,VIRGIN ISLANDS,200,16,72,22.2,13,52,25.0,3,20,15.0,10,15,66.7,23,29,52,11,23,21,4,5,45,0
20716,484515,541_16_05,CANADA,0,TOTALS,CANADA,200,32,91,35.2,27,69,39.1,5,22,22.7,18,30,60.0,24,30,54,22,23,13,17,5,87,1
20717,484527,541_16_05,DOMINICAN REPUBLIC,0,TOTALS,DOMINICAN REPUBLIC,200,25,74,33.8,23,62,37.1,2,12,16.7,22,30,73.3,22,39,61,10,23,23,9,10,74,0
20718,484539,541_16_06,VIRGIN ISLANDS,0,TOTALS,VIRGIN ISLANDS,200,21,69,30.4,7,25,28.0,14,44,31.8,7,15,46.7,8,31,39,17,20,33,11,1,63,1
20719,484552,541_16_06,USA,0,TOTALS,USA,200,41,83,49.4,34,53,64.2,7,30,23.3,18,29,62.1,16,42,58,35,13,20,16,11,107,0
20720,484565,541_16_07,BRAZIL,0,TOTALS,BRAZIL,200,16,62,25.8,14,40,35.0,2,22,9.1,20,42,47.6,22,36,58,10,28,21,9,4,54,1
20721,484578,541_16_07,ARGENTINA,0,TOTALS,ARGENTINA,200,11,56,19.6,8,38,21.1,3,18,16.7,26,29,89.7,10,33,43,9,33,18,11,0,51,0
20722,484591,541_16_08,PUERTO RICO,0,TOTALS,PUERTO RICO,200,26,56,46.4,18,34,52.9,8,22,36.4,10,12,83.3,6,33,39,13,26,16,3,1,70,1
20723,484604,541_16_08,CHILE,0,TOTALS,CHILE,200,18,55,32.7,12,29,41.4,6,26,23.1,18,25,72.0,7,25,32,11,15,10,7,2,60,0
20724,484617,541_16_09,BRAZIL,0,TOTALS,BRAZIL,200,22,71,31.0,16,49,32.7,6,22,27.3,8,9,88.9,20,36,56,11,22,32,4,4,58,0
20725,484630,541_16_09,CANADA,0,TOTALS,CANADA,200,24,67,35.8,15,45,33.3,9,22,40.9,17,24,70.8,11,27,38,18,19,20,17,4,74,1
20726,484642,541_16_10,VIRGIN ISLANDS,0,TOTALS,VIRGIN ISLANDS,200,21,72,29.2,13,49,26.5,8,23,34.8,11,14,78.6,17,25,42,12,22,18,4,5,61,0
20727,484655,541_16_10,PUERTO RICO,0,TOTALS,PUERTO RICO,200,27,76,35.5,17,46,37.0,10,30,33.3,21,27,77.8,24,31,55,18,11,12,9,9,85,1
20728,484668,541_16_11,ARGENTINA,0,TOTALS,ARGENTINA,200,28,72,38.9,20,46,43.5,8,26,30.8,15,29,51.7,17,32,49,23,24,21,10,3,79,1
20729,484680,541_16_11,DOMINICAN REPUBLIC,0,TOTALS,DOMINICAN REPUBLIC,200,26,68,38.2,18,45,40.0,8,23,34.8,15,27,55.6,14,32,46,14,27,24,9,5,75,0
20730,484693,541_16_12,CHILE,0,TOTALS,CHILE,200,17,65,26.2,9,30,30.0,8,35,22.9,8,18,44.4,11,30,41,10,12,11,5,1,50,0
20731,484706,541_16_12,USA,0,TOTALS,USA,200,27,65,41.5,20,40,50.0,7,25,28.0,9,14,64.3,9,41,50,20,19,10,8,8,70,1
20732,484719,541_16_13,ARGENTINA,0,TOTALS,ARGENTINA,200,35,69,50.7,25,43,58.1,10,26,38.5,11,20,55.0,9,30,39,27,32,17,10,5,91,1
20733,484731,541_16_13,VIRGIN ISLANDS,0,TOTALS,VIRGIN ISLANDS,200,23,71,32.4,17,43,39.5,6,28,21.4,27,41,65.9,24,27,51,10,19,21,10,5,79,0
20734,484744,541_16_14,CHILE,0,TOTALS,CHILE,200,25,60,41.7,18,38,47.4,7,22,31.8,15,22,68.2,10,25,35,14,15,12,8,3,72,1
20735,484756,541_16_14,DOMINICAN REPUBLIC,0,TOTALS,DOMINICAN REPUBLIC,200,28,73,38.4,25,54,46.3,3,19,15.8,10,14,71.4,20,29,49,9,20,12,8,4,69,0
20736,484769,541_16_15,CANADA,0,TOTALS,CANADA,200,29,69,42.0,22,43,51.2,7,26,26.9,18,27,66.7,11,31,42,12,19,12,10,4,83,1
20737,484782,541_16_15,PUERTO RICO,0,TOTALS,PUERTO RICO,200,22,64,34.4,17,42,40.5,5,22,22.7,17,23,73.9,14,33,47,9,18,23,5,5,66,0
20738,484795,541_16_16,USA,0,TOTALS,USA,200,30,77,39.0,18,48,37.5,12,29,41.4,16,24,66.7,21,36,57,24,23,20,18,9,88,1
20739,484808,541_16_16,BRAZIL,0,TOTALS,BRAZIL,200,16,73,21.9,15,52,28.8,1,21,4.8,15,24,62.5,24,28,52,12,22,25,10,1,48,0
20740,484820,541_16_17,VIRGIN ISLANDS,0,TOTALS,VIRGIN ISLANDS,200,28,83,33.7,19,47,40.4,9,36,25.0,12,14,85.7,22,27,49,19,13,11,11,7,77,1
20741,484832,541_16_17,DOMINICAN REPUBLIC,0,TOTALS,DOMINICAN REPUBLIC,200,25,68,36.8,20,46,43.5,5,22,22.7,8,17,47.1,20,30,50,18,12,24,6,5,63,0
20742,484845,541_16_18,ARGENTINA,0,TOTALS,ARGENTINA,200,29,68,42.6,22,47,46.8,7,21,33.3,8,12,66.7,19,28,47,10,25,15,8,2,73,1
20743,484858,541_16_18,CHILE,0,TOTALS,CHILE,200,21,56,37.5,14,27,51.9,7,29,24.1,19,24,79.2,8,22,30,11,17,11,8,4,68,0
20744,484871,541_16_19,PUERTO RICO,0,TOTALS,PUERTO RICO,200,24,79,30.4,17,55,30.9,7,24,29.2,3,10,30.0,17,33,50,12,8,7,6,6,58,0
20745,484884,541_16_19,BRAZIL,0,TOTALS,BRAZIL,200,27,70,38.6,26,59,44.1,1,11,9.1,4,10,40.0,13,41,54,12,12,13,5,4,59,1
20746,484897,541_16_20,CANADA,0,TOTALS,CANADA,200,29,74,39.2,16,35,45.7,13,39,33.3,13,24,54.2,13,25,38,17,18,14,3,2,84,0
20747,484910,541_16_20,USA,0,TOTALS,USA,200,37,79,46.8,31,60,51.7,6,19,31.6,19,28,67.9,20,35,55,21,20,11,10,2,99,1
20748,485428,543_16_01,VENEZUELA,0,TOTALS,VENEZUELA,200,23,55,41.8,18,34,52.9,5,21,23.8,15,24,62.5,13,22,35,7,19,15,6,3,66,1
20749,485441,543_16_01,CHILE,0,TOTALS,CHILE,200,24,55,43.6,19,36,52.8,5,19,26.3,5,16,31.2,6,20,26,11,21,17,5,1,58,0
20750,485454,543_16_02,ARGENTINA,0,TOTALS,ARGENTINA,200,31,51,60.8,28,41,68.3,3,10,30.0,13,20,65.0,10,18,28,17,8,18,3,0,78,1
20751,485467,543_16_02,COLOMBIA,0,TOTALS,COLOMBIA,200,22,49,44.9,21,40,52.5,1,9,11.1,4,7,57.1,5,8,13,3,19,9,11,0,49,0
20752,485480,543_16_03,URUGUAY,0,TOTALS,URUGUAY,200,37,69,53.6,31,54,57.4,6,15,40.0,15,21,71.4,8,27,35,21,11,14,5,2,95,1
20753,485493,543_16_03,PERU,0,TOTALS,PERU,200,19,58,32.8,11,40,27.5,8,18,44.4,5,13,38.5,10,22,32,9,16,21,6,1,51,0
20754,485506,543_16_04,ECUADOR,0,TOTALS,ECUADOR,200,13,66,19.7,10,49,20.4,3,17,17.6,7,10,70.0,14,14,28,2,17,28,8,0,36,0
20755,485519,543_16_04,PARAGUAY,0,TOTALS,PARAGUAY,200,35,67,52.2,33,46,71.7,2,21,9.5,18,25,72.0,6,36,42,13,15,20,15,4,90,1
20756,485532,543_16_05,PERU,0,TOTALS,PERU,200,20,57,35.1,18,43,41.9,2,14,14.3,11,21,52.4,5,19,24,6,10,16,6,0,53,0
20757,485545,543_16_05,ARGENTINA,0,TOTALS,ARGENTINA,200,33,68,48.5,27,45,60.0,6,23,26.1,7,13,53.8,13,30,43,13,18,16,11,4,79,1
20758,485558,543_16_06,ECUADOR,0,TOTALS,ECUADOR,200,21,51,41.2,17,35,48.6,4,16,25.0,6,19,31.6,5,9,14,7,21,23,11,2,52,0
20759,485571,543_16_06,VENEZUELA,0,TOTALS,VENEZUELA,200,32,59,54.2,25,45,55.6,7,14,50.0,14,25,56.0,13,23,36,11,17,20,11,4,85,1
20760,485584,543_16_07,COLOMBIA,0,TOTALS,COLOMBIA,200,23,75,30.7,20,56,35.7,3,19,15.8,16,29,55.2,10,21,31,4,18,16,10,1,65,0
20761,485597,543_16_07,URUGUAY,0,TOTALS,URUGUAY,200,34,73,46.6,26,52,50.0,8,21,38.1,15,21,71.4,9,32,41,22,25,19,10,2,91,1
20762,485610,543_16_08,PARAGUAY,0,TOTALS,PARAGUAY,200,35,67,52.2,28,51,54.9,7,16,43.8,9,14,64.3,8,27,35,22,23,14,13,0,86,1
20763,485623,543_16_08,CHILE,0,TOTALS,CHILE,200,14,56,25.0,11,41,26.8,3,15,20.0,10,16,62.5,8,16,24,8,13,22,6,1,41,0
20764,485636,543_16_09,PERU,0,TOTALS,PERU,225,37,74,50.0,32,56,57.1,5,18,27.8,11,29,37.9,8,24,32,17,24,15,9,1,90,0
20765,485649,543_16_09,COLOMBIA,0,TOTALS,COLOMBIA,225,34,80,42.5,23,48,47.9,11,32,34.4,17,28,60.7,14,33,47,12,24,18,9,0,96,1
20766,485662,543_16_10,CHILE,0,TOTALS,CHILE,200,26,61,42.6,20,45,44.4,6,16,37.5,9,12,75.0,10,24,34,9,20,17,6,2,67,1
20767,485675,543_16_10,ECUADOR,0,TOTALS,ECUADOR,200,21,57,36.8,17,45,37.8,4,12,33.3,10,24,41.7,10,25,35,6,16,20,9,1,56,0
20768,485688,543_16_11,ARGENTINA,0,TOTALS,ARGENTINA,200,28,58,48.3,20,36,55.6,8,22,36.4,14,19,73.7,7,24,31,14,20,14,6,1,78,1
20769,485701,543_16_11,URUGUAY,0,TOTALS,URUGUAY,200,22,59,37.3,16,38,42.1,6,21,28.6,20,26,76.9,7,14,21,5,14,10,3,1,70,0
20770,485714,543_16_12,VENEZUELA,0,TOTALS,VENEZUELA,200,19,65,29.2,17,45,37.8,2,20,10.0,15,21,71.4,7,20,27,7,22,26,12,3,55,0
20771,485727,543_16_12,PARAGUAY,0,TOTALS,PARAGUAY,200,31,68,45.6,26,53,49.1,5,15,33.3,15,22,68.2,7,32,39,14,20,24,16,3,82,1
20772,485740,543_16_13,COLOMBIA,0,TOTALS,COLOMBIA,200,30,59,50.8,23,44,52.3,7,15,46.7,13,24,54.2,5,20,25,6,17,14,9,1,80,1
20773,485753,543_16_13,ECUADOR,0,TOTALS,ECUADOR,200,25,55,45.5,23,44,52.3,2,11,18.2,9,20,45.0,8,20,28,5,16,17,5,2,61,0
20774,485766,543_16_14,CHILE,0,TOTALS,CHILE,200,18,59,30.5,16,41,39.0,2,18,11.1,14,21,66.7,8,29,37,5,11,12,8,0,52,1
20775,485779,543_16_14,PERU,0,TOTALS,PERU,200,19,62,30.6,16,45,35.6,3,17,17.6,3,9,33.3,9,30,39,2,17,16,7,3,44,0
20776,485792,543_16_15,ARGENTINA,0,TOTALS,ARGENTINA,200,31,70,44.3,26,53,49.1,5,17,29.4,17,23,73.9,13,30,43,16,18,21,7,4,84,1
20777,485805,543_16_15,VENEZUELA,0,TOTALS,VENEZUELA,200,23,74,31.1,17,53,32.1,6,21,28.6,10,15,66.7,9,13,22,7,21,13,9,2,62,0
20778,485818,543_16_16,PARAGUAY,0,TOTALS,PARAGUAY,200,24,73,32.9,17,50,34.0,7,23,30.4,18,26,69.2,12,21,33,10,20,21,10,1,73,1
20779,485831,543_16_16,URUGUAY,0,TOTALS,URUGUAY,200,25,65,38.5,19,41,46.3,6,24,25.0,13,21,61.9,7,28,35,11,24,22,12,4,69,0
20780,485844,543_16_17,ECUADOR,0,TOTALS,ECUADOR,200,30,73,41.1,28,59,47.5,2,14,14.3,10,13,76.9,8,18,26,9,18,15,18,5,72,1
20781,485857,543_16_17,PERU,0,TOTALS,PERU,200,26,60,43.3,22,44,50.0,4,16,25.0,14,20,70.0,7,27,34,2,17,25,8,3,70,0
20782,485870,543_16_18,COLOMBIA,0,TOTALS,COLOMBIA,200,28,67,41.8,22,44,50.0,6,23,26.1,6,10,60.0,9,25,34,6,18,16,13,1,68,1
20783,485883,543_16_18,CHILE,0,TOTALS,CHILE,200,19,54,35.2,15,34,44.1,4,20,20.0,8,13,61.5,7,18,25,10,12,17,5,5,50,0
20784,485896,543_16_19,VENEZUELA,0,TOTALS,VENEZUELA,200,20,57,35.1,15,42,35.7,5,15,33.3,24,30,80.0,10,28,38,6,24,21,7,3,69,1
20785,485909,543_16_19,URUGUAY,0,TOTALS,URUGUAY,200,19,49,38.8,16,38,42.1,3,11,27.3,21,31,67.7,3,23,26,7,27,18,12,1,62,0
20786,485922,543_16_20,ARGENTINA,0,TOTALS,ARGENTINA,200,24,59,40.7,17,37,45.9,7,22,31.8,14,21,66.7,12,28,40,11,19,17,2,3,69,1
20787,485935,543_16_20,PARAGUAY,0,TOTALS,PARAGUAY,200,21,65,32.3,15,45,33.3,6,20,30.0,12,25,48.0,9,22,31,5,22,7,4,4,60,0
20788,486338,545_16_01,DOMINICAN REPUBLIC,0,TOTALS,DOMINICAN REPUBLIC,200,54,95,56.8,47,79,59.5,7,16,43.8,7,16,43.8,25,37,62,32,13,16,21,2,122,0
20789,486351,545_16_01,TRINIDAD AND TOBAGO,0,TOTALS,TRINIDAD AND TOBAGO,200,24,73,32.9,13,37,35.1,11,36,30.6,6,10,60.0,13,21,34,16,11,29,7,3,65,1
20790,486364,545_16_02,PANAMA,0,TOTALS,PANAMA,200,36,68,52.9,30,53,56.6,6,15,40.0,23,40,57.5,14,35,49,20,14,22,30,4,101,0
20791,486377,545_16_02,GUYANA,0,TOTALS,GUYANA,200,8,57,14.0,5,32,15.6,3,25,12.0,5,16,31.2,15,25,40,5,29,44,10,1,24,1
20792,486390,545_16_03,PUERTO RICO,0,TOTALS,PUERTO RICO,200,33,75,44.0,30,60,50.0,3,15,20.0,15,25,60.0,18,39,57,15,14,15,12,5,84,1
20793,486403,545_16_03,COSTA RICA,0,TOTALS,COSTA RICA,200,15,60,25.0,11,33,33.3,4,27,14.8,11,18,61.1,10,28,38,6,20,24,14,3,45,0
20794,486416,545_16_04,GUYANA,0,TOTALS,GUYANA,200,5,36,13.9,5,28,17.9,0,8,0.0,2,8,25.0,5,20,25,3,20,48,7,0,12,1
20795,486429,545_16_04,DOMINICAN REPUBLIC,0,TOTALS,DOMINICAN REPUBLIC,200,47,85,55.3,39,58,67.2,8,27,29.6,16,26,61.5,24,29,53,33,9,15,34,3,118,0
20796,486442,545_16_05,TRINIDAD AND TOBAGO,0,TOTALS,TRINIDAD AND TOBAGO,200,36,100,36.0,30,66,45.5,6,34,17.6,12,24,50.0,32,27,59,22,23,23,16,4,90,1
20797,486455,545_16_05,PANAMA,0,TOTALS,PANAMA,200,35,72,48.6,30,55,54.5,5,17,29.4,25,34,73.5,13,39,52,22,18,24,11,3,100,0
20798,486468,545_16_06,COSTA RICA,0,TOTALS,COSTA RICA,200,24,78,30.8,17,49,34.7,7,29,24.1,11,18,61.1,21,21,42,15,29,24,16,3,66,0
20799,486481,545_16_06,MEXICO,0,TOTALS,MEXICO,200,31,63,49.2,24,48,50.0,7,15,46.7,26,43,60.5,19,36,55,18,18,22,14,12,95,1
20800,486494,545_16_07,DOMINICAN REPUBLIC,0,TOTALS,DOMINICAN REPUBLIC,200,38,79,48.1,35,57,61.4,3,22,13.6,6,11,54.5,16,42,58,25,17,20,19,9,85,1
20801,486507,545_16_07,PANAMA,0,TOTALS,PANAMA,200,15,62,24.2,12,45,26.7,3,17,17.6,12,23,52.2,9,28,37,12,12,25,9,4,45,0
20802,486520,545_16_08,GUYANA,0,TOTALS,GUYANA,200,23,50,46.0,21,42,50.0,2,8,25.0,12,33,36.4,13,37,50,24,22,62,15,3,60,1
20803,486533,545_16_08,TRINIDAD AND TOBAGO,0,TOTALS,TRINIDAD AND TOBAGO,200,39,90,43.3,29,56,51.8,10,34,29.4,19,32,59.4,17,25,42,33,26,29,38,4,107,0
20804,486546,545_16_09,MEXICO,0,TOTALS,MEXICO,200,14,56,25.0,10,33,30.3,4,23,17.4,22,36,61.1,15,28,43,11,18,29,10,4,54,0
20805,486559,545_16_09,PUERTO RICO,0,TOTALS,PUERTO RICO,200,36,69,52.2,31,55,56.4,5,14,35.7,8,19,42.1,9,32,41,25,27,17,14,6,85,1
20806,486572,545_16_10,COSTA RICA,0,TOTALS,COSTA RICA,200,37,86,43.0,22,45,48.9,15,41,36.6,26,52,50.0,31,24,55,25,18,19,42,2,115,0
20807,486585,545_16_10,GUYANA,0,TOTALS,GUYANA,200,10,41,24.4,9,34,26.5,1,7,14.3,3,19,15.8,14,32,46,8,30,57,13,3,24,1
20808,486598,545_16_11,DOMINICAN REPUBLIC,0,TOTALS,DOMINICAN REPUBLIC,200,23,54,42.6,18,43,41.9,5,11,45.5,13,25,52.0,16,30,46,10,22,29,12,3,64,1
20809,486611,545_16_11,MEXICO,0,TOTALS,MEXICO,200,19,60,31.7,15,43,34.9,4,17,23.5,10,18,55.6,12,23,35,9,25,23,16,3,52,0
20810,486624,545_16_12,PUERTO RICO,0,TOTALS,PUERTO RICO,200,37,85,43.5,30,66,45.5,7,19,36.8,8,19,42.1,17,35,52,24,17,17,22,10,89,1
20811,486637,545_16_12,PANAMA,0,TOTALS,PANAMA,200,15,64,23.4,13,50,26.0,2,14,14.3,12,14,85.7,13,35,48,11,14,31,10,1,44,0
20812,486650,545_16_13,TRINIDAD AND TOBAGO,0,TOTALS,TRINIDAD AND TOBAGO,200,27,73,37.0,20,50,40.0,7,23,30.4,7,12,58.3,17,34,51,18,28,34,10,6,68,0
20813,486663,545_16_13,COSTA RICA,0,TOTALS,COSTA RICA,200,27,73,37.0,21,55,38.2,6,18,33.3,30,46,65.2,17,32,49,24,13,18,26,6,90,1
20814,486676,545_16_14,MEXICO,0,TOTALS,MEXICO,200,41,84,48.8,32,58,55.2,9,26,34.6,9,17,52.9,19,27,46,34,24,19,31,5,100,0
20815,486689,545_16_14,PANAMA,0,TOTALS,PANAMA,200,12,50,24.0,11,41,26.8,1,9,11.1,21,33,63.6,15,29,44,10,19,40,11,4,46,1
20816,486702,545_16_15,DOMINICAN REPUBLIC,0,TOTALS,DOMINICAN REPUBLIC,200,23,59,39.0,20,43,46.5,3,16,18.8,18,29,62.1,9,26,35,10,15,21,12,2,67,0
20817,486715,545_16_15,PUERTO RICO,0,TOTALS,PUERTO RICO,200,29,64,45.3,23,47,48.9,6,17,35.3,10,16,62.5,11,32,43,14,22,22,15,8,74,1
20818,486728,546_16_01,ANTIGUA,0,TOTALS,ANTIGUA,200,20,50,40.0,14,34,41.2,6,16,37.5,25,44,56.8,11,22,33,10,22,40,15,11,71,1
20819,486741,546_16_01,BAHAMAS,0,TOTALS,BAHAMAS,200,46,104,44.2,42,97,43.3,4,7,57.1,13,22,59.1,37,28,65,22,33,22,25,1,109,0
20820,486754,546_16_02,BARBADOS,0,TOTALS,BARBADOS,200,19,87,21.8,17,67,25.4,2,20,10.0,24,45,53.3,30,35,65,11,30,30,19,5,64,1
20821,486765,546_16_02,BRITISH VIRGIN ISLANDS,0,TOTALS,BRITISH VIRGIN ISLANDS,200,21,62,33.9,20,55,36.4,1,7,14.3,18,41,43.9,16,47,63,18,31,36,20,13,61,0
20822,486778,546_16_03,JAMAICA,0,TOTALS,JAMAICA,225,26,75,34.7,24,68,35.3,2,7,28.6,26,47,55.3,24,46,70,13,24,39,15,4,80,1
20823,486791,546_16_03,SURINAM,0,TOTALS,SURINAM,225,26,84,31.0,24,75,32.0,2,9,22.2,13,31,41.9,19,32,51,13,36,31,17,6,67,0
20824,486804,546_16_04,GUYANA,0,TOTALS,GUYANA,200,22,77,28.6,18,59,30.5,4,18,22.2,12,32,37.5,28,37,65,9,21,34,18,5,60,1
20825,486814,546_16_04,ARUBA,0,TOTALS,ARUBA,200,22,73,30.1,18,54,33.3,4,19,21.1,10,24,41.7,17,37,54,10,26,28,21,4,58,0
20826,486827,546_16_05,BAHAMAS,0,TOTALS,BAHAMAS,200,45,89,50.6,42,86,48.8,3,3,100.0,8,19,42.1,26,34,60,24,21,26,26,3,101,0
20827,486838,546_16_05,BRITISH VIRGIN ISLANDS,0,TOTALS,BRITISH VIRGIN ISLANDS,200,12,48,25.0,9,39,23.1,3,9,33.3,13,23,56.5,6,22,28,6,13,38,6,6,40,1
20828,486848,546_16_06,ARUBA,0,TOTALS,ARUBA,200,32,94,34.0,25,62,40.3,7,32,21.9,6,13,46.2,27,42,69,18,15,16,14,5,77,1
20829,486860,546_16_06,TRINIDAD AND TOBAGO,0,TOTALS,TRINIDAD AND TOBAGO,200,23,81,28.4,17,56,30.4,6,25,24.0,7,14,50.0,18,35,53,10,15,21,7,1,59,0
20830,486873,546_16_07,ANTIGUA,0,TOTALS,ANTIGUA,200,41,114,36.0,24,80,30.0,17,34,50.0,14,34,41.2,39,32,71,28,19,20,43,3,113,0
20831,486885,546_16_07,DOMINICA,0,TOTALS,DOMINICA,200,11,48,22.9,9,44,20.5,2,4,50.0,10,23,43.5,12,42,54,6,22,65,10,5,34,1
20832,486898,546_16_08,GUYANA,0,TOTALS,GUYANA,200,18,70,25.7,17,57,29.8,1,13,7.7,19,46,41.3,37,34,71,7,25,36,12,2,56,0
20833,486911,546_16_08,SURINAM,0,TOTALS,SURINAM,200,23,76,30.3,18,52,34.6,5,24,20.8,13,29,44.8,26,26,52,14,36,25,23,6,64,1
20834,486923,546_16_09,DOMINICA,0,TOTALS,DOMINICA,200,17,82,20.7,11,64,17.2,6,18,33.3,5,6,83.3,26,37,63,10,19,32,5,6,45,0
20835,486936,546_16_09,BARBADOS,0,TOTALS,BARBADOS,200,32,82,39.0,30,75,40.0,2,7,28.6,12,25,48.0,19,39,58,18,10,18,26,1,78,1
20836,486947,546_16_10,BRITISH VIRGIN ISLANDS,0,TOTALS,BRITISH VIRGIN ISLANDS,200,22,78,28.2,22,66,33.3,0,12,0.0,27,44,61.4,23,40,63,15,23,25,20,4,71,0
20837,486960,546_16_10,ANTIGUA,0,TOTALS,ANTIGUA,200,23,82,28.0,18,57,31.6,5,25,20.0,22,42,52.4,30,37,67,9,27,31,10,7,73,1
20838,486973,546_16_11,SURINAM,0,TOTALS,SURINAM,200,30,68,44.1,26,57,45.6,4,11,36.4,16,29,55.2,15,35,50,13,29,19,16,3,80,1
20839,486983,546_16_11,ARUBA,0,TOTALS,ARUBA,200,22,60,36.7,14,43,32.6,8,17,47.1,16,33,48.5,11,29,40,11,26,25,8,1,68,0
20840,486996,546_16_12,JAMAICA,0,TOTALS,JAMAICA,200,28,75,37.3,27,63,42.9,1,12,8.3,14,25,56.0,21,38,59,12,19,21,9,8,71,1
20841,487006,546_16_12,ARUBA,0,TOTALS,ARUBA,200,21,78,26.9,14,51,27.5,7,27,25.9,9,18,50.0,22,29,51,16,17,18,10,3,58,0
20842,487018,546_16_13,DOMINICA,0,TOTALS,DOMINICA,200,7,48,14.6,5,41,12.2,2,7,28.6,5,15,33.3,10,23,33,2,24,58,5,5,21,1
20843,487031,546_16_13,BAHAMAS,0,TOTALS,BAHAMAS,200,53,107,49.5,51,101,50.5,2,6,33.3,17,29,58.6,36,30,66,25,17,22,52,2,125,0
20844,487044,546_16_14,BARBADOS,0,TOTALS,BARBADOS,200,28,86,32.6,21,64,32.8,7,22,31.8,12,22,54.5,21,33,54,22,21,20,22,5,75,1
20845,487057,546_16_14,ANTIGUA,0,TOTALS,ANTIGUA,200,22,82,26.8,20,60,33.3,2,22,9.1,15,21,71.4,29,42,71,9,19,33,12,7,61,0
20846,487069,546_16_15,TRINIDAD AND TOBAGO,0,TOTALS,TRINIDAD AND TOBAGO,200,19,67,28.4,11,35,31.4,8,32,25.0,6,9,66.7,14,31,45,7,16,28,10,5,52,0
20847,487082,546_16_15,GUYANA,0,TOTALS,GUYANA,200,28,89,31.5,20,65,30.8,8,24,33.3,5,17,29.4,35,35,70,16,12,25,16,2,69,1
20848,487093,546_16_16,BRITISH VIRGIN ISLANDS,0,TOTALS,BRITISH VIRGIN ISLANDS,200,34,96,35.4,34,87,39.1,0,9,0.0,14,28,50.0,30,26,56,19,15,23,41,5,82,1
20849,487105,546_16_16,DOMINICA,0,TOTALS,DOMINICA,200,14,58,24.1,13,55,23.6,1,3,33.3,8,25,32.0,26,38,64,3,19,59,7,8,37,0
20850,487118,546_16_17,BAHAMAS,0,TOTALS,BAHAMAS,200,42,92,45.7,39,73,53.4,3,19,15.8,13,30,43.3,39,27,66,17,15,13,28,3,100,0
20851,487131,546_16_17,BARBADOS,0,TOTALS,BARBADOS,200,15,53,28.3,10,29,34.5,5,24,20.8,6,14,42.9,13,18,31,11,17,33,6,0,41,1
20852,487144,546_16_18,SURINAM,0,TOTALS,SURINAM,200,31,74,41.9,31,69,44.9,0,5,0.0,10,15,66.7,16,39,55,13,11,25,18,6,72,1
20853,487156,546_16_18,TRINIDAD AND TOBAGO,0,TOTALS,TRINIDAD AND TOBAGO,200,22,77,28.6,16,56,28.6,6,21,28.6,6,9,66.7,16,28,44,12,12,29,14,3,56,0
20854,487169,546_16_19,GUYANA,0,TOTALS,GUYANA,200,27,81,33.3,23,60,38.3,4,21,19.0,15,29,51.7,33,38,71,11,20,27,14,5,73,1
20855,487182,546_16_19,JAMAICA,0,TOTALS,JAMAICA,200,18,90,20.0,16,66,24.2,2,24,8.3,19,28,67.9,37,25,62,11,23,20,15,3,57,0
20856,487194,546_16_20,DOMINICA,0,TOTALS,DOMINICA,200,15,81,18.5,13,62,21.0,2,19,10.5,11,29,37.9,24,46,70,13,22,27,6,2,43,0
20857,487206,546_16_20,TRINIDAD AND TOBAGO,0,TOTALS,TRINIDAD AND TOBAGO,200,25,81,30.9,22,60,36.7,3,21,14.3,12,28,42.9,19,49,68,13,26,23,18,4,65,1
20858,487217,546_16_21,BRITISH VIRGIN ISLANDS,0,TOTALS,BRITISH VIRGIN ISLANDS,200,23,76,30.3,21,55,38.2,2,21,9.5,17,33,51.5,22,36,58,13,21,31,14,2,65,0
20859,487230,546_16_21,SURINAM,0,TOTALS,SURINAM,200,28,89,31.5,26,81,32.1,2,8,25.0,12,24,50.0,29,38,67,22,26,30,20,6,70,1
20860,487243,546_16_22,ANTIGUA,0,TOTALS,ANTIGUA,200,33,81,40.7,31,75,41.3,2,6,33.3,17,33,51.5,23,40,63,10,28,32,18,10,85,1
20861,487253,546_16_22,ARUBA,0,TOTALS,ARUBA,200,26,92,28.3,23,85,27.1,3,7,42.9,16,34,47.1,30,30,60,16,24,28,14,2,71,0
20862,487266,546_16_23,BAHAMAS,0,TOTALS,BAHAMAS,200,33,92,35.9,30,71,42.3,3,21,14.3,3,11,27.3,17,35,52,19,17,13,25,5,72,1
20863,487279,546_16_23,JAMAICA,0,TOTALS,JAMAICA,200,18,70,25.7,18,53,34.0,0,17,0.0,15,23,65.2,22,43,65,11,6,29,3,4,51,0
20864,487292,546_16_24,BARBADOS,0,TOTALS,BARBADOS,200,14,63,22.2,14,47,29.8,0,16,0.0,9,23,39.1,10,25,35,7,23,27,22,2,37,0
20865,487305,546_16_24,GUYANA,0,TOTALS,GUYANA,200,31,80,38.8,26,62,41.9,5,18,27.8,10,24,41.7,31,42,73,19,20,31,14,6,77,1
20866,487315,546_16_25,ARUBA,0,TOTALS,ARUBA,200,22,70,31.4,20,63,31.7,2,7,28.6,11,33,33.3,16,42,58,12,19,34,12,10,57,0
20867,487326,546_16_25,BRITISH VIRGIN ISLANDS,0,TOTALS,BRITISH VIRGIN ISLANDS,200,29,89,32.6,27,81,33.3,2,8,25.0,9,25,36.0,26,40,66,12,25,25,20,2,69,1
20868,487339,546_16_26,ANTIGUA,0,TOTALS,ANTIGUA,200,27,79,34.2,20,57,35.1,7,22,31.8,16,29,55.2,19,28,47,14,15,26,22,6,77,0
20869,487352,546_16_26,SURINAM,0,TOTALS,SURINAM,200,36,90,40.0,32,79,40.5,4,11,36.4,9,24,37.5,32,38,70,23,20,31,19,7,85,1
20870,487365,546_16_27,JAMAICA,0,TOTALS,JAMAICA,200,27,85,31.8,26,76,34.2,1,9,11.1,11,18,61.1,33,38,71,15,5,21,16,4,66,1
20871,487378,546_16_27,BARBADOS,0,TOTALS,BARBADOS,200,24,83,28.9,17,65,26.2,7,18,38.9,3,8,37.5,22,29,51,12,12,19,13,6,58,0
20872,487391,546_16_28,BAHAMAS,0,TOTALS,BAHAMAS,200,30,82,36.6,25,67,37.3,5,15,33.3,19,34,55.9,23,33,56,22,26,16,26,9,84,1
20873,487404,546_16_28,GUYANA,0,TOTALS,GUYANA,200,19,72,26.4,15,50,30.0,4,22,18.2,15,38,39.5,28,33,61,9,24,32,8,9,57,0
20874,487713,548_16_01,MEXICO,0,TOTALS,MEXICO,200,53,90,58.9,49,70,70.0,4,20,20.0,6,6,100.0,16,23,39,32,28,25,27,8,116,0
20875,487726,548_16_01,EL SALVADOR,0,TOTALS,EL SALVADOR,200,17,55,30.9,15,47,31.9,2,8,25.0,16,30,53.3,8,16,24,16,10,44,9,3,52,1
20876,487739,548_16_02,GUATEMALA,0,TOTALS,GUATEMALA,200,15,54,27.8,12,35,34.3,3,19,15.8,6,18,33.3,9,26,35,15,24,26,8,8,40,0
20877,487752,548_16_02,COSTA RICA,0,TOTALS,COSTA RICA,200,14,43,32.6,10,29,34.5,4,14,28.6,18,36,50.0,6,32,38,11,22,30,19,2,50,1
20878,487765,548_16_03,EL SALVADOR,0,TOTALS,EL SALVADOR,200,18,51,35.3,16,43,37.2,2,8,25.0,28,56,50.0,14,41,55,12,18,25,15,2,66,1
20879,487778,548_16_03,GUATEMALA,0,TOTALS,GUATEMALA,200,25,83,30.1,17,54,31.5,8,29,27.6,5,17,29.4,21,30,51,18,38,25,14,4,63,0
20880,487791,548_16_04,PANAMA,0,TOTALS,PANAMA,200,26,76,34.2,20,52,38.5,6,24,25.0,14,28,50.0,16,30,46,12,19,15,8,4,72,0
20881,487804,548_16_04,MEXICO,0,TOTALS,MEXICO,200,36,78,46.2,25,50,50.0,11,28,39.3,7,22,31.8,18,36,54,28,23,18,6,2,90,1
20882,487817,548_16_05,GUATEMALA,0,TOTALS,GUATEMALA,200,20,70,28.6,16,47,34.0,4,23,17.4,5,14,35.7,16,24,40,11,19,34,14,4,49,0
20883,487830,548_16_05,PANAMA,0,TOTALS,PANAMA,200,28,70,40.0,27,56,48.2,1,14,7.1,12,29,41.4,26,34,60,13,16,33,20,8,69,1
20884,487843,548_16_06,COSTA RICA,0,TOTALS,COSTA RICA,200,19,64,29.7,15,37,40.5,4,27,14.8,4,12,33.3,11,28,39,13,23,22,7,7,46,0
20885,487856,548_16_06,EL SALVADOR,0,TOTALS,EL SALVADOR,200,19,57,33.3,17,50,34.0,2,7,28.6,14,24,58.3,12,34,46,8,14,19,14,3,54,1
20886,487869,548_16_07,MEXICO,0,TOTALS,MEXICO,200,34,69,49.3,28,55,50.9,6,14,42.9,21,31,67.7,19,31,50,28,13,25,26,0,95,1
20887,487882,548_16_07,GUATEMALA,0,TOTALS,GUATEMALA,200,15,60,25.0,11,41,26.8,4,19,21.1,4,8,50.0,13,19,32,8,23,39,13,3,38,0
20888,487895,548_16_08,PANAMA,0,TOTALS,PANAMA,200,26,70,37.1,24,49,49.0,2,21,9.5,15,29,51.7,18,33,51,10,11,21,13,6,69,1
20889,487908,548_16_08,COSTA RICA,0,TOTALS,COSTA RICA,200,20,65,30.8,16,46,34.8,4,19,21.1,7,15,46.7,11,33,44,7,21,24,5,2,51,0
20890,487921,548_16_09,EL SALVADOR,0,TOTALS,EL SALVADOR,200,29,65,44.6,28,60,46.7,1,5,20.0,14,32,43.8,12,27,39,15,17,24,15,2,73,1
20891,487934,548_16_09,PANAMA,0,TOTALS,PANAMA,200,41,88,46.6,29,62,46.8,12,26,46.2,10,22,45.5,26,32,58,22,21,23,11,3,104,0
20892,487947,548_16_10,COSTA RICA,0,TOTALS,COSTA RICA,200,27,60,45.0,20,34,58.8,7,26,26.9,3,11,27.3,11,20,31,15,23,31,14,3,64,0
20893,487960,548_16_10,MEXICO,0,TOTALS,MEXICO,200,25,59,42.4,20,43,46.5,5,16,31.2,21,29,72.4,14,24,38,15,13,26,18,1,76,1
20894,488233,550_16_01,SAN MARINO,0,TOTALS,SAN MARINO,200,25,69,36.2,22,46,47.8,3,23,13.0,8,11,72.7,16,39,55,18,16,14,5,2,61,1
20895,488246,550_16_01,MALTA,0,TOTALS,MALTA,200,17,62,27.4,15,40,37.5,2,22,9.1,5,15,33.3,13,28,41,12,14,16,10,4,41,0
20896,488259,550_16_02,WALES,0,TOTALS,WALES,200,13,51,25.5,12,41,29.3,1,10,10.0,6,14,42.9,15,31,46,3,24,31,4,0,33,0
20897,488272,550_16_02,ANDORRA,0,TOTALS,ANDORRA,200,24,63,38.1,18,36,50.0,6,27,22.2,20,29,69.0,10,22,32,16,14,13,14,2,74,1
20898,488284,550_16_03,ARMENIA,0,TOTALS,ARMENIA,200,27,59,45.8,16,35,45.7,11,24,45.8,18,24,75.0,9,27,36,15,13,12,9,4,83,1
20899,488297,550_16_03,MOLDOVA,0,TOTALS,MOLDOVA,200,24,60,40.0,16,36,44.4,8,24,33.3,8,12,66.7,10,24,34,16,20,15,8,5,64,0
20900,488310,550_16_04,IRELAND,0,TOTALS,IRELAND,200,41,72,56.9,28,43,65.1,13,29,44.8,5,19,26.3,13,33,46,26,16,16,20,3,100,0
20901,488320,550_16_04,GIBRALTAR,0,TOTALS,GIBRALTAR,200,17,51,33.3,14,36,38.9,3,15,20.0,6,19,31.6,5,24,29,8,23,26,9,3,43,1
20902,488333,550_16_05,ANDORRA,0,TOTALS,ANDORRA,200,25,58,43.1,20,42,47.6,5,16,31.2,15,18,83.3,9,36,45,11,25,22,8,1,70,1
20903,488345,550_16_05,ARMENIA,0,TOTALS,ARMENIA,200,25,69,36.2,23,51,45.1,2,18,11.1,11,20,55.0,15,22,37,8,21,17,11,5,63,0
20904,488358,550_16_06,MALTA,0,TOTALS,MALTA,200,12,56,21.4,10,37,27.0,2,19,10.5,8,16,50.0,10,15,25,6,16,20,11,2,34,0
20905,488371,550_16_06,IRELAND,0,TOTALS,IRELAND,200,38,72,52.8,34,51,66.7,4,21,19.0,11,15,73.3,20,37,57,23,19,15,10,1,91,1
20906,488384,550_16_07,MOLDOVA,0,TOTALS,MOLDOVA,200,19,59,32.2,12,36,33.3,7,23,30.4,18,28,64.3,10,29,39,15,17,25,13,4,63,1
20907,488397,550_16_07,WALES,0,TOTALS,WALES,200,24,71,33.8,22,63,34.9,2,8,25.0,9,20,45.0,20,34,54,17,27,25,12,0,59,0
20908,488407,550_16_08,GIBRALTAR,0,TOTALS,GIBRALTAR,200,12,59,20.3,8,35,22.9,4,24,16.7,4,13,30.8,11,33,44,4,23,17,4,4,32,0
20909,488420,550_16_08,SAN MARINO,0,TOTALS,SAN MARINO,200,15,58,25.9,10,36,27.8,5,22,22.7,14,21,66.7,11,39,50,8,18,12,10,5,49,1
20910,488432,550_16_09,ARMENIA,0,TOTALS,ARMENIA,200,32,70,45.7,18,34,52.9,14,36,38.9,14,27,51.9,20,36,56,21,12,18,11,4,92,1
20911,488445,550_16_09,WALES,0,TOTALS,WALES,200,15,60,25.0,12,44,27.3,3,16,18.8,7,10,70.0,11,22,33,14,21,21,5,2,40,0
20912,488458,550_16_10,MALTA,0,TOTALS,MALTA,200,24,63,38.1,17,34,50.0,7,29,24.1,15,26,57.7,12,42,54,19,26,17,11,3,70,1
20913,488468,550_16_10,GIBRALTAR,0,TOTALS,GIBRALTAR,200,18,72,25.0,13,56,23.2,5,16,31.2,9,28,32.1,21,30,51,8,22,16,8,0,50,0
20914,488481,550_16_11,ANDORRA,0,TOTALS,ANDORRA,200,24,62,38.7,18,37,48.6,6,25,24.0,26,38,68.4,17,27,44,14,21,18,11,0,80,1
20915,488494,550_16_11,MOLDOVA,0,TOTALS,MOLDOVA,200,25,64,39.1,17,35,48.6,8,29,27.6,14,22,63.6,15,27,42,15,32,21,8,3,72,0
20916,488507,550_16_12,IRELAND,0,TOTALS,IRELAND,200,27,61,44.3,19,36,52.8,8,25,32.0,17,25,68.0,14,29,43,14,19,15,11,2,79,1
20917,488520,550_16_12,SAN MARINO,0,TOTALS,SAN MARINO,200,18,51,35.3,13,32,40.6,5,19,26.3,14,18,77.8,5,24,29,12,23,21,4,3,55,0
20918,488533,550_16_13,MALTA,0,TOTALS,MALTA,200,21,69,30.4,17,48,35.4,4,21,19.0,17,27,63.0,16,26,42,10,12,14,15,4,63,1
20919,488546,550_16_13,WALES,0,TOTALS,WALES,200,20,53,37.7,18,41,43.9,2,12,16.7,9,14,64.3,8,38,46,16,25,30,6,1,51,0
20920,488559,550_16_14,MOLDOVA,0,TOTALS,MOLDOVA,200,29,68,42.6,16,34,47.1,13,34,38.2,14,21,66.7,15,36,51,22,25,24,15,6,85,1
20921,488569,550_16_14,GIBRALTAR,0,TOTALS,GIBRALTAR,200,15,62,24.2,12,40,30.0,3,22,13.6,10,23,43.5,12,25,37,11,20,28,16,4,43,0
20922,488582,550_16_15,IRELAND,0,TOTALS,IRELAND,200,22,68,32.4,15,48,31.2,7,20,35.0,9,13,69.2,13,26,39,8,21,14,3,1,60,0
20923,488594,550_16_15,ARMENIA,0,TOTALS,ARMENIA,200,25,60,41.7,19,45,42.2,6,15,40.0,18,26,69.2,11,35,46,10,18,13,9,7,74,1
20924,488607,550_16_16,ANDORRA,0,TOTALS,ANDORRA,200,20,58,34.5,11,35,31.4,9,23,39.1,14,22,63.6,9,27,36,16,15,18,14,2,63,1
20925,488620,550_16_16,SAN MARINO,0,TOTALS,SAN MARINO,200,23,61,37.7,18,38,47.4,5,23,21.7,6,6,100.0,11,31,42,13,22,26,10,1,57,0
20926,488633,550_16_17,WALES,0,TOTALS,WALES,200,23,63,36.5,16,47,34.0,7,16,43.8,14,29,48.3,14,38,52,17,26,15,12,0,67,1
20927,488643,550_16_17,GIBRALTAR,0,TOTALS,GIBRALTAR,200,14,56,25.0,13,37,35.1,1,19,5.3,11,28,39.3,11,34,45,5,21,17,5,6,40,0
20928,488656,550_16_18,MALTA,0,TOTALS,MALTA,200,28,78,35.9,25,60,41.7,3,18,16.7,4,10,40.0,9,26,35,12,19,16,17,1,63,0
20929,488669,550_16_18,MOLDOVA,0,TOTALS,MOLDOVA,200,23,61,37.7,14,32,43.8,9,29,31.0,18,22,81.8,15,42,57,18,11,32,8,7,73,1
20930,488682,550_16_19,IRELAND,0,TOTALS,IRELAND,200,21,63,33.3,19,37,51.4,2,26,7.7,9,12,75.0,9,34,43,9,22,17,9,4,53,0
20931,488695,550_16_19,SAN MARINO,0,TOTALS,SAN MARINO,200,19,56,33.9,11,27,40.7,8,29,27.6,14,20,70.0,6,32,38,16,17,15,10,1,60,1
20932,488707,550_16_20,ARMENIA,0,TOTALS,ARMENIA,200,31,67,46.3,23,46,50.0,8,21,38.1,9,14,64.3,14,31,45,15,19,11,4,0,79,1
20933,488720,550_16_20,ANDORRA,0,TOTALS,ANDORRA,200,29,71,40.8,22,50,44.0,7,21,33.3,6,11,54.5,10,22,32,21,18,6,5,0,71,0
20934,489058,552_16_01,ITALY,0,TOTALS,ITALY,200,27,65,41.5,19,41,46.3,8,24,33.3,9,14,64.3,11,22,33,14,18,22,17,1,71,0
20935,489071,552_16_01,CZECH REPUBLIC,0,TOTALS,CZECH REPUBLIC,200,29,63,46.0,19,37,51.4,10,26,38.5,14,19,73.7,13,28,41,23,22,23,9,3,82,1
20936,489084,552_16_02,SERBIA,0,TOTALS,SERBIA,200,28,67,41.8,25,47,53.2,3,20,15.0,11,16,68.8,15,23,38,17,23,16,13,5,70,1
20937,489097,552_16_02,LATVIA,0,TOTALS,LATVIA,200,23,61,37.7,14,33,42.4,9,28,32.1,13,21,61.9,15,26,41,13,22,21,8,9,68,0
20938,489110,552_16_03,SWEDEN,0,TOTALS,SWEDEN,200,24,68,35.3,19,43,44.2,5,25,20.0,7,19,36.8,19,35,54,11,18,11,6,5,60,1
20939,489123,552_16_03,BELGIUM,0,TOTALS,BELGIUM,200,17,62,27.4,9,31,29.0,8,31,25.8,11,11,100.0,6,31,37,9,22,11,6,1,53,0
20940,489136,552_16_04,TURKEY,0,TOTALS,TURKEY,200,39,69,56.5,36,58,62.1,3,11,27.3,9,13,69.2,14,27,41,20,15,10,12,6,90,1
20941,489149,552_16_04,LITHUANIA,0,TOTALS,LITHUANIA,200,28,63,44.4,21,41,51.2,7,22,31.8,5,11,45.5,12,18,30,15,23,17,6,1,68,0
20942,489162,552_16_05,ISRAEL,0,TOTALS,ISRAEL,200,30,68,44.1,18,38,47.4,12,30,40.0,9,12,75.0,12,34,46,20,22,16,8,1,81,1
20943,489175,552_16_05,FINLAND,0,TOTALS,FINLAND,200,27,78,34.6,21,47,44.7,6,31,19.4,12,16,75.0,19,29,48,13,17,13,3,1,72,0
20944,489188,552_16_06,HUNGARY,0,TOTALS,HUNGARY,200,18,54,33.3,13,32,40.6,5,22,22.7,3,4,75.0,7,20,27,11,16,24,5,2,44,0
20945,489201,552_16_06,GERMANY,0,TOTALS,GERMANY,200,39,77,50.6,30,49,61.2,9,28,32.1,5,7,71.4,20,28,48,24,13,12,10,7,92,1
20946,489214,552_16_07,SPAIN,0,TOTALS,SPAIN,200,18,55,32.7,12,35,34.3,6,20,30.0,18,28,64.3,11,26,37,11,19,17,11,3,60,1
20947,489227,552_16_07,FRANCE,0,TOTALS,FRANCE,200,23,65,35.4,18,47,38.3,5,18,27.8,8,13,61.5,17,28,45,13,28,20,9,1,59,0
20948,489240,552_16_08,SLOVENIA,0,TOTALS,SLOVENIA,200,26,75,34.7,21,48,43.8,5,27,18.5,13,16,81.2,16,27,43,10,22,12,8,1,70,1
20949,489253,552_16_08,UKRAINE,0,TOTALS,UKRAINE,200,25,71,35.2,18,47,38.3,7,24,29.2,11,17,64.7,18,34,52,11,23,15,8,1,68,0
20950,489266,552_16_09,GERMANY,0,TOTALS,GERMANY,200,22,54,40.7,17,33,51.5,5,21,23.8,14,20,70.0,13,25,38,13,20,22,6,2,63,0
20951,489279,552_16_09,TURKEY,0,TOTALS,TURKEY,200,25,63,39.7,21,44,47.7,4,19,21.1,13,16,81.2,13,21,34,21,21,16,11,4,67,1
20952,489292,552_16_10,BELGIUM,0,TOTALS,BELGIUM,200,23,58,39.7,17,33,51.5,6,25,24.0,12,18,66.7,10,17,27,6,18,24,9,1,64,0
20953,489305,552_16_10,ITALY,0,TOTALS,ITALY,200,33,60,55.0,27,42,64.3,6,18,33.3,17,20,85.0,9,26,35,18,21,20,13,1,89,1
20954,489318,552_16_11,UKRAINE,0,TOTALS,UKRAINE,200,30,62,48.4,16,34,47.1,14,28,50.0,16,19,84.2,14,20,34,15,23,12,8,5,90,1
20955,489331,552_16_11,SERBIA,0,TOTALS,SERBIA,200,22,60,36.7,16,41,39.0,6,19,31.6,19,24,79.2,17,19,36,16,20,17,6,1,69,0
20956,489344,552_16_12,FRANCE,0,TOTALS,FRANCE,200,25,71,35.2,19,41,46.3,6,30,20.0,10,11,90.9,14,19,33,13,18,13,9,2,66,0
20957,489357,552_16_12,ISRAEL,0,TOTALS,ISRAEL,200,32,61,52.5,23,36,63.9,9,25,36.0,13,18,72.2,12,31,43,20,16,20,4,2,86,1
20958,489370,552_16_13,FINLAND,0,TOTALS,FINLAND,225,33,83,39.8,19,32,59.4,14,51,27.5,11,16,68.8,18,26,44,23,26,22,15,3,91,1
20959,489383,552_16_13,SPAIN,0,TOTALS,SPAIN,225,32,63,50.8,22,43,51.2,10,20,50.0,16,24,66.7,8,33,41,15,19,25,12,4,90,0
20960,489396,552_16_14,CZECH REPUBLIC,0,TOTALS,CZECH REPUBLIC,200,23,70,32.9,10,29,34.5,13,41,31.7,8,11,72.7,19,26,45,17,19,11,6,2,67,1
20961,489409,552_16_14,SWEDEN,0,TOTALS,SWEDEN,200,25,64,39.1,21,40,52.5,4,24,16.7,7,12,58.3,15,29,44,6,16,13,5,1,61,0
20962,489422,552_16_15,LITHUANIA,0,TOTALS,LITHUANIA,200,48,68,70.6,38,50,76.0,10,18,55.6,22,34,64.7,11,35,46,37,21,10,8,5,128,0
20963,489435,552_16_15,HUNGARY,0,TOTALS,HUNGARY,200,20,56,35.7,8,37,21.6,12,19,63.2,17,23,73.9,6,13,19,10,28,18,8,0,69,1
20964,489448,552_16_16,LATVIA,0,TOTALS,LATVIA,200,22,55,40.0,13,30,43.3,9,25,36.0,25,34,73.5,19,27,46,17,18,19,5,2,78,1
20965,489461,552_16_16,SLOVENIA,0,TOTALS,SLOVENIA,200,25,67,37.3,18,41,43.9,7,26,26.9,14,16,87.5,15,20,35,16,29,11,15,1,71,0
20966,489474,552_16_17,GERMANY,0,TOTALS,GERMANY,200,28,66,42.4,16,41,39.0,12,25,48.0,10,13,76.9,13,16,29,11,21,12,7,4,78,1
20967,489487,552_16_17,LITHUANIA,0,TOTALS,LITHUANIA,200,27,49,55.1,21,36,58.3,6,13,46.2,17,21,81.0,8,26,34,17,21,17,3,3,77,0
20968,489500,552_16_18,UKRAINE,0,TOTALS,UKRAINE,225,25,84,29.8,18,53,34.0,7,31,22.6,15,26,57.7,19,28,47,17,21,18,15,1,72,1
20969,489513,552_16_18,LATVIA,0,TOTALS,LATVIA,225,24,64,37.5,18,33,54.5,6,31,19.4,16,23,69.6,14,41,55,15,26,32,7,8,70,0
20970,489526,552_16_19,TURKEY,0,TOTALS,TURKEY,200,31,64,48.4,24,44,54.5,7,20,35.0,12,20,60.0,13,28,41,24,18,13,11,2,81,1
20971,489539,552_16_19,HUNGARY,0,TOTALS,HUNGARY,200,26,56,46.4,19,33,57.6,7,23,30.4,5,12,41.7,7,24,31,18,21,18,3,1,64,0
20972,489552,552_16_20,SERBIA,0,TOTALS,SERBIA,200,25,67,37.3,20,54,37.0,5,13,38.5,18,24,75.0,15,31,46,13,19,17,6,5,73,1
20973,489565,552_16_20,SLOVENIA,0,TOTALS,SLOVENIA,200,26,64,40.6,19,40,47.5,7,24,29.2,9,16,56.2,10,27,37,18,24,18,6,4,68,0
20974,489578,552_16_21,FINLAND,0,TOTALS,FINLAND,200,24,54,44.4,23,45,51.1,1,9,11.1,21,30,70.0,11,28,39,12,18,19,9,2,70,1
20975,489591,552_16_21,FRANCE,0,TOTALS,FRANCE,200,26,63,41.3,21,40,52.5,5,23,21.7,8,13,61.5,9,22,31,16,27,15,10,3,65,0
20976,489604,552_16_22,ITALY,0,TOTALS,ITALY,200,22,59,37.3,14,33,42.4,8,26,30.8,13,17,76.5,6,23,29,12,18,9,7,4,65,0
20977,489617,552_16_22,SWEDEN,0,TOTALS,SWEDEN,200,26,64,40.6,18,40,45.0,8,24,33.3,9,14,64.3,14,32,46,15,21,15,4,8,69,1
20978,489630,552_16_23,SPAIN,0,TOTALS,SPAIN,200,32,75,42.7,25,54,46.3,7,21,33.3,19,29,65.5,18,34,52,21,18,13,15,7,90,1
20979,489643,552_16_23,ISRAEL,0,TOTALS,ISRAEL,200,22,67,32.8,9,31,29.0,13,36,36.1,14,19,73.7,12,29,41,20,26,21,7,2,71,0
20980,489656,552_16_24,BELGIUM,0,TOTALS,BELGIUM,200,31,66,47.0,24,46,52.2,7,20,35.0,16,20,80.0,10,26,36,15,19,12,11,0,85,1
20981,489669,552_16_24,CZECH REPUBLIC,0,TOTALS,CZECH REPUBLIC,200,32,69,46.4,22,41,53.7,10,28,35.7,9,14,64.3,12,25,37,16,19,15,4,1,83,0
20982,489682,552_16_25,TURKEY,0,TOTALS,TURKEY,200,30,64,46.9,22,41,53.7,8,23,34.8,14,22,63.6,14,27,41,23,19,16,5,3,82,1
20983,489695,552_16_25,FRANCE,0,TOTALS,FRANCE,200,29,65,44.6,23,41,56.1,6,24,25.0,11,12,91.7,7,25,32,14,23,14,8,2,75,0
20984,489708,552_16_26,SWEDEN,0,TOTALS,SWEDEN,200,18,60,30.0,14,36,38.9,4,24,16.7,13,19,68.4,12,26,38,8,21,11,7,3,53,0
20985,489721,552_16_26,LATVIA,0,TOTALS,LATVIA,200,23,57,40.4,13,29,44.8,10,28,35.7,10,18,55.6,13,30,43,9,19,15,6,2,66,1
20986,489734,552_16_27,SPAIN,0,TOTALS,SPAIN,200,32,65,49.2,26,43,60.5,6,22,27.3,17,21,81.0,15,25,40,19,15,22,14,3,87,1
20987,489747,552_16_27,HUNGARY,0,TOTALS,HUNGARY,200,24,53,45.3,16,33,48.5,8,20,40.0,10,14,71.4,6,19,25,21,24,23,9,1,66,0
20988,489760,552_16_28,CZECH REPUBLIC,0,TOTALS,CZECH REPUBLIC,225,28,71,39.4,18,43,41.9,10,28,35.7,13,21,61.9,15,34,49,17,19,18,7,3,79,1
20989,489773,552_16_28,SLOVENIA,0,TOTALS,SLOVENIA,225,27,69,39.1,16,40,40.0,11,29,37.9,12,19,63.2,10,29,39,21,20,12,10,2,77,0
20990,489786,552_16_29,SERBIA,0,TOTALS,SERBIA,200,25,59,42.4,21,41,51.2,4,18,22.2,11,18,61.1,11,29,40,11,22,19,10,0,65,0
20991,489799,552_16_29,ITALY,0,TOTALS,ITALY,200,23,60,38.3,14,36,38.9,9,24,37.5,15,20,75.0,10,22,32,12,22,15,12,3,70,1
20992,489812,552_16_30,FINLAND,0,TOTALS,FINLAND,200,22,57,38.6,13,30,43.3,9,27,33.3,9,15,60.0,7,20,27,13,24,20,12,3,62,0
20993,489825,552_16_30,LITHUANIA,0,TOTALS,LITHUANIA,200,28,59,47.5,18,36,50.0,10,23,43.5,15,21,71.4,14,30,44,18,20,21,15,4,81,1
20994,489838,552_16_31,GERMANY,0,TOTALS,GERMANY,200,36,78,46.2,27,53,50.9,9,25,36.0,8,13,61.5,26,28,54,21,14,14,7,6,89,1
20995,489851,552_16_31,ISRAEL,0,TOTALS,ISRAEL,200,25,61,41.0,9,29,31.0,16,32,50.0,7,9,77.8,8,20,28,21,17,15,4,0,73,0
20996,489864,552_16_32,UKRAINE,0,TOTALS,UKRAINE,200,35,59,59.3,26,40,65.0,9,19,47.4,16,22,72.7,7,33,40,24,15,13,8,4,95,1
20997,489877,552_16_32,BELGIUM,0,TOTALS,BELGIUM,200,29,78,37.2,19,51,37.3,10,27,37.0,5,7,71.4,16,19,35,11,21,13,9,2,73,0
20998,489890,552_16_33,FRANCE,0,TOTALS,FRANCE,200,24,69,34.8,20,50,40.0,4,19,21.1,13,17,76.5,17,21,38,11,27,15,8,8,65,0
20999,489903,552_16_33,SERBIA,0,TOTALS,SERBIA,200,29,62,46.8,22,43,51.2,7,19,36.8,23,29,79.3,15,30,45,22,20,16,8,3,88,1
21000,489916,552_16_34,TURKEY,0,TOTALS,TURKEY,200,32,70,45.7,27,48,56.2,5,22,22.7,14,24,58.3,20,30,50,16,23,15,7,11,83,1
21001,489929,552_16_34,ITALY,0,TOTALS,ITALY,200,25,70,35.7,17,40,42.5,8,30,26.7,14,20,70.0,14,19,33,9,25,12,10,1,72,0
21002,489942,552_16_35,FINLAND,0,TOTALS,FINLAND,200,15,67,22.4,12,46,26.1,3,21,14.3,14,24,58.3,16,22,38,13,19,17,8,2,47,0
21003,489955,552_16_35,SLOVENIA,0,TOTALS,SLOVENIA,200,32,69,46.4,27,48,56.2,5,21,23.8,12,12,100.0,14,42,56,17,25,20,11,4,81,1
21004,489968,552_16_36,LITHUANIA,0,TOTALS,LITHUANIA,200,29,68,42.6,23,45,51.1,6,23,26.1,15,24,62.5,21,32,53,14,16,15,8,5,79,1
21005,489981,552_16_36,CZECH REPUBLIC,0,TOTALS,CZECH REPUBLIC,200,27,67,40.3,19,48,39.6,8,19,42.1,7,8,87.5,8,23,31,18,24,11,9,5,69,0
21006,489994,552_16_37,ISRAEL,0,TOTALS,ISRAEL,200,30,64,46.9,22,41,53.7,8,23,34.8,25,30,83.3,12,28,40,21,15,18,7,4,93,1
21007,490007,552_16_37,BELGIUM,0,TOTALS,BELGIUM,200,33,75,44.0,21,44,47.7,12,31,38.7,11,13,84.6,12,26,38,10,21,12,9,2,89,0
21008,490020,552_16_38,GERMANY,0,TOTALS,GERMANY,200,22,61,36.1,15,40,37.5,7,21,33.3,13,17,76.5,13,34,47,10,19,17,7,2,64,1
21009,490033,552_16_38,UKRAINE,0,TOTALS,UKRAINE,200,19,69,27.5,10,32,31.2,9,37,24.3,5,9,55.6,17,25,42,16,20,17,11,5,52,0
21010,490046,552_16_39,HUNGARY,0,TOTALS,HUNGARY,200,18,58,31.0,15,41,36.6,3,17,17.6,4,8,50.0,7,26,33,5,19,12,5,2,43,0
21011,490059,552_16_39,SWEDEN,0,TOTALS,SWEDEN,200,24,69,34.8,16,33,48.5,8,36,22.2,6,11,54.5,20,33,53,13,15,10,5,7,62,1
21012,490072,552_16_40,SPAIN,0,TOTALS,SPAIN,200,30,62,48.4,21,42,50.0,9,20,45.0,10,20,50.0,9,26,35,19,20,16,12,4,79,1
21013,490085,552_16_40,LATVIA,0,TOTALS,LATVIA,200,23,63,36.5,15,30,50.0,8,33,24.2,16,20,80.0,14,29,43,21,20,19,10,1,70,0
21014,490098,552_16_41,FRANCE,0,TOTALS,FRANCE,200,30,72,41.7,21,48,43.8,9,24,37.5,5,14,35.7,15,30,45,19,26,20,15,6,74,1
21015,490111,552_16_41,FINLAND,0,TOTALS,FINLAND,200,19,54,35.2,13,32,40.6,6,22,27.3,16,26,61.5,10,26,36,14,18,22,10,5,60,0
21016,490124,552_16_42,ITALY,0,TOTALS,ITALY,200,29,62,46.8,20,42,47.6,9,20,45.0,14,21,66.7,8,31,39,12,20,18,8,4,81,1
21017,490137,552_16_42,CZECH REPUBLIC,0,TOTALS,CZECH REPUBLIC,200,24,68,35.3,15,40,37.5,9,28,32.1,9,12,75.0,13,27,40,13,23,15,8,1,66,0
21018,490150,552_16_43,BELGIUM,0,TOTALS,BELGIUM,200,32,72,44.4,22,45,48.9,10,27,37.0,15,19,78.9,13,37,50,16,19,11,7,4,89,1
21019,490163,552_16_43,HUNGARY,0,TOTALS,HUNGARY,200,31,73,42.5,22,48,45.8,9,25,36.0,12,18,66.7,10,29,39,10,23,10,9,0,83,0
21020,490176,552_16_44,UKRAINE,0,TOTALS,UKRAINE,200,26,73,35.6,21,51,41.2,5,22,22.7,5,9,55.6,16,25,41,17,18,17,12,2,62,0
21021,490189,552_16_44,LATVIA,0,TOTALS,LATVIA,200,31,65,47.7,19,40,47.5,12,25,48.0,10,14,71.4,11,29,40,20,18,17,7,3,84,1
21022,490202,552_16_45,SERBIA,0,TOTALS,SERBIA,225,26,62,41.9,18,37,48.6,8,25,32.0,17,25,68.0,13,27,40,14,20,25,11,4,77,0
21023,490215,552_16_45,SLOVENIA,0,TOTALS,SLOVENIA,225,35,65,53.8,27,44,61.4,8,21,38.1,11,16,68.8,6,27,33,24,20,19,13,2,89,1
21024,490228,552_16_46,GERMANY,0,TOTALS,GERMANY,200,18,70,25.7,11,41,26.8,7,29,24.1,9,15,60.0,21,30,51,13,23,16,5,3,52,0
21025,490241,552_16_46,SPAIN,0,TOTALS,SPAIN,200,19,56,33.9,13,32,40.6,6,24,25.0,17,18,94.4,7,33,40,8,16,14,9,3,61,1
21026,490254,552_16_47,ISRAEL,0,TOTALS,ISRAEL,200,27,64,42.2,21,46,45.7,6,18,33.3,9,12,75.0,10,25,35,15,19,14,6,1,69,0
21027,490267,552_16_47,SWEDEN,0,TOTALS,SWEDEN,200,29,67,43.3,15,29,51.7,14,38,36.8,11,17,64.7,16,27,43,22,18,14,8,5,83,1
21028,490280,552_16_48,TURKEY,0,TOTALS,TURKEY,200,21,57,36.8,13,31,41.9,8,26,30.8,14,23,60.9,13,30,43,17,24,20,6,4,64,0
21029,490293,552_16_48,LITHUANIA,0,TOTALS,LITHUANIA,200,22,66,33.3,14,43,32.6,8,23,34.8,16,22,72.7,15,26,41,14,21,13,6,2,68,1
21030,490306,552_16_49,CZECH REPUBLIC,0,TOTALS,CZECH REPUBLIC,200,39,75,52.0,23,39,59.0,16,36,44.4,11,18,61.1,13,29,42,27,20,18,5,2,105,1
21031,490319,552_16_49,UKRAINE,0,TOTALS,UKRAINE,200,38,78,48.7,28,51,54.9,10,27,37.0,17,24,70.8,14,26,40,27,20,12,12,1,103,0
21032,490332,552_16_50,FRANCE,0,TOTALS,FRANCE,200,27,70,38.6,19,40,47.5,8,30,26.7,17,19,89.5,17,26,43,19,17,12,7,0,79,1
21033,490345,552_16_50,BELGIUM,0,TOTALS,BELGIUM,200,26,60,43.3,21,43,48.8,5,17,29.4,13,18,72.2,8,27,35,14,16,14,9,0,70,0
21034,490358,552_16_51,ITALY,0,TOTALS,ITALY,200,32,65,49.2,19,35,54.3,13,30,43.3,9,10,90.0,10,21,31,26,19,13,15,5,86,1
21035,490371,552_16_51,LATVIA,0,TOTALS,LATVIA,200,24,62,38.7,11,30,36.7,13,32,40.6,18,19,94.7,15,23,38,16,16,17,5,1,79,0
21036,490384,552_16_52,FINLAND,0,TOTALS,FINLAND,200,34,77,44.2,21,44,47.7,13,33,39.4,10,11,90.9,16,27,43,28,20,15,10,3,91,1
21037,490397,552_16_52,HUNGARY,0,TOTALS,HUNGARY,200,28,63,44.4,24,48,50.0,4,15,26.7,10,18,55.6,11,28,39,14,17,22,5,4,70,0
21038,490410,552_16_53,SERBIA,0,TOTALS,SERBIA,200,36,65,55.4,30,48,62.5,6,17,35.3,10,15,66.7,7,33,40,19,19,18,10,5,88,1
21039,490423,552_16_53,ISRAEL,0,TOTALS,ISRAEL,200,23,68,33.8,20,47,42.6,3,21,14.3,11,17,64.7,14,21,35,14,19,19,11,2,60,0
21040,490436,552_16_54,SLOVENIA,0,TOTALS,SLOVENIA,200,32,66,48.5,26,43,60.5,6,23,26.1,12,16,75.0,13,30,43,18,22,13,5,0,82,1
21041,490449,552_16_54,SWEDEN,0,TOTALS,SWEDEN,200,24,64,37.5,14,29,48.3,10,35,28.6,19,26,73.1,11,21,32,14,19,12,8,4,77,0
21042,490462,552_16_55,TURKEY,0,TOTALS,TURKEY,200,31,64,48.4,22,41,53.7,9,23,39.1,5,11,45.5,14,19,33,17,14,11,12,3,76,1
21043,490475,552_16_55,GERMANY,0,TOTALS,GERMANY,200,25,54,46.3,18,37,48.6,7,17,41.2,4,5,80.0,10,22,32,13,19,21,3,3,61,0
21044,490488,552_16_56,LITHUANIA,0,TOTALS,LITHUANIA,200,20,64,31.2,10,31,32.3,10,33,30.3,5,5,100.0,12,31,43,11,21,16,1,1,55,0
21045,490501,552_16_56,SPAIN,0,TOTALS,SPAIN,200,25,69,36.2,21,57,36.8,4,12,33.3,14,18,77.8,14,31,45,11,15,6,11,4,68,1
21046,490514,553_16_01,ALBANIA,0,TOTALS,ALBANIA,200,17,57,29.8,17,44,38.6,0,13,0.0,10,21,47.6,10,31,41,8,25,25,10,1,44,0
21047,490527,553_16_01,GREAT BRITAIN,0,TOTALS,GREAT BRITAIN,200,21,61,34.4,18,37,48.6,3,24,12.5,17,28,60.7,13,33,46,14,19,17,11,3,62,1
21048,490540,553_16_02,MONTENEGRO,0,TOTALS,MONTENEGRO,200,30,63,47.6,24,44,54.5,6,19,31.6,12,24,50.0,13,24,37,16,18,16,16,6,78,1
21049,490553,553_16_02,GEORGIA,0,TOTALS,GEORGIA,200,21,62,33.9,14,39,35.9,7,23,30.4,6,11,54.5,18,19,37,10,24,26,6,4,55,0
21050,490566,553_16_03,NETHERLANDS,0,TOTALS,NETHERLANDS,200,25,63,39.7,22,50,44.0,3,13,23.1,16,27,59.3,19,23,42,16,10,15,14,3,69,1
21051,490579,553_16_03,KOSOVO,0,TOTALS,KOSOVO,200,16,48,33.3,13,29,44.8,3,19,15.8,5,8,62.5,7,23,30,8,26,27,8,1,40,0
21052,490590,553_16_04,ARMENIA,0,TOTALS,ARMENIA,200,21,66,31.8,16,33,48.5,5,33,15.2,9,16,56.2,10,32,42,9,18,18,9,3,56,0
21053,490603,553_16_04,MKD,0,TOTALS,MKD,200,22,61,36.1,14,33,42.4,8,28,28.6,15,20,75.0,7,37,44,14,21,14,13,1,67,1
21054,490616,553_16_05,CROATIA,0,TOTALS,CROATIA,200,39,72,54.2,30,48,62.5,9,24,37.5,13,16,81.2,13,24,37,23,23,8,13,1,100,0
21055,490629,553_16_05,ROMANIA,0,TOTALS,ROMANIA,200,24,61,39.3,17,36,47.2,7,25,28.0,12,22,54.5,16,21,37,14,19,23,4,3,67,1
21056,490642,553_16_06,RUSSIA,0,TOTALS,RUSSIA,200,22,64,34.4,19,47,40.4,3,17,17.6,14,20,70.0,16,29,45,10,17,22,13,8,61,1
21057,490655,553_16_06,ESTONIA,0,TOTALS,ESTONIA,200,19,62,30.6,16,43,37.2,3,19,15.8,8,17,47.1,14,30,44,10,23,23,13,7,49,0
21058,490668,553_16_07,IRELAND,0,TOTALS,IRELAND,200,18,56,32.1,13,34,38.2,5,22,22.7,6,12,50.0,8,21,29,11,15,20,7,0,47,0
21059,490681,553_16_07,GREECE,0,TOTALS,GREECE,200,36,64,56.2,25,38,65.8,11,26,42.3,10,10,100.0,7,33,40,26,18,13,6,5,93,1
21060,490694,553_16_08,BELARUS,0,TOTALS,BELARUS,200,24,55,43.6,18,37,48.6,6,18,33.3,19,22,86.4,7,36,43,16,18,23,6,4,73,1
21061,490707,553_16_08,ICELAND,0,TOTALS,ICELAND,200,27,85,31.8,21,49,42.9,6,36,16.7,10,16,62.5,20,26,46,11,25,11,16,0,70,0
21062,490720,553_16_09,SLOVAK REPUBLIC,0,TOTALS,SLOVAK REPUBLIC,200,26,75,34.7,18,46,39.1,8,29,27.6,13,16,81.2,21,23,44,18,23,19,9,1,73,0
21063,490733,553_16_09,BULGARIA,0,TOTALS,BULGARIA,200,28,65,43.1,21,47,44.7,7,18,38.9,20,30,66.7,15,29,44,15,18,15,15,0,83,1
21064,490746,553_16_10,PORTUGAL,0,TOTALS,PORTUGAL,200,20,65,30.8,11,36,30.6,9,29,31.0,21,26,80.8,8,27,35,13,14,10,15,1,70,1
21065,490757,553_16_10,ARMENIA,0,TOTALS,ARMENIA,200,22,59,37.3,16,45,35.6,6,14,42.9,4,9,44.4,11,40,51,9,27,31,5,1,54,0
21066,490770,553_16_11,MKD,0,TOTALS,MKD,200,17,59,28.8,13,35,37.1,4,24,16.7,6,10,60.0,12,19,31,7,27,15,6,2,44,0
21067,490783,553_16_11,MONTENEGRO,0,TOTALS,MONTENEGRO,200,22,56,39.3,21,44,47.7,1,12,8.3,22,35,62.9,18,30,48,12,18,11,8,8,67,1
21068,490796,553_16_12,GREAT BRITAIN,0,TOTALS,GREAT BRITAIN,200,20,58,34.5,15,31,48.4,5,27,18.5,21,37,56.8,12,40,52,11,14,19,12,4,66,1
21069,490809,553_16_12,IRELAND,0,TOTALS,IRELAND,200,20,70,28.6,16,46,34.8,4,24,16.7,12,20,60.0,15,30,45,10,23,18,9,1,56,0
21070,490822,553_16_13,POLAND,0,TOTALS,POLAND,200,26,61,42.6,21,40,52.5,5,21,23.8,23,29,79.3,10,31,41,17,25,27,16,2,80,1
21071,490835,553_16_13,BELARUS,0,TOTALS,BELARUS,200,18,55,32.7,15,40,37.5,3,15,20.0,12,21,57.1,9,24,33,9,20,29,14,4,51,0
21072,490848,553_16_14,KOSOVO,0,TOTALS,KOSOVO,200,25,61,41.0,22,42,52.4,3,19,15.8,9,16,56.2,11,34,45,11,17,17,8,1,62,1
21073,490861,553_16_14,ALBANIA,0,TOTALS,ALBANIA,200,20,63,31.7,17,45,37.8,3,18,16.7,12,21,57.1,13,28,41,12,18,15,9,1,55,0
21074,490874,553_16_15,GREECE,0,TOTALS,GREECE,200,27,66,40.9,22,41,53.7,5,25,20.0,9,13,69.2,14,27,41,19,14,11,13,2,68,1
21075,490887,553_16_15,NETHERLANDS,0,TOTALS,NETHERLANDS,200,14,50,28.0,10,31,32.3,4,19,21.1,4,7,57.1,10,24,34,5,15,22,6,3,36,0
21076,490900,553_16_16,BOSNIA AND HERZEGOVINA,0,TOTALS,BOSNIA AND HERZEGOVINA,200,42,80,52.5,39,64,60.9,3,16,18.8,10,17,58.8,21,43,64,18,19,19,10,7,97,1
21077,490913,553_16_16,SLOVAK REPUBLIC,0,TOTALS,SLOVAK REPUBLIC,200,16,69,23.2,9,36,25.0,7,33,21.2,12,20,60.0,10,18,28,9,22,19,10,2,51,0
21078,490926,553_16_17,ICELAND,0,TOTALS,ICELAND,200,28,84,33.3,22,49,44.9,6,35,17.1,9,16,56.2,28,28,56,11,20,16,10,3,71,1
21079,490939,553_16_17,RUSSIA,0,TOTALS,RUSSIA,200,23,60,38.3,13,32,40.6,10,28,35.7,9,14,64.3,10,26,36,10,21,18,8,4,65,0
21080,490952,553_16_18,BULGARIA,0,TOTALS,BULGARIA,200,19,62,30.6,12,34,35.3,7,28,25.0,2,8,25.0,6,22,28,11,22,20,10,2,47,0
21081,490965,553_16_18,CROATIA,0,TOTALS,CROATIA,200,34,64,53.1,30,46,65.2,4,18,22.2,9,22,40.9,11,36,47,18,18,19,10,2,81,1
21082,490978,553_16_19,KOSOVO,0,TOTALS,KOSOVO,200,23,59,39.0,17,38,44.7,6,21,28.6,6,8,75.0,7,29,36,8,17,18,6,1,58,0
21083,490991,553_16_19,GREAT BRITAIN,0,TOTALS,GREAT BRITAIN,200,28,71,39.4,21,43,48.8,7,28,25.0,9,13,69.2,13,29,42,18,9,12,11,1,72,1
21084,491004,553_16_20,GEORGIA,0,TOTALS,GEORGIA,200,34,57,59.6,26,39,66.7,8,18,44.4,9,20,45.0,12,25,37,23,21,19,9,6,85,1
21085,491017,553_16_20,MKD,0,TOTALS,MKD,200,22,58,37.9,14,36,38.9,8,22,36.4,9,17,52.9,13,14,27,9,24,19,11,3,61,0
21086,491030,553_16_21,NETHERLANDS,0,TOTALS,NETHERLANDS,225,17,62,27.4,13,46,28.3,4,16,25.0,20,33,60.6,20,34,54,4,27,24,6,4,58,0
21087,491043,553_16_21,IRELAND,0,TOTALS,IRELAND,225,20,68,29.4,13,39,33.3,7,29,24.1,17,24,70.8,17,30,47,10,25,17,15,3,64,1
21088,491056,553_16_22,MONTENEGRO,0,TOTALS,MONTENEGRO,200,26,63,41.3,24,51,47.1,2,12,16.7,12,26,46.2,22,34,56,13,13,17,8,6,66,1
21089,491069,553_16_22,PORTUGAL,0,TOTALS,PORTUGAL,200,14,58,24.1,10,30,33.3,4,28,14.3,4,10,40.0,9,21,30,6,22,17,9,1,36,0
21090,491082,553_16_23,ROMANIA,0,TOTALS,ROMANIA,200,29,66,43.9,23,50,46.0,6,16,37.5,12,23,52.2,17,32,49,15,22,19,10,6,76,1
21091,491095,553_16_23,BULGARIA,0,TOTALS,BULGARIA,200,17,57,29.8,14,39,35.9,3,18,16.7,12,17,70.6,9,21,30,11,21,19,10,3,49,0
21092,491108,553_16_24,ESTONIA,0,TOTALS,ESTONIA,200,23,61,37.7,15,33,45.5,8,28,28.6,18,33,54.5,18,37,55,20,31,21,7,3,72,0
21093,491121,553_16_24,ICELAND,0,TOTALS,ICELAND,200,25,67,37.3,16,36,44.4,9,31,29.0,16,31,51.6,10,23,33,14,26,10,15,3,75,1
21094,491134,553_16_25,ALBANIA,0,TOTALS,ALBANIA,200,14,58,24.1,8,43,18.6,6,15,40.0,1,4,25.0,8,17,25,7,25,24,6,1,35,0
21095,491147,553_16_25,GREECE,0,TOTALS,GREECE,200,32,62,51.6,21,38,55.3,11,24,45.8,22,30,73.3,13,36,49,23,13,14,17,9,97,1
21096,491160,553_16_26,RUSSIA,0,TOTALS,RUSSIA,200,19,54,35.2,11,34,32.4,8,20,40.0,14,22,63.6,6,28,34,13,24,23,11,6,60,0
21097,491173,553_16_26,POLAND,0,TOTALS,POLAND,200,23,64,35.9,17,45,37.8,6,19,31.6,18,28,64.3,13,31,44,14,20,17,10,9,70,1
21098,491186,553_16_27,CROATIA,0,TOTALS,CROATIA,200,23,61,37.7,13,32,40.6,10,29,34.5,14,24,58.3,10,26,36,18,26,20,12,2,70,1
21099,491199,553_16_27,BOSNIA AND HERZEGOVINA,0,TOTALS,BOSNIA AND HERZEGOVINA,200,20,60,33.3,13,39,33.3,7,21,33.3,19,26,73.1,15,32,47,11,25,26,7,3,66,0
21100,491210,553_16_28,ARMENIA,0,TOTALS,ARMENIA,200,17,71,23.9,13,51,25.5,4,20,20.0,6,9,66.7,13,28,41,11,18,13,6,7,44,0
21101,491223,553_16_28,MONTENEGRO,0,TOTALS,MONTENEGRO,200,29,75,38.7,21,49,42.9,8,26,30.8,12,16,75.0,18,41,59,16,11,10,6,2,78,1
21102,491236,553_16_29,PORTUGAL,0,TOTALS,PORTUGAL,200,18,63,28.6,13,40,32.5,5,23,21.7,14,24,58.3,11,12,23,11,22,14,10,2,55,0
21103,491249,553_16_29,GEORGIA,0,TOTALS,GEORGIA,200,25,48,52.1,14,27,51.9,11,21,52.4,21,29,72.4,11,37,48,18,24,31,7,4,82,1
21104,491262,553_16_30,IRELAND,0,TOTALS,IRELAND,200,22,58,37.9,15,37,40.5,7,21,33.3,16,25,64.0,11,26,37,17,19,23,16,3,67,1
21105,491275,553_16_30,ALBANIA,0,TOTALS,ALBANIA,200,16,54,29.6,12,34,35.3,4,20,20.0,11,22,50.0,16,25,41,8,25,27,14,2,47,0
21106,491288,553_16_31,BELARUS,0,TOTALS,BELARUS,200,21,56,37.5,18,44,40.9,3,12,25.0,13,18,72.2,11,28,39,17,18,28,9,7,58,0
21107,491301,553_16_31,RUSSIA,0,TOTALS,RUSSIA,200,31,73,42.5,23,47,48.9,8,26,30.8,14,21,66.7,14,24,38,13,20,17,19,1,84,1
21108,491314,553_16_32,GREAT BRITAIN,0,TOTALS,GREAT BRITAIN,200,16,61,26.2,10,39,25.6,6,22,27.3,10,17,58.8,14,31,45,13,17,10,4,5,48,1
21109,491327,553_16_32,NETHERLANDS,0,TOTALS,NETHERLANDS,200,15,62,24.2,12,44,27.3,3,18,16.7,7,10,70.0,16,32,48,9,16,17,3,1,40,0
21110,491340,553_16_33,GREECE,0,TOTALS,GREECE,200,43,74,58.1,34,49,69.4,9,25,36.0,8,14,57.1,16,30,46,30,13,13,21,4,103,0
21111,491353,553_16_33,KOSOVO,0,TOTALS,KOSOVO,200,17,54,31.5,10,24,41.7,7,30,23.3,3,5,60.0,6,18,24,6,16,29,9,0,44,1
21112,491366,553_16_34,SLOVAK REPUBLIC,0,TOTALS,SLOVAK REPUBLIC,200,22,74,29.7,16,44,36.4,6,30,20.0,4,11,36.4,17,27,44,10,29,23,8,5,54,0
21113,491379,553_16_34,CROATIA,0,TOTALS,CROATIA,200,33,80,41.2,28,56,50.0,5,24,20.8,21,31,67.7,23,36,59,23,17,16,12,5,92,1
21114,491392,553_16_35,POLAND,0,TOTALS,POLAND,200,19,58,32.8,17,38,44.7,2,20,10.0,20,29,69.0,16,33,49,10,22,32,14,5,60,1
21115,491405,553_16_35,ESTONIA,0,TOTALS,ESTONIA,200,16,63,25.4,11,39,28.2,5,24,20.8,11,18,61.1,12,22,34,10,29,27,20,1,48,0
21116,491418,553_16_36,BOSNIA AND HERZEGOVINA,0,TOTALS,BOSNIA AND HERZEGOVINA,200,28,69,40.6,24,50,48.0,4,19,21.1,13,21,61.9,15,31,46,16,14,14,11,8,73,1
21117,491431,553_16_36,ROMANIA,0,TOTALS,ROMANIA,200,20,61,32.8,11,34,32.4,9,27,33.3,9,16,56.2,12,25,37,13,23,22,8,0,58,0
21118,491444,553_16_37,ALBANIA,0,TOTALS,ALBANIA,200,20,51,39.2,17,40,42.5,3,11,27.3,11,14,78.6,5,18,23,14,17,18,8,2,54,0
21119,491457,553_16_37,NETHERLANDS,0,TOTALS,NETHERLANDS,200,24,49,49.0,20,35,57.1,4,14,28.6,13,17,76.5,7,25,32,13,14,19,8,3,65,1
21120,491470,553_16_38,MKD,0,TOTALS,MKD,200,18,51,35.3,14,31,45.2,4,20,20.0,14,18,77.8,11,22,33,8,21,18,10,4,54,0
21121,491483,553_16_38,PORTUGAL,0,TOTALS,PORTUGAL,200,22,58,37.9,18,42,42.9,4,16,25.0,15,20,75.0,13,23,36,18,16,18,10,2,63,1
21122,491496,553_16_39,KOSOVO,0,TOTALS,KOSOVO,200,19,61,31.1,14,40,35.0,5,21,23.8,9,15,60.0,8,26,34,9,21,16,11,1,52,0
21123,491509,553_16_39,IRELAND,0,TOTALS,IRELAND,200,24,62,38.7,17,38,44.7,7,24,29.2,12,19,63.2,14,37,51,14,14,23,11,2,67,1
21124,491522,553_16_40,GEORGIA,0,TOTALS,GEORGIA,200,26,68,38.2,17,37,45.9,9,31,29.0,1,3,33.3,8,35,43,14,16,17,5,3,62,0
21125,491533,553_16_40,ARMENIA,0,TOTALS,ARMENIA,200,25,70,35.7,19,55,34.5,6,15,40.0,9,17,52.9,15,35,50,13,8,17,5,3,65,1
21126,491546,553_16_41,BULGARIA,0,TOTALS,BULGARIA,200,25,59,42.4,21,37,56.8,4,22,18.2,4,4,100.0,5,24,29,16,20,21,12,1,58,0
21127,491559,553_16_41,BOSNIA AND HERZEGOVINA,0,TOTALS,BOSNIA AND HERZEGOVINA,200,28,66,42.4,22,45,48.9,6,21,28.6,12,19,63.2,16,27,43,22,13,20,10,3,74,1
21128,491572,553_16_42,ICELAND,0,TOTALS,ICELAND,200,20,71,28.2,12,29,41.4,8,42,19.0,14,17,82.4,21,27,48,15,17,15,6,2,62,1
21129,491585,553_16_42,POLAND,0,TOTALS,POLAND,200,23,59,39.0,19,31,61.3,4,28,14.3,10,18,55.6,12,29,41,18,18,16,11,3,60,0
21130,491598,553_16_43,GREECE,0,TOTALS,GREECE,200,33,62,53.2,25,42,59.5,8,20,40.0,8,9,88.9,7,29,36,23,14,11,11,6,82,1
21131,491611,553_16_43,GREAT BRITAIN,0,TOTALS,GREAT BRITAIN,200,22,69,31.9,12,39,30.8,10,30,33.3,7,13,53.8,21,23,44,11,12,17,6,6,61,0
21132,491624,553_16_44,ESTONIA,0,TOTALS,ESTONIA,200,28,69,40.6,23,45,51.1,5,24,20.8,9,17,52.9,15,24,39,14,16,20,11,3,70,0
21133,491637,553_16_44,BELARUS,0,TOTALS,BELARUS,200,26,60,43.3,19,44,43.2,7,16,43.8,13,15,86.7,8,30,38,18,20,24,11,2,72,1
21134,491650,553_16_45,ROMANIA,0,TOTALS,ROMANIA,200,28,63,44.4,25,43,58.1,3,20,15.0,12,17,70.6,12,28,40,11,21,19,10,4,71,0
21135,491663,553_16_45,SLOVAK REPUBLIC,0,TOTALS,SLOVAK REPUBLIC,200,25,64,39.1,13,31,41.9,12,33,36.4,13,18,72.2,11,24,35,15,21,15,14,2,75,1
21136,491674,553_16_46,ARMENIA,0,TOTALS,ARMENIA,200,27,66,40.9,22,48,45.8,5,18,27.8,15,17,88.2,9,31,40,10,13,12,4,1,74,1
21137,491687,553_16_46,ESTONIA,0,TOTALS,ESTONIA,200,28,77,36.4,24,50,48.0,4,27,14.8,8,11,72.7,16,32,48,15,22,10,6,1,68,0
21138,491700,553_16_47,ALBANIA,0,TOTALS,ALBANIA,200,20,62,32.3,17,49,34.7,3,13,23.1,13,15,86.7,9,22,31,12,23,19,14,4,56,0
21139,491713,553_16_47,BULGARIA,0,TOTALS,BULGARIA,200,27,64,42.2,17,36,47.2,10,28,35.7,12,22,54.5,20,32,52,21,17,25,9,3,76,1
21140,491726,553_16_48,MONTENEGRO,0,TOTALS,MONTENEGRO,200,25,53,47.2,21,36,58.3,4,17,23.5,9,23,39.1,11,29,40,15,20,16,5,7,63,1
21141,491739,553_16_48,POLAND,0,TOTALS,POLAND,200,17,59,28.8,10,39,25.6,7,20,35.0,10,16,62.5,13,24,37,12,21,17,7,1,51,0
21142,491752,553_16_49,PORTUGAL,0,TOTALS,PORTUGAL,200,29,69,42.0,20,46,43.5,9,23,39.1,8,14,57.1,12,15,27,18,15,14,17,2,75,1
21143,491765,553_16_49,BELARUS,0,TOTALS,BELARUS,200,28,56,50.0,23,43,53.5,5,13,38.5,13,14,92.9,13,27,40,16,19,23,7,2,74,0
21144,491778,553_16_50,CROATIA,0,TOTALS,CROATIA,200,27,68,39.7,20,41,48.8,7,27,25.9,8,11,72.7,13,36,49,14,21,20,12,1,69,1
21145,491791,553_16_50,GREAT BRITAIN,0,TOTALS,GREAT BRITAIN,200,18,64,28.1,16,44,36.4,2,20,10.0,15,18,83.3,12,28,40,6,16,17,10,2,53,0
21146,491804,553_16_51,ROMANIA,0,TOTALS,ROMANIA,200,27,55,49.1,22,38,57.9,5,17,29.4,12,19,63.2,11,30,41,17,15,20,9,3,71,1
21147,491817,553_16_51,NETHERLANDS,0,TOTALS,NETHERLANDS,207,22,59,37.3,18,41,43.9,4,18,22.2,6,18,33.3,11,19,30,16,19,15,11,1,54,0
21148,491830,553_16_52,GREECE,0,TOTALS,GREECE,200,28,70,40.0,19,35,54.3,9,35,25.7,12,22,54.5,16,19,35,18,19,8,14,4,77,1
21149,491843,553_16_52,BOSNIA AND HERZEGOVINA,0,TOTALS,BOSNIA AND HERZEGOVINA,200,21,54,38.9,19,40,47.5,2,14,14.3,7,15,46.7,14,28,42,9,21,23,3,2,51,0
21150,491856,553_16_53,RUSSIA,0,TOTALS,RUSSIA,200,36,69,52.2,24,44,54.5,12,25,48.0,8,11,72.7,10,26,36,20,18,9,11,8,92,1
21151,491869,553_16_53,MKD,0,TOTALS,MKD,208,20,60,33.3,16,42,38.1,4,18,22.2,15,23,65.2,14,23,37,14,15,19,6,1,59,0
21152,491882,553_16_54,ICELAND,0,TOTALS,ICELAND,200,35,79,44.3,22,44,50.0,13,35,37.1,11,18,61.1,16,32,48,15,15,5,14,4,94,1
21153,491895,553_16_54,GEORGIA,0,TOTALS,GEORGIA,200,22,63,34.9,16,38,42.1,6,25,24.0,4,8,50.0,10,31,41,13,16,19,1,1,54,0
21154,491908,553_16_55,IRELAND,0,TOTALS,IRELAND,200,28,68,41.2,26,49,53.1,2,19,10.5,19,27,70.4,12,30,42,16,22,12,13,2,77,1
21155,491921,553_16_55,SLOVAK REPUBLIC,0,TOTALS,SLOVAK REPUBLIC,200,24,61,39.3,18,38,47.4,6,23,26.1,16,24,66.7,9,31,40,18,23,20,8,2,70,0
21156,491934,553_16_56,BULGARIA,0,TOTALS,BULGARIA,200,29,63,46.0,23,34,67.6,6,29,20.7,14,21,66.7,18,32,50,14,13,20,11,4,78,1
21157,491947,553_16_56,KOSOVO,0,TOTALS,KOSOVO,200,22,65,33.8,16,37,43.2,6,28,21.4,4,7,57.1,11,19,30,10,19,17,10,0,54,0
21158,491960,553_16_57,PORTUGAL,0,TOTALS,PORTUGAL,200,22,75,29.3,16,47,34.0,6,28,21.4,6,10,60.0,16,20,36,13,21,12,18,1,56,0
21159,491973,553_16_57,ROMANIA,0,TOTALS,ROMANIA,200,16,49,32.7,12,30,40.0,4,19,21.1,26,29,89.7,13,38,51,11,17,27,9,5,62,1
21160,491986,553_16_58,BELARUS,0,TOTALS,BELARUS,200,33,67,49.3,27,50,54.0,6,17,35.3,4,5,80.0,9,34,43,24,17,10,8,4,76,1
21161,491999,553_16_58,NETHERLANDS,0,TOTALS,NETHERLANDS,200,15,58,25.9,13,42,31.0,2,16,12.5,11,16,68.8,8,24,32,7,11,18,6,3,43,0
21162,492012,553_16_59,RUSSIA,0,TOTALS,RUSSIA,200,35,65,53.8,29,44,65.9,6,21,28.6,14,25,56.0,11,39,50,11,18,18,16,7,90,1
21163,492025,553_16_59,IRELAND,0,TOTALS,IRELAND,200,11,54,20.4,9,35,25.7,2,19,10.5,11,18,61.1,8,24,32,3,23,28,5,2,35,0
21164,492038,553_16_60,MKD,0,TOTALS,MKD,200,36,69,52.2,27,43,62.8,9,26,34.6,11,15,73.3,14,27,41,21,20,15,8,3,92,1
21165,492051,553_16_60,SLOVAK REPUBLIC,0,TOTALS,SLOVAK REPUBLIC,200,27,63,42.9,19,33,57.6,8,30,26.7,13,23,56.5,12,20,32,16,19,15,10,4,75,0
21166,492064,553_16_61,MONTENEGRO,0,TOTALS,MONTENEGRO,200,29,59,49.2,18,30,60.0,11,29,37.9,21,30,70.0,8,24,32,17,21,9,7,4,90,1
21167,492077,553_16_61,CROATIA,0,TOTALS,CROATIA,200,28,65,43.1,21,43,48.8,7,22,31.8,11,13,84.6,14,23,37,8,24,11,4,0,74,0
21168,492090,553_16_62,POLAND,0,TOTALS,POLAND,200,30,63,47.6,23,42,54.8,7,21,33.3,11,17,64.7,11,28,39,21,18,18,8,5,78,1
21169,492103,553_16_62,GREAT BRITAIN,0,TOTALS,GREAT BRITAIN,200,27,69,39.1,19,46,41.3,8,23,34.8,12,18,66.7,15,23,38,16,15,15,12,2,74,0
21170,492116,553_16_63,ICELAND,0,TOTALS,ICELAND,200,28,69,40.6,19,39,48.7,9,30,30.0,5,7,71.4,8,35,43,11,18,14,6,5,70,1
21171,492129,553_16_63,GREECE,0,TOTALS,GREECE,200,26,69,37.7,16,45,35.6,10,24,41.7,5,11,45.5,12,32,44,17,15,15,5,4,67,0
21172,492142,553_16_64,GEORGIA,0,TOTALS,GEORGIA,200,19,67,28.4,14,43,32.6,5,24,20.8,6,11,54.5,12,19,31,10,21,14,9,2,49,0
21173,492155,553_16_64,BOSNIA AND HERZEGOVINA,0,TOTALS,BOSNIA AND HERZEGOVINA,200,33,59,55.9,28,45,62.2,5,14,35.7,18,31,58.1,12,37,49,20,11,16,7,3,89,1
21174,492168,553_16_65,KOSOVO,0,TOTALS,KOSOVO,200,26,65,40.0,17,37,45.9,9,28,32.1,8,16,50.0,13,25,38,16,26,22,8,0,69,0
21175,492181,553_16_65,ESTONIA,0,TOTALS,ESTONIA,200,30,64,46.9,25,47,53.2,5,17,29.4,28,39,71.8,14,29,43,25,15,12,13,6,93,1
21176,492194,553_16_66,BULGARIA,0,TOTALS,BULGARIA,200,25,70,35.7,17,34,50.0,8,36,22.2,3,4,75.0,9,30,39,14,18,16,10,1,61,0
21177,492205,553_16_66,ARMENIA,0,TOTALS,ARMENIA,200,26,66,39.4,23,47,48.9,3,19,15.8,10,21,47.6,13,33,46,16,10,20,8,1,65,1
21178,492218,553_16_67,BELARUS,0,TOTALS,BELARUS,200,36,71,50.7,33,55,60.0,3,16,18.8,10,16,62.5,12,41,53,30,13,15,12,2,85,1
21179,492231,553_16_67,MKD,0,TOTALS,MKD,200,14,66,21.2,13,44,29.5,1,22,4.5,4,9,44.4,13,25,38,5,18,22,5,0,33,0
21180,492244,553_16_68,NETHERLANDS,0,TOTALS,NETHERLANDS,200,29,63,46.0,27,52,51.9,2,11,18.2,16,24,66.7,18,34,52,17,12,17,10,2,76,1
21181,492257,553_16_68,SLOVAK REPUBLIC,0,TOTALS,SLOVAK REPUBLIC,200,18,60,30.0,9,33,27.3,9,27,33.3,1,4,25.0,9,18,27,15,18,22,5,2,46,0
21182,492270,553_16_69,PORTUGAL,0,TOTALS,PORTUGAL,200,26,67,38.8,19,42,45.2,7,25,28.0,5,7,71.4,14,30,44,17,10,15,15,0,64,1
21183,492283,553_16_69,IRELAND,0,TOTALS,IRELAND,200,15,48,31.2,14,35,40.0,1,13,7.7,7,13,53.8,5,26,31,10,12,24,9,3,38,0
21184,492296,553_16_70,GREAT BRITAIN,0,TOTALS,GREAT BRITAIN,200,28,68,41.2,25,45,55.6,3,23,13.0,18,29,62.1,17,33,50,14,13,11,16,3,77,1
21185,492309,553_16_70,GEORGIA,0,TOTALS,GEORGIA,200,16,57,28.1,14,38,36.8,2,19,10.5,7,16,43.8,11,29,40,9,21,22,5,4,41,0
21186,492322,553_16_71,ROMANIA,0,TOTALS,ROMANIA,200,28,63,44.4,24,48,50.0,4,15,26.7,12,18,66.7,21,20,41,13,19,20,7,1,72,0
21187,492335,553_16_71,RUSSIA,0,TOTALS,RUSSIA,200,29,67,43.3,22,40,55.0,7,27,25.9,13,22,59.1,18,17,35,19,19,14,17,6,78,1
21188,492348,553_16_72,POLAND,0,TOTALS,POLAND,200,24,75,32.0,16,42,38.1,8,33,24.2,7,10,70.0,13,24,37,20,24,22,10,2,63,0
21189,492361,553_16_72,BOSNIA AND HERZEGOVINA,0,TOTALS,BOSNIA AND HERZEGOVINA,200,35,64,54.7,31,46,67.4,4,18,22.2,20,29,69.0,11,37,48,25,11,20,12,1,94,1
21190,492374,553_16_73,CROATIA,0,TOTALS,CROATIA,200,24,64,37.5,18,45,40.0,6,19,31.6,13,15,86.7,10,33,43,12,23,17,9,1,67,0
21191,492387,553_16_73,GREECE,0,TOTALS,GREECE,200,22,60,36.7,12,31,38.7,10,29,34.5,19,26,73.1,8,29,37,10,20,15,10,2,73,1
21192,492400,553_16_74,MONTENEGRO,0,TOTALS,MONTENEGRO,225,31,73,42.5,27,48,56.2,4,25,16.0,12,18,66.7,14,41,55,14,20,21,12,6,78,1
21193,492413,553_16_74,ICELAND,0,TOTALS,ICELAND,225,26,77,33.8,16,42,38.1,10,35,28.6,14,18,77.8,12,31,43,11,18,16,9,4,76,0
21194,494918,556_16_01,SPAIN,0,TOTALS,SPAIN,200,25,74,33.8,18,40,45.0,7,34,20.6,17,23,73.9,19,27,46,17,21,13,6,0,74,1
21195,494931,556_16_01,CROATIA,0,TOTALS,CROATIA,200,26,63,41.3,25,51,49.0,1,12,8.3,9,17,52.9,15,29,44,18,26,15,6,3,62,0
21196,494943,556_16_02,BOSNIA AND HERZEGOVINA,0,TOTALS,BOSNIA AND HERZEGOVINA,225,34,65,52.3,28,43,65.1,6,22,27.3,29,39,74.4,16,40,56,21,26,32,8,6,103,1
21197,494956,556_16_02,ISRAEL,0,TOTALS,ISRAEL,225,36,93,38.7,25,59,42.4,11,34,32.4,19,31,61.3,24,20,44,24,31,16,16,3,102,0
21198,494969,556_16_03,ITALY,0,TOTALS,ITALY,200,28,68,41.2,20,41,48.8,8,27,29.6,11,17,64.7,14,30,44,21,15,16,14,4,75,1
21199,494982,556_16_03,SWEDEN,0,TOTALS,SWEDEN,200,18,56,32.1,11,32,34.4,7,24,29.2,13,15,86.7,7,29,36,14,17,24,11,4,56,0
21200,494995,556_16_04,LATVIA,0,TOTALS,LATVIA,200,21,63,33.3,20,38,52.6,1,25,4.0,7,12,58.3,12,32,44,4,21,17,6,1,50,0
21201,495008,556_16_04,LITHUANIA,0,TOTALS,LITHUANIA,200,21,63,33.3,16,35,45.7,5,28,17.9,15,22,68.2,12,32,44,11,14,15,7,5,62,1
21202,495021,556_16_05,TURKEY,0,TOTALS,TURKEY,200,25,58,43.1,20,44,45.5,5,14,35.7,27,33,81.8,10,24,34,16,26,23,14,2,82,1
21203,495034,556_16_05,GREECE,0,TOTALS,GREECE,200,25,62,40.3,21,45,46.7,4,17,23.5,24,31,77.4,13,24,37,16,26,27,16,4,78,0
21204,495047,556_16_06,FRANCE,0,TOTALS,FRANCE,200,17,55,30.9,14,34,41.2,3,21,14.3,16,25,64.0,12,44,56,11,20,24,8,6,53,1
21205,495060,556_16_06,RUSSIA,0,TOTALS,RUSSIA,200,20,70,28.6,15,38,39.5,5,32,15.6,3,10,30.0,9,31,40,12,21,12,10,2,48,0
21206,495073,556_16_07,GERMANY,0,TOTALS,GERMANY,200,36,62,58.1,25,38,65.8,11,24,45.8,9,13,69.2,7,30,37,20,15,19,8,7,92,1
21207,495086,556_16_07,FINLAND,0,TOTALS,FINLAND,200,27,71,38.0,25,56,44.6,2,15,13.3,7,14,50.0,14,20,34,10,19,17,7,0,63,0
21208,495099,556_16_08,SERBIA,0,TOTALS,SERBIA,200,25,69,36.2,18,42,42.9,7,27,25.9,11,15,73.3,17,29,46,12,10,16,8,5,68,1
21209,495112,556_16_08,SLOVENIA,0,TOTALS,SLOVENIA,200,25,60,41.7,20,39,51.3,5,21,23.8,5,7,71.4,5,29,34,11,16,15,9,2,60,0
21210,495125,556_16_09,SWEDEN,0,TOTALS,SWEDEN,200,17,61,27.9,14,40,35.0,3,21,14.3,11,14,78.6,10,32,42,6,20,20,6,2,48,0
21211,495138,556_16_09,SPAIN,0,TOTALS,SPAIN,200,21,62,33.9,18,38,47.4,3,24,12.5,13,18,72.2,11,33,44,10,15,16,10,2,58,1
21212,495151,556_16_10,LITHUANIA,0,TOTALS,LITHUANIA,200,25,61,41.0,22,38,57.9,3,23,13.0,17,27,63.0,12,26,38,16,28,19,9,5,70,0
21213,495163,556_16_10,BOSNIA AND HERZEGOVINA,0,TOTALS,BOSNIA AND HERZEGOVINA,200,26,71,36.6,22,54,40.7,4,17,23.5,23,38,60.5,24,26,50,9,23,18,8,0,79,1
21214,495176,556_16_11,ISRAEL,0,TOTALS,ISRAEL,200,24,76,31.6,16,45,35.6,8,31,25.8,14,22,63.6,22,26,48,12,23,11,13,3,70,0
21215,495189,556_16_11,LATVIA,0,TOTALS,LATVIA,200,24,55,43.6,15,27,55.6,9,28,32.1,14,21,66.7,8,32,40,17,17,20,6,4,71,1
21216,495202,556_16_12,SLOVENIA,0,TOTALS,SLOVENIA,200,19,54,35.2,13,33,39.4,6,21,28.6,6,9,66.7,8,19,27,16,19,25,9,0,50,0
21217,495215,556_16_12,FRANCE,0,TOTALS,FRANCE,200,30,58,51.7,22,35,62.9,8,23,34.8,13,17,76.5,10,29,39,26,16,17,15,3,81,1
21218,495228,556_16_13,FINLAND,0,TOTALS,FINLAND,200,27,63,42.9,22,39,56.4,5,24,20.8,6,11,54.5,8,37,45,16,21,19,10,4,65,1
21219,495241,556_16_13,TURKEY,0,TOTALS,TURKEY,200,20,66,30.3,15,44,34.1,5,22,22.7,8,21,38.1,16,30,46,12,21,18,8,2,53,0
21220,495254,556_16_14,RUSSIA,0,TOTALS,RUSSIA,200,27,70,38.6,20,34,58.8,7,36,19.4,9,13,69.2,20,36,56,14,15,17,9,5,70,1
21221,495267,556_16_14,SERBIA,0,TOTALS,SERBIA,200,15,66,22.7,12,43,27.9,3,23,13.0,10,16,62.5,17,25,42,8,17,13,9,3,43,0
21222,495280,556_16_15,CROATIA,0,TOTALS,CROATIA,200,23,60,38.3,18,36,50.0,5,24,20.8,27,33,81.8,17,28,45,11,20,23,8,4,78,0
21223,495293,556_16_15,ITALY,0,TOTALS,ITALY,200,30,70,42.9,20,48,41.7,10,22,45.5,14,17,82.4,11,20,31,23,26,14,13,2,84,1
21224,495306,556_16_16,GREECE,0,TOTALS,GREECE,200,23,63,36.5,13,33,39.4,10,30,33.3,14,22,63.6,12,22,34,17,18,17,13,1,70,0
21225,495319,556_16_16,GERMANY,0,TOTALS,GERMANY,200,31,67,46.3,18,31,58.1,13,36,36.1,10,12,83.3,13,32,45,22,22,20,12,3,85,1
21226,495332,556_16_17,ISRAEL,0,TOTALS,ISRAEL,225,32,97,33.0,23,52,44.2,9,45,20.0,15,18,83.3,28,27,55,11,30,12,13,5,88,0
21227,495345,556_16_17,LITHUANIA,0,TOTALS,LITHUANIA,232,30,75,40.0,18,33,54.5,12,42,28.6,22,34,64.7,24,38,62,21,22,21,8,5,94,1
21228,495358,556_16_18,SLOVENIA,0,TOTALS,SLOVENIA,200,20,68,29.4,18,50,36.0,2,18,11.1,7,8,87.5,14,29,43,7,19,17,5,3,49,0
21229,495371,556_16_18,RUSSIA,0,TOTALS,RUSSIA,200,30,64,46.9,20,36,55.6,10,28,35.7,11,20,55.0,9,34,43,17,15,11,8,4,81,1
21230,495384,556_16_19,SWEDEN,0,TOTALS,SWEDEN,200,30,63,47.6,21,40,52.5,9,23,39.1,8,11,72.7,11,20,31,17,18,23,12,2,77,0
21231,495397,556_16_19,CROATIA,0,TOTALS,CROATIA,200,30,58,51.7,23,42,54.8,7,16,43.8,11,16,68.8,9,21,30,18,15,24,10,4,78,1
21232,495410,556_16_20,FRANCE,0,TOTALS,FRANCE,200,26,57,45.6,20,41,48.8,6,16,37.5,13,18,72.2,9,20,29,15,18,16,12,7,71,1
21233,495423,556_16_20,SERBIA,0,TOTALS,SERBIA,200,28,67,41.8,22,47,46.8,6,20,30.0,6,16,37.5,25,23,48,10,20,21,10,3,68,0
21234,495436,556_16_21,TURKEY,0,TOTALS,TURKEY,200,24,68,35.3,18,46,39.1,6,22,27.3,16,26,61.5,19,25,44,18,20,14,10,2,70,0
21235,495449,556_16_21,GERMANY,0,TOTALS,GERMANY,200,28,66,42.4,18,36,50.0,10,30,33.3,14,16,87.5,12,28,40,21,24,15,8,5,80,1
21236,495462,556_16_22,FINLAND,0,TOTALS,FINLAND,200,21,60,35.0,16,41,39.0,5,19,26.3,24,32,75.0,14,33,47,9,28,22,6,1,71,0
21237,495475,556_16_22,GREECE,0,TOTALS,GREECE,200,24,61,39.3,20,43,46.5,4,18,22.2,21,29,72.4,7,26,33,12,25,14,9,4,73,1
21238,495488,556_16_23,SPAIN,0,TOTALS,SPAIN,200,23,67,34.3,16,39,41.0,7,28,25.0,9,19,47.4,12,26,38,15,23,17,7,3,62,0
21239,495501,556_16_23,ITALY,0,TOTALS,ITALY,200,29,59,49.2,25,45,55.6,4,14,28.6,6,18,33.3,10,33,43,12,21,20,8,3,68,1
21240,495514,556_16_24,LATVIA,0,TOTALS,LATVIA,200,28,65,43.1,16,32,50.0,12,33,36.4,6,14,42.9,13,25,38,14,24,8,2,4,74,1
21241,495526,556_16_24,BOSNIA AND HERZEGOVINA,0,TOTALS,BOSNIA AND HERZEGOVINA,200,23,67,34.3,17,44,38.6,6,23,26.1,13,22,59.1,17,30,47,8,20,12,4,2,65,0
21242,495539,556_16_25,LATVIA,0,TOTALS,LATVIA,200,19,56,33.9,11,32,34.4,8,24,33.3,24,35,68.6,13,27,40,7,19,17,7,3,70,0
21243,495552,556_16_25,SLOVENIA,0,TOTALS,SLOVENIA,200,33,71,46.5,29,53,54.7,4,18,22.2,16,21,76.2,14,30,44,11,24,13,11,2,86,1
21244,495565,556_16_26,GERMANY,0,TOTALS,GERMANY,200,24,59,40.7,18,41,43.9,6,18,33.3,24,33,72.7,20,32,52,12,18,24,7,1,78,1
21245,495578,556_16_26,SPAIN,0,TOTALS,SPAIN,200,25,63,39.7,11,26,42.3,14,37,37.8,10,16,62.5,8,16,24,19,27,20,12,1,74,0
21246,495591,556_16_27,GREECE,0,TOTALS,GREECE,200,30,64,46.9,24,45,53.3,6,19,31.6,14,21,66.7,15,25,40,19,21,14,8,2,80,1
21247,495604,556_16_27,SWEDEN,0,TOTALS,SWEDEN,200,24,54,44.4,14,35,40.0,10,19,52.6,11,18,61.1,9,23,32,14,23,16,6,2,69,0
21248,495617,556_16_28,LITHUANIA,0,TOTALS,LITHUANIA,200,32,69,46.4,22,39,56.4,10,30,33.3,8,16,50.0,16,29,45,17,18,17,8,3,82,1
21249,495630,556_16_28,RUSSIA,0,TOTALS,RUSSIA,200,28,70,40.0,18,42,42.9,10,28,35.7,15,19,78.9,11,26,37,11,16,11,8,0,81,0
21250,495643,556_16_29,CROATIA,0,TOTALS,CROATIA,200,23,69,33.3,15,45,33.3,8,24,33.3,15,19,78.9,14,34,48,19,26,20,9,2,69,0
21251,495656,556_16_29,TURKEY,0,TOTALS,TURKEY,200,28,78,35.9,26,58,44.8,2,20,10.0,13,22,59.1,21,31,52,11,20,18,11,4,71,1
21252,495669,556_16_30,ITALY,0,TOTALS,ITALY,200,20,60,33.3,19,44,43.2,1,16,6.2,20,23,87.0,14,31,45,16,18,18,8,3,61,1
21253,495682,556_16_30,FINLAND,0,TOTALS,FINLAND,200,19,62,30.6,11,39,28.2,8,23,34.8,10,16,62.5,14,27,41,9,24,20,5,5,56,0
21254,495695,556_16_31,SERBIA,0,TOTALS,SERBIA,200,25,57,43.9,19,32,59.4,6,25,24.0,13,24,54.2,12,35,47,15,17,21,10,3,69,1
21255,495708,556_16_31,ISRAEL,0,TOTALS,ISRAEL,200,24,66,36.4,17,40,42.5,7,26,26.9,8,16,50.0,11,24,35,15,24,16,13,3,63,0
21256,495721,556_16_32,FRANCE,0,TOTALS,FRANCE,200,28,75,37.3,21,51,41.2,7,24,29.2,12,16,75.0,22,26,48,19,26,12,6,7,75,1
21257,495733,556_16_32,BOSNIA AND HERZEGOVINA,0,TOTALS,BOSNIA AND HERZEGOVINA,200,22,57,38.6,20,41,48.8,2,16,12.5,15,23,65.2,11,27,38,18,16,14,8,1,61,0
21258,495746,556_16_33,SWEDEN,0,TOTALS,SWEDEN,200,32,74,43.2,25,50,50.0,7,24,29.2,11,19,57.9,16,16,32,10,22,8,9,2,82,0
21259,495759,556_16_33,LATVIA,0,TOTALS,LATVIA,200,32,64,50.0,24,44,54.5,8,20,40.0,19,24,79.2,18,25,43,23,22,14,3,3,91,1
21260,495772,556_16_34,SPAIN,0,TOTALS,SPAIN,200,26,70,37.1,20,49,40.8,6,21,28.6,12,15,80.0,18,40,58,20,17,17,5,3,70,1
21261,495785,556_16_34,RUSSIA,0,TOTALS,RUSSIA,200,21,72,29.2,15,42,35.7,6,30,20.0,7,13,53.8,14,26,40,13,21,10,11,1,55,0
21262,495798,556_16_35,CROATIA,0,TOTALS,CROATIA,200,31,63,49.2,21,35,60.0,10,28,35.7,15,20,75.0,17,29,46,22,18,18,4,1,87,1
21263,495811,556_16_35,ISRAEL,0,TOTALS,ISRAEL,200,31,71,43.7,19,41,46.3,12,30,40.0,10,12,83.3,11,18,29,16,22,8,9,1,84,0
21264,495824,556_16_36,FINLAND,0,TOTALS,FINLAND,200,30,76,39.5,21,46,45.7,9,30,30.0,3,5,60.0,18,19,37,17,23,22,8,1,72,0
21265,495836,556_16_36,BOSNIA AND HERZEGOVINA,0,TOTALS,BOSNIA AND HERZEGOVINA,200,35,62,56.5,32,48,66.7,3,14,21.4,22,33,66.7,11,26,37,22,10,15,11,4,95,1
21266,495849,556_16_37,TURKEY,0,TOTALS,TURKEY,200,19,55,34.5,17,40,42.5,2,15,13.3,18,24,75.0,17,25,42,11,15,16,6,4,58,0
21267,495862,556_16_37,SERBIA,0,TOTALS,SERBIA,200,28,69,40.6,20,44,45.5,8,25,32.0,9,9,100.0,16,23,39,14,19,13,9,2,73,1
21268,495875,556_16_38,GERMANY,0,TOTALS,GERMANY,200,25,76,32.9,21,43,48.8,4,33,12.1,8,12,66.7,15,32,47,15,21,12,6,5,62,0
21269,495888,556_16_38,LITHUANIA,0,TOTALS,LITHUANIA,200,22,65,33.8,13,34,38.2,9,31,29.0,16,21,76.2,13,37,50,15,20,13,8,1,69,1
21270,495901,556_16_39,GREECE,0,TOTALS,GREECE,200,28,67,41.8,23,51,45.1,5,16,31.2,9,14,64.3,13,25,38,16,15,14,9,2,70,1
21271,495914,556_16_39,SLOVENIA,0,TOTALS,SLOVENIA,200,28,61,45.9,22,41,53.7,6,20,30.0,6,9,66.7,10,29,39,16,15,20,6,1,68,0
21272,495927,556_16_40,ITALY,0,TOTALS,ITALY,200,30,56,53.6,23,37,62.2,7,19,36.8,5,7,71.4,3,20,23,20,18,18,10,1,72,0
21273,495940,556_16_40,FRANCE,0,TOTALS,FRANCE,200,28,56,50.0,20,38,52.6,8,18,44.4,18,23,78.3,8,23,31,18,14,17,12,1,82,1
21274,495953,556_16_41,SWEDEN,0,TOTALS,SWEDEN,200,23,57,40.4,17,33,51.5,6,24,25.0,14,16,87.5,7,24,31,12,14,17,8,2,66,0
21275,495966,556_16_41,ISRAEL,0,TOTALS,ISRAEL,200,36,74,48.6,26,45,57.8,10,29,34.5,8,12,66.7,17,27,44,17,15,16,10,2,90,1
21276,495979,556_16_42,LATVIA,0,TOTALS,LATVIA,200,29,61,47.5,14,30,46.7,15,31,48.4,17,23,73.9,11,28,39,24,17,10,6,4,90,1
21277,495992,556_16_42,CROATIA,0,TOTALS,CROATIA,200,28,69,40.6,16,44,36.4,12,25,48.0,8,11,72.7,15,25,40,19,23,13,3,2,76,0
21278,496005,556_16_43,RUSSIA,0,TOTALS,RUSSIA,200,33,75,44.0,24,46,52.2,9,29,31.0,7,14,50.0,12,29,41,21,13,11,12,4,82,1
21279,496018,556_16_43,FINLAND,0,TOTALS,FINLAND,200,26,67,38.8,19,48,39.6,7,19,36.8,8,12,66.7,14,32,46,18,13,23,5,2,67,0
21280,496031,556_16_44,SPAIN,0,TOTALS,SPAIN,200,31,72,43.1,26,49,53.1,5,23,21.7,10,15,66.7,15,23,38,22,20,15,14,2,77,1
21281,496043,556_16_44,BOSNIA AND HERZEGOVINA,0,TOTALS,BOSNIA AND HERZEGOVINA,200,26,60,43.3,23,40,57.5,3,20,15.0,10,16,62.5,12,27,39,15,17,24,6,2,65,0
21282,496056,556_16_45,SLOVENIA,0,TOTALS,SLOVENIA,200,24,60,40.0,17,37,45.9,7,23,30.4,16,18,88.9,9,33,42,17,20,17,7,1,71,1
21283,496069,556_16_45,TURKEY,0,TOTALS,TURKEY,200,22,68,32.4,15,42,35.7,7,26,26.9,12,17,70.6,16,28,44,17,23,18,9,0,63,0
21284,496082,556_16_46,GREECE,0,TOTALS,GREECE,200,27,61,44.3,16,36,44.4,11,25,44.0,9,15,60.0,11,26,37,19,14,17,11,3,74,1
21285,496095,556_16_46,SERBIA,0,TOTALS,SERBIA,200,28,57,49.1,21,37,56.8,7,20,35.0,4,14,28.6,8,26,34,13,16,19,4,2,67,0
21286,496108,556_16_47,GERMANY,0,TOTALS,GERMANY,200,22,60,36.7,18,36,50.0,4,24,16.7,20,25,80.0,8,33,41,18,18,23,9,5,68,0
21287,496121,556_16_47,ITALY,0,TOTALS,ITALY,200,28,70,40.0,20,43,46.5,8,27,29.6,10,16,62.5,10,33,43,19,24,18,11,0,74,1
21288,496134,556_16_48,LITHUANIA,0,TOTALS,LITHUANIA,200,24,73,32.9,14,35,40.0,10,38,26.3,10,18,55.6,18,23,41,16,18,13,13,3,68,0
21289,496147,556_16_48,FRANCE,0,TOTALS,FRANCE,200,27,58,46.6,17,36,47.2,10,22,45.5,11,15,73.3,10,33,43,9,15,23,6,2,75,1
21290,496160,557_16_01,AUSTRIA,0,TOTALS,AUSTRIA,200,25,53,47.2,16,31,51.6,9,22,40.9,8,11,72.7,11,22,33,9,20,30,7,1,67,0
21291,496173,557_16_01,ROMANIA,0,TOTALS,ROMANIA,200,33,66,50.0,28,56,50.0,5,10,50.0,8,13,61.5,13,17,30,10,18,18,17,1,79,1
21292,496186,557_16_02,NETHERLANDS,0,TOTALS,NETHERLANDS,200,27,79,34.2,21,53,39.6,6,26,23.1,5,10,50.0,25,36,61,11,28,20,9,5,65,0
21293,496199,557_16_02,ESTONIA,0,TOTALS,ESTONIA,200,28,75,37.3,21,47,44.7,7,28,25.0,8,19,42.1,18,29,47,13,15,14,13,2,71,1
21294,496212,557_16_03,MONTENEGRO,0,TOTALS,MONTENEGRO,200,24,48,50.0,20,39,51.3,4,9,44.4,19,28,67.9,11,31,42,13,21,19,7,8,71,1
21295,496225,557_16_03,BELGIUM,0,TOTALS,BELGIUM,200,22,65,33.8,16,40,40.0,6,25,24.0,9,13,69.2,11,18,29,10,22,12,10,1,59,0
21296,496238,557_16_04,DENMARK,0,TOTALS,DENMARK,200,24,62,38.7,21,39,53.8,3,23,13.0,2,7,28.6,12,27,39,18,28,21,10,3,53,0
21297,496251,557_16_04,CZECH REPUBLIC,0,TOTALS,CZECH REPUBLIC,200,19,66,28.8,14,44,31.8,5,22,22.7,23,37,62.2,25,27,52,8,13,16,15,5,66,1
21298,496264,557_16_05,POLAND,0,TOTALS,POLAND,200,23,53,43.4,14,32,43.8,9,21,42.9,17,26,65.4,9,20,29,13,16,17,7,4,72,0
21299,496277,557_16_05,HUNGARY,0,TOTALS,HUNGARY,200,29,58,50.0,21,37,56.8,8,21,38.1,10,17,58.8,7,23,30,17,24,16,10,1,76,1
21300,496290,557_16_06,BELARUS,0,TOTALS,BELARUS,200,25,68,36.8,22,53,41.5,3,15,20.0,13,24,54.2,19,31,50,17,17,19,12,7,66,1
21301,496303,557_16_06,PORTUGAL,0,TOTALS,PORTUGAL,200,19,64,29.7,16,51,31.4,3,13,23.1,13,18,72.2,14,26,40,8,22,22,8,7,54,0
21302,496316,557_16_07,ICELAND,0,TOTALS,ICELAND,200,35,73,47.9,24,46,52.2,11,27,40.7,16,21,76.2,17,34,51,18,16,23,16,3,97,1
21303,496329,557_16_07,LUXEMBOURG,0,TOTALS,LUXEMBOURG,200,19,60,31.7,17,44,38.6,2,16,12.5,10,18,55.6,7,21,28,9,18,23,6,3,50,0
21304,496342,557_16_08,MKD,0,TOTALS,MKD,200,28,74,37.8,23,49,46.9,5,25,20.0,8,14,57.1,13,23,36,10,15,14,7,4,69,0
21305,496355,557_16_08,BULGARIA,0,TOTALS,BULGARIA,200,38,71,53.5,34,59,57.6,4,12,33.3,8,10,80.0,11,36,47,17,17,14,6,8,88,1
21306,496368,557_16_09,UKRAINE,0,TOTALS,UKRAINE,200,29,62,46.8,22,44,50.0,7,18,38.9,9,26,34.6,11,31,42,10,24,16,11,3,74,1
21307,496381,557_16_09,ENGLAND,0,TOTALS,ENGLAND,200,21,63,33.3,14,43,32.6,7,20,35.0,16,29,55.2,14,29,43,9,24,20,8,2,65,0
21308,496394,557_16_10,CYPRUS,0,TOTALS,CYPRUS,200,25,70,35.7,17,46,37.0,8,24,33.3,9,13,69.2,16,46,62,11,17,29,10,6,67,1
21309,496407,557_16_10,IRELAND,0,TOTALS,IRELAND,200,23,82,28.0,16,52,30.8,7,30,23.3,8,16,50.0,18,30,48,12,14,16,14,6,61,0
21310,496420,557_16_11,GEORGIA,0,TOTALS,GEORGIA,200,35,71,49.3,30,43,69.8,5,28,17.9,19,33,57.6,16,37,53,18,16,20,12,6,94,1
21311,496433,557_16_11,ALBANIA,0,TOTALS,ALBANIA,200,14,65,21.5,12,39,30.8,2,26,7.7,9,18,50.0,16,28,44,10,30,28,12,3,39,0
21312,496446,557_16_12,SLOVAK REPUBLIC,0,TOTALS,SLOVAK REPUBLIC,200,30,58,51.7,25,35,71.4,5,23,21.7,9,14,64.3,14,29,43,11,14,22,14,3,74,1
21313,496459,557_16_12,SCOTLAND,0,TOTALS,SCOTLAND,200,19,52,36.5,8,18,44.4,11,34,32.4,7,9,77.8,6,16,22,10,16,23,8,0,56,0
21314,496472,557_16_13,BELGIUM,0,TOTALS,BELGIUM,200,27,78,34.6,21,52,40.4,6,26,23.1,15,18,83.3,15,32,47,16,21,10,18,3,75,1
21315,496485,557_16_13,BELARUS,0,TOTALS,BELARUS,200,21,65,32.3,19,42,45.2,2,23,8.7,13,25,52.0,19,35,54,12,19,23,6,5,57,0
21316,496498,557_16_14,CZECH REPUBLIC,0,TOTALS,CZECH REPUBLIC,225,20,72,27.8,11,36,30.6,9,36,25.0,12,18,66.7,16,44,60,10,17,20,11,8,61,1
21317,496511,557_16_14,ICELAND,0,TOTALS,ICELAND,225,21,77,27.3,13,42,31.0,8,35,22.9,9,12,75.0,12,36,48,14,18,16,10,5,59,0
21318,496524,557_16_15,BULGARIA,0,TOTALS,BULGARIA,200,26,68,38.2,23,51,45.1,3,17,17.6,14,20,70.0,14,27,41,10,21,17,12,4,69,0
21319,496537,557_16_15,POLAND,0,TOTALS,POLAND,200,27,59,45.8,22,44,50.0,5,15,33.3,15,23,65.2,8,32,40,9,20,20,12,3,74,1
21320,496550,557_16_16,PORTUGAL,0,TOTALS,PORTUGAL,225,22,66,33.3,20,49,40.8,2,17,11.8,27,31,87.1,13,21,34,3,14,14,9,4,73,0
21321,496563,557_16_16,AUSTRIA,0,TOTALS,AUSTRIA,225,27,65,41.5,13,37,35.1,14,28,50.0,6,11,54.5,17,28,45,13,26,26,4,5,74,1
21322,496576,557_16_17,HUNGARY,0,TOTALS,HUNGARY,200,35,60,58.3,26,41,63.4,9,19,47.4,10,21,47.6,14,32,46,24,14,20,14,2,88,1
21323,496589,557_16_17,CYPRUS,0,TOTALS,CYPRUS,200,16,52,30.8,13,34,38.2,3,18,16.7,6,10,60.0,6,15,21,3,18,21,11,6,41,0
21324,496602,557_16_18,SCOTLAND,0,TOTALS,SCOTLAND,200,19,66,28.8,14,44,31.8,5,22,22.7,3,8,37.5,15,25,40,9,18,24,6,5,48,1
21325,496615,557_16_18,GEORGIA,0,TOTALS,GEORGIA,200,37,85,43.5,27,50,54.0,10,35,28.6,17,23,73.9,30,37,67,27,16,14,12,5,101,0
21326,496628,557_16_19,ESTONIA,0,TOTALS,ESTONIA,200,20,66,30.3,11,34,32.4,9,32,28.1,15,21,71.4,15,24,39,10,18,16,10,2,64,0
21327,496641,557_16_19,DENMARK,0,TOTALS,DENMARK,200,27,61,44.3,23,47,48.9,4,14,28.6,9,16,56.2,12,33,45,16,24,21,5,4,67,1
21328,496654,557_16_20,ALBANIA,0,TOTALS,ALBANIA,200,19,53,35.8,14,35,40.0,5,18,27.8,7,12,58.3,11,29,40,10,20,32,9,0,50,0
21329,496667,557_16_20,UKRAINE,0,TOTALS,UKRAINE,200,28,74,37.8,21,49,42.9,7,25,28.0,20,28,71.4,21,29,50,15,19,20,17,6,83,1
21330,496680,557_16_21,IRELAND,0,TOTALS,IRELAND,200,28,76,36.8,20,42,47.6,8,34,23.5,18,27,66.7,11,29,40,15,26,11,11,1,82,0
21331,496693,557_16_21,MKD,0,TOTALS,MKD,200,32,71,45.1,22,43,51.2,10,28,35.7,22,28,78.6,12,40,52,21,20,19,4,5,96,1
21332,496706,557_16_22,ENGLAND,0,TOTALS,ENGLAND,200,16,55,29.1,10,29,34.5,6,26,23.1,10,19,52.6,9,32,41,8,17,17,7,2,48,0
21333,496719,557_16_22,SLOVAK REPUBLIC,0,TOTALS,SLOVAK REPUBLIC,200,23,65,35.4,17,35,48.6,6,30,20.0,7,13,53.8,12,33,45,11,20,15,7,2,59,1
21334,496732,557_16_23,ROMANIA,0,TOTALS,ROMANIA,200,26,65,40.0,20,45,44.4,6,20,30.0,6,8,75.0,11,20,31,11,23,21,4,3,64,1
21335,496745,557_16_23,MONTENEGRO,0,TOTALS,MONTENEGRO,200,34,66,51.5,25,39,64.1,9,27,33.3,24,30,80.0,12,26,38,20,13,14,15,2,101,0
21336,496758,557_16_24,LUXEMBOURG,0,TOTALS,LUXEMBOURG,200,23,54,42.6,20,42,47.6,3,12,25.0,18,27,66.7,9,17,26,14,16,23,8,0,67,0
21337,496771,557_16_24,NETHERLANDS,0,TOTALS,NETHERLANDS,200,31,67,46.3,26,42,61.9,5,25,20.0,13,17,76.5,20,27,47,19,29,25,12,2,80,1
21338,496784,557_16_25,CYPRUS,0,TOTALS,CYPRUS,200,16,54,29.6,11,37,29.7,5,17,29.4,5,7,71.4,6,28,34,9,21,21,8,5,42,0
21339,496797,557_16_25,POLAND,0,TOTALS,POLAND,200,23,59,39.0,14,32,43.8,9,27,33.3,15,21,71.4,10,33,43,16,16,17,10,7,70,1
21340,496810,557_16_26,ICELAND,0,TOTALS,ICELAND,200,27,72,37.5,22,44,50.0,5,28,17.9,14,29,48.3,17,25,42,12,16,13,15,0,73,1
21341,496823,557_16_26,DENMARK,0,TOTALS,DENMARK,200,24,57,42.1,17,33,51.5,7,24,29.2,13,20,65.0,8,37,45,15,23,22,7,5,68,0
21342,496836,557_16_27,IRELAND,0,TOTALS,IRELAND,200,29,77,37.7,23,61,37.7,6,16,37.5,3,10,30.0,10,23,33,18,19,25,15,2,67,1
21343,496849,557_16_27,BULGARIA,0,TOTALS,BULGARIA,200,42,71,59.2,26,38,68.4,16,33,48.5,13,18,72.2,6,41,47,20,16,26,16,8,113,0
21344,496862,557_16_28,AUSTRIA,0,TOTALS,AUSTRIA,200,17,63,27.0,14,44,31.8,3,19,15.8,8,10,80.0,17,17,34,9,17,17,9,1,45,0
21345,496875,557_16_28,BELGIUM,0,TOTALS,BELGIUM,200,37,64,57.8,32,47,68.1,5,17,29.4,12,19,63.2,11,29,40,16,14,12,12,3,91,1
21346,496888,557_16_29,PORTUGAL,0,TOTALS,PORTUGAL,200,20,60,33.3,17,43,39.5,3,17,17.6,19,28,67.9,19,25,44,5,14,16,15,2,62,1
21347,496901,557_16_29,ROMANIA,0,TOTALS,ROMANIA,200,18,57,31.6,13,39,33.3,5,18,27.8,4,12,33.3,15,23,38,4,27,22,6,1,45,0
21348,496914,557_16_30,LUXEMBOURG,0,TOTALS,LUXEMBOURG,200,17,63,27.0,15,53,28.3,2,10,20.0,17,24,70.8,12,31,43,8,20,22,7,5,53,0
21349,496927,557_16_30,ESTONIA,0,TOTALS,ESTONIA,200,29,75,38.7,25,47,53.2,4,28,14.3,14,16,87.5,13,35,48,15,22,17,11,4,76,1
21350,496940,557_16_31,NETHERLANDS,0,TOTALS,NETHERLANDS,200,23,65,35.4,17,39,43.6,6,26,23.1,10,19,52.6,22,22,44,8,27,23,8,1,62,0
21351,496953,557_16_31,CZECH REPUBLIC,0,TOTALS,CZECH REPUBLIC,200,26,56,46.4,18,26,69.2,8,30,26.7,23,30,76.7,12,23,35,16,22,14,11,3,83,1
21352,496966,557_16_32,MKD,0,TOTALS,MKD,200,25,68,36.8,20,43,46.5,5,25,20.0,1,5,20.0,11,34,45,16,17,24,9,5,56,0
21353,496979,557_16_32,HUNGARY,0,TOTALS,HUNGARY,200,32,74,43.2,26,53,49.1,6,21,28.6,8,15,53.3,14,33,47,17,16,16,12,6,78,1
21354,496992,557_16_33,SLOVAK REPUBLIC,0,TOTALS,SLOVAK REPUBLIC,200,24,82,29.3,17,43,39.5,7,39,17.9,6,9,66.7,24,28,52,12,25,16,11,0,61,0
21355,497005,557_16_33,UKRAINE,0,TOTALS,UKRAINE,200,30,69,43.5,24,50,48.0,6,19,31.6,12,25,48.0,17,32,49,12,13,16,9,5,78,1
21356,497018,557_16_34,BELARUS,0,TOTALS,BELARUS,200,24,60,40.0,20,38,52.6,4,22,18.2,4,8,50.0,11,26,37,12,23,29,5,3,56,0
21357,497031,557_16_34,MONTENEGRO,0,TOTALS,MONTENEGRO,200,31,68,45.6,22,44,50.0,9,24,37.5,24,28,85.7,10,26,36,16,16,12,13,3,95,1
21358,497044,557_16_35,SCOTLAND,0,TOTALS,SCOTLAND,200,30,74,40.5,21,43,48.8,9,31,29.0,14,25,56.0,18,30,48,15,20,20,6,1,83,1
21359,497057,557_16_35,ALBANIA,0,TOTALS,ALBANIA,200,22,64,34.4,15,37,40.5,7,27,25.9,14,20,70.0,14,27,41,12,25,18,8,3,65,0
21360,497070,557_16_36,GEORGIA,0,TOTALS,GEORGIA,200,26,77,33.8,15,43,34.9,11,34,32.4,13,20,65.0,11,39,50,11,20,20,16,7,76,1
21361,497083,557_16_36,ENGLAND,0,TOTALS,ENGLAND,200,27,75,36.0,23,53,43.4,4,22,18.2,12,18,66.7,13,43,56,9,20,28,13,6,70,0
21362,497096,557_16_37,HUNGARY,0,TOTALS,HUNGARY,200,33,66,50.0,27,46,58.7,6,20,30.0,22,38,57.9,19,38,57,22,18,20,10,4,94,1
21363,497109,557_16_37,IRELAND,0,TOTALS,IRELAND,200,18,65,27.7,13,37,35.1,5,28,17.9,14,20,70.0,11,19,30,8,24,18,9,1,55,0
21364,497122,557_16_38,CZECH REPUBLIC,0,TOTALS,CZECH REPUBLIC,200,29,64,45.3,26,46,56.5,3,18,16.7,12,18,66.7,21,36,57,14,11,21,16,1,73,1
21365,497135,557_16_38,LUXEMBOURG,0,TOTALS,LUXEMBOURG,200,16,60,26.7,16,50,32.0,0,10,0.0,1,1,100.0,8,18,26,5,18,21,10,3,33,0
21366,497148,557_16_39,MONTENEGRO,0,TOTALS,MONTENEGRO,200,28,68,41.2,20,45,44.4,8,23,34.8,23,31,74.2,16,28,44,16,16,12,17,3,87,1
21367,497161,557_16_39,AUSTRIA,0,TOTALS,AUSTRIA,200,18,56,32.1,12,32,37.5,6,24,25.0,3,8,37.5,11,28,39,8,22,27,6,3,45,0
21368,497174,557_16_40,ENGLAND,0,TOTALS,ENGLAND,200,41,71,57.7,37,54,68.5,4,17,23.5,9,14,64.3,12,33,45,18,19,9,15,5,95,1
21369,497187,557_16_40,SCOTLAND,0,TOTALS,SCOTLAND,200,18,57,31.6,12,35,34.3,6,22,27.3,9,18,50.0,9,17,26,10,14,21,4,1,51,0
21370,497200,557_16_41,ROMANIA,0,TOTALS,ROMANIA,200,26,67,38.8,20,46,43.5,6,21,28.6,11,21,52.4,11,30,41,14,18,25,8,2,69,0
21371,497213,557_16_41,BELARUS,0,TOTALS,BELARUS,200,33,69,47.8,30,49,61.2,3,20,15.0,8,16,50.0,9,32,41,20,21,22,13,4,77,1
21372,497226,557_16_42,ALBANIA,0,TOTALS,ALBANIA,200,16,47,34.0,14,35,40.0,2,12,16.7,11,23,47.8,11,22,33,7,19,32,11,2,45,0
21373,497239,557_16_42,SLOVAK REPUBLIC,0,TOTALS,SLOVAK REPUBLIC,200,36,70,51.4,28,47,59.6,8,23,34.8,13,24,54.2,17,27,44,20,22,20,19,3,93,1
21374,497252,557_16_43,BELGIUM,0,TOTALS,BELGIUM,200,22,65,33.8,18,42,42.9,4,23,17.4,5,13,38.5,12,30,42,9,19,14,6,2,53,0
21375,497265,557_16_43,PORTUGAL,0,TOTALS,PORTUGAL,200,22,59,37.3,21,49,42.9,1,10,10.0,11,19,57.9,9,31,40,10,18,15,6,3,56,1
21376,497278,557_16_44,POLAND,0,TOTALS,POLAND,200,37,67,55.2,26,42,61.9,11,25,44.0,19,24,79.2,14,30,44,23,23,18,15,3,104,0
21377,497291,557_16_44,MKD,0,TOTALS,MKD,200,22,57,38.6,17,34,50.0,5,23,21.7,17,25,68.0,6,19,25,8,28,23,11,1,66,1
21378,497304,557_16_45,DENMARK,0,TOTALS,DENMARK,200,20,49,40.8,15,32,46.9,5,17,29.4,14,27,51.9,13,27,40,15,18,31,15,2,59,1
21379,497317,557_16_45,NETHERLANDS,0,TOTALS,NETHERLANDS,200,20,63,31.7,14,31,45.2,6,32,18.8,7,17,41.2,16,17,33,11,22,27,16,6,53,0
21380,497330,557_16_46,BULGARIA,0,TOTALS,BULGARIA,200,31,73,42.5,25,49,51.0,6,24,25.0,14,21,66.7,17,27,44,13,10,13,15,1,82,1
21381,497343,557_16_46,CYPRUS,0,TOTALS,CYPRUS,200,26,61,42.6,16,40,40.0,10,21,47.6,5,9,55.6,10,27,37,8,18,22,6,1,67,0
21382,497356,557_16_47,ESTONIA,0,TOTALS,ESTONIA,200,29,64,45.3,22,43,51.2,7,21,33.3,21,30,70.0,12,41,53,10,25,16,7,12,86,1
21383,497369,557_16_47,ICELAND,0,TOTALS,ICELAND,200,22,77,28.6,12,44,27.3,10,33,30.3,12,24,50.0,19,27,46,12,30,13,10,2,66,0
21384,497382,557_16_48,UKRAINE,0,TOTALS,UKRAINE,200,24,63,38.1,20,45,44.4,4,18,22.2,19,23,82.6,8,28,36,13,19,14,12,1,71,0
21385,497395,557_16_48,GEORGIA,0,TOTALS,GEORGIA,200,26,65,40.0,20,38,52.6,6,27,22.2,14,24,58.3,13,32,45,13,22,18,7,5,72,1
21386,497408,557_16_49,PORTUGAL,0,TOTALS,PORTUGAL,200,15,61,24.6,12,47,25.5,3,14,21.4,12,16,75.0,15,25,40,4,20,22,6,3,45,0
21387,497421,557_16_49,MONTENEGRO,0,TOTALS,MONTENEGRO,200,29,62,46.8,21,41,51.2,8,21,38.1,14,23,60.9,13,34,47,16,19,16,15,5,80,1
21388,497434,557_16_50,ENGLAND,0,TOTALS,ENGLAND,200,29,56,51.8,22,43,51.2,7,13,53.8,18,28,64.3,8,34,42,8,13,18,14,6,83,1
21389,497447,557_16_50,ALBANIA,0,TOTALS,ALBANIA,200,17,62,27.4,11,43,25.6,6,19,31.6,2,2,100.0,7,21,28,8,23,25,4,1,42,0
21390,497460,557_16_51,BELGIUM,0,TOTALS,BELGIUM,200,32,70,45.7,24,46,52.2,8,24,33.3,12,19,63.2,15,31,46,19,17,15,15,5,84,1
21391,497473,557_16_51,ROMANIA,0,TOTALS,ROMANIA,200,17,53,32.1,13,39,33.3,4,14,28.6,7,18,38.9,9,28,37,8,17,26,7,3,45,0
21392,497486,557_16_52,LUXEMBOURG,0,TOTALS,LUXEMBOURG,200,24,65,36.9,22,56,39.3,2,9,22.2,2,6,33.3,11,18,29,14,21,21,11,1,52,0
21393,497499,557_16_52,DENMARK,0,TOTALS,DENMARK,200,30,63,47.6,24,43,55.8,6,20,30.0,17,26,65.4,15,31,46,14,15,16,10,9,83,1
21394,497512,557_16_53,HUNGARY,0,TOTALS,HUNGARY,200,27,55,49.1,23,41,56.1,4,14,28.6,13,19,68.4,10,24,34,15,22,25,13,5,71,1
21395,497525,557_16_53,BULGARIA,0,TOTALS,BULGARIA,200,26,57,45.6,24,44,54.5,2,13,15.4,16,22,72.7,9,21,30,7,17,19,12,3,70,0
21396,497538,557_16_54,NETHERLANDS,0,TOTALS,NETHERLANDS,200,27,79,34.2,19,58,32.8,8,21,38.1,4,7,57.1,17,32,49,18,23,21,9,2,66,0
21397,497551,557_16_54,ICELAND,0,TOTALS,ICELAND,200,24,64,37.5,14,34,41.2,10,30,33.3,19,23,82.6,8,34,42,15,9,19,8,3,77,1
21398,497564,557_16_55,SCOTLAND,0,TOTALS,SCOTLAND,200,25,70,35.7,18,45,40.0,7,25,28.0,8,14,57.1,12,25,37,15,11,22,9,1,65,0
21399,497577,557_16_55,UKRAINE,0,TOTALS,UKRAINE,200,37,68,54.4,27,44,61.4,10,24,41.7,8,11,72.7,7,32,39,19,18,18,9,4,92,1
21400,497590,557_16_56,MKD,0,TOTALS,MKD,200,33,72,45.8,26,45,57.8,7,27,25.9,9,14,64.3,11,37,48,17,17,17,11,4,82,1
21401,497603,557_16_56,CYPRUS,0,TOTALS,CYPRUS,200,19,68,27.9,13,44,29.5,6,24,25.0,10,17,58.8,13,27,40,7,21,20,9,0,54,0
21402,497616,557_16_57,GEORGIA,0,TOTALS,GEORGIA,200,19,58,32.8,15,34,44.1,4,24,16.7,6,12,50.0,13,30,43,8,24,23,5,5,48,0
21403,497629,557_16_57,SLOVAK REPUBLIC,0,TOTALS,SLOVAK REPUBLIC,200,23,71,32.4,16,53,30.2,7,18,38.9,15,26,57.7,20,27,47,11,19,13,14,3,68,1
21404,497642,557_16_58,IRELAND,0,TOTALS,IRELAND,200,32,75,42.7,27,55,49.1,5,20,25.0,10,17,58.8,9,27,36,11,23,17,12,3,79,0
21405,497655,557_16_58,POLAND,0,TOTALS,POLAND,200,30,62,48.4,25,46,54.3,5,16,31.2,23,37,62.2,12,37,49,15,18,24,12,4,88,1
21406,497668,557_16_59,AUSTRIA,0,TOTALS,AUSTRIA,200,25,62,40.3,17,32,53.1,8,30,26.7,9,12,75.0,14,21,35,11,18,25,10,4,67,0
21407,497681,557_16_59,BELARUS,0,TOTALS,BELARUS,200,33,67,49.3,26,49,53.1,7,18,38.9,10,13,76.9,11,21,32,16,17,20,18,0,83,1
21408,497694,557_16_60,CZECH REPUBLIC,0,TOTALS,CZECH REPUBLIC,200,24,65,36.9,19,41,46.3,5,24,20.8,5,7,71.4,13,22,35,12,19,13,11,0,58,0
21409,497707,557_16_60,ESTONIA,0,TOTALS,ESTONIA,200,24,53,45.3,16,32,50.0,8,21,38.1,9,12,75.0,8,26,34,18,15,16,6,1,65,1
21410,497720,557_16_61,BULGARIA,0,TOTALS,BULGARIA,200,32,59,54.2,24,37,64.9,8,22,36.4,20,28,71.4,9,28,37,14,26,21,13,6,92,1
21411,497733,557_16_61,PORTUGAL,0,TOTALS,PORTUGAL,200,23,57,40.4,21,50,42.0,2,7,28.6,19,28,67.9,10,24,34,11,21,23,12,1,67,0
21412,497746,557_16_62,CYPRUS,0,TOTALS,CYPRUS,200,21,60,35.0,20,43,46.5,1,17,5.9,6,9,66.7,10,36,46,5,19,25,4,4,49,0
21413,497759,557_16_62,AUSTRIA,0,TOTALS,AUSTRIA,200,24,65,36.9,18,45,40.0,6,20,30.0,10,17,58.8,9,26,35,8,14,10,17,3,64,1
21414,497772,557_16_63,HUNGARY,0,TOTALS,HUNGARY,200,23,47,48.9,14,25,56.0,9,22,40.9,13,22,59.1,6,26,32,11,19,27,9,6,68,1
21415,497785,557_16_63,BELGIUM,0,TOTALS,BELGIUM,200,25,60,41.7,20,42,47.6,5,18,27.8,8,12,66.7,9,21,30,12,22,23,17,0,63,0
21416,497798,557_16_64,SCOTLAND,0,TOTALS,SCOTLAND,200,23,68,33.8,16,41,39.0,7,27,25.9,8,14,57.1,13,25,38,12,18,21,10,4,61,0
21417,497811,557_16_64,LUXEMBOURG,0,TOTALS,LUXEMBOURG,200,26,67,38.8,24,53,45.3,2,14,14.3,11,18,61.1,18,29,47,13,16,18,12,2,65,1
21418,497824,557_16_65,UKRAINE,0,TOTALS,UKRAINE,200,25,62,40.3,18,41,43.9,7,21,33.3,10,21,47.6,14,29,43,13,17,20,13,0,67,1
21419,497837,557_16_65,CZECH REPUBLIC,0,TOTALS,CZECH REPUBLIC,200,24,71,33.8,15,33,45.5,9,38,23.7,5,9,55.6,14,25,39,14,22,19,9,4,62,0
21420,497850,557_16_66,GEORGIA,0,TOTALS,GEORGIA,200,25,69,36.2,19,51,37.3,6,18,33.3,7,16,43.8,17,33,50,14,21,27,18,10,63,1
21421,497863,557_16_66,DENMARK,0,TOTALS,DENMARK,200,21,80,26.2,18,65,27.7,3,15,20.0,15,22,68.2,21,30,51,13,21,26,18,4,60,0
21422,497876,557_16_67,ROMANIA,0,TOTALS,ROMANIA,200,34,61,55.7,27,42,64.3,7,19,36.8,12,21,57.1,12,33,45,20,17,25,6,4,87,1
21423,497889,557_16_67,IRELAND,0,TOTALS,IRELAND,200,31,69,44.9,22,39,56.4,9,30,30.0,10,19,52.6,8,20,28,15,19,15,15,0,81,0
21424,497902,557_16_68,ESTONIA,0,TOTALS,ESTONIA,200,23,67,34.3,14,33,42.4,9,34,26.5,12,15,80.0,20,24,44,11,21,20,7,5,67,0
21425,497915,557_16_68,SLOVAK REPUBLIC,0,TOTALS,SLOVAK REPUBLIC,200,23,63,36.5,17,45,37.8,6,18,33.3,19,22,86.4,17,23,40,15,16,20,14,2,71,1
21426,497928,557_16_69,BELARUS,0,TOTALS,BELARUS,200,35,81,43.2,31,65,47.7,4,16,25.0,9,17,52.9,24,30,54,16,22,18,9,6,83,1
21427,497941,557_16_69,MKD,0,TOTALS,MKD,200,29,71,40.8,19,39,48.7,10,32,31.2,14,21,66.7,12,24,36,16,15,17,10,4,82,0
21428,497954,557_16_70,MONTENEGRO,0,TOTALS,MONTENEGRO,200,28,63,44.4,20,37,54.1,8,26,30.8,11,15,73.3,8,27,35,16,25,15,11,4,75,1
21429,497967,557_16_70,POLAND,0,TOTALS,POLAND,200,20,53,37.7,14,35,40.0,6,18,33.3,7,15,46.7,7,27,34,11,22,21,5,3,53,0
21430,497980,557_16_71,ICELAND,0,TOTALS,ICELAND,200,24,67,35.8,17,40,42.5,7,27,25.9,9,13,69.2,7,26,33,9,20,16,8,2,64,0
21431,497993,557_16_71,ENGLAND,0,TOTALS,ENGLAND,200,28,77,36.4,25,56,44.6,3,21,14.3,11,25,44.0,23,33,56,10,17,19,8,6,70,1
21432,498006,557_16_72,NETHERLANDS,0,TOTALS,NETHERLANDS,200,34,71,47.9,25,47,53.2,9,24,37.5,15,24,62.5,20,33,53,18,22,16,14,1,92,1
21433,498019,557_16_72,ALBANIA,0,TOTALS,ALBANIA,200,18,54,33.3,13,36,36.1,5,18,27.8,9,14,64.3,5,20,25,9,22,21,10,3,50,0
21434,498032,557_16_73,BULGARIA,0,TOTALS,BULGARIA,225,41,86,47.7,37,67,55.2,4,19,21.1,15,23,65.2,8,35,43,19,19,24,13,6,101,0
21435,498045,557_16_73,GEORGIA,0,TOTALS,GEORGIA,225,40,88,45.5,32,68,47.1,8,20,40.0,15,24,62.5,16,38,54,26,22,24,15,10,103,1
21436,498058,557_16_74,CYPRUS,0,TOTALS,CYPRUS,200,21,67,31.3,16,42,38.1,5,25,20.0,5,8,62.5,15,21,36,11,17,19,12,5,52,0
21437,498071,557_16_74,SCOTLAND,0,TOTALS,SCOTLAND,200,25,54,46.3,18,35,51.4,7,19,36.8,9,10,90.0,8,31,39,16,13,26,9,1,66,1
21438,498084,557_16_75,BELGIUM,0,TOTALS,BELGIUM,200,29,66,43.9,18,41,43.9,11,25,44.0,5,10,50.0,10,31,41,18,16,13,11,3,74,1
21439,498097,557_16_75,CZECH REPUBLIC,0,TOTALS,CZECH REPUBLIC,200,20,65,30.8,15,51,29.4,5,14,35.7,13,18,72.2,15,29,44,10,14,17,5,3,58,0
21440,498110,557_16_76,AUSTRIA,0,TOTALS,AUSTRIA,200,28,65,43.1,21,42,50.0,7,23,30.4,18,25,72.0,14,28,42,13,17,18,10,8,81,1
21441,498123,557_16_76,LUXEMBOURG,0,TOTALS,LUXEMBOURG,200,29,65,44.6,26,56,46.4,3,9,33.3,11,19,57.9,10,26,36,16,24,16,11,3,72,0
21442,498136,557_16_77,POLAND,0,TOTALS,POLAND,200,31,67,46.3,20,45,44.4,11,22,50.0,13,15,86.7,12,27,39,15,17,19,10,4,86,1
21443,498149,557_16_77,ESTONIA,0,TOTALS,ESTONIA,200,23,55,41.8,19,43,44.2,4,12,33.3,10,13,76.9,6,23,29,10,22,23,7,5,60,0
21444,498162,557_16_78,PORTUGAL,0,TOTALS,PORTUGAL,200,26,70,37.1,20,50,40.0,6,20,30.0,7,8,87.5,19,28,47,16,9,21,14,3,65,1
21445,498175,557_16_78,DENMARK,0,TOTALS,DENMARK,200,20,51,39.2,19,37,51.4,1,14,7.1,5,11,45.5,6,23,29,9,19,24,7,9,46,0
21446,498188,557_16_79,IRELAND,0,TOTALS,IRELAND,200,24,71,33.8,21,47,44.7,3,24,12.5,17,29,58.6,14,27,41,10,23,10,10,4,68,0
21447,498201,557_16_79,ALBANIA,0,TOTALS,ALBANIA,200,28,61,45.9,26,47,55.3,2,14,14.3,11,21,52.4,8,37,45,10,25,24,6,2,69,1
21448,498214,557_16_80,HUNGARY,0,TOTALS,HUNGARY,200,22,61,36.1,18,35,51.4,4,26,15.4,10,16,62.5,8,28,36,14,19,18,12,2,58,0
21449,498227,557_16_80,UKRAINE,0,TOTALS,UKRAINE,200,27,70,38.6,17,43,39.5,10,27,37.0,14,19,73.7,16,31,47,14,19,18,8,4,78,1
21450,498240,557_16_81,MKD,0,TOTALS,MKD,200,31,76,40.8,19,39,48.7,12,37,32.4,10,20,50.0,13,26,39,16,20,13,6,4,84,0
21451,498253,557_16_81,ICELAND,0,TOTALS,ICELAND,200,32,72,44.4,22,40,55.0,10,32,31.2,20,28,71.4,16,34,50,13,19,17,9,0,94,1
21452,498266,557_16_82,MONTENEGRO,0,TOTALS,MONTENEGRO,200,24,58,41.4,15,34,44.1,9,24,37.5,30,38,78.9,8,31,39,14,22,12,8,2,87,1
21453,498279,557_16_82,SLOVAK REPUBLIC,0,TOTALS,SLOVAK REPUBLIC,200,26,63,41.3,18,37,48.6,8,26,30.8,12,22,54.5,9,28,37,10,28,15,6,0,72,0
21454,498292,557_16_83,BELARUS,0,TOTALS,BELARUS,200,23,58,39.7,13,31,41.9,10,27,37.0,8,13,61.5,11,23,34,10,17,25,2,4,64,0
21455,498305,557_16_83,ENGLAND,0,TOTALS,ENGLAND,200,34,68,50.0,30,58,51.7,4,10,40.0,9,17,52.9,12,23,35,13,14,16,17,6,81,1
21456,498318,557_16_84,ROMANIA,0,TOTALS,ROMANIA,200,20,54,37.0,13,31,41.9,7,23,30.4,10,20,50.0,9,31,40,8,22,18,2,1,57,0
21457,498331,557_16_84,NETHERLANDS,0,TOTALS,NETHERLANDS,200,22,64,34.4,16,37,43.2,6,27,22.2,19,31,61.3,15,27,42,13,23,14,7,2,69,1
21458,498344,557_16_85,CYPRUS,0,TOTALS,CYPRUS,200,22,66,33.3,17,40,42.5,5,26,19.2,7,12,58.3,9,26,35,12,19,10,4,4,56,0
21459,498357,557_16_85,IRELAND,0,TOTALS,IRELAND,200,26,62,41.9,19,39,48.7,7,23,30.4,13,16,81.2,10,32,42,16,16,10,4,0,72,1
21460,498370,557_16_86,SCOTLAND,0,TOTALS,SCOTLAND,200,24,63,38.1,15,32,46.9,9,31,29.0,11,19,57.9,10,28,38,14,18,16,7,3,68,0
21461,498383,557_16_86,ALBANIA,0,TOTALS,ALBANIA,200,25,51,49.0,19,37,51.4,6,14,42.9,15,27,55.6,4,30,34,13,15,16,6,3,71,1
21462,498396,557_16_87,CZECH REPUBLIC,0,TOTALS,CZECH REPUBLIC,200,27,63,42.9,18,40,45.0,9,23,39.1,2,8,25.0,13,18,31,13,14,16,8,1,65,0
21463,498409,557_16_87,ESTONIA,0,TOTALS,ESTONIA,200,26,54,48.1,12,32,37.5,14,22,63.6,12,14,85.7,11,25,36,18,16,19,9,2,78,1
21464,498422,557_16_88,DENMARK,0,TOTALS,DENMARK,200,38,77,49.4,35,53,66.0,3,24,12.5,6,14,42.9,14,38,52,20,22,13,9,0,85,1
21465,498435,557_16_88,MKD,0,TOTALS,MKD,200,21,62,33.9,16,35,45.7,5,27,18.5,14,19,73.7,7,25,32,10,15,14,7,3,61,0
21466,498448,557_16_89,BELGIUM,0,TOTALS,BELGIUM,200,30,68,44.1,26,54,48.1,4,14,28.6,7,10,70.0,9,33,42,17,22,12,8,0,71,1
21467,498461,557_16_89,POLAND,0,TOTALS,POLAND,200,18,57,31.6,11,32,34.4,7,25,28.0,8,17,47.1,9,29,38,10,14,18,7,6,51,0
21468,498474,557_16_90,AUSTRIA,0,TOTALS,AUSTRIA,200,23,60,38.3,15,33,45.5,8,27,29.6,10,16,62.5,8,24,32,16,10,25,9,2,64,0
21469,498487,557_16_90,NETHERLANDS,0,TOTALS,NETHERLANDS,200,34,77,44.2,24,52,46.2,10,25,40.0,7,9,77.8,17,31,48,19,17,20,12,2,85,1
21470,498500,557_16_91,PORTUGAL,0,TOTALS,PORTUGAL,200,26,67,38.8,23,53,43.4,3,14,21.4,5,7,71.4,10,38,48,15,18,25,7,2,60,0
21471,498513,557_16_91,ICELAND,0,TOTALS,ICELAND,200,22,72,30.6,17,40,42.5,5,32,15.6,15,22,68.2,12,32,44,8,13,14,14,4,64,1
21472,498526,557_16_92,GEORGIA,0,TOTALS,GEORGIA,200,25,59,42.4,13,25,52.0,12,34,35.3,19,30,63.3,9,30,39,14,28,18,3,1,81,0
21473,498539,557_16_92,ENGLAND,0,TOTALS,ENGLAND,200,28,70,40.0,23,52,44.2,5,18,27.8,24,31,77.4,14,28,42,9,24,9,9,5,85,1
21474,498552,557_16_93,LUXEMBOURG,0,TOTALS,LUXEMBOURG,200,25,57,43.9,22,45,48.9,3,12,25.0,17,23,73.9,6,38,44,17,16,23,8,2,70,1
21475,498565,557_16_93,ROMANIA,0,TOTALS,ROMANIA,200,26,71,36.6,21,48,43.8,5,23,21.7,7,15,46.7,10,29,39,19,22,15,15,1,64,0
21476,498578,557_16_94,BULGARIA,0,TOTALS,BULGARIA,200,33,61,54.1,31,49,63.3,2,12,16.7,6,12,50.0,4,28,32,15,17,22,18,7,74,0
21477,498591,557_16_94,BELARUS,0,TOTALS,BELARUS,200,32,71,45.1,28,61,45.9,4,10,40.0,7,17,41.2,15,26,41,10,14,23,10,4,75,1
21478,498604,557_16_95,HUNGARY,0,TOTALS,HUNGARY,200,23,51,45.1,15,29,51.7,8,22,36.4,8,15,53.3,9,22,31,17,18,24,12,4,62,0
21479,498617,557_16_95,SLOVAK REPUBLIC,0,TOTALS,SLOVAK REPUBLIC,200,25,62,40.3,20,40,50.0,5,22,22.7,8,14,57.1,15,19,34,12,22,19,14,2,63,1
21480,498630,557_16_96,UKRAINE,0,TOTALS,UKRAINE,200,23,50,46.0,18,29,62.1,5,21,23.8,21,32,65.6,7,28,35,12,22,18,5,0,72,0
21481,498643,557_16_96,MONTENEGRO,0,TOTALS,MONTENEGRO,200,30,72,41.7,21,38,55.3,9,34,26.5,14,23,60.9,18,23,41,17,27,13,9,0,83,1
21482,498656,558_16_01,ANDORRA,0,TOTALS,ANDORRA,200,24,72,33.3,15,44,34.1,9,28,32.1,12,21,57.1,15,28,43,15,13,11,13,1,69,1
21483,498668,558_16_01,AZERBAIJAN,0,TOTALS,AZERBAIJAN,200,27,69,39.1,25,50,50.0,2,19,10.5,3,8,37.5,15,33,48,14,22,24,6,6,59,0
21484,498681,558_16_02,GIBRALTAR,0,TOTALS,GIBRALTAR,200,31,62,50.0,26,49,53.1,5,13,38.5,11,21,52.4,7,20,27,17,17,20,14,3,78,1
21485,498693,558_16_02,PRINCIPALITY OF MONACO,0,TOTALS,PRINCIPALITY OF MONACO,200,24,72,33.3,21,44,47.7,3,28,10.7,13,16,81.2,12,21,33,13,22,21,11,3,64,0
21486,498706,558_16_03,MALTA,0,TOTALS,MALTA,200,35,70,50.0,33,61,54.1,2,9,22.2,14,28,50.0,12,25,37,12,20,19,12,1,87,1
21487,498719,558_16_03,MOLDOVA,0,TOTALS,MOLDOVA,200,32,75,42.7,26,57,45.6,6,18,33.3,9,17,52.9,22,24,46,8,24,19,7,8,79,0
21488,498732,558_16_04,KOSOVO,0,TOTALS,KOSOVO,200,34,77,44.2,31,63,49.2,3,14,21.4,15,22,68.2,21,31,52,14,14,24,18,1,86,1
21489,498745,558_16_04,SAN MARINO,0,TOTALS,SAN MARINO,200,21,64,32.8,15,36,41.7,6,28,21.4,5,8,62.5,4,22,26,13,16,30,13,5,54,0
21490,498758,558_16_05,WALES,0,TOTALS,WALES,200,26,74,35.1,20,50,40.0,6,24,25.0,4,10,40.0,8,29,37,12,15,11,3,2,62,0
21491,498771,558_16_05,KOSOVO,0,TOTALS,KOSOVO,200,32,82,39.0,25,55,45.5,7,27,25.9,5,11,45.5,23,39,62,8,17,19,5,2,76,1
21492,498784,558_16_06,SAN MARINO,0,TOTALS,SAN MARINO,200,33,68,48.5,25,46,54.3,8,22,36.4,12,17,70.6,6,34,40,14,21,26,13,5,86,1
21493,498797,558_16_06,MALTA,0,TOTALS,MALTA,200,30,74,40.5,27,60,45.0,3,14,21.4,11,20,55.0,12,32,44,12,23,28,15,0,74,0
21494,498809,558_16_07,AZERBAIJAN,0,TOTALS,AZERBAIJAN,200,34,83,41.0,20,38,52.6,14,45,31.1,7,16,43.8,29,35,64,19,24,18,9,8,89,1
21495,498822,558_16_07,GIBRALTAR,0,TOTALS,GIBRALTAR,200,20,61,32.8,19,51,37.3,1,10,10.0,13,24,54.2,8,24,32,15,15,16,8,0,54,0
21496,498834,558_16_08,PRINCIPALITY OF MONACO,0,TOTALS,PRINCIPALITY OF MONACO,200,22,59,37.3,19,45,42.2,3,14,21.4,13,21,61.9,8,21,29,8,24,29,14,0,60,0
21497,498847,558_16_08,ANDORRA,0,TOTALS,ANDORRA,200,34,81,42.0,27,52,51.9,7,29,24.1,16,28,57.1,27,33,60,18,18,25,16,1,91,1
21498,498860,558_16_09,MALTA,0,TOTALS,MALTA,200,25,70,35.7,22,52,42.3,3,18,16.7,6,9,66.7,11,22,33,7,21,14,6,4,59,0
21499,498873,558_16_09,WALES,0,TOTALS,WALES,200,29,63,46.0,24,43,55.8,5,20,25.0,19,31,61.3,16,35,51,12,9,13,6,1,82,1
21500,498886,558_16_10,MOLDOVA,0,TOTALS,MOLDOVA,200,24,63,38.1,22,53,41.5,2,10,20.0,18,33,54.5,16,36,52,5,25,31,11,4,68,0
21501,498899,558_16_10,SAN MARINO,0,TOTALS,SAN MARINO,200,28,68,41.2,18,45,40.0,10,23,43.5,12,23,52.2,11,22,33,7,26,20,9,0,78,1
21502,498912,558_16_11,KOSOVO,0,TOTALS,KOSOVO,200,44,87,50.6,36,58,62.1,8,29,27.6,14,16,87.5,21,40,61,26,15,13,11,4,110,0
21503,498925,558_16_11,MALTA,0,TOTALS,MALTA,200,24,69,34.8,19,45,42.2,5,24,20.8,8,11,72.7,6,23,29,15,14,19,6,1,61,1
21504,498938,558_16_12,WALES,0,TOTALS,WALES,200,24,67,35.8,13,38,34.2,11,29,37.9,10,18,55.6,14,23,37,13,21,21,9,3,69,1
21505,498951,558_16_12,MOLDOVA,0,TOTALS,MOLDOVA,200,23,75,30.7,20,58,34.5,3,17,17.6,13,17,76.5,29,31,60,8,17,26,7,2,62,0
21506,498964,558_16_13,GIBRALTAR,0,TOTALS,GIBRALTAR,200,19,40,47.5,15,30,50.0,4,10,40.0,11,19,57.9,5,15,20,9,28,36,8,0,53,0
21507,498977,558_16_13,ANDORRA,0,TOTALS,ANDORRA,200,34,76,44.7,22,42,52.4,12,34,35.3,18,33,54.5,31,18,49,28,23,18,20,0,98,1
21508,498989,558_16_14,AZERBAIJAN,0,TOTALS,AZERBAIJAN,200,35,87,40.2,31,60,51.7,4,27,14.8,5,8,62.5,26,37,63,16,18,22,12,8,79,1
21509,499001,558_16_14,PRINCIPALITY OF MONACO,0,TOTALS,PRINCIPALITY OF MONACO,200,22,75,29.3,17,54,31.5,5,21,23.8,12,21,57.1,17,29,46,13,12,20,10,1,61,0
21510,499014,558_16_15,MOLDOVA,0,TOTALS,MOLDOVA,200,23,77,29.9,18,52,34.6,5,25,20.0,7,14,50.0,20,19,39,10,11,23,10,2,58,1
21511,499027,558_16_15,KOSOVO,0,TOTALS,KOSOVO,200,50,86,58.1,41,67,61.2,9,19,47.4,7,12,58.3,21,39,60,29,11,15,16,7,116,0
21512,499040,558_16_16,SAN MARINO,0,TOTALS,SAN MARINO,200,26,68,38.2,21,42,50.0,5,26,19.2,12,21,57.1,7,39,46,12,20,17,14,4,69,1
21513,499053,558_16_16,WALES,0,TOTALS,WALES,200,18,61,29.5,17,41,41.5,1,20,5.0,10,23,43.5,10,38,48,9,20,25,8,2,47,0
21514,499066,558_16_17,GIBRALTAR,0,TOTALS,GIBRALTAR,200,19,51,37.3,17,42,40.5,2,9,22.2,22,38,57.9,8,28,36,14,24,30,13,1,62,0
21515,499079,558_16_17,MOLDOVA,0,TOTALS,MOLDOVA,200,23,61,37.7,16,35,45.7,7,26,26.9,11,23,47.8,15,30,45,15,30,35,13,4,64,1
21516,499092,558_16_18,MALTA,0,TOTALS,MALTA,200,28,87,32.2,21,63,33.3,7,24,29.2,6,12,50.0,22,32,54,18,15,29,20,3,69,0
21517,499104,558_16_18,PRINCIPALITY OF MONACO,0,TOTALS,PRINCIPALITY OF MONACO,200,27,71,38.0,23,53,43.4,4,18,22.2,14,17,82.4,11,40,51,14,12,34,16,6,72,1
21518,499117,558_16_19,WALES,0,TOTALS,WALES,200,30,75,40.0,18,42,42.9,12,33,36.4,4,9,44.4,17,30,47,23,11,22,8,6,76,1
21519,499130,558_16_19,GIBRALTAR,0,TOTALS,GIBRALTAR,200,29,69,42.0,22,51,43.1,7,18,38.9,4,5,80.0,9,30,39,15,13,21,9,3,69,0
21520,499142,558_16_20,PRINCIPALITY OF MONACO,0,TOTALS,PRINCIPALITY OF MONACO,225,34,84,40.5,28,62,45.2,6,22,27.3,18,26,69.2,13,29,42,20,26,22,22,1,92,1
21521,499155,558_16_20,MOLDOVA,0,TOTALS,MOLDOVA,225,27,78,34.6,19,49,38.8,8,29,27.6,25,36,69.4,26,40,66,13,17,34,15,5,87,0
21522,499168,558_16_21,KOSOVO,0,TOTALS,KOSOVO,200,26,73,35.6,18,42,42.9,8,31,25.8,6,10,60.0,17,22,39,17,18,14,12,0,66,0
21523,499180,558_16_21,AZERBAIJAN,0,TOTALS,AZERBAIJAN,200,30,62,48.4,22,31,71.0,8,31,25.8,9,15,60.0,11,32,43,19,12,20,5,5,77,1
21524,499193,558_16_22,ANDORRA,0,TOTALS,ANDORRA,200,34,86,39.5,29,64,45.3,5,22,22.7,16,37,43.2,40,33,73,25,20,14,10,1,89,1
21525,499206,558_16_22,SAN MARINO,0,TOTALS,SAN MARINO,200,24,56,42.9,19,40,47.5,5,16,31.2,10,20,50.0,6,22,28,9,29,19,6,5,63,0
21526,499219,558_16_23,GIBRALTAR,0,TOTALS,GIBRALTAR,200,29,64,45.3,26,52,50.0,3,12,25.0,21,31,67.7,2,35,37,16,17,20,14,3,82,0
21527,499232,558_16_23,MALTA,0,TOTALS,MALTA,200,33,85,38.8,24,55,43.6,9,30,30.0,10,18,55.6,19,37,56,22,24,21,10,2,85,1
21528,499245,558_16_24,WALES,0,TOTALS,WALES,200,28,78,35.9,15,46,32.6,13,32,40.6,10,16,62.5,25,34,59,23,5,21,6,3,79,1
21529,499257,558_16_24,PRINCIPALITY OF MONACO,0,TOTALS,PRINCIPALITY OF MONACO,200,30,80,37.5,26,59,44.1,4,21,19.0,5,7,71.4,15,28,43,16,13,16,12,2,69,0
21530,499270,558_16_25,SAN MARINO,0,TOTALS,SAN MARINO,200,16,64,25.0,12,37,32.4,4,27,14.8,21,30,70.0,6,23,29,7,18,17,12,3,57,1
21531,499283,558_16_25,KOSOVO,0,TOTALS,KOSOVO,200,38,76,50.0,28,51,54.9,10,25,40.0,14,19,73.7,17,45,62,24,28,19,14,5,100,0
21532,499296,558_16_26,ANDORRA,0,TOTALS,ANDORRA,200,19,77,24.7,13,52,25.0,6,25,24.0,13,25,52.0,26,24,50,14,21,13,8,0,57,0
21533,499308,558_16_26,AZERBAIJAN,0,TOTALS,AZERBAIJAN,200,25,57,43.9,18,37,48.6,7,20,35.0,17,24,70.8,9,36,45,13,21,18,9,7,74,1
21534,502797,562_16_01,ITALY,0,TOTALS,ITALY,194,28,68,41.2,22,39,56.4,6,29,20.7,9,14,64.3,9,21,30,18,25,11,10,3,71,0
21535,502810,562_16_01,LATVIA,0,TOTALS,LATVIA,200,25,57,43.9,17,33,51.5,8,24,33.3,21,27,77.8,14,34,48,22,17,21,9,1,79,1
21536,502823,562_16_02,GREECE,0,TOTALS,GREECE,200,23,53,43.4,16,34,47.1,7,19,36.8,14,24,58.3,8,35,43,16,27,26,12,1,67,0
21537,502836,562_16_02,FINLAND,0,TOTALS,FINLAND,200,25,68,36.8,13,35,37.1,12,33,36.4,12,26,46.2,14,27,41,23,20,19,9,2,74,1
21538,502849,562_16_03,SPAIN,0,TOTALS,SPAIN,200,30,69,43.5,26,44,59.1,4,25,16.0,16,33,48.5,23,25,48,17,18,17,17,3,80,1
21539,502862,562_16_03,SWEDEN,0,TOTALS,SWEDEN,200,16,51,31.4,8,25,32.0,8,26,30.8,10,14,71.4,10,24,34,11,21,30,7,3,50,0
21540,502875,562_16_04,SERBIA,0,TOTALS,SERBIA,200,31,70,44.3,27,59,45.8,4,11,36.4,11,19,57.9,19,31,50,19,18,26,13,2,77,1
21541,502888,562_16_04,ESTONIA,0,TOTALS,ESTONIA,200,26,70,37.1,21,52,40.4,5,18,27.8,5,6,83.3,11,22,33,15,25,22,16,3,62,0
21542,502901,562_16_05,TURKEY,0,TOTALS,TURKEY,200,31,66,47.0,28,57,49.1,3,9,33.3,8,20,40.0,8,30,38,20,19,15,15,5,73,1
21543,502914,562_16_05,POLAND,0,TOTALS,POLAND,200,18,68,26.5,13,48,27.1,5,20,25.0,8,13,61.5,21,34,55,12,19,28,8,5,49,0
21544,502927,562_16_06,LITHUANIA,0,TOTALS,LITHUANIA,200,34,76,44.7,25,56,44.6,9,20,45.0,19,28,67.9,22,37,59,22,19,17,10,7,96,1
21545,502940,562_16_06,BOSNIA AND HERZEGOVINA,0,TOTALS,BOSNIA AND HERZEGOVINA,200,18,65,27.7,15,51,29.4,3,14,21.4,7,19,36.8,15,24,39,7,27,24,12,3,46,0
21546,502953,562_16_07,GERMANY,0,TOTALS,GERMANY,200,15,64,23.4,14,47,29.8,1,17,5.9,10,15,66.7,16,30,46,7,19,14,8,1,41,0
21547,502966,562_16_07,CROATIA,0,TOTALS,CROATIA,200,19,53,35.8,16,37,43.2,3,16,18.8,13,21,61.9,9,34,43,7,17,18,8,4,54,1
21548,502979,562_16_08,FRANCE,0,TOTALS,FRANCE,200,22,73,30.1,18,46,39.1,4,27,14.8,8,11,72.7,14,35,49,10,23,14,6,2,56,0
21549,502992,562_16_08,MONTENEGRO,0,TOTALS,MONTENEGRO,200,20,61,32.8,16,37,43.2,4,24,16.7,15,23,65.2,9,37,46,12,11,12,8,7,59,1
21550,503005,562_16_09,SWEDEN,0,TOTALS,SWEDEN,200,13,49,26.5,12,36,33.3,1,13,7.7,23,35,65.7,8,25,33,7,24,23,9,2,50,0
21551,503018,562_16_09,ITALY,0,TOTALS,ITALY,200,31,65,47.7,19,37,51.4,12,28,42.9,15,24,62.5,13,32,45,26,26,19,14,6,89,1
21552,503031,562_16_10,ESTONIA,0,TOTALS,ESTONIA,200,19,59,32.2,18,43,41.9,1,16,6.2,4,9,44.4,14,25,39,13,17,22,5,3,43,0
21553,503044,562_16_10,GREECE,0,TOTALS,GREECE,200,23,60,38.3,19,44,43.2,4,16,25.0,10,21,47.6,16,27,43,15,19,17,15,3,60,1
21554,503057,562_16_11,CROATIA,0,TOTALS,CROATIA,200,20,61,32.8,17,37,45.9,3,24,12.5,10,14,71.4,16,24,40,18,21,25,6,2,53,0
21555,503070,562_16_11,TURKEY,0,TOTALS,TURKEY,200,21,59,35.6,18,43,41.9,3,16,18.8,14,18,77.8,13,24,37,14,18,21,12,4,59,1
21556,503083,562_16_12,BOSNIA AND HERZEGOVINA,0,TOTALS,BOSNIA AND HERZEGOVINA,200,13,61,21.3,5,30,16.7,8,31,25.8,12,20,60.0,10,30,40,9,18,20,12,2,46,0
21557,503096,562_16_12,FRANCE,0,TOTALS,FRANCE,200,20,58,34.5,17,38,44.7,3,20,15.0,12,19,63.2,10,41,51,20,21,24,14,0,55,1
21558,503109,562_16_13,POLAND,0,TOTALS,POLAND,200,19,64,29.7,12,38,31.6,7,26,26.9,13,23,56.5,15,16,31,9,11,19,16,3,58,0
21559,503122,562_16_13,GERMANY,0,TOTALS,GERMANY,200,31,68,45.6,25,48,52.1,6,20,30.0,7,9,77.8,21,31,52,14,22,25,13,2,75,1
21560,503135,562_16_14,MONTENEGRO,0,TOTALS,MONTENEGRO,200,27,73,37.0,19,44,43.2,8,29,27.6,10,10,100.0,13,23,36,18,19,15,6,5,72,0
21561,503148,562_16_14,LITHUANIA,0,TOTALS,LITHUANIA,200,33,74,44.6,22,46,47.8,11,28,39.3,19,24,79.2,19,32,51,23,15,14,9,0,96,1
21562,503161,562_16_15,LATVIA,0,TOTALS,LATVIA,200,25,68,36.8,20,44,45.5,5,24,20.8,16,24,66.7,13,29,42,15,23,18,6,4,71,0
21563,503174,562_16_15,SPAIN,0,TOTALS,SPAIN,200,31,79,39.2,20,44,45.5,11,35,31.4,18,31,58.1,26,36,62,25,23,18,12,1,91,1
21564,503187,562_16_16,FINLAND,0,TOTALS,FINLAND,200,25,69,36.2,14,36,38.9,11,33,33.3,9,19,47.4,13,24,37,20,20,19,21,0,70,1
21565,503200,562_16_16,SERBIA,0,TOTALS,SERBIA,200,21,54,38.9,16,38,42.1,5,16,31.2,14,19,73.7,12,34,46,8,16,33,13,2,61,0
21566,503213,562_16_17,GERMANY,0,TOTALS,GERMANY,200,23,59,39.0,14,37,37.8,9,22,40.9,16,18,88.9,15,29,44,20,25,18,3,0,71,1
21567,503226,562_16_17,TURKEY,0,TOTALS,TURKEY,200,23,59,39.0,20,42,47.6,3,17,17.6,16,29,55.2,11,18,29,15,21,9,9,4,65,0
21568,503239,562_16_18,MONTENEGRO,0,TOTALS,MONTENEGRO,200,26,71,36.6,22,49,44.9,4,22,18.2,8,15,53.3,18,23,41,18,14,11,12,2,64,1
21569,503252,562_16_18,BOSNIA AND HERZEGOVINA,0,TOTALS,BOSNIA AND HERZEGOVINA,200,22,55,40.0,16,34,47.1,6,21,28.6,8,10,80.0,10,28,38,11,17,21,7,2,58,0
21570,503265,562_16_19,ITALY,0,TOTALS,ITALY,200,24,69,34.8,19,38,50.0,5,31,16.1,10,13,76.9,13,32,45,18,27,19,5,2,63,0
21571,503278,562_16_19,SPAIN,0,TOTALS,SPAIN,200,22,60,36.7,15,33,45.5,7,27,25.9,19,38,50.0,15,31,46,14,17,18,8,0,70,1
21572,503291,562_16_20,GREECE,0,TOTALS,GREECE,200,21,62,33.9,14,40,35.0,7,22,31.8,10,20,50.0,12,24,36,19,23,18,14,6,59,1
21573,503304,562_16_20,SERBIA,0,TOTALS,SERBIA,200,18,55,32.7,14,37,37.8,4,18,22.2,15,25,60.0,15,35,50,16,19,23,9,6,55,0
21574,503317,562_16_21,POLAND,0,TOTALS,POLAND,200,18,75,24.0,15,58,25.9,3,17,17.6,9,22,40.9,24,20,44,11,24,23,13,2,48,0
21575,503330,562_16_21,CROATIA,0,TOTALS,CROATIA,200,25,61,41.0,23,47,48.9,2,14,14.3,15,23,65.2,15,35,50,20,23,27,11,10,67,1
21576,503343,562_16_22,ESTONIA,0,TOTALS,ESTONIA,200,23,72,31.9,16,49,32.7,7,23,30.4,8,14,57.1,18,27,45,22,27,24,14,3,61,0
21577,503356,562_16_22,FINLAND,0,TOTALS,FINLAND,200,24,54,44.4,20,38,52.6,4,16,25.0,27,41,65.9,8,33,41,19,17,22,14,3,79,1
21578,503369,562_16_23,SWEDEN,0,TOTALS,SWEDEN,200,20,62,32.3,12,33,36.4,8,29,27.6,20,32,62.5,8,37,45,19,27,17,10,3,68,1
21579,503382,562_16_23,LATVIA,0,TOTALS,LATVIA,200,20,62,32.3,13,39,33.3,7,23,30.4,19,30,63.3,11,37,48,20,26,19,8,4,66,0
21580,503395,562_16_24,LITHUANIA,0,TOTALS,LITHUANIA,200,26,67,38.8,18,37,48.6,8,30,26.7,15,24,62.5,14,31,45,14,13,14,8,3,75,1
21581,503408,562_16_24,FRANCE,0,TOTALS,FRANCE,200,25,73,34.2,18,50,36.0,7,23,30.4,7,13,53.8,17,28,45,14,21,20,11,1,64,0
21582,503421,562_16_25,ITALY,0,TOTALS,ITALY,200,29,66,43.9,14,34,41.2,15,32,46.9,13,16,81.2,11,28,39,22,16,11,8,4,86,1
21583,503434,562_16_25,GERMANY,0,TOTALS,GERMANY,200,19,59,32.2,14,37,37.8,5,22,22.7,14,16,87.5,11,27,38,6,20,17,4,1,57,0
21584,503447,562_16_26,MONTENEGRO,0,TOTALS,MONTENEGRO,200,27,67,40.3,21,44,47.7,6,23,26.1,15,22,68.2,14,21,35,17,16,15,15,1,75,1
21585,503460,562_16_26,SERBIA,0,TOTALS,SERBIA,200,25,58,43.1,21,45,46.7,4,13,30.8,6,11,54.5,11,29,40,19,20,23,2,3,60,0
21586,503473,562_16_27,TURKEY,0,TOTALS,TURKEY,200,25,59,42.4,21,44,47.7,4,15,26.7,20,29,69.0,17,29,46,13,25,18,12,1,74,1
21587,503486,562_16_27,LATVIA,0,TOTALS,LATVIA,200,21,60,35.0,11,30,36.7,10,30,33.3,14,25,56.0,15,17,32,13,24,16,8,5,66,0
21588,503499,562_16_28,LITHUANIA,0,TOTALS,LITHUANIA,200,32,65,49.2,26,45,57.8,6,20,30.0,24,38,63.2,13,25,38,15,10,11,12,3,94,1
21589,503512,562_16_28,ESTONIA,0,TOTALS,ESTONIA,200,32,76,42.1,22,58,37.9,10,18,55.6,0,2,0.0,19,29,48,18,27,19,6,0,74,0
21590,503525,562_16_29,SPAIN,0,TOTALS,SPAIN,200,41,79,51.9,32,50,64.0,9,29,31.0,5,16,31.2,18,29,47,33,15,16,13,6,96,1
21591,503538,562_16_29,POLAND,0,TOTALS,POLAND,200,27,73,37.0,19,51,37.3,8,22,36.4,5,7,71.4,15,23,38,21,17,19,8,4,67,0
21592,503551,562_16_30,GREECE,0,TOTALS,GREECE,200,14,56,25.0,9,29,31.0,5,27,18.5,10,19,52.6,12,22,34,16,21,18,12,1,43,0
21593,503564,562_16_30,FRANCE,0,TOTALS,FRANCE,200,20,53,37.7,14,32,43.8,6,21,28.6,13,24,54.2,13,34,47,16,18,24,11,0,59,1
21594,503577,562_16_31,FINLAND,0,TOTALS,FINLAND,200,21,73,28.8,15,40,37.5,6,33,18.2,7,15,46.7,23,30,53,17,17,18,17,1,55,1
21595,503590,562_16_31,BOSNIA AND HERZEGOVINA,0,TOTALS,BOSNIA AND HERZEGOVINA,200,15,56,26.8,11,36,30.6,4,20,20.0,4,8,50.0,10,35,45,9,17,26,6,4,38,0
21596,503603,562_16_32,CROATIA,0,TOTALS,CROATIA,250,25,74,33.8,20,53,37.7,5,21,23.8,19,30,63.3,20,48,68,20,18,22,4,15,74,1
21597,503616,562_16_32,SWEDEN,0,TOTALS,SWEDEN,250,24,87,27.6,16,51,31.4,8,36,22.2,11,17,64.7,16,32,48,17,27,12,9,1,67,0
21598,503629,562_16_33,SWEDEN,0,TOTALS,SWEDEN,200,19,48,39.6,15,30,50.0,4,18,22.2,17,32,53.1,3,33,36,11,23,23,11,3,59,1
21599,503642,562_16_33,GREECE,0,TOTALS,GREECE,200,15,60,25.0,11,38,28.9,4,22,18.2,23,28,82.1,14,31,45,10,24,21,13,3,57,0
21600,503655,562_16_34,CROATIA,0,TOTALS,CROATIA,200,23,55,41.8,17,37,45.9,6,18,33.3,17,22,77.3,10,31,41,20,10,18,9,4,69,1
21601,503668,562_16_34,FRANCE,0,TOTALS,FRANCE,200,20,64,31.2,15,36,41.7,5,28,17.9,7,8,87.5,12,21,33,11,20,18,12,2,52,0
21602,503681,562_16_35,GERMANY,0,TOTALS,GERMANY,200,21,60,35.0,15,41,36.6,6,19,31.6,18,27,66.7,10,34,44,13,19,21,8,1,66,1
21603,503694,562_16_35,ESTONIA,0,TOTALS,ESTONIA,200,23,63,36.5,21,45,46.7,2,18,11.1,11,16,68.8,6,30,36,12,25,18,8,2,59,0
21604,503707,562_16_36,ITALY,0,TOTALS,ITALY,200,25,68,36.8,21,44,47.7,4,24,16.7,13,16,81.2,8,23,31,16,16,9,11,3,67,0
21605,503720,562_16_36,LITHUANIA,0,TOTALS,LITHUANIA,200,31,71,43.7,20,44,45.5,11,27,40.7,11,13,84.6,17,35,52,16,15,18,3,4,84,1
21606,503733,562_16_37,POLAND,0,TOTALS,POLAND,200,27,75,36.0,18,38,47.4,9,37,24.3,10,15,66.7,17,27,44,15,21,15,10,3,73,0
21607,503746,562_16_37,SERBIA,0,TOTALS,SERBIA,200,32,69,46.4,30,60,50.0,2,9,22.2,16,18,88.9,12,33,45,21,18,15,9,4,82,1
21608,503759,562_16_38,TURKEY,0,TOTALS,TURKEY,225,27,67,40.3,21,50,42.0,6,17,35.3,20,30,66.7,11,35,46,11,22,16,4,3,80,1
21609,503772,562_16_38,FINLAND,0,TOTALS,FINLAND,225,27,75,36.0,16,43,37.2,11,32,34.4,13,28,46.4,19,31,50,23,26,17,4,4,78,0
21610,503785,562_16_39,LATVIA,0,TOTALS,LATVIA,200,30,66,45.5,20,31,64.5,10,35,28.6,17,23,73.9,14,31,45,23,21,13,10,7,87,1
21611,503798,562_16_39,BOSNIA AND HERZEGOVINA,0,TOTALS,BOSNIA AND HERZEGOVINA,200,20,68,29.4,14,50,28.0,6,18,33.3,18,26,69.2,18,24,42,9,24,14,10,1,64,0
21612,503811,562_16_40,SPAIN,0,TOTALS,SPAIN,200,29,65,44.6,20,37,54.1,9,28,32.1,8,24,33.3,17,32,49,21,17,21,17,4,75,1
21613,503824,562_16_40,MONTENEGRO,0,TOTALS,MONTENEGRO,200,21,55,38.2,17,36,47.2,4,19,21.1,9,20,45.0,6,29,35,16,22,22,11,5,55,0
21614,503837,562_16_41,GERMANY,0,TOTALS,GERMANY,200,24,67,35.8,15,44,34.1,9,23,39.1,14,23,60.9,20,30,50,17,14,12,8,6,71,1
21615,503850,562_16_41,SWEDEN,0,TOTALS,SWEDEN,200,26,61,42.6,20,39,51.3,6,22,27.3,6,9,66.7,7,26,33,17,24,13,5,2,64,0
21616,503863,562_16_42,ESTONIA,0,TOTALS,ESTONIA,200,23,56,41.1,19,32,59.4,4,24,16.7,15,19,78.9,11,21,32,16,19,16,10,2,65,1
21617,503876,562_16_42,GREECE,0,TOTALS,GREECE,200,20,52,38.5,13,33,39.4,7,19,36.8,12,16,75.0,11,22,33,17,19,23,8,1,59,0
21618,503889,562_16_43,SERBIA,0,TOTALS,SERBIA,225,30,80,37.5,28,71,39.4,2,9,22.2,20,28,71.4,28,35,63,19,16,15,7,3,82,1
21619,503902,562_16_43,LATVIA,0,TOTALS,LATVIA,225,29,78,37.2,16,42,38.1,13,36,36.1,10,12,83.3,14,25,39,22,24,12,6,4,81,0
21620,503915,562_16_44,POLAND,0,TOTALS,POLAND,200,27,69,39.1,20,47,42.6,7,22,31.8,10,13,76.9,15,24,39,17,26,20,12,5,71,0
21621,503928,562_16_44,BOSNIA AND HERZEGOVINA,0,TOTALS,BOSNIA AND HERZEGOVINA,200,21,56,37.5,12,34,35.3,9,22,40.9,24,36,66.7,14,27,41,11,20,19,13,2,75,1
21622,503941,562_16_45,ITALY,0,TOTALS,ITALY,200,23,62,37.1,19,37,51.4,4,25,16.0,18,26,69.2,6,22,28,10,21,14,14,3,68,0
21623,503954,562_16_45,FRANCE,0,TOTALS,FRANCE,200,26,56,46.4,18,35,51.4,8,21,38.1,17,25,68.0,12,35,47,26,21,27,11,0,77,1
21624,503967,562_16_46,LITHUANIA,0,TOTALS,LITHUANIA,200,27,76,35.5,17,45,37.8,10,31,32.3,3,6,50.0,18,29,47,17,18,14,10,3,67,1
21625,503980,562_16_46,CROATIA,0,TOTALS,CROATIA,200,20,63,31.7,15,43,34.9,5,20,25.0,14,15,93.3,13,31,44,12,14,20,6,3,59,0
21626,503993,562_16_47,MONTENEGRO,0,TOTALS,MONTENEGRO,200,27,66,40.9,19,35,54.3,8,31,25.8,11,18,61.1,6,18,24,21,21,19,20,4,73,0
21627,504006,562_16_47,FINLAND,0,TOTALS,FINLAND,200,32,67,47.8,21,42,50.0,11,25,44.0,10,14,71.4,16,36,52,26,18,26,8,2,85,1
21628,504019,562_16_48,SPAIN,0,TOTALS,SPAIN,200,29,70,41.4,24,44,54.5,5,26,19.2,12,22,54.5,14,25,39,22,16,13,13,5,75,1
21629,504032,562_16_48,TURKEY,0,TOTALS,TURKEY,200,24,67,35.8,17,40,42.5,7,27,25.9,15,17,88.2,19,33,52,10,18,19,5,3,70,0
21630,504045,562_16_49,POLAND,0,TOTALS,POLAND,200,30,58,51.7,25,48,52.1,5,10,50.0,20,32,62.5,9,19,28,15,21,22,18,1,85,1
21631,504058,562_16_49,GREECE,0,TOTALS,GREECE,200,26,55,47.3,20,40,50.0,6,15,40.0,16,23,69.6,14,24,38,20,26,32,17,2,74,0
21632,504071,562_16_50,LATVIA,0,TOTALS,LATVIA,200,27,64,42.2,22,41,53.7,5,23,21.7,6,11,54.5,8,37,45,16,18,18,9,3,65,1
21633,504084,562_16_50,SWEDEN,0,TOTALS,SWEDEN,200,17,61,27.9,12,42,28.6,5,19,26.3,12,21,57.1,11,28,39,11,15,16,12,2,51,0
21634,504097,562_16_51,SERBIA,0,TOTALS,SERBIA,200,26,60,43.3,25,54,46.3,1,6,16.7,10,15,66.7,14,28,42,11,14,20,7,4,63,0
21635,504110,562_16_51,GERMANY,0,TOTALS,GERMANY,200,24,61,39.3,12,36,33.3,12,25,48.0,5,10,50.0,9,23,32,16,20,15,6,1,65,1
21636,504123,562_16_52,BOSNIA AND HERZEGOVINA,0,TOTALS,BOSNIA AND HERZEGOVINA,200,22,64,34.4,21,46,45.7,1,18,5.6,14,25,56.0,14,23,37,7,14,19,14,6,59,0
21637,504136,562_16_52,ESTONIA,0,TOTALS,ESTONIA,200,37,80,46.2,32,57,56.1,5,23,21.7,6,8,75.0,20,35,55,32,22,21,12,1,85,1
21638,504149,562_16_53,MONTENEGRO,0,TOTALS,MONTENEGRO,200,26,60,43.3,21,42,50.0,5,18,27.8,18,32,56.2,12,29,41,9,17,19,5,1,75,0
21639,504162,562_16_53,ITALY,0,TOTALS,ITALY,200,34,71,47.9,29,46,63.0,5,25,20.0,8,12,66.7,9,30,39,21,25,14,10,5,81,1
21640,504175,562_16_54,FINLAND,0,TOTALS,FINLAND,200,28,71,39.4,18,38,47.4,10,33,30.3,13,23,56.5,11,27,38,19,19,12,14,0,79,1
21641,504188,562_16_54,FRANCE,0,TOTALS,FRANCE,200,25,58,43.1,17,31,54.8,8,27,29.6,13,24,54.2,7,35,42,18,20,22,7,1,71,0
21642,504201,562_16_55,TURKEY,0,TOTALS,TURKEY,225,28,84,33.3,22,52,42.3,6,32,18.8,15,27,55.6,12,34,46,14,26,9,17,6,77,1
21643,504214,562_16_55,CROATIA,0,TOTALS,CROATIA,225,20,63,31.7,14,44,31.8,6,19,31.6,24,39,61.5,16,46,62,15,20,26,5,2,70,0
21644,504227,562_16_56,SPAIN,0,TOTALS,SPAIN,200,28,76,36.8,18,36,50.0,10,40,25.0,8,11,72.7,17,25,42,18,16,13,12,11,74,1
21645,504240,562_16_56,LITHUANIA,0,TOTALS,LITHUANIA,200,28,76,36.8,20,50,40.0,8,26,30.8,8,11,72.7,24,30,54,10,14,19,6,1,72,0
21646,504253,563_16_01,PORTUGAL,0,TOTALS,PORTUGAL,200,20,60,33.3,16,40,40.0,4,20,20.0,6,9,66.7,9,23,32,5,19,19,9,3,50,0
21647,504266,563_16_01,NETHERLANDS,0,TOTALS,NETHERLANDS,200,24,56,42.9,14,35,40.0,10,21,47.6,14,20,70.0,9,31,40,14,15,19,7,2,72,1
21648,504279,563_16_02,ENGLAND,0,TOTALS,ENGLAND,200,24,80,30.0,16,52,30.8,8,28,28.6,9,15,60.0,27,38,65,16,21,28,16,5,65,1
21649,504291,563_16_02,IRELAND,0,TOTALS,IRELAND,200,19,72,26.4,17,51,33.3,2,21,9.5,10,22,45.5,19,31,50,11,14,24,12,5,50,0
21650,504304,563_16_03,KOSOVO,0,TOTALS,KOSOVO,200,16,53,30.2,15,39,38.5,1,14,7.1,14,30,46.7,10,27,37,6,23,25,10,8,47,0
21651,504317,563_16_03,SLOVENIA,0,TOTALS,SLOVENIA,200,24,73,32.9,19,45,42.2,5,28,17.9,17,26,65.4,24,30,54,12,27,21,14,2,70,1
21652,504330,563_16_04,RUSSIA,0,TOTALS,RUSSIA,200,29,65,44.6,28,49,57.1,1,16,6.2,17,24,70.8,15,37,52,11,14,23,9,8,76,1
21653,504343,563_16_04,LUXEMBOURG,0,TOTALS,LUXEMBOURG,200,23,69,33.3,21,52,40.4,2,17,11.8,7,12,58.3,12,26,38,9,22,21,10,1,55,0
21654,504356,563_16_05,SCOTLAND,0,TOTALS,SCOTLAND,200,12,57,21.1,12,42,28.6,0,15,0.0,9,20,45.0,10,23,33,3,18,30,6,1,33,1
21655,504369,563_16_05,ISRAEL,0,TOTALS,ISRAEL,200,45,89,50.6,34,60,56.7,11,29,37.9,15,24,62.5,27,39,66,25,18,13,22,1,116,0
21656,504382,563_16_06,ROMANIA,0,TOTALS,ROMANIA,200,25,64,39.1,23,52,44.2,2,12,16.7,21,50,42.0,22,42,64,21,18,22,11,5,73,1
21657,504395,563_16_06,AUSTRIA,0,TOTALS,AUSTRIA,200,16,66,24.2,11,35,31.4,5,31,16.1,5,18,27.8,13,32,45,8,34,24,13,2,42,0
21658,504408,563_16_07,MKD,0,TOTALS,MKD,200,24,60,40.0,17,39,43.6,7,21,33.3,2,4,50.0,10,27,37,15,18,20,8,1,57,0
21659,504421,563_16_07,HUNGARY,0,TOTALS,HUNGARY,200,22,58,37.9,11,35,31.4,11,23,47.8,8,12,66.7,11,25,36,22,13,17,10,2,63,1
21660,504434,563_16_08,BELGIUM,0,TOTALS,BELGIUM,200,21,58,36.2,18,43,41.9,3,15,20.0,16,29,55.2,15,35,50,14,20,21,12,3,61,1
21661,504447,563_16_08,SLOVAK REPUBLIC,0,TOTALS,SLOVAK REPUBLIC,200,16,59,27.1,11,30,36.7,5,29,17.2,8,17,47.1,11,29,40,7,26,21,7,4,45,0
21662,504460,563_16_09,BULGARIA,0,TOTALS,BULGARIA,200,28,73,38.4,19,41,46.3,9,32,28.1,17,30,56.7,24,25,49,18,23,19,10,0,82,0
21663,504473,563_16_09,CZECH REPUBLIC,0,TOTALS,CZECH REPUBLIC,200,35,63,55.6,28,43,65.1,7,20,35.0,7,18,38.9,9,26,35,18,24,18,8,6,84,1
21664,504486,563_16_10,BELARUS,0,TOTALS,BELARUS,200,25,63,39.7,20,47,42.6,5,16,31.2,16,30,53.3,11,45,56,10,23,24,11,7,71,1
21665,504499,563_16_10,DENMARK,0,TOTALS,DENMARK,200,13,62,21.0,13,53,24.5,0,9,0.0,16,31,51.6,10,33,43,6,24,19,9,4,42,0
21666,504512,563_16_11,UKRAINE,0,TOTALS,UKRAINE,200,31,73,42.5,30,55,54.5,1,18,5.6,6,12,50.0,22,27,49,13,17,29,26,3,69,1
21667,504525,563_16_11,NORWAY,0,TOTALS,NORWAY,200,14,53,26.4,12,39,30.8,2,14,14.3,9,15,60.0,12,23,35,8,14,39,15,0,39,0
21668,504538,563_16_12,ICELAND,0,TOTALS,ICELAND,200,32,61,52.5,26,40,65.0,6,21,28.6,9,11,81.8,6,36,42,16,22,23,13,2,79,1
21669,504551,563_16_12,GEORGIA,0,TOTALS,GEORGIA,200,29,82,35.4,23,59,39.0,6,23,26.1,8,19,42.1,23,24,47,11,16,18,17,0,72,0
21670,504564,563_16_13,NETHERLANDS,0,TOTALS,NETHERLANDS,200,16,57,28.1,12,41,29.3,4,16,25.0,12,23,52.2,15,32,47,12,16,19,5,3,48,0
21671,504577,563_16_13,RUSSIA,0,TOTALS,RUSSIA,200,19,70,27.1,10,29,34.5,9,41,22.0,4,5,80.0,17,28,45,13,26,17,7,4,51,1
21672,504590,563_16_14,ISRAEL,0,TOTALS,ISRAEL,200,31,72,43.1,25,49,51.0,6,23,26.1,12,18,66.7,12,37,49,13,22,19,16,2,80,1
21673,504603,563_16_14,MKD,0,TOTALS,MKD,200,19,52,36.5,13,35,37.1,6,17,35.3,14,24,58.3,4,31,35,11,18,27,10,4,58,0
21674,504616,563_16_15,SLOVENIA,0,TOTALS,SLOVENIA,200,26,70,37.1,21,43,48.8,5,27,18.5,17,24,70.8,18,30,48,12,23,21,16,2,74,1
21675,504629,563_16_15,ROMANIA,0,TOTALS,ROMANIA,200,21,57,36.8,16,37,43.2,5,20,25.0,18,23,78.3,9,28,37,11,24,23,9,5,65,0
21676,504642,563_16_16,LUXEMBOURG,0,TOTALS,LUXEMBOURG,200,18,70,25.7,13,49,26.5,5,21,23.8,14,26,53.8,16,32,48,12,25,17,11,2,55,0
21677,504655,563_16_16,BELARUS,0,TOTALS,BELARUS,200,23,59,39.0,15,36,41.7,8,23,34.8,21,34,61.8,12,41,53,12,20,21,9,5,75,1
21678,504668,563_16_17,HUNGARY,0,TOTALS,HUNGARY,225,24,74,32.4,18,44,40.9,6,30,20.0,7,11,63.6,15,35,50,9,17,15,3,1,61,0
21679,504681,563_16_17,ENGLAND,0,TOTALS,ENGLAND,225,24,76,31.6,19,49,38.8,5,27,18.5,13,19,68.4,17,34,51,8,16,12,12,3,66,1
21680,504694,563_16_18,SLOVAK REPUBLIC,0,TOTALS,SLOVAK REPUBLIC,225,21,73,28.8,15,42,35.7,6,31,19.4,24,32,75.0,17,33,50,13,24,17,7,5,72,1
21681,504707,563_16_18,ICELAND,0,TOTALS,ICELAND,225,20,66,30.3,15,39,38.5,5,27,18.5,19,31,61.3,15,33,48,10,26,17,8,3,64,0
21682,504720,563_16_19,DENMARK,0,TOTALS,DENMARK,200,13,42,31.0,12,27,44.4,1,15,6.7,11,17,64.7,7,29,36,7,21,30,5,3,38,0
21683,504733,563_16_19,PORTUGAL,0,TOTALS,PORTUGAL,200,26,77,33.8,26,59,44.1,0,18,0.0,9,23,39.1,28,23,51,15,18,16,22,1,61,1
21684,504746,563_16_20,NORWAY,0,TOTALS,NORWAY,200,24,60,40.0,19,41,46.3,5,19,26.3,0,8,0.0,10,26,36,17,14,22,8,2,53,0
21685,504759,563_16_20,KOSOVO,0,TOTALS,KOSOVO,200,28,69,40.6,25,55,45.5,3,14,21.4,7,18,38.9,19,29,48,15,17,21,14,5,66,1
21686,504772,563_16_21,GEORGIA,0,TOTALS,GEORGIA,200,32,71,45.1,27,50,54.0,5,21,23.8,13,24,54.2,17,32,49,20,23,25,16,3,82,1
21687,504785,563_16_21,BULGARIA,0,TOTALS,BULGARIA,200,28,81,34.6,20,50,40.0,8,31,25.8,11,19,57.9,21,27,48,17,22,24,14,3,75,0
21688,504797,563_16_22,IRELAND,0,TOTALS,IRELAND,200,30,66,45.5,23,44,52.3,7,22,31.8,9,13,69.2,13,36,49,22,21,32,7,6,76,1
21689,504810,563_16_22,SCOTLAND,0,TOTALS,SCOTLAND,200,24,87,27.6,18,60,30.0,6,27,22.2,5,18,27.8,31,22,53,15,19,27,13,3,59,0
21690,504823,563_16_23,AUSTRIA,0,TOTALS,AUSTRIA,200,11,56,19.6,10,38,26.3,1,18,5.6,15,24,62.5,17,24,41,4,18,32,8,0,38,0
21691,504836,563_16_23,UKRAINE,0,TOTALS,UKRAINE,200,28,70,40.0,23,42,54.8,5,28,17.9,6,15,40.0,20,31,51,13,20,25,18,3,67,1
21692,504849,563_16_24,CZECH REPUBLIC,0,TOTALS,CZECH REPUBLIC,200,19,50,38.0,10,28,35.7,9,22,40.9,8,14,57.1,9,29,38,14,18,19,8,1,55,1
21693,504862,563_16_24,BELGIUM,0,TOTALS,BELGIUM,200,18,63,28.6,13,44,29.5,5,19,26.3,11,15,73.3,18,23,41,13,18,15,10,1,52,0
21694,504875,563_16_25,PORTUGAL,0,TOTALS,PORTUGAL,200,22,66,33.3,18,44,40.9,4,22,18.2,6,11,54.5,11,25,36,12,19,22,19,1,54,0
21695,504888,563_16_25,BELARUS,0,TOTALS,BELARUS,200,23,54,42.6,19,43,44.2,4,11,36.4,14,21,66.7,8,35,43,11,12,29,11,2,64,1
21696,504901,563_16_26,ENGLAND,0,TOTALS,ENGLAND,200,31,74,41.9,22,43,51.2,9,31,29.0,9,21,42.9,14,28,42,12,24,14,6,3,80,0
21697,504914,563_16_26,ISRAEL,0,TOTALS,ISRAEL,200,28,61,45.9,20,38,52.6,8,23,34.8,23,30,76.7,8,34,42,13,22,17,5,2,87,1
21698,504927,563_16_27,ROMANIA,0,TOTALS,ROMANIA,200,34,65,52.3,29,50,58.0,5,15,33.3,16,26,61.5,12,43,55,22,23,18,10,7,89,1
21699,504940,563_16_27,KOSOVO,0,TOTALS,KOSOVO,200,17,80,21.2,13,53,24.5,4,27,14.8,14,18,77.8,23,20,43,8,21,15,8,1,52,0
21700,504953,563_16_28,HUNGARY,0,TOTALS,HUNGARY,200,33,73,45.2,22,42,52.4,11,31,35.5,13,15,86.7,13,27,40,25,14,11,7,4,90,1
21701,504965,563_16_28,IRELAND,0,TOTALS,IRELAND,200,29,72,40.3,27,58,46.6,2,14,14.3,6,13,46.2,18,27,45,14,16,21,7,2,66,0
21702,504978,563_16_29,MKD,0,TOTALS,MKD,200,37,67,55.2,29,43,67.4,8,24,33.3,18,28,64.3,10,26,36,21,15,19,22,3,100,0
21703,504991,563_16_29,SCOTLAND,0,TOTALS,SCOTLAND,200,18,53,34.0,12,37,32.4,6,16,37.5,5,13,38.5,12,25,37,10,24,36,10,2,47,1
21704,505004,563_16_30,UKRAINE,0,TOTALS,UKRAINE,200,18,64,28.1,16,36,44.4,2,28,7.1,21,35,60.0,22,24,46,11,21,16,11,4,59,0
21705,505017,563_16_30,SLOVENIA,0,TOTALS,SLOVENIA,200,27,69,39.1,23,50,46.0,4,19,21.1,13,21,61.9,23,27,50,16,29,18,8,3,71,1
21706,505030,563_16_31,RUSSIA,0,TOTALS,RUSSIA,200,31,77,40.3,24,51,47.1,7,26,26.9,25,31,80.6,22,30,52,23,26,20,16,3,94,1
21707,505043,563_16_31,DENMARK,0,TOTALS,DENMARK,200,22,59,37.3,13,37,35.1,9,22,40.9,22,36,61.1,13,25,38,12,27,23,6,2,75,0
21708,505056,563_16_32,CZECH REPUBLIC,0,TOTALS,CZECH REPUBLIC,200,26,70,37.1,21,51,41.2,5,19,26.3,5,9,55.6,15,24,39,13,15,19,13,2,62,0
21709,505069,563_16_32,SLOVAK REPUBLIC,0,TOTALS,SLOVAK REPUBLIC,200,25,60,41.7,17,36,47.2,8,24,33.3,6,8,75.0,9,29,38,13,16,22,10,4,64,1
21710,505082,563_16_33,BULGARIA,0,TOTALS,BULGARIA,200,37,78,47.4,26,55,47.3,11,23,47.8,14,24,58.3,16,32,48,21,26,21,11,6,99,1
21711,505095,563_16_33,ICELAND,0,TOTALS,ICELAND,200,28,72,38.9,24,51,47.1,4,21,19.0,16,20,80.0,13,27,40,9,19,28,13,10,76,0
21712,505108,563_16_34,NETHERLANDS,0,TOTALS,NETHERLANDS,200,31,75,41.3,27,57,47.4,4,18,22.2,20,34,58.8,26,38,64,17,15,22,16,3,86,1
21713,505121,563_16_34,LUXEMBOURG,0,TOTALS,LUXEMBOURG,200,21,73,28.8,20,55,36.4,1,18,5.6,6,10,60.0,13,22,35,10,25,20,10,2,49,0
21714,505134,563_16_35,AUSTRIA,0,TOTALS,AUSTRIA,200,26,79,32.9,17,44,38.6,9,35,25.7,3,8,37.5,18,36,54,11,21,25,7,2,64,0
21715,505147,563_16_35,NORWAY,0,TOTALS,NORWAY,200,27,69,39.1,17,37,45.9,10,32,31.2,14,22,63.6,8,39,47,19,12,20,15,3,78,1
21716,505160,563_16_36,BELGIUM,0,TOTALS,BELGIUM,200,29,73,39.7,22,51,43.1,7,22,31.8,2,9,22.2,14,31,45,22,18,15,13,3,67,1
21717,505173,563_16_36,GEORGIA,0,TOTALS,GEORGIA,200,17,57,29.8,12,35,34.3,5,22,22.7,13,20,65.0,10,31,41,10,14,24,10,0,52,0
21718,505186,563_16_37,ICELAND,0,TOTALS,ICELAND,200,18,55,32.7,11,37,29.7,7,18,38.9,12,25,48.0,9,25,34,9,16,16,10,2,55,0
21719,505199,563_16_37,BELGIUM,0,TOTALS,BELGIUM,200,28,71,39.4,25,54,46.3,3,17,17.6,5,10,50.0,19,31,50,17,25,17,9,3,64,1
21720,505212,563_16_38,LUXEMBOURG,0,TOTALS,LUXEMBOURG,200,19,65,29.2,15,41,36.6,4,24,16.7,5,11,45.5,12,26,38,5,15,19,12,1,47,0
21721,505225,563_16_38,PORTUGAL,0,TOTALS,PORTUGAL,200,28,62,45.2,20,36,55.6,8,26,30.8,14,20,70.0,11,37,48,17,14,18,12,4,78,1
21722,505238,563_16_39,KOSOVO,0,TOTALS,KOSOVO,200,20,53,37.7,18,40,45.0,2,13,15.4,14,28,50.0,10,22,32,10,14,16,9,3,56,0
21723,505251,563_16_39,UKRAINE,0,TOTALS,UKRAINE,200,27,70,38.6,22,49,44.9,5,21,23.8,11,16,68.8,23,29,52,13,22,16,7,4,70,1
21724,505264,563_16_40,DENMARK,0,TOTALS,DENMARK,200,22,57,38.6,18,46,39.1,4,11,36.4,5,8,62.5,12,22,34,11,18,30,7,2,53,0
21725,505277,563_16_40,NETHERLANDS,0,TOTALS,NETHERLANDS,200,26,69,37.7,21,45,46.7,5,24,20.8,12,15,80.0,22,24,46,16,16,27,17,5,69,1
21726,505290,563_16_41,ISRAEL,0,TOTALS,ISRAEL,200,21,66,31.8,16,45,35.6,5,21,23.8,15,22,68.2,15,37,52,11,25,18,9,6,62,1
21727,505303,563_16_41,HUNGARY,0,TOTALS,HUNGARY,200,19,60,31.7,15,37,40.5,4,23,17.4,12,21,57.1,7,33,40,19,15,18,8,3,54,0
21728,505316,563_16_42,SLOVENIA,0,TOTALS,SLOVENIA,200,28,82,34.1,25,58,43.1,3,24,12.5,11,20,55.0,26,37,63,22,21,19,14,0,70,1
21729,505329,563_16_42,AUSTRIA,0,TOTALS,AUSTRIA,200,20,60,33.3,12,36,33.3,8,24,33.3,8,17,47.1,8,32,40,9,22,24,8,3,56,0
21730,505341,563_16_43,IRELAND,0,TOTALS,IRELAND,200,22,73,30.1,16,47,34.0,6,26,23.1,9,16,56.2,22,38,60,11,17,28,7,2,59,0
21731,505354,563_16_43,MKD,0,TOTALS,MKD,200,26,78,33.3,19,58,32.8,7,20,35.0,12,21,57.1,19,31,50,16,20,16,17,5,71,1
21732,505367,563_16_44,SLOVAK REPUBLIC,0,TOTALS,SLOVAK REPUBLIC,200,25,59,42.4,11,24,45.8,14,35,40.0,15,21,71.4,9,29,38,16,26,18,10,2,79,1
21733,505380,563_16_44,BULGARIA,0,TOTALS,BULGARIA,200,29,67,43.3,24,39,61.5,5,28,17.9,12,29,41.4,19,27,46,17,19,19,10,3,75,0
21734,505393,563_16_45,GEORGIA,0,TOTALS,GEORGIA,200,25,55,45.5,17,39,43.6,8,16,50.0,12,24,50.0,7,30,37,13,18,24,6,1,70,0
21735,505406,563_16_45,CZECH REPUBLIC,0,TOTALS,CZECH REPUBLIC,200,26,71,36.6,22,51,43.1,4,20,20.0,16,25,64.0,18,28,46,14,22,20,8,4,72,1
21736,505419,563_16_46,BELARUS,0,TOTALS,BELARUS,200,21,64,32.8,18,44,40.9,3,20,15.0,6,12,50.0,11,22,33,3,14,18,7,2,51,0
21737,505432,563_16_46,RUSSIA,0,TOTALS,RUSSIA,200,33,66,50.0,30,50,60.0,3,16,18.8,7,9,77.8,12,35,47,21,16,19,12,3,76,1
21738,505445,563_16_47,SCOTLAND,0,TOTALS,SCOTLAND,200,13,66,19.7,8,45,17.8,5,21,23.8,5,8,62.5,18,29,47,8,20,31,8,3,36,0
21739,505458,563_16_47,ENGLAND,0,TOTALS,ENGLAND,200,24,71,33.8,18,44,40.9,6,27,22.2,7,15,46.7,18,34,52,20,16,23,7,2,61,1
21740,505471,563_16_48,NORWAY,0,TOTALS,NORWAY,200,19,62,30.6,12,29,41.4,7,33,21.2,9,14,64.3,12,24,36,12,14,23,14,3,54,0
21741,505484,563_16_48,ROMANIA,0,TOTALS,ROMANIA,200,28,68,41.2,20,49,40.8,8,19,42.1,4,9,44.4,18,33,51,14,19,26,13,2,68,1
21742,505497,563_16_49,DENMARK,0,TOTALS,DENMARK,225,23,78,29.5,13,49,26.5,10,29,34.5,17,24,70.8,19,34,53,16,18,23,16,2,73,1
21743,505510,563_16_49,LUXEMBOURG,0,TOTALS,LUXEMBOURG,225,27,74,36.5,23,55,41.8,4,19,21.1,9,17,52.9,15,39,54,16,21,28,8,1,67,0
21744,505523,563_16_50,GEORGIA,0,TOTALS,GEORGIA,200,36,74,48.6,28,47,59.6,8,27,29.6,4,6,66.7,15,33,48,24,19,24,10,1,84,1
21745,505536,563_16_50,SLOVAK REPUBLIC,0,TOTALS,SLOVAK REPUBLIC,200,21,72,29.2,16,45,35.6,5,27,18.5,14,19,73.7,18,24,42,12,16,20,5,4,61,0
21746,505549,563_16_51,CZECH REPUBLIC,0,TOTALS,CZECH REPUBLIC,200,31,82,37.8,19,50,38.0,12,32,37.5,11,17,64.7,24,31,55,12,21,15,9,3,85,1
21747,505562,563_16_51,ICELAND,0,TOTALS,ICELAND,200,22,69,31.9,18,51,35.3,4,18,22.2,14,24,58.3,16,31,47,9,18,19,3,2,62,0
21748,505575,563_16_52,RUSSIA,0,TOTALS,RUSSIA,200,18,63,28.6,12,42,28.6,6,21,28.6,5,12,41.7,12,29,41,11,13,16,4,1,47,0
21749,505588,563_16_52,PORTUGAL,0,TOTALS,PORTUGAL,200,25,66,37.9,16,41,39.0,9,25,36.0,8,14,57.1,11,34,45,15,19,10,10,3,67,1
21750,505601,563_16_53,ENGLAND,0,TOTALS,ENGLAND,200,25,53,47.2,17,30,56.7,8,23,34.8,11,15,73.3,9,30,39,13,11,24,14,1,69,1
21751,505614,563_16_53,MKD,0,TOTALS,MKD,200,15,62,24.2,12,36,33.3,3,26,11.5,5,7,71.4,16,21,37,10,13,25,11,4,38,0
21752,505627,563_16_54,HUNGARY,0,TOTALS,HUNGARY,200,34,71,47.9,29,54,53.7,5,17,29.4,15,23,65.2,13,34,47,21,9,10,12,3,88,1
21753,505640,563_16_54,SCOTLAND,0,TOTALS,SCOTLAND,200,19,70,27.1,16,56,28.6,3,14,21.4,6,8,75.0,17,26,43,5,20,22,7,2,47,0
21754,505653,563_16_55,NETHERLANDS,0,TOTALS,NETHERLANDS,200,20,56,35.7,16,34,47.1,4,22,18.2,19,27,70.4,11,27,38,18,22,22,5,3,63,0
21755,505666,563_16_55,BELARUS,0,TOTALS,BELARUS,200,28,65,43.1,26,50,52.0,2,15,13.3,12,23,52.2,14,26,40,15,18,16,11,5,70,1
21756,505679,563_16_56,SLOVENIA,0,TOTALS,SLOVENIA,200,39,80,48.8,32,57,56.1,7,23,30.4,11,15,73.3,22,33,55,18,17,16,11,4,96,1
21757,505692,563_16_56,NORWAY,0,TOTALS,NORWAY,200,15,52,28.8,9,27,33.3,6,25,24.0,12,18,66.7,6,20,26,5,17,22,11,3,48,0
21758,505705,563_16_57,BELGIUM,0,TOTALS,BELGIUM,200,36,67,53.7,27,51,52.9,9,16,56.2,11,16,68.8,13,29,42,15,11,16,12,8,92,1
21759,505718,563_16_57,BULGARIA,0,TOTALS,BULGARIA,200,27,66,40.9,20,42,47.6,7,24,29.2,6,12,50.0,13,18,31,17,16,17,8,2,67,0
21760,505731,563_16_58,ISRAEL,0,TOTALS,ISRAEL,200,24,69,34.8,18,43,41.9,6,26,23.1,7,11,63.6,12,28,40,15,21,21,13,2,61,1
21761,505743,563_16_58,IRELAND,0,TOTALS,IRELAND,200,24,63,38.1,22,50,44.0,2,13,15.4,8,16,50.0,14,35,49,9,9,28,8,6,58,0
21762,505756,563_16_59,UKRAINE,0,TOTALS,UKRAINE,200,25,60,41.7,17,31,54.8,8,29,27.6,20,27,74.1,19,26,45,14,14,24,11,6,78,1
21763,505769,563_16_59,ROMANIA,0,TOTALS,ROMANIA,200,20,57,35.1,12,42,28.6,8,15,53.3,10,16,62.5,10,20,30,16,21,21,9,3,58,0
21764,505782,563_16_60,AUSTRIA,0,TOTALS,AUSTRIA,200,20,78,25.6,17,57,29.8,3,21,14.3,8,21,38.1,22,40,62,7,22,28,14,1,51,0
21765,505795,563_16_60,KOSOVO,0,TOTALS,KOSOVO,200,23,71,32.4,18,47,38.3,5,24,20.8,15,30,50.0,13,42,55,12,20,23,15,6,66,1
21766,505808,563_16_61,RUSSIA,0,TOTALS,RUSSIA,200,23,71,32.4,16,46,34.8,7,25,28.0,9,14,64.3,14,32,46,12,14,12,7,2,62,1
21767,505821,563_16_61,ENGLAND,0,TOTALS,ENGLAND,200,24,63,38.1,18,43,41.9,6,20,30.0,7,9,77.8,8,35,43,7,17,15,8,2,61,0
21768,505834,563_16_62,NETHERLANDS,0,TOTALS,NETHERLANDS,200,25,70,35.7,16,38,42.1,9,32,28.1,6,14,42.9,25,25,50,21,21,27,11,5,65,1
21769,505847,563_16_62,MKD,0,TOTALS,MKD,200,22,54,40.7,20,41,48.8,2,13,15.4,12,21,57.1,11,24,35,13,19,24,17,7,58,0
21770,505860,563_16_63,DENMARK,0,TOTALS,DENMARK,200,25,75,33.3,17,48,35.4,8,27,29.6,19,31,61.3,22,25,47,13,19,21,20,2,77,1
21771,505873,563_16_63,SCOTLAND,0,TOTALS,SCOTLAND,200,20,55,36.4,16,39,41.0,4,16,25.0,14,27,51.9,17,36,53,5,21,35,10,2,58,0
21772,505886,563_16_64,CZECH REPUBLIC,0,TOTALS,CZECH REPUBLIC,200,21,68,30.9,15,42,35.7,6,26,23.1,2,4,50.0,11,25,36,9,22,13,5,5,50,0
21773,505899,563_16_64,UKRAINE,0,TOTALS,UKRAINE,200,28,64,43.8,21,46,45.7,7,18,38.9,17,27,63.0,15,38,53,15,12,11,5,4,80,1
21774,505912,563_16_65,SLOVAK REPUBLIC,0,TOTALS,SLOVAK REPUBLIC,200,20,56,35.7,12,27,44.4,8,29,27.6,13,20,65.0,11,28,39,14,20,20,12,3,61,1
21775,505925,563_16_65,KOSOVO,0,TOTALS,KOSOVO,200,19,60,31.7,15,37,40.5,4,23,17.4,8,19,42.1,18,28,46,12,19,26,9,2,50,0
21776,505938,563_16_66,BULGARIA,0,TOTALS,BULGARIA,200,30,73,41.1,21,41,51.2,9,32,28.1,7,17,41.2,16,36,52,23,18,30,21,4,76,1
21777,505951,563_16_66,AUSTRIA,0,TOTALS,AUSTRIA,200,25,69,36.2,22,50,44.0,3,19,15.8,10,18,55.6,15,33,48,13,19,37,20,1,63,0
21778,505964,563_16_67,ISRAEL,0,TOTALS,ISRAEL,200,26,66,39.4,20,45,44.4,6,21,28.6,26,33,78.8,16,33,49,17,21,16,10,3,84,1
21779,505977,563_16_67,BELARUS,0,TOTALS,BELARUS,200,24,68,35.3,15,32,46.9,9,36,25.0,12,17,70.6,13,25,38,15,25,19,8,4,69,0
21780,505990,563_16_68,HUNGARY,0,TOTALS,HUNGARY,200,20,46,43.5,14,28,50.0,6,18,33.3,12,24,50.0,12,32,44,14,19,27,9,2,58,0
21781,506003,563_16_68,PORTUGAL,0,TOTALS,PORTUGAL,200,26,61,42.6,21,44,47.7,5,17,29.4,8,16,50.0,8,19,27,15,23,13,18,1,65,1
21782,506015,563_16_69,IRELAND,0,TOTALS,IRELAND,200,29,74,39.2,24,57,42.1,5,17,29.4,13,22,59.1,16,32,48,18,13,23,10,5,76,1
21783,506028,563_16_69,LUXEMBOURG,0,TOTALS,LUXEMBOURG,200,33,83,39.8,29,63,46.0,4,20,20.0,4,6,66.7,16,33,49,16,22,17,9,5,74,0
21784,506041,563_16_70,SLOVENIA,0,TOTALS,SLOVENIA,225,29,66,43.9,25,48,52.1,4,18,22.2,21,32,65.6,15,36,51,16,21,24,5,0,83,1
21785,506054,563_16_70,BELGIUM,0,TOTALS,BELGIUM,225,31,73,42.5,26,54,48.1,5,19,26.3,14,19,73.7,8,25,33,19,27,15,9,5,81,0
21786,506067,563_16_71,ROMANIA,0,TOTALS,ROMANIA,200,26,78,33.3,23,63,36.5,3,15,20.0,24,42,57.1,24,30,54,17,25,29,20,4,79,0
21787,506080,563_16_71,GEORGIA,0,TOTALS,GEORGIA,200,29,68,42.6,20,40,50.0,9,28,32.1,20,27,74.1,13,33,46,24,27,30,20,4,87,1
21788,506093,563_16_72,NORWAY,0,TOTALS,NORWAY,200,18,59,30.5,14,40,35.0,4,19,21.1,22,33,66.7,16,35,51,7,17,20,10,6,62,1
21789,506106,563_16_72,ICELAND,0,TOTALS,ICELAND,200,19,70,27.1,15,53,28.3,4,17,23.5,6,10,60.0,18,28,46,15,24,20,7,3,48,0
21790,506119,563_16_73,ENGLAND,0,TOTALS,ENGLAND,200,21,55,38.2,17,39,43.6,4,16,25.0,18,32,56.2,9,31,40,7,18,15,8,3,64,1
21791,506132,563_16_73,CZECH REPUBLIC,0,TOTALS,CZECH REPUBLIC,200,24,69,34.8,14,38,36.8,10,31,32.3,5,10,50.0,15,32,47,14,22,14,4,2,63,0
21792,506145,563_16_74,MKD,0,TOTALS,MKD,225,25,73,34.2,25,59,42.4,0,14,0.0,16,25,64.0,15,27,42,19,23,26,18,1,66,0
21793,506158,563_16_74,KOSOVO,0,TOTALS,KOSOVO,225,28,67,41.8,24,48,50.0,4,19,21.1,8,21,38.1,20,33,53,19,21,35,12,2,68,1
21794,506171,563_16_75,SCOTLAND,0,TOTALS,SCOTLAND,200,15,74,20.3,14,55,25.5,1,19,5.3,14,23,60.9,20,39,59,7,26,30,15,1,45,0
21795,506184,563_16_75,AUSTRIA,0,TOTALS,AUSTRIA,200,25,79,31.6,19,46,41.3,6,33,18.2,18,39,46.2,24,44,68,12,19,21,18,7,74,1
21796,506197,563_16_76,BELARUS,0,TOTALS,BELARUS,200,29,61,47.5,22,44,50.0,7,17,41.2,6,10,60.0,12,26,38,17,15,16,7,4,71,1
21797,506210,563_16_76,BELGIUM,0,TOTALS,BELGIUM,200,26,65,40.0,20,49,40.8,6,16,37.5,10,12,83.3,11,23,34,15,10,13,8,5,68,0
21798,506223,563_16_77,HUNGARY,0,TOTALS,HUNGARY,200,31,65,47.7,22,45,48.9,9,20,45.0,15,22,68.2,13,28,41,27,15,20,8,2,86,1
21799,506236,563_16_77,ROMANIA,0,TOTALS,ROMANIA,200,25,58,43.1,24,49,49.0,1,9,11.1,10,16,62.5,8,23,31,16,23,25,12,5,61,0
21800,506249,563_16_78,LUXEMBOURG,0,TOTALS,LUXEMBOURG,200,25,62,40.3,20,46,43.5,5,16,31.2,11,17,64.7,9,29,38,6,24,22,11,4,66,0
21801,506262,563_16_78,ICELAND,0,TOTALS,ICELAND,200,25,71,35.2,22,56,39.3,3,15,20.0,20,28,71.4,20,32,52,9,19,20,11,5,73,1
21802,506275,563_16_79,RUSSIA,0,TOTALS,RUSSIA,200,27,65,41.5,22,47,46.8,5,18,27.8,10,15,66.7,19,28,47,10,14,16,5,4,69,1
21803,506288,563_16_79,UKRAINE,0,TOTALS,UKRAINE,200,24,53,45.3,21,39,53.8,3,14,21.4,4,7,57.1,3,22,25,8,21,13,8,3,55,0
21804,506301,563_16_80,NETHERLANDS,0,TOTALS,NETHERLANDS,200,17,57,29.8,11,33,33.3,6,24,25.0,11,25,44.0,16,29,45,12,15,21,8,3,51,0
21805,506314,563_16_80,SLOVAK REPUBLIC,0,TOTALS,SLOVAK REPUBLIC,200,21,64,32.8,15,38,39.5,6,26,23.1,8,14,57.1,15,28,43,11,18,16,11,3,56,1
21806,506327,563_16_81,DENMARK,0,TOTALS,DENMARK,200,28,66,42.4,21,45,46.7,7,21,33.3,17,30,56.7,13,19,32,13,21,25,11,2,80,0
21807,506340,563_16_81,BULGARIA,0,TOTALS,BULGARIA,200,31,63,49.2,22,40,55.0,9,23,39.1,16,24,66.7,12,32,44,21,20,30,16,0,87,1
21808,506353,563_16_82,ISRAEL,0,TOTALS,ISRAEL,200,30,58,51.7,18,33,54.5,12,25,48.0,11,22,50.0,8,28,36,11,21,14,4,2,83,1
21809,506366,563_16_82,SLOVENIA,0,TOTALS,SLOVENIA,200,26,75,34.7,20,40,50.0,6,35,17.1,13,20,65.0,20,25,45,10,20,10,8,0,71,0
21810,506379,563_16_83,PORTUGAL,0,TOTALS,PORTUGAL,200,28,61,45.9,18,36,50.0,10,25,40.0,13,22,59.1,14,15,29,21,21,14,16,0,79,1
21811,506392,563_16_83,GEORGIA,0,TOTALS,GEORGIA,200,19,41,46.3,14,26,53.8,5,15,33.3,19,29,65.5,9,24,33,13,21,25,5,3,62,0
21812,506404,563_16_84,IRELAND,0,TOTALS,IRELAND,200,23,65,35.4,21,50,42.0,2,15,13.3,16,28,57.1,17,21,38,14,20,20,9,2,64,0
21813,506417,563_16_84,NORWAY,0,TOTALS,NORWAY,200,26,56,46.4,19,36,52.8,7,20,35.0,14,23,60.9,10,28,38,9,22,28,12,4,73,1
21814,506430,563_16_85,AUSTRIA,0,TOTALS,AUSTRIA,200,25,75,33.3,21,58,36.2,4,17,23.5,13,21,61.9,14,23,37,12,17,15,14,6,67,0
21815,506443,563_16_85,ICELAND,0,TOTALS,ICELAND,200,34,75,45.3,25,57,43.9,9,18,50.0,10,15,66.7,19,38,57,14,16,25,10,5,87,1
21816,506456,563_16_86,MKD,0,TOTALS,MKD,225,29,77,37.7,19,42,45.2,10,35,28.6,9,17,52.9,10,27,37,18,16,20,21,3,77,0
21817,506469,563_16_86,ROMANIA,0,TOTALS,ROMANIA,225,33,78,42.3,21,49,42.9,12,29,41.4,10,15,66.7,19,38,57,28,15,29,10,5,88,1
21818,506482,563_16_87,DENMARK,0,TOTALS,DENMARK,200,30,79,38.0,19,54,35.2,11,25,44.0,10,13,76.9,16,34,50,13,25,20,10,1,81,1
21819,506494,563_16_87,IRELAND,0,TOTALS,IRELAND,200,25,69,36.2,22,50,44.0,3,19,15.8,18,29,62.1,15,34,49,10,15,21,13,5,71,0
21820,506507,563_16_88,KOSOVO,0,TOTALS,KOSOVO,200,19,64,29.7,16,54,29.6,3,10,30.0,5,16,31.2,17,29,46,10,13,22,9,3,46,0
21821,506520,563_16_88,HUNGARY,0,TOTALS,HUNGARY,200,34,71,47.9,27,50,54.0,7,21,33.3,5,11,45.5,12,30,42,29,12,12,12,2,80,1
21822,506533,563_16_89,CZECH REPUBLIC,0,TOTALS,CZECH REPUBLIC,200,25,57,43.9,20,39,51.3,5,18,27.8,9,17,52.9,12,27,39,18,15,19,5,1,64,0
21823,506546,563_16_89,BELGIUM,0,TOTALS,BELGIUM,200,31,69,44.9,26,56,46.4,5,13,38.5,8,14,57.1,14,25,39,19,17,12,6,4,75,1
21824,506559,563_16_90,SCOTLAND,0,TOTALS,SCOTLAND,200,22,62,35.5,17,46,37.0,5,16,31.2,10,27,37.0,18,33,51,11,19,29,9,4,59,0
21825,506572,563_16_90,LUXEMBOURG,0,TOTALS,LUXEMBOURG,200,25,66,37.9,20,53,37.7,5,13,38.5,13,25,52.0,13,30,43,14,19,21,14,2,68,1
21826,506585,563_16_91,NETHERLANDS,0,TOTALS,NETHERLANDS,200,27,69,39.1,20,46,43.5,7,23,30.4,8,15,53.3,20,29,49,18,19,23,17,2,69,1
21827,506598,563_16_91,GEORGIA,0,TOTALS,GEORGIA,200,18,51,35.3,14,30,46.7,4,21,19.0,7,14,50.0,7,25,32,12,15,29,14,3,47,0
21828,506611,563_16_92,ENGLAND,0,TOTALS,ENGLAND,200,25,67,37.3,18,43,41.9,7,24,29.2,15,25,60.0,22,34,56,13,17,24,12,5,72,1
21829,506624,563_16_92,BELARUS,0,TOTALS,BELARUS,200,18,63,28.6,15,42,35.7,3,21,14.3,14,18,77.8,11,23,34,11,19,20,7,5,53,0
21830,506637,563_16_93,BULGARIA,0,TOTALS,BULGARIA,200,33,74,44.6,27,50,54.0,6,24,25.0,5,11,45.5,11,33,44,19,14,15,17,3,77,1
21831,506650,563_16_93,NORWAY,0,TOTALS,NORWAY,200,23,62,37.1,17,41,41.5,6,21,28.6,6,9,66.7,7,31,38,13,9,23,8,2,58,0
21832,506663,563_16_94,SLOVAK REPUBLIC,0,TOTALS,SLOVAK REPUBLIC,200,14,66,21.2,10,31,32.3,4,35,11.4,13,15,86.7,14,27,41,9,16,13,6,1,45,0
21833,506676,563_16_94,PORTUGAL,0,TOTALS,PORTUGAL,200,24,61,39.3,20,42,47.6,4,19,21.1,4,13,30.8,14,38,52,12,17,18,6,0,56,1
21834,506689,563_16_95,UKRAINE,0,TOTALS,UKRAINE,200,24,64,37.5,14,40,35.0,10,24,41.7,13,21,61.9,9,26,35,15,17,13,12,2,71,0
21835,506702,563_16_95,SLOVENIA,0,TOTALS,SLOVENIA,200,28,64,43.8,16,36,44.4,12,28,42.9,11,16,68.8,11,32,43,19,24,20,6,1,79,1
21836,506715,563_16_96,RUSSIA,0,TOTALS,RUSSIA,200,27,69,39.1,19,36,52.8,8,33,24.2,20,33,60.6,18,33,51,17,17,17,6,4,82,1
21837,506728,563_16_96,ISRAEL,0,TOTALS,ISRAEL,200,30,70,42.9,24,49,49.0,6,21,28.6,10,16,62.5,9,27,36,7,28,19,7,2,76,0
21838,506741,564_16_01,MOLDOVA,0,TOTALS,MOLDOVA,200,32,83,38.6,29,69,42.0,3,14,21.4,14,21,66.7,29,35,64,10,11,18,7,4,81,1
21839,506754,564_16_01,ALBANIA,0,TOTALS,ALBANIA,192,19,70,27.1,15,51,29.4,4,19,21.1,6,7,85.7,13,24,37,8,14,25,7,2,48,0
21840,506767,564_16_02,ANDORRA,0,TOTALS,ANDORRA,200,29,87,33.3,29,73,39.7,0,14,0.0,13,25,52.0,31,37,68,11,17,19,14,4,71,1
21841,506780,564_16_02,ARMENIA,0,TOTALS,ARMENIA,200,19,63,30.2,14,36,38.9,5,27,18.5,5,15,33.3,10,31,41,16,22,24,10,6,48,0
21842,506793,564_16_03,CYPRUS,0,TOTALS,CYPRUS,200,35,94,37.2,33,79,41.8,2,15,13.3,8,12,66.7,27,33,60,15,16,14,31,2,80,1
21843,506806,564_16_03,SAN MARINO,0,TOTALS,SAN MARINO,200,10,45,22.2,6,24,25.0,4,21,19.0,4,7,57.1,3,32,35,7,13,43,7,4,28,0
21844,506819,564_16_04,WALES,0,TOTALS,WALES,200,21,54,38.9,17,36,47.2,4,18,22.2,5,9,55.6,5,24,29,11,13,30,12,3,51,0
21845,506832,564_16_04,AZERBAIJAN,0,TOTALS,AZERBAIJAN,200,32,75,42.7,26,52,50.0,6,23,26.1,5,12,41.7,21,30,51,23,17,25,20,3,75,1
21846,506845,564_16_05,GIBRALTAR,0,TOTALS,GIBRALTAR,200,29,60,48.3,27,51,52.9,2,9,22.2,6,11,54.5,9,31,40,22,16,27,14,3,66,1
21847,506858,564_16_05,ANDORRA,0,TOTALS,ANDORRA,200,24,68,35.3,20,49,40.8,4,19,21.1,6,13,46.2,17,24,41,11,18,28,16,7,58,0
21848,506871,564_16_06,MALTA,0,TOTALS,MALTA,200,25,81,30.9,20,53,37.7,5,28,17.9,10,15,66.7,19,33,52,12,25,20,18,5,65,1
21849,506884,564_16_06,WALES,0,TOTALS,WALES,200,22,65,33.8,18,51,35.3,4,14,28.6,15,37,40.5,19,37,56,16,18,27,6,4,63,0
21850,506897,564_16_07,AZERBAIJAN,0,TOTALS,AZERBAIJAN,200,26,68,38.2,25,52,48.1,1,16,6.2,9,18,50.0,20,42,62,18,20,30,12,5,62,0
21851,506910,564_16_07,CYPRUS,0,TOTALS,CYPRUS,200,24,90,26.7,16,58,27.6,8,32,25.0,7,21,33.3,33,26,59,14,22,16,22,3,63,1
21852,506923,564_16_08,ARMENIA,0,TOTALS,ARMENIA,200,21,74,28.4,18,56,32.1,3,18,16.7,6,10,60.0,12,25,37,10,19,18,10,4,51,0
21853,506936,564_16_08,MOLDOVA,0,TOTALS,MOLDOVA,200,28,79,35.4,26,67,38.8,2,12,16.7,17,22,77.3,26,40,66,16,15,22,9,13,75,1
21854,506949,564_16_09,SAN MARINO,0,TOTALS,SAN MARINO,200,18,50,36.0,11,36,30.6,7,14,50.0,17,25,68.0,8,27,35,12,18,21,7,7,60,0
21855,506962,564_16_09,AZERBAIJAN,0,TOTALS,AZERBAIJAN,200,28,86,32.6,27,74,36.5,1,12,8.3,6,16,37.5,35,30,65,7,23,19,14,5,63,1
21856,506975,564_16_10,ALBANIA,0,TOTALS,ALBANIA,200,19,68,27.9,16,39,41.0,3,29,10.3,6,8,75.0,14,36,50,14,14,22,7,4,47,0
21857,506988,564_16_10,ARMENIA,0,TOTALS,ARMENIA,200,22,63,34.9,13,34,38.2,9,29,31.0,4,7,57.1,5,34,39,16,11,19,9,3,57,1
21858,507001,564_16_11,CYPRUS,0,TOTALS,CYPRUS,200,31,98,31.6,25,62,40.3,6,36,16.7,4,11,36.4,35,29,64,21,19,26,27,2,72,1
21859,507014,564_16_11,MALTA,0,TOTALS,MALTA,200,16,45,35.6,13,29,44.8,3,16,18.8,8,16,50.0,4,33,37,8,14,41,10,3,43,0
21860,507027,564_16_12,MOLDOVA,0,TOTALS,MOLDOVA,200,29,78,37.2,22,55,40.0,7,23,30.4,12,22,54.5,26,43,69,20,14,30,19,10,77,1
21861,507040,564_16_12,GIBRALTAR,0,TOTALS,GIBRALTAR,200,17,73,23.3,16,62,25.8,1,11,9.1,5,11,45.5,17,25,42,8,14,28,14,5,40,0
21862,507053,564_16_13,MALTA,0,TOTALS,MALTA,200,24,71,33.8,21,60,35.0,3,11,27.3,7,15,46.7,11,35,46,12,21,13,13,2,58,1
21863,507066,564_16_13,SAN MARINO,0,TOTALS,SAN MARINO,200,20,68,29.4,18,50,36.0,2,18,11.1,15,27,55.6,18,40,58,7,17,20,8,7,57,0
21864,507079,564_16_14,GIBRALTAR,0,TOTALS,GIBRALTAR,200,17,57,29.8,15,38,39.5,2,19,10.5,24,36,66.7,11,25,36,10,14,26,17,0,60,0
21865,507092,564_16_14,ALBANIA,0,TOTALS,ALBANIA,200,29,60,48.3,21,40,52.5,8,20,40.0,8,15,53.3,9,31,40,21,28,29,13,1,74,1
21866,507105,564_16_15,ANDORRA,0,TOTALS,ANDORRA,200,22,87,25.3,20,72,27.8,2,15,13.3,8,12,66.7,15,25,40,12,26,21,23,3,54,0
21867,507118,564_16_15,MOLDOVA,0,TOTALS,MOLDOVA,200,25,67,37.3,23,57,40.4,2,10,20.0,16,28,57.1,20,51,71,21,16,39,13,12,68,1
21868,507131,564_16_16,WALES,0,TOTALS,WALES,200,17,52,32.7,13,39,33.3,4,13,30.8,18,27,66.7,10,37,47,14,16,34,6,7,56,0
21869,507144,564_16_16,CYPRUS,0,TOTALS,CYPRUS,200,24,86,27.9,21,60,35.0,3,26,11.5,9,16,56.2,25,26,51,11,25,21,19,5,60,1
21870,507157,564_16_17,ARMENIA,0,TOTALS,ARMENIA,200,14,61,23.0,9,36,25.0,5,25,20.0,11,23,47.8,10,39,49,9,23,24,4,4,44,0
21871,507170,564_16_17,GIBRALTAR,0,TOTALS,GIBRALTAR,200,27,82,32.9,26,61,42.6,1,21,4.8,18,29,62.1,19,42,61,14,21,14,16,3,73,1
21872,507183,564_16_18,AZERBAIJAN,0,TOTALS,AZERBAIJAN,200,38,83,45.8,35,63,55.6,3,20,15.0,2,7,28.6,25,44,69,25,7,19,11,6,81,1
21873,507196,564_16_18,MALTA,0,TOTALS,MALTA,200,13,70,18.6,10,45,22.2,3,25,12.0,4,7,57.1,15,20,35,6,9,18,10,1,33,0
21874,507209,564_16_19,SAN MARINO,0,TOTALS,SAN MARINO,200,23,60,38.3,20,43,46.5,3,17,17.6,16,26,61.5,15,28,43,8,20,22,8,4,65,1
21875,507222,564_16_19,WALES,0,TOTALS,WALES,200,20,66,30.3,15,48,31.2,5,18,27.8,11,19,57.9,20,26,46,14,25,23,10,5,56,0
21876,507235,564_16_20,ALBANIA,0,TOTALS,ALBANIA,200,12,55,21.8,8,38,21.1,4,17,23.5,9,18,50.0,12,26,38,10,18,27,8,2,37,0
21877,507248,564_16_20,ANDORRA,0,TOTALS,ANDORRA,200,27,76,35.5,27,66,40.9,0,10,0.0,6,17,35.3,26,34,60,18,15,20,11,3,60,1
21878,507261,564_16_21,MALTA,0,TOTALS,MALTA,200,34,83,41.0,19,54,35.2,15,29,51.7,4,13,30.8,16,32,48,23,19,18,17,0,87,1
21879,507274,564_16_21,ARMENIA,0,TOTALS,ARMENIA,200,23,70,32.9,18,54,33.3,5,16,31.2,12,17,70.6,17,34,51,14,15,27,8,6,63,0
21880,507287,564_16_22,ANDORRA,0,TOTALS,ANDORRA,200,27,68,39.7,26,60,43.3,1,8,12.5,12,25,48.0,18,32,50,19,18,28,21,5,67,1
21881,507300,564_16_22,SAN MARINO,0,TOTALS,SAN MARINO,200,20,52,38.5,18,42,42.9,2,10,20.0,8,16,50.0,4,29,33,14,22,34,17,4,50,0
21882,507313,564_16_23,CYPRUS,0,TOTALS,CYPRUS,200,27,84,32.1,19,51,37.3,8,33,24.2,8,16,50.0,24,29,53,23,22,24,27,10,70,1
21883,507326,564_16_23,GIBRALTAR,0,TOTALS,GIBRALTAR,200,12,49,24.5,11,43,25.6,1,6,16.7,11,20,55.0,11,35,46,7,12,42,12,4,36,0
21884,507339,564_16_24,MOLDOVA,0,TOTALS,MOLDOVA,200,11,60,18.3,6,36,16.7,5,24,20.8,17,20,85.0,17,33,50,5,12,22,8,9,44,0
21885,507352,564_16_24,AZERBAIJAN,0,TOTALS,AZERBAIJAN,200,27,91,29.7,22,71,31.0,5,20,25.0,1,4,25.0,31,30,61,15,19,14,17,3,60,1
21886,507365,564_16_25,WALES,0,TOTALS,WALES,200,26,64,40.6,21,41,51.2,5,23,21.7,10,18,55.6,19,27,46,22,11,25,10,1,67,1
21887,507378,564_16_25,ALBANIA,0,TOTALS,ALBANIA,200,20,58,34.5,15,43,34.9,5,15,33.3,8,9,88.9,11,21,32,15,11,27,15,2,53,0
21888,507391,564_16_26,ARMENIA,0,TOTALS,ARMENIA,200,26,66,39.4,23,57,40.4,3,9,33.3,12,16,75.0,6,33,39,13,27,18,9,5,67,0
21889,507404,564_16_26,SAN MARINO,0,TOTALS,SAN MARINO,200,25,68,36.8,19,47,40.4,6,21,28.6,17,33,51.5,17,35,52,9,16,19,9,7,73,1
21890,507417,564_16_27,MALTA,0,TOTALS,MALTA,200,26,67,38.8,23,52,44.2,3,15,20.0,17,23,73.9,14,36,50,19,18,27,19,3,72,1
21891,507430,564_16_27,ANDORRA,0,TOTALS,ANDORRA,200,23,78,29.5,20,57,35.1,3,21,14.3,8,17,47.1,21,31,52,11,20,30,16,3,57,0
21892,507443,564_16_28,GIBRALTAR,0,TOTALS,GIBRALTAR,200,23,71,32.4,21,52,40.4,2,19,10.5,8,14,57.1,14,26,40,14,23,34,14,7,56,0
21893,507456,564_16_28,MOLDOVA,0,TOTALS,MOLDOVA,200,29,75,38.7,21,56,37.5,8,19,42.1,15,25,60.0,24,36,60,18,13,32,25,9,81,1
21894,507469,564_16_29,CYPRUS,0,TOTALS,CYPRUS,200,25,69,36.2,20,50,40.0,5,19,26.3,7,14,50.0,16,23,39,22,21,22,18,1,62,1
21895,507482,564_16_29,AZERBAIJAN,0,TOTALS,AZERBAIJAN,200,19,59,32.2,15,39,38.5,4,20,20.0,8,16,50.0,19,28,47,10,15,30,8,5,50,0
21896,511560,568_16_01,AUSTRALIA,0,TOTALS,AUSTRALIA,200,40,78,51.3,34,49,69.4,6,29,20.7,9,24,37.5,23,35,58,15,7,14,21,2,95,1
21897,511572,568_16_01,TAHITI,0,TOTALS,TAHITI,200,6,46,13.0,4,27,14.8,2,19,10.5,0,0,0.0,5,23,28,3,14,33,6,0,14,0
21898,511584,568_16_02,NEW CALEDONIA,0,TOTALS,NEW CALEDONIA,200,27,73,37.0,23,52,44.2,4,21,19.0,8,15,53.3,17,26,43,14,21,19,8,3,66,1
21899,511595,568_16_02,SAMOA,0,TOTALS,SAMOA,200,22,70,31.4,19,56,33.9,3,14,21.4,16,28,57.1,28,30,58,5,18,22,9,5,63,0
21900,511608,568_16_03,FIJI,0,TOTALS,FIJI,200,20,62,32.3,18,49,36.7,2,13,15.4,9,22,40.9,20,25,45,8,21,37,15,3,51,0
21901,511620,568_16_03,GUAM,0,TOTALS,GUAM,200,24,76,31.6,20,61,32.8,4,15,26.7,12,17,70.6,25,22,47,7,20,31,15,0,64,1
21902,511631,568_16_04,SAMOA,0,TOTALS,SAMOA,200,15,49,30.6,11,29,37.9,4,20,20.0,1,4,25.0,11,19,30,4,24,38,2,1,35,1
21903,511644,568_16_04,NEW ZEALAND,0,TOTALS,NEW ZEALAND,200,48,83,57.8,46,68,67.6,2,15,13.3,24,29,82.8,19,25,44,17,11,9,18,3,122,0
21904,511656,568_16_05,TAHITI,0,TOTALS,TAHITI,200,18,60,30.0,12,34,35.3,6,26,23.1,7,24,29.2,15,25,40,5,28,33,15,2,49,0
21905,511669,568_16_05,FIJI,0,TOTALS,FIJI,200,22,55,40.0,20,37,54.1,2,18,11.1,19,33,57.6,16,34,50,14,23,35,16,3,65,1
21906,511682,568_16_06,GUAM,0,TOTALS,GUAM,200,16,67,23.9,8,41,19.5,8,26,30.8,1,5,20.0,8,13,21,9,11,11,4,1,41,1
21907,511695,568_16_06,AUSTRALIA,0,TOTALS,AUSTRALIA,200,47,78,60.3,31,39,79.5,16,39,41.0,7,13,53.8,20,45,65,33,9,9,6,4,117,0
21908,511708,568_16_07,NEW CALEDONIA,0,TOTALS,NEW CALEDONIA,200,9,50,18.0,8,31,25.8,1,19,5.3,3,8,37.5,5,25,30,6,27,49,10,0,22,1
21909,511721,568_16_07,NEW ZEALAND,0,TOTALS,NEW ZEALAND,200,59,94,62.8,53,69,76.8,6,25,24.0,13,24,54.2,15,38,53,27,10,15,33,4,137,0
21910,511734,568_16_08,GUAM,0,TOTALS,GUAM,200,32,74,43.2,21,48,43.8,11,26,42.3,16,31,51.6,22,25,47,13,21,12,10,0,91,1
21911,511746,568_16_08,TAHITI,0,TOTALS,TAHITI,200,21,53,39.6,16,35,45.7,5,18,27.8,10,16,62.5,9,28,37,12,26,25,5,2,57,0
21912,511759,568_16_09,FIJI,0,TOTALS,FIJI,200,13,60,21.7,10,24,41.7,3,36,8.3,2,6,33.3,10,23,33,8,16,24,8,8,31,0
21913,511772,568_16_09,AUSTRALIA,0,TOTALS,AUSTRALIA,200,31,79,39.2,23,43,53.5,8,36,22.2,15,20,75.0,28,38,66,20,8,17,12,2,85,1
21914,511783,568_16_10,SAMOA,0,TOTALS,SAMOA,200,28,64,43.8,21,50,42.0,7,14,50.0,11,18,61.1,20,44,64,18,21,31,11,7,74,1
21915,511795,568_16_10,TAHITI,0,TOTALS,TAHITI,200,24,83,28.9,19,41,46.3,5,42,11.9,12,21,57.1,16,18,34,6,18,19,21,0,65,0
21916,511808,568_16_11,FIJI,0,TOTALS,FIJI,200,24,76,31.6,24,61,39.3,0,15,0.0,9,26,34.6,17,30,47,9,25,35,17,3,57,0
21917,511819,568_16_11,SAMOA,0,TOTALS,SAMOA,200,24,59,40.7,21,49,42.9,3,10,30.0,10,30,33.3,16,41,57,6,23,44,21,5,61,1
21918,511832,568_16_12,AUSTRALIA,0,TOTALS,AUSTRALIA,200,49,79,62.0,36,42,85.7,13,37,35.1,10,13,76.9,18,33,51,37,7,12,20,2,121,0
21919,511845,568_16_12,NEW CALEDONIA,0,TOTALS,NEW CALEDONIA,200,12,55,21.8,7,34,20.6,5,21,23.8,1,2,50.0,10,12,22,7,12,33,7,0,30,1
21920,511858,568_16_13,NEW ZEALAND,0,TOTALS,NEW ZEALAND,200,51,83,61.4,46,67,68.7,5,16,31.2,9,17,52.9,17,31,48,28,19,9,12,6,116,0
21921,511871,568_16_13,GUAM,0,TOTALS,GUAM,200,18,57,31.6,11,39,28.2,7,18,38.9,11,16,68.8,9,20,29,12,14,27,5,0,54,1
21922,511884,568_16_14,NEW CALEDONIA,0,TOTALS,NEW CALEDONIA,200,25,65,38.5,20,50,40.0,5,15,33.3,13,27,48.1,20,37,57,18,25,38,9,4,68,0
21923,511897,568_16_14,GUAM,0,TOTALS,GUAM,200,32,84,38.1,24,58,41.4,8,26,30.8,15,21,71.4,18,27,45,21,19,18,24,1,87,1
21924,511910,568_16_15,AUSTRALIA,0,TOTALS,AUSTRALIA,200,19,70,27.1,15,40,37.5,4,30,13.3,9,13,69.2,14,20,34,8,22,14,14,9,51,0
21925,511923,568_16_15,NEW ZEALAND,0,TOTALS,NEW ZEALAND,200,20,58,34.5,14,40,35.0,6,18,33.3,11,20,55.0,17,37,54,9,17,27,8,4,57,1
21926,512416,570_17_01,NEW ZEALAND,0,TOTALS,NEW ZEALAND,200,34,64,53.1,31,51,60.8,3,13,23.1,17,33,51.5,15,31,46,19,17,28,6,2,88,1
21927,512429,570_17_01,KOREA,0,TOTALS,KOREA,200,33,80,41.2,30,59,50.8,3,21,14.3,12,15,80.0,12,22,34,22,29,20,15,0,81,0
21928,512442,570_17_02,JAPAN,0,TOTALS,JAPAN,200,26,57,45.6,19,32,59.4,7,25,28.0,8,18,44.4,6,28,34,18,19,15,1,2,67,0
21929,512455,570_17_02,SPAIN,0,TOTALS,SPAIN,200,30,65,46.2,25,39,64.1,5,26,19.2,13,19,68.4,9,29,38,23,20,10,8,4,78,1
21930,512468,570_17_03,ARGENTINA,0,TOTALS,ARGENTINA,200,19,61,31.1,14,36,38.9,5,25,20.0,10,22,45.5,15,38,53,13,24,19,8,1,53,0
21931,512481,570_17_03,FRANCE,0,TOTALS,FRANCE,200,20,66,30.3,11,39,28.2,9,27,33.3,13,24,54.2,15,31,46,14,24,16,10,2,62,1
21932,512494,570_17_04,CANADA,0,TOTALS,CANADA,200,37,87,42.5,30,61,49.2,7,26,26.9,10,22,45.5,25,48,73,24,26,21,7,2,91,1
21933,512507,570_17_04,MALI,0,TOTALS,MALI,200,12,78,15.4,10,45,22.2,2,33,6.1,16,34,47.1,21,26,47,9,16,17,9,2,42,0
21934,512520,570_17_05,IRAN,0,TOTALS,IRAN,200,17,57,29.8,14,35,40.0,3,22,13.6,11,26,42.3,11,18,29,11,28,25,5,0,48,1
21935,512533,570_17_05,USA,0,TOTALS,USA,200,41,74,55.4,32,53,60.4,9,21,42.9,17,25,68.0,18,34,52,31,21,15,10,6,108,0
21936,512546,570_17_06,GERMANY,0,TOTALS,GERMANY,200,29,69,42.0,16,46,34.8,13,23,56.5,8,14,57.1,10,20,30,16,24,15,8,2,79,0
21937,512559,570_17_06,LITHUANIA,0,TOTALS,LITHUANIA,200,34,61,55.7,25,40,62.5,9,21,42.9,21,26,80.8,10,29,39,30,15,15,5,5,98,1
21938,512572,570_17_07,EGYPT,0,TOTALS,EGYPT,200,24,51,47.1,17,32,53.1,7,19,36.8,12,27,44.4,10,38,48,14,18,28,3,6,67,1
21939,512585,570_17_07,PUERTO RICO,0,TOTALS,PUERTO RICO,200,25,84,29.8,17,51,33.3,8,33,24.2,7,10,70.0,22,24,46,11,24,13,13,1,65,0
21940,512598,570_17_08,ANGOLA,0,TOTALS,ANGOLA,225,22,61,36.1,19,42,45.2,3,19,15.8,19,37,51.4,11,38,49,17,29,23,9,7,66,0
21941,512611,570_17_08,ITALY,0,TOTALS,ITALY,225,22,70,31.4,17,44,38.6,5,26,19.2,21,38,55.3,15,35,50,21,29,17,13,3,70,1
21942,512624,570_17_09,KOREA,0,TOTALS,KOREA,200,28,73,38.4,21,46,45.7,7,27,25.9,13,22,59.1,13,21,34,27,21,14,8,2,76,1
21943,512637,570_17_09,ARGENTINA,0,TOTALS,ARGENTINA,200,41,80,51.2,32,59,54.2,9,21,42.9,9,14,64.3,18,33,51,29,21,17,7,2,100,0
21944,512650,570_17_10,MALI,0,TOTALS,MALI,200,28,76,36.8,24,50,48.0,4,26,15.4,13,28,46.4,26,34,60,13,22,16,6,4,73,0
21945,512663,570_17_10,JAPAN,0,TOTALS,JAPAN,200,28,73,38.4,20,43,46.5,8,30,26.7,12,22,54.5,15,31,46,21,23,13,6,0,76,1
21946,512676,570_17_11,FRANCE,0,TOTALS,FRANCE,200,28,66,42.4,21,43,48.8,7,23,30.4,17,23,73.9,13,20,33,21,26,11,12,1,80,1
21947,512689,570_17_11,NEW ZEALAND,0,TOTALS,NEW ZEALAND,200,23,52,44.2,16,29,55.2,7,23,30.4,16,29,55.2,10,28,38,17,24,26,5,3,69,0
21948,512702,570_17_12,SPAIN,0,TOTALS,SPAIN,200,29,64,45.3,23,44,52.3,6,20,30.0,14,19,73.7,16,28,44,15,31,18,4,2,78,1
21949,512715,570_17_12,CANADA,0,TOTALS,CANADA,200,24,68,35.3,20,48,41.7,4,20,20.0,21,36,58.3,22,24,46,12,19,13,7,3,73,0
21950,512728,570_17_13,PUERTO RICO,0,TOTALS,PUERTO RICO,200,14,65,21.5,10,45,22.2,4,20,20.0,17,26,65.4,14,14,28,13,25,10,11,1,49,0
21951,512741,570_17_13,GERMANY,0,TOTALS,GERMANY,200,24,49,49.0,20,37,54.1,4,12,33.3,17,25,68.0,12,44,56,25,25,24,5,4,69,1
21952,512754,570_17_14,USA,0,TOTALS,USA,200,39,86,45.3,30,62,48.4,9,24,37.5,22,36,61.1,28,35,63,22,15,15,14,2,109,0
21953,512767,570_17_14,ANGOLA,0,TOTALS,ANGOLA,200,25,68,36.8,16,42,38.1,9,26,34.6,9,16,56.2,11,27,38,20,26,23,5,1,68,1
21954,512780,570_17_15,ITALY,0,TOTALS,ITALY,200,23,63,36.5,19,49,38.8,4,14,28.6,14,24,58.3,15,30,45,21,18,19,14,1,64,1
21955,512793,570_17_15,IRAN,0,TOTALS,IRAN,200,20,57,35.1,19,40,47.5,1,17,5.9,4,14,28.6,9,29,38,11,20,25,10,4,45,0
21956,512806,570_17_16,LITHUANIA,0,TOTALS,LITHUANIA,200,33,79,41.8,21,44,47.7,12,35,34.3,10,18,55.6,13,32,45,25,20,14,16,3,88,1
21957,512819,570_17_16,EGYPT,0,TOTALS,EGYPT,200,17,54,31.5,13,31,41.9,4,23,17.4,12,24,50.0,9,35,44,12,19,30,10,3,50,0
21958,512832,570_17_17,CANADA,0,TOTALS,CANADA,200,37,78,47.4,27,46,58.7,10,32,31.2,16,25,64.0,18,35,53,24,13,16,9,5,100,0
21959,512845,570_17_17,JAPAN,0,TOTALS,JAPAN,200,26,72,36.1,16,36,44.4,10,36,27.8,13,18,72.2,15,25,40,18,20,16,7,1,75,1
21960,512858,570_17_18,SPAIN,0,TOTALS,SPAIN,200,22,63,34.9,16,43,37.2,6,20,30.0,12,17,70.6,11,34,45,15,25,21,10,2,62,1
21961,512871,570_17_18,MALI,0,TOTALS,MALI,200,14,60,23.3,14,52,26.9,0,8,0.0,15,28,53.6,18,30,48,10,21,27,11,1,43,0
21962,512884,570_17_19,IRAN,0,TOTALS,IRAN,200,15,55,27.3,9,23,39.1,6,32,18.8,12,22,54.5,11,28,39,12,21,20,3,2,48,0
21963,512897,570_17_19,ANGOLA,0,TOTALS,ANGOLA,200,25,65,38.5,18,48,37.5,7,17,41.2,13,21,61.9,15,30,45,10,16,19,11,4,70,1
21964,512910,570_17_20,ITALY,0,TOTALS,ITALY,200,24,74,32.4,17,50,34.0,7,24,29.2,10,14,71.4,12,28,40,19,32,18,9,5,65,0
21965,512923,570_17_20,USA,0,TOTALS,USA,200,31,80,38.8,22,56,39.3,9,24,37.5,27,42,64.3,29,38,67,23,16,16,11,6,98,1
21966,512936,570_17_21,ARGENTINA,0,TOTALS,ARGENTINA,200,27,76,35.5,17,45,37.8,10,31,32.3,10,15,66.7,17,26,43,18,27,9,6,2,74,1
21967,512949,570_17_21,NEW ZEALAND,0,TOTALS,NEW ZEALAND,200,22,70,31.4,17,51,33.3,5,19,26.3,21,32,65.6,26,34,60,10,19,16,5,4,70,0
21968,512962,570_17_22,KOREA,0,TOTALS,KOREA,200,20,53,37.7,16,35,45.7,4,18,22.2,11,16,68.8,1,21,22,19,20,21,8,3,55,0
21969,512975,570_17_22,FRANCE,0,TOTALS,FRANCE,200,36,85,42.4,30,61,49.2,6,24,25.0,9,15,60.0,27,31,58,21,16,15,13,2,87,1
21970,512988,570_17_23,GERMANY,0,TOTALS,GERMANY,200,24,60,40.0,17,34,50.0,7,26,26.9,11,17,64.7,8,37,45,22,23,19,12,0,66,1
21971,513001,570_17_23,EGYPT,0,TOTALS,EGYPT,200,14,57,24.6,11,36,30.6,3,21,14.3,9,27,33.3,14,29,43,7,17,22,8,3,40,0
21972,513014,570_17_24,PUERTO RICO,0,TOTALS,PUERTO RICO,200,20,66,30.3,13,37,35.1,7,29,24.1,10,19,52.6,17,18,35,13,21,21,8,0,57,0
21973,513027,570_17_24,LITHUANIA,0,TOTALS,LITHUANIA,200,34,66,51.5,21,36,58.3,13,30,43.3,15,23,65.2,16,32,48,29,17,16,12,5,96,1
21974,513040,570_17_25,CANADA,0,TOTALS,CANADA,200,28,70,40.0,18,38,47.4,10,32,31.2,21,27,77.8,19,39,58,19,19,19,4,3,87,1
21975,513053,570_17_25,ANGOLA,0,TOTALS,ANGOLA,200,21,75,28.0,15,48,31.2,6,27,22.2,17,28,60.7,15,22,37,11,23,10,11,2,65,0
21976,513066,570_17_26,JAPAN,0,TOTALS,JAPAN,200,18,56,32.1,14,35,40.0,4,21,19.0,15,21,71.4,10,35,45,8,16,22,2,5,55,0
21977,513079,570_17_26,ITALY,0,TOTALS,ITALY,200,22,78,28.2,19,58,32.8,3,20,15.0,10,14,71.4,21,30,51,15,20,13,10,4,57,1
21978,513092,570_17_27,MALI,0,TOTALS,MALI,200,24,71,33.8,17,47,36.2,7,24,29.2,14,25,56.0,8,21,29,17,25,21,6,0,69,1
21979,513105,570_17_27,USA,0,TOTALS,USA,200,43,83,51.8,37,61,60.7,6,22,27.3,25,35,71.4,26,39,65,33,21,19,12,3,117,0
21980,513118,570_17_28,SPAIN,0,TOTALS,SPAIN,200,29,67,43.3,21,41,51.2,8,26,30.8,4,9,44.4,15,36,51,22,20,16,6,1,70,1
21981,513131,570_17_28,IRAN,0,TOTALS,IRAN,200,18,57,31.6,13,29,44.8,5,28,17.9,9,17,52.9,5,24,29,11,13,13,8,1,50,0
21982,513144,570_17_29,KOREA,0,TOTALS,KOREA,200,25,69,36.2,20,48,41.7,5,21,23.8,8,10,80.0,10,17,27,22,27,25,11,3,63,1
21983,513157,570_17_29,LITHUANIA,0,TOTALS,LITHUANIA,200,40,74,54.1,32,53,60.4,8,21,38.1,22,27,81.5,19,36,55,35,16,22,16,7,110,0
21984,513170,570_17_30,FRANCE,0,TOTALS,FRANCE,200,35,64,54.7,29,47,61.7,6,17,35.3,8,9,88.9,10,30,40,30,21,14,3,2,84,1
21985,513183,570_17_30,PUERTO RICO,0,TOTALS,PUERTO RICO,200,22,62,35.5,14,40,35.0,8,22,36.4,14,22,63.6,11,19,30,16,19,13,7,1,66,0
21986,513196,570_17_31,NEW ZEALAND,0,TOTALS,NEW ZEALAND,200,22,69,31.9,19,52,36.5,3,17,17.6,18,24,75.0,17,28,45,12,19,23,5,1,65,0
21987,513209,570_17_31,GERMANY,0,TOTALS,GERMANY,200,26,60,43.3,21,41,51.2,5,19,26.3,15,21,71.4,6,26,32,24,23,18,13,6,72,1
21988,513222,570_17_32,ARGENTINA,0,TOTALS,ARGENTINA,200,20,51,39.2,9,25,36.0,11,26,42.3,21,32,65.6,6,28,34,19,14,18,14,0,72,1
21989,513235,570_17_32,EGYPT,0,TOTALS,EGYPT,200,28,71,39.4,21,44,47.7,7,27,25.9,4,7,57.1,15,29,44,17,24,21,11,2,67,0
21990,513248,570_17_33,LITHUANIA,0,TOTALS,LITHUANIA,200,20,66,30.3,15,35,42.9,5,31,16.1,23,46,50.0,20,33,53,19,23,10,7,0,68,0
21991,513261,570_17_33,ITALY,0,TOTALS,ITALY,200,24,73,32.9,18,53,34.0,6,20,30.0,19,25,76.0,20,36,56,20,36,11,3,1,73,1
21992,513274,570_17_34,PUERTO RICO,0,TOTALS,PUERTO RICO,200,23,60,38.3,14,37,37.8,9,23,39.1,8,11,72.7,10,28,38,22,18,17,9,0,63,1
21993,513287,570_17_34,ANGOLA,0,TOTALS,ANGOLA,200,24,60,40.0,20,33,60.6,4,27,14.8,7,12,58.3,6,27,33,19,15,16,10,1,59,0
21994,513300,570_17_35,NEW ZEALAND,0,TOTALS,NEW ZEALAND,200,35,65,53.8,31,48,64.6,4,17,23.5,13,20,65.0,10,40,50,28,17,20,6,2,87,1
21995,513313,570_17_35,MALI,0,TOTALS,MALI,200,25,85,29.4,21,55,38.2,4,30,13.3,9,17,52.9,23,25,48,9,21,14,12,1,63,0
21996,513326,570_17_36,ARGENTINA,0,TOTALS,ARGENTINA,200,15,61,24.6,10,31,32.3,5,30,16.7,23,33,69.7,14,27,41,11,33,16,5,1,58,0
21997,513339,570_17_36,SPAIN,0,TOTALS,SPAIN,200,20,56,35.7,14,33,42.4,6,23,26.1,24,36,66.7,10,34,44,15,29,16,6,6,70,1
21998,513352,570_17_37,EGYPT,0,TOTALS,EGYPT,200,23,76,30.3,22,59,37.3,1,17,5.9,10,32,31.2,24,34,58,15,23,15,9,11,57,1
21999,513365,570_17_37,IRAN,0,TOTALS,IRAN,200,15,59,25.4,14,43,32.6,1,16,6.2,22,32,68.8,14,33,47,10,20,19,8,5,53,0
22000,513378,570_17_38,FRANCE,0,TOTALS,FRANCE,200,26,71,36.6,20,43,46.5,6,28,21.4,9,22,40.9,17,25,42,20,26,17,12,4,67,0
22001,513391,570_17_38,CANADA,0,TOTALS,CANADA,200,24,55,43.6,19,40,47.5,5,15,33.3,20,32,62.5,11,32,43,21,17,20,5,1,73,1
22002,513404,570_17_39,KOREA,0,TOTALS,KOREA,200,25,61,41.0,19,35,54.3,6,26,23.1,8,14,57.1,11,26,37,15,25,21,5,6,64,0
22003,513417,570_17_39,JAPAN,0,TOTALS,JAPAN,200,24,61,39.3,14,36,38.9,10,25,40.0,19,23,82.6,13,27,40,18,15,19,10,2,77,1
22004,513430,570_17_40,GERMANY,0,TOTALS,GERMANY,200,26,66,39.4,20,44,45.5,6,22,27.3,1,5,20.0,12,25,37,11,16,23,5,5,59,0
22005,513443,570_17_40,USA,0,TOTALS,USA,200,34,75,45.3,29,57,50.9,5,18,27.8,8,16,50.0,17,27,44,20,16,17,14,5,81,1
22006,513456,570_17_41,ANGOLA,0,TOTALS,ANGOLA,200,25,55,45.5,18,39,46.2,7,16,43.8,16,27,59.3,8,38,46,20,22,23,12,2,73,1
22007,513469,570_17_41,MALI,0,TOTALS,MALI,200,22,66,33.3,18,46,39.1,4,20,20.0,6,16,37.5,13,23,36,14,17,17,12,1,54,0
22008,513482,570_17_42,ARGENTINA,0,TOTALS,ARGENTINA,200,29,72,40.3,18,40,45.0,11,32,34.4,8,14,57.1,7,30,37,26,25,10,8,3,77,0
22009,513495,570_17_42,LITHUANIA,0,TOTALS,LITHUANIA,200,27,67,40.3,19,33,57.6,8,34,23.5,23,31,74.2,12,40,52,26,19,12,5,2,85,1
22010,513508,570_17_43,IRAN,0,TOTALS,IRAN,200,30,74,40.5,29,54,53.7,1,20,5.0,16,31,51.6,20,20,40,25,16,13,12,1,77,0
22011,513521,570_17_43,KOREA,0,TOTALS,KOREA,200,33,64,51.6,29,48,60.4,4,16,25.0,11,13,84.6,10,27,37,28,20,19,5,0,81,1
22012,513534,570_17_44,FRANCE,0,TOTALS,FRANCE,200,23,64,35.9,19,48,39.6,4,16,25.0,10,20,50.0,13,14,27,11,30,13,6,0,60,0
22013,513547,570_17_44,GERMANY,0,TOTALS,GERMANY,200,24,40,60.0,16,25,64.0,8,15,53.3,30,39,76.9,5,32,37,24,22,19,7,4,86,1
22014,513560,570_17_45,PUERTO RICO,0,TOTALS,PUERTO RICO,200,31,75,41.3,26,59,44.1,5,16,31.2,7,13,53.8,12,21,33,13,15,9,12,1,74,1
22015,513573,570_17_45,NEW ZEALAND,0,TOTALS,NEW ZEALAND,200,27,56,48.2,20,36,55.6,7,20,35.0,9,20,45.0,12,34,46,15,15,23,4,3,70,0
22016,513586,570_17_46,SPAIN,0,TOTALS,SPAIN,200,22,47,46.8,16,34,47.1,6,13,46.2,13,24,54.2,10,32,42,15,22,20,5,0,63,0
22017,513599,570_17_46,ITALY,0,TOTALS,ITALY,200,23,66,34.8,16,43,37.2,7,23,30.4,13,23,56.5,15,18,33,19,23,6,10,3,66,1
22018,513612,570_17_47,EGYPT,0,TOTALS,EGYPT,225,31,79,39.2,24,53,45.3,7,26,26.9,4,11,36.4,18,31,49,22,27,12,5,5,73,0
22019,513625,570_17_47,JAPAN,0,TOTALS,JAPAN,225,22,69,31.9,16,49,32.7,6,20,30.0,26,36,72.2,18,32,50,23,16,13,3,4,76,1
22020,513638,570_17_48,CANADA,0,TOTALS,CANADA,200,32,76,42.1,26,51,51.0,6,25,24.0,29,40,72.5,17,36,53,17,28,14,2,4,99,1
22021,513651,570_17_48,USA,0,TOTALS,USA,207,28,85,32.9,22,62,35.5,6,23,26.1,25,43,58.1,30,32,62,17,27,14,11,5,87,0
22022,513664,570_17_49,MALI,0,TOTALS,MALI,200,20,61,32.8,18,48,37.5,2,13,15.4,19,33,57.6,24,28,52,15,20,21,6,2,61,0
22023,513677,570_17_49,IRAN,0,TOTALS,IRAN,200,25,70,35.7,18,44,40.9,7,26,26.9,13,20,65.0,19,22,41,15,27,13,11,0,70,1
22024,513690,570_17_50,ANGOLA,0,TOTALS,ANGOLA,200,22,69,31.9,21,49,42.9,1,20,5.0,13,28,46.4,17,35,52,13,15,12,8,3,58,1
22025,513703,570_17_50,KOREA,0,TOTALS,KOREA,200,19,68,27.9,15,44,34.1,4,24,16.7,14,16,87.5,13,37,50,17,19,17,3,1,56,0
22026,513716,570_17_51,PUERTO RICO,0,TOTALS,PUERTO RICO,200,29,66,43.9,24,48,50.0,5,18,27.8,5,8,62.5,9,28,37,20,16,10,8,1,68,1
22027,513729,570_17_51,JAPAN,0,TOTALS,JAPAN,200,25,61,41.0,19,39,48.7,6,22,27.3,11,19,57.9,12,29,41,19,14,13,3,2,67,0
22028,513742,570_17_52,NEW ZEALAND,0,TOTALS,NEW ZEALAND,200,31,64,48.4,26,45,57.8,5,19,26.3,18,28,64.3,17,33,50,22,12,15,6,2,85,1
22029,513755,570_17_52,EGYPT,0,TOTALS,EGYPT,200,28,70,40.0,19,41,46.3,9,29,31.0,4,9,44.4,10,22,32,17,23,12,5,2,69,0
22030,513768,570_17_53,FRANCE,0,TOTALS,FRANCE,200,22,59,37.3,15,37,40.5,7,22,31.8,18,27,66.7,15,26,41,22,25,14,9,1,69,1
22031,513781,570_17_53,ARGENTINA,0,TOTALS,ARGENTINA,200,22,60,36.7,17,42,40.5,5,18,27.8,14,27,51.9,11,24,35,16,23,13,7,2,63,0
22032,513794,570_17_54,USA,0,TOTALS,USA,200,30,56,53.6,18,37,48.6,12,19,63.2,24,37,64.9,12,39,51,23,18,25,5,2,96,1
22033,513807,570_17_54,SPAIN,0,TOTALS,SPAIN,200,28,82,34.1,19,53,35.8,9,29,31.0,7,16,43.8,17,18,35,14,31,13,11,3,72,0
22034,513820,570_17_55,GERMANY,0,TOTALS,GERMANY,200,31,64,48.4,26,48,54.2,5,16,31.2,13,17,76.5,14,26,40,20,16,21,15,6,80,1
22035,513833,570_17_55,LITHUANIA,0,TOTALS,LITHUANIA,200,25,61,41.0,14,31,45.2,11,30,36.7,13,16,81.2,12,20,32,15,19,22,9,0,74,0
22036,513846,570_17_56,CANADA,0,TOTALS,CANADA,200,28,84,33.3,22,60,36.7,6,24,25.0,17,26,65.4,23,48,71,16,18,10,4,2,79,1
22037,513859,570_17_56,ITALY,0,TOTALS,ITALY,200,22,74,29.7,18,49,36.7,4,25,16.0,12,23,52.2,10,36,46,19,19,7,5,5,60,0
22038,515302,572_17_01,MOZAMBIQUE,0,TOTALS,MOZAMBIQUE,200,15,52,28.8,11,31,35.5,4,21,19.0,13,25,52.0,7,26,33,9,20,6,8,1,47,0
22039,515315,572_17_01,EGYPT,0,TOTALS,EGYPT,200,28,63,44.4,18,29,62.1,10,34,29.4,9,18,50.0,14,33,47,15,20,12,4,1,75,1
22040,515328,572_17_02,DEM.REP. OF CONGO,0,TOTALS,DEM.REP. OF CONGO,225,33,76,43.4,29,55,52.7,4,21,19.0,12,20,60.0,14,34,48,18,27,28,14,5,82,0
22041,515341,572_17_02,MALI,0,TOTALS,MALI,225,30,75,40.0,25,49,51.0,5,26,19.2,22,40,55.0,15,28,43,12,24,25,17,3,87,1
22042,515354,572_17_03,GUINEA,0,TOTALS,GUINEA,200,23,60,38.3,17,38,44.7,6,22,27.3,3,7,42.9,5,31,36,12,19,15,8,3,55,0
22043,515367,572_17_03,RWANDA,0,TOTALS,RWANDA,200,26,70,37.1,17,41,41.5,9,29,31.0,14,22,63.6,13,31,44,10,16,12,9,1,75,1
22044,515380,572_17_04,CAF,0,TOTALS,CAF,200,23,45,51.1,16,28,57.1,7,17,41.2,13,22,59.1,8,12,20,3,24,7,4,1,66,0
22045,515393,572_17_04,MOROCCO,0,TOTALS,MOROCCO,200,23,38,60.5,16,26,61.5,7,12,58.3,23,32,71.9,4,11,15,11,16,7,3,1,76,1
22046,515406,572_17_05,TUNISIA,0,TOTALS,TUNISIA,200,24,52,46.2,17,28,60.7,7,24,29.2,13,30,43.3,9,30,39,10,24,15,5,2,68,1
22047,515418,572_17_05,CAMEROON,0,TOTALS,CAMEROON,200,15,49,30.6,10,27,37.0,5,22,22.7,16,25,64.0,9,29,38,5,31,20,6,1,51,0
22048,515431,572_17_06,SENEGAL,0,TOTALS,SENEGAL,200,31,57,54.4,24,39,61.5,7,18,38.9,14,30,46.7,9,21,30,24,17,6,10,0,83,1
22049,515444,572_17_06,SOUTH AFRICA,0,TOTALS,SOUTH AFRICA,200,18,57,31.6,13,30,43.3,5,27,18.5,3,13,23.1,13,18,31,5,18,17,2,0,44,0
22050,515457,572_17_07,NIGERIA,0,TOTALS,NIGERIA,200,25,61,41.0,18,37,48.6,7,24,29.2,21,32,65.6,13,29,42,17,21,11,5,3,78,1
22051,515470,572_17_07,COTE D'IVOIRE,0,TOTALS,COTE D'IVOIRE,200,28,72,38.9,16,40,40.0,12,32,37.5,9,13,69.2,17,25,42,16,25,12,3,1,77,0
22052,515483,572_17_08,ANGOLA,0,TOTALS,ANGOLA,225,33,83,39.8,19,43,44.2,14,40,35.0,14,22,63.6,13,33,46,13,25,16,11,2,94,1
22053,515496,572_17_08,UGANDA,0,TOTALS,UGANDA,225,32,73,43.8,21,37,56.8,11,36,30.6,14,27,51.9,11,31,42,16,16,15,7,1,89,0
22054,515508,572_17_09,CAMEROON,0,TOTALS,CAMEROON,200,31,61,50.8,18,31,58.1,13,30,43.3,21,30,70.0,9,27,36,16,20,13,10,3,96,1
22055,515521,572_17_09,GUINEA,0,TOTALS,GUINEA,200,20,54,37.0,19,41,46.3,1,13,7.7,13,18,72.2,7,24,31,3,24,21,6,1,54,0
22056,515534,572_17_10,SOUTH AFRICA,0,TOTALS,SOUTH AFRICA,200,22,69,31.9,16,42,38.1,6,27,22.2,11,15,73.3,10,28,38,10,20,5,5,1,61,0
22057,515547,572_17_10,MOZAMBIQUE,0,TOTALS,MOZAMBIQUE,200,25,59,42.4,19,37,51.4,6,22,27.3,11,26,42.3,4,32,36,17,17,10,4,1,67,1
22058,515560,572_17_11,COTE D'IVOIRE,0,TOTALS,COTE D'IVOIRE,200,21,70,30.0,14,34,41.2,7,36,19.4,11,22,50.0,11,27,38,11,23,18,11,0,60,0
22059,515573,572_17_11,DEM.REP. OF CONGO,0,TOTALS,DEM.REP. OF CONGO,200,33,74,44.6,27,47,57.4,6,27,22.2,9,23,39.1,16,35,51,19,21,16,5,7,81,1
22060,515586,572_17_12,UGANDA,0,TOTALS,UGANDA,200,21,67,31.3,16,36,44.4,5,31,16.1,7,14,50.0,9,27,36,4,20,9,12,0,54,0
22061,515599,572_17_12,CAF,0,TOTALS,CAF,200,22,61,36.1,16,35,45.7,6,26,23.1,7,19,36.8,12,31,43,9,19,16,2,0,57,1
22062,515612,572_17_13,RWANDA,0,TOTALS,RWANDA,200,23,72,31.9,17,51,33.3,6,21,28.6,8,13,61.5,15,19,34,8,19,13,8,1,60,0
22063,515625,572_17_13,TUNISIA,0,TOTALS,TUNISIA,200,30,60,50.0,22,35,62.9,8,25,32.0,10,22,45.5,10,34,44,20,15,20,6,4,78,1
22064,515638,572_17_14,EGYPT,0,TOTALS,EGYPT,200,21,64,32.8,16,33,48.5,5,31,16.1,5,8,62.5,8,22,30,12,23,16,5,0,52,0
22065,515651,572_17_14,SENEGAL,0,TOTALS,SENEGAL,200,32,65,49.2,24,45,53.3,8,20,40.0,15,27,55.6,11,23,34,11,19,13,5,5,87,1
22066,515664,572_17_15,MALI,0,TOTALS,MALI,200,23,68,33.8,18,46,39.1,5,22,22.7,16,27,59.3,15,24,39,9,23,18,11,1,67,0
22067,515677,572_17_15,NIGERIA,0,TOTALS,NIGERIA,200,32,67,47.8,21,41,51.2,11,26,42.3,15,23,65.2,13,34,47,15,24,25,13,3,90,1
22068,515690,572_17_16,MOROCCO,0,TOTALS,MOROCCO,200,20,54,37.0,17,35,48.6,3,19,15.8,17,26,65.4,10,30,40,7,20,12,4,3,60,1
22069,515703,572_17_16,ANGOLA,0,TOTALS,ANGOLA,200,20,67,29.9,16,39,41.0,4,28,14.3,9,18,50.0,6,25,31,6,23,8,3,0,53,0
22070,515716,572_17_17,RWANDA,0,TOTALS,RWANDA,200,30,69,43.5,21,44,47.7,9,25,36.0,8,16,50.0,8,30,38,15,20,10,6,1,77,0
22071,515728,572_17_17,CAMEROON,0,TOTALS,CAMEROON,200,30,72,41.7,23,42,54.8,7,30,23.3,14,19,73.7,15,30,45,15,17,13,4,2,81,1
22072,515741,572_17_18,EGYPT,0,TOTALS,EGYPT,200,23,61,37.7,12,23,52.2,11,38,28.9,13,19,68.4,7,32,39,20,17,9,6,2,70,1
22073,515754,572_17_18,SOUTH AFRICA,0,TOTALS,SOUTH AFRICA,200,21,67,31.3,17,44,38.6,4,23,17.4,5,9,55.6,12,32,44,13,19,12,4,1,51,0
22074,515767,572_17_19,NIGERIA,0,TOTALS,NIGERIA,200,28,75,37.3,19,48,39.6,9,27,33.3,12,15,80.0,15,31,46,16,25,19,11,3,77,0
22075,515780,572_17_19,DEM.REP. OF CONGO,0,TOTALS,DEM.REP. OF CONGO,200,31,72,43.1,27,50,54.0,4,22,18.2,17,22,77.3,10,33,43,16,18,18,9,6,83,1
22076,515793,572_17_20,MOROCCO,0,TOTALS,MOROCCO,200,26,62,41.9,19,36,52.8,7,26,26.9,20,33,60.6,4,23,27,11,21,15,15,5,79,1
22077,515806,572_17_20,UGANDA,0,TOTALS,UGANDA,200,21,61,34.4,11,32,34.4,10,29,34.5,18,28,64.3,12,29,41,13,28,25,8,0,70,0
22078,515819,572_17_21,TUNISIA,0,TOTALS,TUNISIA,200,24,57,42.1,17,35,48.6,7,22,31.8,9,22,40.9,8,26,34,19,21,11,10,1,64,1
22079,515832,572_17_21,GUINEA,0,TOTALS,GUINEA,200,20,57,35.1,14,34,41.2,6,23,26.1,13,19,68.4,10,27,37,14,22,19,7,5,59,0
22080,515845,572_17_22,SENEGAL,0,TOTALS,SENEGAL,200,29,62,46.8,20,31,64.5,9,31,29.0,13,20,65.0,13,37,50,22,16,11,4,7,80,1
22081,515858,572_17_22,MOZAMBIQUE,0,TOTALS,MOZAMBIQUE,200,17,63,27.0,11,43,25.6,6,20,30.0,9,14,64.3,9,23,32,10,15,13,5,1,49,0
22082,515871,572_17_23,MALI,0,TOTALS,MALI,200,26,58,44.8,19,34,55.9,7,24,29.2,33,44,75.0,7,25,32,10,19,11,9,1,92,1
22083,515884,572_17_23,COTE D'IVOIRE,0,TOTALS,COTE D'IVOIRE,200,26,61,42.6,21,43,48.8,5,18,27.8,6,12,50.0,12,27,39,16,33,26,7,0,63,0
22084,515897,572_17_24,ANGOLA,0,TOTALS,ANGOLA,200,20,69,29.0,16,44,36.4,4,25,16.0,22,31,71.0,18,30,48,8,23,14,11,2,66,1
22085,515910,572_17_24,CAF,0,TOTALS,CAF,200,13,52,25.0,11,39,28.2,2,13,15.4,16,27,59.3,5,22,27,5,28,19,4,1,44,0
22086,515923,572_17_25,MOROCCO,0,TOTALS,MOROCCO,200,24,58,41.4,16,41,39.0,8,17,47.1,10,17,58.8,12,28,40,8,20,17,9,4,66,1
22087,515936,572_17_25,EGYPT,0,TOTALS,EGYPT,200,21,53,39.6,11,25,44.0,10,28,35.7,10,16,62.5,5,23,28,14,21,19,8,1,62,0
22088,515949,572_17_26,NIGERIA,0,TOTALS,NIGERIA,200,37,62,59.7,21,36,58.3,16,26,61.5,16,24,66.7,7,32,39,22,20,14,2,2,106,0
22089,515961,572_17_26,CAMEROON,0,TOTALS,CAMEROON,200,30,76,39.5,16,41,39.0,14,35,40.0,17,25,68.0,17,23,40,10,20,10,7,1,91,1
22090,515974,572_17_27,TUNISIA,0,TOTALS,TUNISIA,200,31,68,45.6,18,36,50.0,13,32,40.6,6,12,50.0,13,23,36,23,23,8,5,2,81,1
22091,515987,572_17_27,DEM.REP. OF CONGO,0,TOTALS,DEM.REP. OF CONGO,200,20,56,35.7,16,40,40.0,4,16,25.0,16,23,69.6,12,24,36,8,12,16,3,6,60,0
22092,516000,572_17_28,SENEGAL,0,TOTALS,SENEGAL,200,20,51,39.2,15,33,45.5,5,18,27.8,21,32,65.6,11,32,43,14,17,15,9,2,66,1
22093,516013,572_17_28,ANGOLA,0,TOTALS,ANGOLA,200,18,61,29.5,12,33,36.4,6,28,21.4,15,21,71.4,12,24,36,11,27,11,7,1,57,0
22094,516026,572_17_29,MOROCCO,0,TOTALS,MOROCCO,200,20,59,33.9,16,42,38.1,4,17,23.5,8,12,66.7,11,30,41,10,23,13,6,1,52,0
22095,516039,572_17_29,TUNISIA,0,TOTALS,TUNISIA,200,20,52,38.5,13,29,44.8,7,23,30.4,13,23,56.5,5,28,33,16,14,12,8,1,60,1
22096,516052,572_17_30,NIGERIA,0,TOTALS,NIGERIA,200,27,64,42.2,24,39,61.5,3,25,12.0,19,27,70.4,13,25,38,9,18,11,4,0,76,1
22097,516065,572_17_30,SENEGAL,0,TOTALS,SENEGAL,200,27,63,42.9,19,38,50.0,8,25,32.0,9,13,69.2,12,26,38,14,34,19,1,2,71,0
22098,516078,572_17_31,SENEGAL,0,TOTALS,SENEGAL,200,29,67,43.3,23,41,56.1,6,26,23.1,9,15,60.0,14,26,40,13,15,9,9,1,73,1
22099,516091,572_17_31,MOROCCO,0,TOTALS,MOROCCO,200,25,59,42.4,20,42,47.6,5,17,29.4,7,18,38.9,10,24,34,11,15,15,3,0,62,0
22100,516104,572_17_32,NIGERIA,0,TOTALS,NIGERIA,200,24,54,44.4,18,34,52.9,6,20,30.0,11,16,68.8,8,23,31,6,18,14,4,2,65,0
22101,516117,572_17_32,TUNISIA,0,TOTALS,TUNISIA,200,29,60,48.3,17,28,60.7,12,32,37.5,7,11,63.6,10,23,33,17,19,12,4,3,77,1
22102,516130,573_17_01,RWANDA,0,TOTALS,RWANDA,200,28,80,35.0,19,48,39.6,9,32,28.1,11,15,73.3,19,23,42,21,20,11,15,2,76,1
22103,516141,573_17_01,KENYA,0,TOTALS,KENYA,200,20,50,40.0,15,30,50.0,5,20,25.0,15,20,75.0,10,36,46,13,17,32,7,3,60,0
22104,516154,573_17_02,EGYPT,0,TOTALS,EGYPT,200,27,65,41.5,21,35,60.0,6,30,20.0,27,46,58.7,21,29,50,17,12,11,6,5,87,1
22105,516165,573_17_02,SOUTH SUDAN,0,TOTALS,SOUTH SUDAN,200,30,72,41.7,19,36,52.8,11,36,30.6,5,8,62.5,12,26,38,13,30,14,3,1,76,0
22106,516178,573_17_03,UGANDA,0,TOTALS,UGANDA,200,40,80,50.0,34,52,65.4,6,28,21.4,8,12,66.7,10,39,49,27,12,16,10,5,94,1
22107,516188,573_17_03,SOMALIA,0,TOTALS,SOMALIA,200,26,69,37.7,13,34,38.2,13,35,37.1,7,13,53.8,6,33,39,12,12,22,4,1,72,0
22108,516198,573_17_04,SOMALIA,0,TOTALS,SOMALIA,200,26,76,34.2,17,39,43.6,9,37,24.3,22,27,81.5,18,24,42,10,26,18,10,3,83,0
22109,516209,573_17_04,BURUNDI,0,TOTALS,BURUNDI,200,35,68,51.5,28,47,59.6,7,21,33.3,19,26,73.1,12,35,47,21,25,26,12,3,96,1
22110,516220,573_17_05,SOUTH SUDAN,0,TOTALS,SOUTH SUDAN,200,24,51,47.1,19,40,47.5,5,11,45.5,15,21,71.4,16,28,44,12,14,28,4,3,68,1
22111,516231,573_17_05,KENYA,0,TOTALS,KENYA,200,22,67,32.8,16,43,37.2,6,24,25.0,16,18,88.9,16,12,28,13,18,15,12,0,66,0
22112,516244,573_17_06,EGYPT,0,TOTALS,EGYPT,200,27,52,51.9,21,36,58.3,6,16,37.5,23,35,65.7,6,36,42,20,24,20,8,4,83,1
22113,516257,573_17_06,RWANDA,0,TOTALS,RWANDA,200,25,74,33.8,18,46,39.1,7,28,25.0,14,25,56.0,16,24,40,20,29,14,10,2,71,0
22114,516268,573_17_07,SOUTH SUDAN,0,TOTALS,SOUTH SUDAN,200,29,76,38.2,19,52,36.5,10,24,41.7,12,14,85.7,17,24,41,12,24,13,6,2,80,0
22115,516281,573_17_07,RWANDA,0,TOTALS,RWANDA,200,29,63,46.0,16,33,48.5,13,30,43.3,19,22,86.4,11,29,40,19,16,16,6,0,90,1
22116,516292,573_17_08,BURUNDI,0,TOTALS,BURUNDI,200,21,67,31.3,19,47,40.4,2,20,10.0,10,11,90.9,9,22,31,5,17,16,4,3,54,0
22117,516305,573_17_08,UGANDA,0,TOTALS,UGANDA,200,39,79,49.4,27,53,50.9,12,26,46.2,9,16,56.2,22,33,55,23,14,12,5,6,99,1
22118,516316,573_17_09,KENYA,0,TOTALS,KENYA,200,20,68,29.4,18,44,40.9,2,24,8.3,5,6,83.3,17,14,31,15,22,21,11,1,47,0
22119,516329,573_17_09,EGYPT,0,TOTALS,EGYPT,200,29,52,55.8,20,24,83.3,9,28,32.1,19,29,65.5,10,32,42,26,12,19,12,5,86,1
22120,516342,573_17_10,ALGERIA,0,TOTALS,ALGERIA,200,23,65,35.4,16,36,44.4,7,29,24.1,18,27,66.7,5,13,18,5,27,13,10,2,71,0
22121,516356,573_17_10,MOROCCO,0,TOTALS,MOROCCO,200,26,49,53.1,17,30,56.7,9,19,47.4,15,27,55.6,6,21,27,5,20,12,5,3,76,1
22122,516367,573_17_11,KENYA,0,TOTALS,KENYA,200,35,65,53.8,35,60,58.3,0,5,0.0,20,29,69.0,17,28,45,12,19,26,12,2,90,1
22123,516378,573_17_11,SOMALIA,0,TOTALS,SOMALIA,200,32,71,45.1,21,39,53.8,11,32,34.4,12,16,75.0,13,17,30,16,20,19,8,3,87,0
22124,516389,573_17_12,REPUBLIC OF BENIN,0,TOTALS,REPUBLIC OF BENIN,200,23,61,37.7,18,44,40.9,5,17,29.4,18,27,66.7,17,29,46,12,21,24,7,1,69,1
22125,516402,573_17_12,BURKINA FASO,0,TOTALS,BURKINA FASO,200,23,69,33.3,22,51,43.1,1,18,5.6,14,32,43.8,22,22,44,8,22,18,13,3,61,0
22126,516413,573_17_13,KENYA,0,TOTALS,KENYA,225,29,88,33.0,25,56,44.6,4,32,12.5,22,36,61.1,22,29,51,15,23,13,14,4,84,0
22127,516424,573_17_13,SOUTH SUDAN,0,TOTALS,SOUTH SUDAN,225,33,83,39.8,26,54,48.1,7,29,24.1,16,18,88.9,21,43,64,23,26,20,5,5,89,1
22128,516437,573_17_14,SENEGAL,0,TOTALS,SENEGAL,200,29,69,42.0,23,45,51.1,6,24,25.0,14,27,51.9,14,36,50,15,33,18,10,5,78,1
22129,516450,573_17_14,CAPE VERDE,0,TOTALS,CAPE VERDE,200,16,60,26.7,10,28,35.7,6,32,18.8,26,42,61.9,14,32,46,8,26,18,8,1,64,0
22130,516463,573_17_15,MOROCCO,0,TOTALS,MOROCCO,200,24,55,43.6,21,43,48.8,3,12,25.0,16,33,48.5,2,6,8,8,20,13,7,0,67,0
22131,516476,573_17_15,TUNISIA,0,TOTALS,TUNISIA,200,27,59,45.8,19,31,61.3,8,28,28.6,17,25,68.0,3,6,9,9,26,13,8,0,79,1
22132,516489,573_17_16,MALI,0,TOTALS,MALI,200,22,57,38.6,16,37,43.2,6,20,30.0,8,14,57.1,11,26,37,7,20,17,8,1,58,0
22133,516502,573_17_16,GUINEA,0,TOTALS,GUINEA,200,23,63,36.5,13,33,39.4,10,30,33.3,6,20,30.0,17,23,40,4,22,20,8,2,62,1
22134,516515,573_17_17,BURKINA FASO,0,TOTALS,BURKINA FASO,200,14,50,28.0,13,40,32.5,1,10,10.0,19,24,79.2,13,30,43,4,22,37,9,2,48,0
22135,516527,573_17_17,COTE D'IVOIRE,0,TOTALS,COTE D'IVOIRE,200,24,71,33.8,18,45,40.0,6,26,23.1,17,28,60.7,21,26,47,13,21,28,23,0,71,1
22136,516540,573_17_18,UGANDA,0,TOTALS,UGANDA,200,29,57,50.9,24,41,58.5,5,16,31.2,14,18,77.8,7,24,31,14,17,19,11,3,77,1
22137,516553,573_17_18,RWANDA,0,TOTALS,RWANDA,200,21,55,38.2,18,32,56.2,3,23,13.0,19,22,86.4,8,23,31,14,22,22,9,2,64,0
22138,516566,573_17_19,EGYPT,0,TOTALS,EGYPT,200,52,81,64.2,37,46,80.4,15,35,42.9,16,24,66.7,17,33,50,39,8,7,11,6,135,0
22139,516577,573_17_19,BURUNDI,0,TOTALS,BURUNDI,200,28,75,37.3,19,47,40.4,9,28,32.1,6,8,75.0,16,16,32,16,14,17,3,0,71,1
22140,516590,573_17_20,RWANDA,0,TOTALS,RWANDA,200,34,65,52.3,26,46,56.5,8,19,42.1,13,15,86.7,5,40,45,22,18,15,8,3,89,1
22141,516601,573_17_20,BURUNDI,0,TOTALS,BURUNDI,200,27,80,33.8,19,50,38.0,8,30,26.7,13,15,86.7,13,25,38,12,14,14,3,0,75,0
22142,516614,573_17_21,GUINEA,0,TOTALS,GUINEA,200,21,57,36.8,10,26,38.5,11,31,35.5,15,24,62.5,16,36,52,9,27,30,9,5,68,1
22143,516627,573_17_21,SENEGAL,0,TOTALS,SENEGAL,200,13,51,25.5,8,27,29.6,5,24,20.8,24,42,57.1,10,23,33,6,20,21,13,0,55,0
22144,516640,573_17_22,ALGERIA,0,TOTALS,ALGERIA,200,27,56,48.2,24,40,60.0,3,16,18.8,20,28,71.4,5,18,23,7,24,14,8,1,77,0
22145,516653,573_17_22,TUNISIA,0,TOTALS,TUNISIA,200,29,52,55.8,18,27,66.7,11,25,44.0,18,25,72.0,6,23,29,12,26,18,7,1,87,1
22146,516666,573_17_23,CAPE VERDE,0,TOTALS,CAPE VERDE,200,15,57,26.3,10,34,29.4,5,23,21.7,19,31,61.3,12,31,43,9,29,15,8,6,54,0
22147,516679,573_17_23,MALI,0,TOTALS,MALI,200,16,60,26.7,13,41,31.7,3,19,15.8,26,44,59.1,18,33,51,8,27,13,9,2,61,1
22148,516691,573_17_24,COTE D'IVOIRE,0,TOTALS,COTE D'IVOIRE,200,29,71,40.8,23,50,46.0,6,21,28.6,5,9,55.6,19,31,50,7,24,28,14,0,69,1
22149,516704,573_17_24,REPUBLIC OF BENIN,0,TOTALS,REPUBLIC OF BENIN,200,21,61,34.4,17,42,40.5,4,19,21.1,9,18,50.0,15,25,40,6,16,29,14,5,55,0
22150,516717,573_17_25,UGANDA,0,TOTALS,UGANDA,200,28,68,41.2,20,39,51.3,8,29,27.6,8,12,66.7,6,21,27,18,20,11,5,3,72,0
22151,516730,573_17_25,EGYPT,0,TOTALS,EGYPT,200,37,83,44.6,32,54,59.3,5,29,17.2,16,21,76.2,25,32,57,21,18,13,7,3,95,1
22152,516743,573_17_26,ZIMBABWE,0,TOTALS,ZIMBABWE,200,28,70,40.0,26,52,50.0,2,18,11.1,10,29,34.5,17,15,32,10,24,14,15,1,68,0
22153,516756,573_17_26,MOZAMBIQUE,0,TOTALS,MOZAMBIQUE,200,26,54,48.1,14,27,51.9,12,27,44.4,16,25,64.0,8,26,34,16,24,16,4,3,80,1
22154,516769,573_17_27,CAPE VERDE,0,TOTALS,CAPE VERDE,200,19,60,31.7,18,44,40.9,1,16,6.2,23,32,71.9,13,35,48,14,17,19,13,4,62,1
22155,516782,573_17_27,GUINEA,0,TOTALS,GUINEA,200,20,70,28.6,13,35,37.1,7,35,20.0,9,13,69.2,16,33,49,13,24,19,11,4,56,0
22156,516795,573_17_28,MOZAMBIQUE,0,TOTALS,MOZAMBIQUE,200,28,57,49.1,19,35,54.3,9,22,40.9,20,31,64.5,5,29,34,12,20,17,10,5,85,1
22157,516808,573_17_28,ZIMBABWE,0,TOTALS,ZIMBABWE,200,25,68,36.8,17,42,40.5,8,26,30.8,7,11,63.6,6,18,24,12,25,17,7,0,65,0
22158,516820,573_17_29,CAF,0,TOTALS,CAF,200,20,54,37.0,11,17,64.7,9,37,24.3,15,29,51.7,14,17,31,8,19,9,2,0,64,0
22159,516832,573_17_29,DEM.REP. OF CONGO,0,TOTALS,DEM.REP. OF CONGO,200,30,59,50.8,20,28,71.4,10,31,32.3,15,23,65.2,11,16,27,16,21,9,2,4,85,1
22160,516845,573_17_30,MALI,0,TOTALS,MALI,200,26,47,55.3,17,31,54.8,9,16,56.2,21,35,60.0,7,29,36,15,16,14,7,3,82,1
22161,516858,573_17_30,SENEGAL,0,TOTALS,SENEGAL,200,10,51,19.6,7,28,25.0,3,23,13.0,14,17,82.4,11,18,29,6,28,18,6,1,37,0
22162,516870,573_17_31,DEM.REP. OF CONGO,0,TOTALS,DEM.REP. OF CONGO,200,26,56,46.4,21,37,56.8,5,19,26.3,19,35,54.3,16,25,41,15,31,11,6,3,76,0
22163,516883,573_17_31,CAF,0,TOTALS,CAF,200,31,84,36.9,28,69,40.6,3,15,20.0,15,32,46.9,31,22,53,13,25,10,7,0,80,1
22164,516896,573_17_32,TUNISIA,0,TOTALS,TUNISIA,192,25,58,43.1,14,26,53.8,11,32,34.4,10,13,76.9,6,21,27,17,24,11,7,0,71,1
22165,516909,573_17_32,MOROCCO,0,TOTALS,MOROCCO,200,18,44,40.9,12,26,46.2,6,18,33.3,15,22,68.2,9,28,37,2,24,16,5,0,57,0
22166,516922,573_17_33,MALI,0,TOTALS,MALI,200,22,60,36.7,18,44,40.9,4,16,25.0,10,17,58.8,14,19,33,6,18,18,7,1,58,0
22167,516934,573_17_33,CAPE VERDE,0,TOTALS,CAPE VERDE,200,24,49,49.0,17,33,51.5,7,16,43.8,9,20,45.0,5,24,29,12,15,18,4,3,64,1
22168,516947,573_17_34,SENEGAL,0,TOTALS,SENEGAL,200,25,60,41.7,18,35,51.4,7,25,28.0,10,14,71.4,7,23,30,17,16,9,5,0,67,1
22169,516960,573_17_34,GUINEA,0,TOTALS,GUINEA,200,20,42,47.6,16,26,61.5,4,16,25.0,5,14,35.7,3,28,31,9,14,16,4,1,49,0
22170,516973,573_17_35,CAMEROON,0,TOTALS,CAMEROON,200,28,67,41.8,15,33,45.5,13,34,38.2,6,12,50.0,8,33,41,24,15,20,14,9,75,1
22171,516980,573_17_35,CHAD,0,TOTALS,CHAD,200,23,68,33.8,17,49,34.7,6,19,31.6,10,13,76.9,15,28,43,14,15,15,18,2,62,0
22172,516993,573_17_36,MOROCCO,0,TOTALS,MOROCCO,200,27,55,49.1,27,44,61.4,0,11,0.0,23,32,71.9,8,28,36,10,31,20,5,3,77,1
22173,517006,573_17_36,ALGERIA,0,TOTALS,ALGERIA,200,20,53,37.7,18,40,45.0,2,13,15.4,29,35,82.9,9,22,31,6,30,20,5,0,71,0
22174,517019,573_17_37,GUINEA,0,TOTALS,GUINEA,200,18,59,30.5,13,34,38.2,5,25,20.0,2,7,28.6,11,20,31,10,20,12,6,2,43,0
22175,517032,573_17_37,MALI,0,TOTALS,MALI,200,22,51,43.1,17,40,42.5,5,11,45.5,15,21,71.4,10,28,38,4,12,17,3,0,64,1
22176,517046,573_17_38,BURKINA FASO,0,TOTALS,BURKINA FASO,200,27,60,45.0,26,47,55.3,1,13,7.7,1,5,20.0,9,32,41,3,15,20,3,1,56,1
22177,517059,573_17_38,REPUBLIC OF BENIN,0,TOTALS,REPUBLIC OF BENIN,200,16,53,30.2,13,33,39.4,3,20,15.0,8,13,61.5,3,18,21,13,8,8,7,0,43,0
22178,517072,573_17_39,ZAMBIA,0,TOTALS,ZAMBIA,200,14,54,25.9,9,33,27.3,5,21,23.8,22,37,59.5,9,16,25,10,27,19,7,2,55,0
22179,517085,573_17_39,SOUTH AFRICA,0,TOTALS,SOUTH AFRICA,200,27,61,44.3,15,32,46.9,12,29,41.4,26,39,66.7,11,27,38,15,26,17,10,2,92,1
22180,517097,573_17_40,CAPE VERDE,0,TOTALS,CAPE VERDE,200,24,61,39.3,17,40,42.5,7,21,33.3,11,21,52.4,9,19,28,14,21,14,3,0,66,0
22181,517110,573_17_40,SENEGAL,0,TOTALS,SENEGAL,200,28,57,49.1,20,33,60.6,8,24,33.3,12,32,37.5,13,32,45,15,20,17,4,3,76,1
22182,517120,573_17_41,CHAD,0,TOTALS,CHAD,200,29,85,34.1,24,56,42.9,5,29,17.2,8,19,42.1,22,39,61,14,20,22,10,3,71,1
22183,517132,573_17_41,GABON,0,TOTALS,GABON,200,17,61,27.9,16,43,37.2,1,18,5.6,7,16,43.8,10,36,46,9,20,21,10,4,42,0
22184,517145,573_17_42,TUNISIA,0,TOTALS,TUNISIA,200,27,71,38.0,17,34,50.0,10,37,27.0,10,17,58.8,12,33,45,12,18,10,11,0,74,1
22185,517158,573_17_42,ALGERIA,0,TOTALS,ALGERIA,200,22,58,37.9,21,43,48.8,1,15,6.7,11,16,68.8,5,34,39,6,22,17,3,1,56,0
22186,517171,573_17_43,GUINEA,0,TOTALS,GUINEA,200,21,58,36.2,17,37,45.9,4,21,19.0,21,28,75.0,8,23,31,6,20,10,3,0,67,1
22187,517183,573_17_43,CAPE VERDE,0,TOTALS,CAPE VERDE,200,20,62,32.3,13,34,38.2,7,28,25.0,13,23,56.5,18,28,46,11,21,16,3,0,60,0
22188,517196,573_17_44,COTE D'IVOIRE,0,TOTALS,COTE D'IVOIRE,200,21,47,44.7,14,28,50.0,7,19,36.8,22,26,84.6,5,22,27,7,20,22,6,0,71,1
22189,517210,573_17_44,BURKINA FASO,0,TOTALS,BURKINA FASO,200,15,44,34.1,12,26,46.2,3,18,16.7,24,38,63.2,4,10,14,2,8,10,7,1,57,0
22190,517223,573_17_45,SOUTH AFRICA,0,TOTALS,SOUTH AFRICA,200,18,65,27.7,13,32,40.6,5,33,15.2,10,14,71.4,9,16,25,10,18,13,10,0,51,0
22191,517236,573_17_45,ANGOLA,0,TOTALS,ANGOLA,200,31,74,41.9,22,44,50.0,9,30,30.0,16,20,80.0,20,27,47,25,19,21,7,7,87,1
22192,517249,573_17_46,SENEGAL,0,TOTALS,SENEGAL,225,27,61,44.3,21,41,51.2,6,20,30.0,19,31,61.3,11,37,48,14,24,10,2,1,79,1
22193,517262,573_17_46,MALI,0,TOTALS,MALI,225,28,77,36.4,22,51,43.1,6,26,23.1,10,17,58.8,12,26,38,5,25,6,1,1,72,0
22194,517275,573_17_47,CAMEROON,0,TOTALS,CAMEROON,200,25,63,39.7,18,43,41.9,7,20,35.0,11,26,42.3,21,30,51,18,22,25,7,4,68,1
22195,517288,573_17_47,GABON,0,TOTALS,GABON,200,21,58,36.2,12,34,35.3,9,24,37.5,14,20,70.0,6,24,30,10,26,21,9,5,65,0
22196,517301,573_17_48,ZAMBIA,0,TOTALS,ZAMBIA,200,19,68,27.9,15,45,33.3,4,23,17.4,12,23,52.2,13,16,29,18,24,21,16,3,54,0
22197,517314,573_17_48,ANGOLA,0,TOTALS,ANGOLA,200,26,60,43.3,20,31,64.5,6,29,20.7,21,28,75.0,5,20,25,25,19,22,16,4,79,1
22198,517327,573_17_49,GABON,0,TOTALS,GABON,200,21,70,30.0,15,36,41.7,6,34,17.6,12,20,60.0,13,31,44,10,20,20,9,1,60,0
22199,517337,573_17_49,CHAD,0,TOTALS,CHAD,200,31,70,44.3,25,49,51.0,6,21,28.6,13,23,56.5,13,39,52,22,22,16,12,7,81,1
22200,517350,573_17_50,SOUTH AFRICA,0,TOTALS,SOUTH AFRICA,200,23,70,32.9,21,55,38.2,2,15,13.3,23,33,69.7,10,24,34,6,27,28,8,4,71,0
22201,517363,573_17_50,ZAMBIA,0,TOTALS,ZAMBIA,200,29,89,32.6,25,64,39.1,4,25,16.0,20,32,62.5,16,26,42,17,26,22,11,8,82,1
22202,517376,573_17_51,GABON,0,TOTALS,GABON,200,11,53,20.8,3,18,16.7,8,35,22.9,13,25,52.0,4,29,33,9,23,26,7,3,43,0
22203,517389,573_17_51,CAMEROON,0,TOTALS,CAMEROON,200,30,69,43.5,26,49,53.1,4,20,20.0,13,26,50.0,16,41,57,15,25,21,11,4,77,1
22204,517402,573_17_52,ANGOLA,0,TOTALS,ANGOLA,200,29,65,44.6,23,44,52.3,6,21,28.6,27,31,87.1,11,28,39,23,22,18,15,2,91,1
22205,517415,573_17_52,SOUTH AFRICA,0,TOTALS,SOUTH AFRICA,200,16,62,25.8,9,40,22.5,7,22,31.8,18,26,69.2,4,18,22,9,23,18,10,0,57,0
22206,517425,573_17_53,CHAD,0,TOTALS,CHAD,200,20,69,29.0,11,33,33.3,9,36,25.0,10,13,76.9,14,27,41,17,26,15,6,4,59,0
22207,517438,573_17_53,CAMEROON,0,TOTALS,CAMEROON,200,22,76,28.9,17,49,34.7,5,27,18.5,21,30,70.0,32,36,68,14,15,17,6,4,70,1
22208,517451,573_17_54,ANGOLA,0,TOTALS,ANGOLA,200,30,74,40.5,20,44,45.5,10,30,33.3,13,18,72.2,8,27,35,16,13,16,12,9,83,1
22209,517464,573_17_54,ZAMBIA,0,TOTALS,ZAMBIA,200,18,76,23.7,12,46,26.1,6,30,20.0,3,6,50.0,14,24,38,9,19,23,8,4,45,0
22210,517478,573_17_55,SOUTH AFRICA,0,TOTALS,SOUTH AFRICA,200,24,69,34.8,14,38,36.8,10,31,32.3,16,19,84.2,14,28,42,16,19,22,9,4,74,1
22211,517493,573_17_55,ZIMBABWE,0,TOTALS,ZIMBABWE,200,26,61,42.6,21,42,50.0,5,19,26.3,10,19,52.6,10,31,41,15,17,20,9,6,67,0
22212,517506,573_17_56,ZIMBABWE,0,TOTALS,ZIMBABWE,200,24,67,35.8,11,35,31.4,13,32,40.6,9,18,50.0,14,29,43,16,23,19,5,5,70,1
22213,517519,573_17_56,SOUTH AFRICA,0,TOTALS,SOUTH AFRICA,200,22,67,32.8,19,43,44.2,3,24,12.5,21,31,67.7,18,31,49,9,15,15,8,1,68,0
22214,517532,573_17_57,ZIMBABWE,0,TOTALS,ZIMBABWE,200,18,55,32.7,13,35,37.1,5,20,25.0,14,27,51.9,6,23,29,7,22,24,4,1,55,0
22215,517549,573_17_57,CAF,0,TOTALS,CAF,200,32,61,52.5,29,49,59.2,3,12,25.0,12,25,48.0,9,38,47,18,24,17,14,2,79,1
22216,517559,573_17_58,CHAD,0,TOTALS,CHAD,200,18,58,31.0,17,33,51.5,1,25,4.0,20,49,40.8,12,42,54,9,20,16,14,4,57,1
22217,517572,573_17_58,ZIMBABWE,0,TOTALS,ZIMBABWE,200,18,67,26.9,16,48,33.3,2,19,10.5,7,23,30.4,12,38,50,9,33,20,12,0,45,0
22218,517585,573_17_59,CAF,0,TOTALS,CAF,200,25,63,39.7,21,44,47.7,4,19,21.1,13,26,50.0,6,39,45,16,14,15,6,1,67,1
22219,517595,573_17_59,CHAD,0,TOTALS,CHAD,200,25,76,32.9,17,36,47.2,8,40,20.0,6,14,42.9,13,37,50,13,20,17,5,1,64,0
22220,519086,576_17_01,KAZAKHSTAN,0,TOTALS,KAZAKHSTAN,200,18,44,40.9,13,26,50.0,5,18,27.8,8,17,47.1,8,22,30,11,15,27,7,3,49,0
22221,519099,576_17_01,NEW ZEALAND,0,TOTALS,NEW ZEALAND,200,28,66,42.4,21,42,50.0,7,24,29.2,7,9,77.8,16,21,37,13,18,16,17,2,70,1
22222,519112,576_17_02,JAPAN,0,TOTALS,JAPAN,200,19,55,34.5,12,32,37.5,7,23,30.4,23,25,92.0,4,16,20,12,18,10,4,2,68,0
22223,519125,576_17_02,AUSTRALIA,0,TOTALS,AUSTRALIA,200,33,65,50.8,25,42,59.5,8,23,34.8,10,14,71.4,15,32,47,23,20,19,5,1,84,1
22224,519138,576_17_03,HONG KONG,0,TOTALS,HONG KONG,200,23,64,35.9,19,43,44.2,4,21,19.0,12,14,85.7,10,21,31,14,26,15,10,1,62,0
22225,519151,576_17_03,CHINESE TAIPEI,0,TOTALS,CHINESE TAIPEI,200,25,56,44.6,21,33,63.6,4,23,17.4,23,32,71.9,12,31,43,9,18,16,5,1,77,1
22226,519164,576_17_04,LEBANON,0,TOTALS,LEBANON,200,28,67,41.8,22,48,45.8,6,19,31.6,10,19,52.6,14,25,39,14,18,10,9,4,72,1
22227,519177,576_17_04,KOREA,0,TOTALS,KOREA,200,25,59,42.4,19,34,55.9,6,25,24.0,10,15,66.7,8,29,37,20,21,14,5,1,66,0
22228,519190,576_17_05,CHINA,0,TOTALS,CHINA,200,34,75,45.3,22,45,48.9,12,30,40.0,7,16,43.8,19,20,39,17,27,15,6,4,87,0
22229,519203,576_17_05,PHILIPPINES,0,TOTALS,PHILIPPINES,200,32,55,58.2,22,38,57.9,10,17,58.8,22,27,81.5,5,25,30,16,18,12,9,9,96,1
22230,519216,576_17_06,IRAN,0,TOTALS,IRAN,200,40,78,51.3,32,54,59.3,8,24,33.3,13,25,52.0,15,34,49,25,14,14,15,1,101,0
22231,519229,576_17_06,INDIA,0,TOTALS,INDIA,200,21,62,33.9,15,38,39.5,6,24,25.0,6,10,60.0,9,24,33,11,21,24,3,1,54,1
22232,519242,576_17_07,IRAQ,0,TOTALS,IRAQ,200,29,72,40.3,18,39,46.2,11,33,33.3,6,14,42.9,11,26,37,23,19,13,12,5,75,1
22233,519254,576_17_07,QATAR,0,TOTALS,QATAR,200,25,63,39.7,18,41,43.9,7,22,31.8,9,18,50.0,13,34,47,14,14,25,6,0,66,0
22234,519266,576_17_08,JORDAN,0,TOTALS,JORDAN,200,24,73,32.9,15,40,37.5,9,33,27.3,11,23,47.8,20,28,48,16,21,16,6,1,68,1
22235,519279,576_17_08,SYRIA,0,TOTALS,SYRIA,200,25,66,37.9,19,44,43.2,6,22,27.3,10,21,47.6,15,32,47,18,26,19,4,3,66,0
22236,519292,576_17_09,CHINESE TAIPEI,0,TOTALS,CHINESE TAIPEI,200,16,56,28.6,12,38,31.6,4,18,22.2,13,18,72.2,10,24,34,7,16,17,4,2,49,0
22237,519305,576_17_09,JAPAN,0,TOTALS,JAPAN,200,34,71,47.9,24,49,49.0,10,22,45.5,9,11,81.8,12,31,43,21,19,9,9,4,87,1
22238,519318,576_17_10,AUSTRALIA,0,TOTALS,AUSTRALIA,200,39,71,54.9,26,36,72.2,13,35,37.1,8,13,61.5,17,31,48,27,10,13,7,1,99,1
22239,519331,576_17_10,HONG KONG,0,TOTALS,HONG KONG,200,25,66,37.9,19,46,41.3,6,20,30.0,2,3,66.7,7,19,26,14,19,14,8,1,58,0
22240,519344,576_17_11,KOREA,0,TOTALS,KOREA,200,44,69,63.8,28,40,70.0,16,29,55.2,12,14,85.7,8,37,45,38,20,10,10,1,116,0
22241,519357,576_17_11,KAZAKHSTAN,0,TOTALS,KAZAKHSTAN,200,19,63,30.2,13,35,37.1,6,28,21.4,11,15,73.3,10,19,29,14,21,16,4,2,55,1
22242,519370,576_17_12,NEW ZEALAND,0,TOTALS,NEW ZEALAND,200,32,71,45.1,27,50,54.0,5,21,23.8,17,20,85.0,17,21,38,11,23,10,7,0,86,1
22243,519383,576_17_12,LEBANON,0,TOTALS,LEBANON,200,31,58,53.4,29,43,67.4,2,15,13.3,18,24,75.0,7,23,30,23,21,12,5,4,82,0
22244,519395,576_17_13,QATAR,0,TOTALS,QATAR,200,25,61,41.0,19,39,48.7,6,22,27.3,11,18,61.1,8,17,25,10,22,13,5,1,67,0
22245,519408,576_17_13,CHINA,0,TOTALS,CHINA,200,33,61,54.1,23,35,65.7,10,26,38.5,16,23,69.6,12,28,40,18,18,14,7,4,92,1
22246,519421,576_17_14,PHILIPPINES,0,TOTALS,PHILIPPINES,200,28,74,37.8,16,45,35.6,12,29,41.4,16,23,69.6,17,30,47,20,26,13,7,2,84,1
22247,519434,576_17_14,IRAQ,0,TOTALS,IRAQ,200,23,64,35.9,17,35,48.6,6,29,20.7,16,30,53.3,16,30,46,12,22,17,5,8,68,0
22248,519447,576_17_15,INDIA,0,TOTALS,INDIA,200,22,60,36.7,16,38,42.1,6,22,27.3,4,5,80.0,8,33,41,17,14,20,5,5,54,0
22249,519459,576_17_15,JORDAN,0,TOTALS,JORDAN,200,25,73,34.2,19,49,38.8,6,24,25.0,5,12,41.7,18,30,48,13,15,11,12,7,61,1
22250,519472,576_17_16,SYRIA,0,TOTALS,SYRIA,200,27,67,40.3,23,49,46.9,4,18,22.2,5,9,55.6,15,21,36,19,17,19,8,3,63,0
22251,519485,576_17_16,IRAN,0,TOTALS,IRAN,200,34,76,44.7,23,44,52.3,11,32,34.4,8,14,57.1,21,28,49,29,16,13,8,4,87,1
22252,519498,576_17_17,JAPAN,0,TOTALS,JAPAN,200,34,63,54.0,23,45,51.1,11,18,61.1,13,17,76.5,10,29,39,28,11,15,15,4,92,1
22253,519511,576_17_17,HONG KONG,0,TOTALS,HONG KONG,200,20,58,34.5,8,36,22.2,12,22,54.5,7,10,70.0,8,19,27,13,16,21,7,1,59,0
22254,519524,576_17_18,CHINESE TAIPEI,0,TOTALS,CHINESE TAIPEI,200,21,55,38.2,13,34,38.2,8,21,38.1,0,2,0.0,5,17,22,9,21,25,5,4,50,0
22255,519537,576_17_18,AUSTRALIA,0,TOTALS,AUSTRALIA,200,36,72,50.0,33,50,66.0,3,22,13.6,15,17,88.2,16,28,44,19,15,15,12,1,90,1
22256,519550,576_17_19,KOREA,0,TOTALS,KOREA,200,27,56,48.2,22,35,62.9,5,21,23.8,17,26,65.4,7,25,32,23,22,13,7,4,76,1
22257,519563,576_17_19,NEW ZEALAND,0,TOTALS,NEW ZEALAND,200,26,59,44.1,22,43,51.2,4,16,25.0,19,21,90.5,7,24,31,16,23,11,5,2,75,0
22258,519576,576_17_20,KAZAKHSTAN,0,TOTALS,KAZAKHSTAN,200,29,70,41.4,23,43,53.5,6,27,22.2,10,19,52.6,20,15,35,14,24,15,10,1,74,0
22259,519589,576_17_20,LEBANON,0,TOTALS,LEBANON,200,36,60,60.0,29,47,61.7,7,13,53.8,17,25,68.0,13,26,39,22,22,15,13,4,96,1
22260,519602,576_17_21,IRAQ,0,TOTALS,IRAQ,200,23,66,34.8,14,40,35.0,9,26,34.6,5,10,50.0,14,26,40,15,26,18,10,4,60,0
22261,519615,576_17_21,CHINA,0,TOTALS,CHINA,200,22,55,40.0,20,37,54.1,2,18,11.1,15,25,60.0,11,30,41,8,21,17,10,1,61,1
22262,519628,576_17_22,PHILIPPINES,0,TOTALS,PHILIPPINES,200,28,71,39.4,13,29,44.8,15,42,35.7,9,13,69.2,15,27,42,23,17,17,9,4,80,1
22263,519640,576_17_22,QATAR,0,TOTALS,QATAR,200,29,61,47.5,23,39,59.0,6,22,27.3,10,18,55.6,6,28,34,16,14,17,10,0,74,0
22264,519653,576_17_23,IRAN,0,TOTALS,IRAN,200,29,57,50.9,23,43,53.5,6,14,42.9,19,31,61.3,8,34,42,25,14,12,5,1,83,1
22265,519665,576_17_23,JORDAN,0,TOTALS,JORDAN,200,26,67,38.8,18,47,38.3,8,20,40.0,11,13,84.6,8,25,33,15,26,7,7,4,71,0
22266,519678,576_17_24,SYRIA,0,TOTALS,SYRIA,200,37,79,46.8,32,59,54.2,5,20,25.0,8,13,61.5,17,35,52,22,17,12,8,2,87,1
22267,519691,576_17_24,INDIA,0,TOTALS,INDIA,200,27,79,34.2,15,38,39.5,12,41,29.3,12,15,80.0,17,26,43,25,15,14,10,3,78,0
22268,519704,576_17_25,JAPAN,0,TOTALS,JAPAN,200,25,59,42.4,18,41,43.9,7,18,38.9,11,18,61.1,11,24,35,15,15,18,10,4,68,0
22269,519717,576_17_25,KOREA,0,TOTALS,KOREA,200,31,68,45.6,22,43,51.2,9,25,36.0,10,12,83.3,12,27,39,24,17,14,11,9,81,1
22270,519730,576_17_26,LEBANON,0,TOTALS,LEBANON,200,32,64,50.0,22,40,55.0,10,24,41.7,16,26,61.5,16,28,44,26,12,18,9,3,90,1
22271,519743,576_17_26,CHINESE TAIPEI,0,TOTALS,CHINESE TAIPEI,200,30,67,44.8,21,40,52.5,9,27,33.3,8,9,88.9,9,19,28,18,20,15,12,2,77,0
22272,519756,576_17_27,CHINA,0,TOTALS,CHINA,200,30,70,42.9,20,38,52.6,10,32,31.2,11,13,84.6,17,19,36,17,14,15,10,1,81,1
22273,519769,576_17_27,SYRIA,0,TOTALS,SYRIA,200,32,58,55.2,26,40,65.0,6,18,33.3,9,15,60.0,7,23,30,18,14,17,12,2,79,0
22274,519781,576_17_28,JORDAN,0,TOTALS,JORDAN,200,26,54,48.1,18,37,48.6,8,17,47.1,24,32,75.0,11,36,47,23,20,28,9,4,84,1
22275,519794,576_17_28,IRAQ,0,TOTALS,IRAQ,200,28,78,35.9,24,61,39.3,4,17,23.5,10,20,50.0,20,20,40,16,27,16,19,2,70,0
22276,519807,576_17_29,PHILIPPINES,0,TOTALS,PHILIPPINES,200,34,75,45.3,23,50,46.0,11,25,44.0,7,12,58.3,16,14,30,14,21,15,2,2,86,1
22277,519820,576_17_29,KOREA,0,TOTALS,KOREA,200,44,66,66.7,28,45,62.2,16,21,76.2,14,22,63.6,10,24,34,34,20,12,9,4,118,0
22278,519833,576_17_30,IRAN,0,TOTALS,IRAN,200,32,64,50.0,23,46,50.0,9,18,50.0,7,10,70.0,11,33,44,18,17,16,6,3,80,1
22279,519846,576_17_30,LEBANON,0,TOTALS,LEBANON,200,27,71,38.0,21,47,44.7,6,24,25.0,10,14,71.4,11,19,30,17,13,7,12,3,70,0
22280,519859,576_17_31,AUSTRALIA,0,TOTALS,AUSTRALIA,200,32,62,51.6,20,38,52.6,12,24,50.0,21,30,70.0,14,19,33,23,15,14,17,4,97,1
22281,519872,576_17_31,CHINA,0,TOTALS,CHINA,200,28,60,46.7,21,45,46.7,7,15,46.7,8,10,80.0,13,17,30,12,28,24,6,6,71,0
22282,519885,576_17_32,NEW ZEALAND,0,TOTALS,NEW ZEALAND,200,34,70,48.6,23,40,57.5,11,30,36.7,19,21,90.5,18,26,44,26,19,13,5,3,98,1
22283,519897,576_17_32,JORDAN,0,TOTALS,JORDAN,200,25,57,43.9,17,38,44.7,8,19,42.1,12,16,75.0,7,17,24,11,19,14,7,2,70,0
22284,519909,576_17_33,JORDAN,0,TOTALS,JORDAN,200,20,61,32.8,16,41,39.0,4,20,20.0,11,13,84.6,11,14,25,12,15,12,6,2,55,0
22285,519922,576_17_33,CHINA,0,TOTALS,CHINA,200,35,52,67.3,27,39,69.2,8,13,61.5,8,11,72.7,5,30,35,22,13,15,6,5,86,1
22286,519935,576_17_34,LEBANON,0,TOTALS,LEBANON,200,34,67,50.7,26,48,54.2,8,19,42.1,30,37,81.1,12,32,44,27,23,13,8,10,106,0
22287,519948,576_17_34,PHILIPPINES,0,TOTALS,PHILIPPINES,200,26,69,37.7,17,45,37.8,9,24,37.5,26,27,96.3,10,19,29,17,26,11,8,2,87,1
22288,519961,576_17_35,NEW ZEALAND,0,TOTALS,NEW ZEALAND,200,30,69,43.5,25,52,48.1,5,17,29.4,14,15,93.3,12,20,32,13,22,14,4,1,79,1
22289,519974,576_17_35,AUSTRALIA,0,TOTALS,AUSTRALIA,200,40,71,56.3,31,53,58.5,9,18,50.0,17,23,73.9,13,28,41,29,17,11,7,3,106,0
22290,519987,576_17_36,IRAN,0,TOTALS,IRAN,200,32,58,55.2,23,42,54.8,9,16,56.2,14,23,60.9,10,28,38,23,20,17,9,3,87,1
22291,520000,576_17_36,KOREA,0,TOTALS,KOREA,200,28,68,41.2,17,40,42.5,11,28,39.3,14,17,82.4,10,20,30,24,25,16,9,0,81,0
22292,520013,576_17_37,PHILIPPINES,0,TOTALS,PHILIPPINES,200,24,70,34.3,15,40,37.5,9,30,30.0,18,21,85.7,13,33,46,21,19,9,9,3,75,1
22293,520025,576_17_37,JORDAN,0,TOTALS,JORDAN,200,22,62,35.5,12,33,36.4,10,29,34.5,16,25,64.0,12,33,45,12,18,16,4,2,70,0
22294,520038,576_17_38,LEBANON,0,TOTALS,LEBANON,200,25,50,50.0,24,40,60.0,1,10,10.0,27,35,77.1,12,26,38,8,22,19,6,9,78,0
22295,520051,576_17_38,CHINA,0,TOTALS,CHINA,200,27,62,43.5,21,44,47.7,6,18,33.3,19,25,76.0,12,17,29,21,29,12,7,1,79,1
22296,520064,576_17_39,KOREA,0,TOTALS,KOREA,200,26,58,44.8,16,32,50.0,10,26,38.5,18,23,78.3,6,25,31,22,18,12,13,6,80,1
22297,520077,576_17_39,NEW ZEALAND,0,TOTALS,NEW ZEALAND,200,30,76,39.5,27,55,49.1,3,21,14.3,8,12,66.7,23,28,51,10,21,17,5,2,71,0
22298,520090,576_17_40,IRAN,0,TOTALS,IRAN,200,19,54,35.2,18,44,40.9,1,10,10.0,17,26,65.4,8,27,35,13,22,14,4,4,56,0
22299,520103,576_17_40,AUSTRALIA,0,TOTALS,AUSTRALIA,200,32,70,45.7,28,53,52.8,4,17,23.5,11,16,68.8,14,31,45,22,24,11,7,0,79,1
22300,520740,578_17_01,PALESTINE,0,TOTALS,PALESTINE,200,26,73,35.6,20,48,41.7,6,25,24.0,7,10,70.0,12,26,38,8,26,12,8,0,65,1
22301,520753,578_17_01,IRAN,0,TOTALS,IRAN,200,40,64,62.5,19,30,63.3,21,34,61.8,13,19,68.4,15,39,54,20,10,13,12,3,114,0
22302,520766,578_17_02,IRAQ,0,TOTALS,IRAQ,200,16,71,22.5,12,40,30.0,4,31,12.9,10,20,50.0,16,31,47,7,18,21,6,6,46,0
22303,520779,578_17_02,LEBANON,0,TOTALS,LEBANON,200,31,77,40.3,22,58,37.9,9,19,47.4,15,26,57.7,20,40,60,12,22,15,13,4,86,1
22304,520792,578_17_03,SYRIA,0,TOTALS,SYRIA,200,26,59,44.1,16,36,44.4,10,23,43.5,8,19,42.1,13,34,47,9,11,20,6,2,70,0
22305,520805,578_17_03,JORDAN,0,TOTALS,JORDAN,200,31,78,39.7,18,47,38.3,13,31,41.9,3,7,42.9,14,26,40,21,16,11,12,3,78,1
22306,520818,578_17_04,IRAN,0,TOTALS,IRAN,200,35,64,54.7,19,36,52.8,16,28,57.1,6,9,66.7,13,35,48,19,13,21,15,2,92,1
22307,520831,578_17_04,SYRIA,0,TOTALS,SYRIA,200,19,59,32.2,16,45,35.6,3,14,21.4,7,15,46.7,9,16,25,8,12,18,12,2,48,0
22308,520844,578_17_05,LEBANON,0,TOTALS,LEBANON,200,38,82,46.3,26,43,60.5,12,39,30.8,11,19,57.9,17,36,53,14,18,17,14,2,99,1
22309,520857,578_17_05,PALESTINE,0,TOTALS,PALESTINE,200,28,79,35.4,22,54,40.7,6,25,24.0,13,16,81.2,13,30,43,7,21,19,12,0,75,0
22310,520870,578_17_06,JORDAN,0,TOTALS,JORDAN,200,23,63,36.5,16,33,48.5,7,30,23.3,13,24,54.2,13,33,46,11,12,25,12,2,66,1
22311,520883,578_17_06,IRAQ,0,TOTALS,IRAQ,200,26,76,34.2,22,47,46.8,4,29,13.8,6,12,50.0,16,29,45,9,22,21,14,2,62,0
22312,520896,578_17_07,IRAQ,0,TOTALS,IRAQ,200,27,64,42.2,19,36,52.8,8,28,28.6,4,12,33.3,17,29,46,11,17,17,8,6,66,1
22313,520909,578_17_07,SYRIA,0,TOTALS,SYRIA,200,18,61,29.5,13,41,31.7,5,20,25.0,12,17,70.6,13,24,37,12,14,15,6,2,53,0
22314,520922,578_17_08,LEBANON,0,TOTALS,LEBANON,200,20,59,33.9,15,42,35.7,5,17,29.4,20,30,66.7,9,30,39,9,29,14,8,2,65,1
22315,520935,578_17_08,IRAN,0,TOTALS,IRAN,200,19,60,31.7,15,43,34.9,4,17,23.5,20,30,66.7,14,28,42,4,25,20,8,2,62,0
22316,520948,578_17_09,PALESTINE,0,TOTALS,PALESTINE,200,28,79,35.4,21,57,36.8,7,22,31.8,12,16,75.0,17,28,45,6,21,9,8,2,75,0
22317,520961,578_17_09,JORDAN,0,TOTALS,JORDAN,200,31,62,50.0,14,26,53.8,17,36,47.2,11,20,55.0,9,31,40,18,21,15,7,6,90,1
22318,520974,578_17_10,IRAN,0,TOTALS,IRAN,200,35,72,48.6,26,44,59.1,9,28,32.1,13,19,68.4,19,36,55,22,24,18,7,0,92,1
22319,520987,578_17_10,IRAQ,0,TOTALS,IRAQ,200,26,73,35.6,19,49,38.8,7,24,29.2,21,26,80.8,12,19,31,19,23,7,11,5,80,0
22320,521000,578_17_11,JORDAN,0,TOTALS,JORDAN,200,24,62,38.7,14,35,40.0,10,27,37.0,3,11,27.3,8,27,35,17,22,20,9,3,61,0
22321,521013,578_17_11,LEBANON,0,TOTALS,LEBANON,200,28,68,41.2,21,40,52.5,7,28,25.0,9,15,60.0,11,30,41,14,17,18,13,2,72,1
22322,521026,578_17_12,SYRIA,0,TOTALS,SYRIA,200,30,71,42.3,20,47,42.6,10,24,41.7,16,27,59.3,15,34,49,15,15,8,10,2,86,1
22323,521039,578_17_12,PALESTINE,0,TOTALS,PALESTINE,200,30,76,39.5,25,58,43.1,5,18,27.8,5,11,45.5,13,26,39,11,22,13,3,2,70,0
22324,521052,578_17_13,LEBANON,0,TOTALS,LEBANON,200,29,67,43.3,18,39,46.2,11,28,39.3,9,17,52.9,12,27,39,15,15,11,12,1,78,1
22325,521065,578_17_13,SYRIA,0,TOTALS,SYRIA,200,24,62,38.7,17,41,41.5,7,21,33.3,9,14,64.3,13,28,41,13,17,20,5,1,64,0
22326,521078,578_17_14,PALESTINE,0,TOTALS,PALESTINE,200,19,74,25.7,13,52,25.0,6,22,27.3,4,8,50.0,19,32,51,3,11,24,7,2,48,0
22327,521091,578_17_14,IRAQ,0,TOTALS,IRAQ,200,31,70,44.3,25,43,58.1,6,27,22.2,11,17,64.7,10,37,47,13,9,15,13,6,79,1
22328,521104,578_17_15,JORDAN,0,TOTALS,JORDAN,200,25,55,45.5,17,35,48.6,8,20,40.0,1,3,33.3,5,24,29,14,19,21,6,2,59,0
22329,521117,578_17_15,IRAN,0,TOTALS,IRAN,200,31,67,46.3,19,38,50.0,12,29,41.4,8,10,80.0,9,24,33,18,11,13,13,0,82,1
22330,521130,579_17_01,JAPAN,0,TOTALS,JAPAN,200,32,61,52.5,27,41,65.9,5,20,25.0,9,15,60.0,9,26,35,20,19,13,8,2,78,1
22331,521143,579_17_01,KOREA,0,TOTALS,KOREA,200,29,68,42.6,19,44,43.2,10,24,41.7,4,10,40.0,14,24,38,16,20,14,8,0,72,0
22332,521156,579_17_02,CHINA,0,TOTALS,CHINA,200,34,60,56.7,24,41,58.5,10,19,52.6,18,22,81.8,12,28,40,22,18,16,10,3,96,1
22333,521169,579_17_02,CHINESE TAIPEI,0,TOTALS,CHINESE TAIPEI,200,24,67,35.8,18,44,40.9,6,23,26.1,9,17,52.9,18,15,33,13,20,16,8,4,63,0
22334,521180,579_17_03,MACAU,0,TOTALS,MACAU,200,19,64,29.7,14,41,34.1,5,23,21.7,4,7,57.1,6,25,31,9,15,25,2,1,47,1
22335,521193,579_17_03,JAPAN,0,TOTALS,JAPAN,200,49,79,62.0,39,61,63.9,10,18,55.6,11,19,57.9,9,41,50,39,12,9,17,5,119,0
22336,521206,579_17_04,HONG KONG,0,TOTALS,HONG KONG,200,23,72,31.9,14,36,38.9,9,36,25.0,5,8,62.5,11,18,29,18,16,12,11,3,60,0
22337,521219,579_17_04,CHINA,0,TOTALS,CHINA,200,32,60,53.3,20,36,55.6,12,24,50.0,14,16,87.5,9,38,47,25,12,18,7,2,90,1
22338,521232,579_17_05,KOREA,0,TOTALS,KOREA,200,40,88,45.5,19,36,52.8,21,52,40.4,8,11,72.7,17,33,50,37,10,8,20,4,109,0
22339,521243,579_17_05,MACAU,0,TOTALS,MACAU,200,26,72,36.1,23,52,44.2,3,20,15.0,3,4,75.0,13,30,43,10,9,23,5,2,58,1
22340,521256,579_17_06,CHINESE TAIPEI,0,TOTALS,CHINESE TAIPEI,200,37,71,52.1,33,56,58.9,4,15,26.7,14,17,82.4,12,37,49,26,25,13,10,3,92,1
22341,521269,579_17_06,HONG KONG,0,TOTALS,HONG KONG,200,17,58,29.3,11,33,33.3,6,25,24.0,17,22,77.3,6,22,28,14,20,17,3,1,57,0
22342,521280,579_17_07,MACAU,0,TOTALS,MACAU,200,25,65,38.5,19,53,35.8,6,12,50.0,25,33,75.8,8,26,34,12,16,12,6,2,81,0
22343,521293,579_17_07,HONG KONG,0,TOTALS,HONG KONG,200,38,79,48.1,31,54,57.4,7,25,28.0,13,17,76.5,15,36,51,23,28,15,8,2,96,1
22344,521306,579_17_08,CHINA,0,TOTALS,CHINA,225,41,78,52.6,34,63,54.0,7,15,46.7,15,24,62.5,19,27,46,21,12,15,8,3,104,0
22345,521319,579_17_08,KOREA,0,TOTALS,KOREA,225,38,77,49.4,19,42,45.2,19,35,54.3,11,13,84.6,13,19,32,26,22,14,8,9,106,1
22346,521332,579_17_09,JAPAN,0,TOTALS,JAPAN,200,26,62,41.9,21,48,43.8,5,14,35.7,16,20,80.0,11,20,31,17,21,13,5,2,73,0
22347,521345,579_17_09,CHINESE TAIPEI,0,TOTALS,CHINESE TAIPEI,200,33,70,47.1,31,62,50.0,2,8,25.0,10,18,55.6,21,25,46,17,21,15,9,0,78,1
22348,521358,579_17_10,KOREA,0,TOTALS,KOREA,200,27,66,40.9,20,38,52.6,7,28,25.0,3,7,42.9,14,25,39,24,25,16,3,4,64,0
22349,521371,579_17_10,CHINESE TAIPEI,0,TOTALS,CHINESE TAIPEI,200,27,65,41.5,24,53,45.3,3,12,25.0,20,28,71.4,17,27,44,14,18,9,10,2,77,1
22350,521384,579_17_11,CHINA,0,TOTALS,CHINA,200,21,50,42.0,16,39,41.0,5,11,45.5,11,17,64.7,11,20,31,11,13,21,6,4,58,0
22351,521397,579_17_11,JAPAN,0,TOTALS,JAPAN,200,29,66,43.9,21,46,45.7,8,20,40.0,10,12,83.3,18,19,37,22,20,12,10,5,76,1
22352,521408,580_17_01,INDONESIA,0,TOTALS,INDONESIA,200,26,63,41.3,10,28,35.7,16,35,45.7,3,3,100.0,10,31,41,19,14,15,7,5,71,1
22353,521421,580_17_01,SINGAPORE,0,TOTALS,SINGAPORE,200,19,59,32.2,15,42,35.7,4,17,23.5,8,12,66.7,10,26,36,11,7,15,3,3,50,0
22354,521434,580_17_02,MALAYSIA,0,TOTALS,MALAYSIA,200,28,77,36.4,20,48,41.7,8,29,27.6,3,6,50.0,10,30,40,14,34,12,7,5,67,0
22355,521447,580_17_02,THAILAND,0,TOTALS,THAILAND,200,21,62,33.9,18,47,38.3,3,15,20.0,29,43,67.4,19,40,59,17,9,18,3,2,74,1
22356,521460,580_17_03,MYANMAR,0,TOTALS,MYANMAR,200,15,71,21.1,10,41,24.4,5,30,16.7,5,5,100.0,14,18,32,8,13,38,4,1,40,1
22357,521473,580_17_03,PHILIPPINES,0,TOTALS,PHILIPPINES,200,63,99,63.6,52,65,80.0,11,34,32.4,10,13,76.9,16,42,58,45,8,10,25,11,147,0
22358,521483,580_17_04,VIETNAM,0,TOTALS,VIETNAM,200,22,56,39.3,19,40,47.5,3,16,18.8,4,9,44.4,8,27,35,13,12,25,7,0,51,0
22359,521496,580_17_04,THAILAND,0,TOTALS,THAILAND,200,29,71,40.8,21,39,53.8,8,32,25.0,10,11,90.9,14,29,43,22,10,17,12,3,76,1
22360,521507,580_17_05,INDONESIA,0,TOTALS,INDONESIA,200,22,63,34.9,14,33,42.4,8,30,26.7,11,17,64.7,20,32,52,14,21,19,9,2,63,1
22361,521520,580_17_05,MALAYSIA,0,TOTALS,MALAYSIA,200,10,46,21.7,5,28,17.9,5,18,27.8,17,20,85.0,6,24,30,5,16,18,7,3,42,0
22362,521533,580_17_06,PHILIPPINES,0,TOTALS,PHILIPPINES,200,46,80,57.5,38,55,69.1,8,25,32.0,13,14,92.9,14,34,48,25,16,8,7,5,113,0
22363,521546,580_17_06,SINGAPORE,0,TOTALS,SINGAPORE,200,22,59,37.3,14,37,37.8,8,22,36.4,14,20,70.0,4,19,23,12,14,16,4,1,66,1
22364,521559,580_17_07,THAILAND,0,TOTALS,THAILAND,200,19,53,35.8,15,34,44.1,4,19,21.1,17,19,89.5,12,37,49,15,10,23,5,5,59,0
22365,521570,580_17_07,INDONESIA,0,TOTALS,INDONESIA,200,23,70,32.9,14,35,40.0,9,35,25.7,5,9,55.6,13,22,35,15,20,11,5,1,60,1
22366,521583,580_17_08,MYANMAR,0,TOTALS,MYANMAR,200,16,73,21.9,13,47,27.7,3,26,11.5,9,19,47.4,14,21,35,11,14,24,19,5,44,0
22367,521593,580_17_08,VIETNAM,0,TOTALS,VIETNAM,200,35,59,59.3,34,54,63.0,1,5,20.0,6,12,50.0,8,45,53,22,17,36,11,4,77,1
22368,521606,580_17_09,MALAYSIA,0,TOTALS,MALAYSIA,200,19,55,34.5,11,31,35.5,8,24,33.3,5,12,41.7,7,20,27,10,23,18,2,1,51,1
22369,521619,580_17_09,PHILIPPINES,0,TOTALS,PHILIPPINES,200,35,69,50.7,24,44,54.5,11,25,44.0,25,29,86.2,17,31,48,23,13,8,9,1,106,0
22370,521632,580_17_10,THAILAND,0,TOTALS,THAILAND,200,45,91,49.5,43,70,61.4,2,21,9.5,10,17,58.8,26,36,62,22,4,15,15,9,102,0
22371,521645,580_17_10,MYANMAR,0,TOTALS,MYANMAR,200,15,65,23.1,13,45,28.9,2,20,10.0,3,4,75.0,13,23,36,4,13,32,9,2,35,1
22372,521658,580_17_11,SINGAPORE,0,TOTALS,SINGAPORE,200,15,65,23.1,13,49,26.5,2,16,12.5,9,14,64.3,15,37,52,10,17,16,2,6,41,0
22373,521671,580_17_11,MALAYSIA,0,TOTALS,MALAYSIA,200,18,60,30.0,16,47,34.0,2,13,15.4,7,13,53.8,7,34,41,6,19,12,5,9,45,1
22374,521682,580_17_12,INDONESIA,0,TOTALS,INDONESIA,200,35,72,48.6,21,34,61.8,14,38,36.8,11,17,64.7,15,38,53,29,20,13,12,7,95,1
22375,521692,580_17_12,VIETNAM,0,TOTALS,VIETNAM,200,18,63,28.6,16,54,29.6,2,9,22.2,14,23,60.9,11,26,37,9,16,17,6,0,52,0
22376,521705,580_17_13,MYANMAR,0,TOTALS,MYANMAR,200,12,68,17.6,11,54,20.4,1,14,7.1,7,12,58.3,16,19,35,7,19,22,13,1,32,0
22377,521718,580_17_13,SINGAPORE,0,TOTALS,SINGAPORE,200,33,62,53.2,31,51,60.8,2,11,18.2,17,28,60.7,13,40,53,28,17,21,9,6,85,1
22378,521731,580_17_14,MALAYSIA,0,TOTALS,MALAYSIA,225,30,83,36.1,24,53,45.3,6,30,20.0,20,27,74.1,16,28,44,22,22,16,12,7,86,1
22379,521741,580_17_14,VIETNAM,0,TOTALS,VIETNAM,225,30,72,41.7,23,55,41.8,7,17,41.2,18,29,62.1,15,36,51,11,21,22,8,4,85,0
22380,521754,580_17_15,PHILIPPINES,0,TOTALS,PHILIPPINES,200,42,79,53.2,32,51,62.7,10,28,35.7,14,19,73.7,19,31,50,24,13,9,9,6,108,0
22381,521767,580_17_15,THAILAND,0,TOTALS,THAILAND,200,23,67,34.3,20,47,42.6,3,20,15.0,4,7,57.1,13,20,33,10,18,19,4,2,53,1
22382,521780,580_17_16,MYANMAR,0,TOTALS,MYANMAR,200,23,71,32.4,22,58,37.9,1,13,7.7,3,4,75.0,19,15,34,13,15,34,7,1,50,1
22383,521793,580_17_16,INDONESIA,0,TOTALS,INDONESIA,200,52,80,65.0,37,48,77.1,15,32,46.9,4,11,36.4,15,30,45,37,13,20,21,8,123,0
22384,521806,580_17_17,SINGAPORE,0,TOTALS,SINGAPORE,200,20,65,30.8,14,42,33.3,6,23,26.1,11,17,64.7,17,22,39,13,15,14,4,0,57,0
22385,521819,580_17_17,THAILAND,0,TOTALS,THAILAND,200,26,54,48.1,20,37,54.1,6,17,35.3,9,14,64.3,7,28,35,10,18,16,2,4,67,1
22386,521829,580_17_18,VIETNAM,0,TOTALS,VIETNAM,200,20,63,31.7,16,48,33.3,4,15,26.7,8,11,72.7,4,14,18,5,16,15,7,0,52,1
22387,521842,580_17_18,PHILIPPINES,0,TOTALS,PHILIPPINES,200,41,67,61.2,31,42,73.8,10,25,40.0,15,21,71.4,13,38,51,27,15,16,10,5,107,0
22388,521855,580_17_19,MALAYSIA,0,TOTALS,MALAYSIA,200,41,76,53.9,38,63,60.3,3,13,23.1,11,14,78.6,17,27,44,24,15,29,15,2,96,1
22389,521868,580_17_19,MYANMAR,0,TOTALS,MYANMAR,200,29,64,45.3,21,44,47.7,8,20,40.0,5,13,38.5,10,21,31,15,16,35,17,6,71,0
22390,521878,580_17_20,VIETNAM,0,TOTALS,VIETNAM,200,21,58,36.2,16,46,34.8,5,12,41.7,13,19,68.4,11,31,42,10,12,15,5,0,60,0
22391,521891,580_17_20,SINGAPORE,0,TOTALS,SINGAPORE,200,30,68,44.1,26,54,48.1,4,14,28.6,6,11,54.5,10,29,39,20,18,8,6,2,70,1
22392,521904,580_17_21,PHILIPPINES,0,TOTALS,PHILIPPINES,200,35,71,49.3,22,35,62.9,13,36,36.1,14,17,82.4,21,32,53,22,15,16,4,5,97,1
22393,521917,580_17_21,INDONESIA,0,TOTALS,INDONESIA,200,24,64,37.5,16,38,42.1,8,26,30.8,8,12,66.7,8,17,25,18,17,12,6,0,64,0
22394,521930,581_17_01,MALAYSIA,0,TOTALS,MALAYSIA,200,25,67,37.3,20,43,46.5,5,24,20.8,8,20,40.0,21,49,70,16,26,44,10,2,63,1
22395,521943,581_17_01,INDONESIA,0,TOTALS,INDONESIA,200,21,80,26.2,18,56,32.1,3,24,12.5,13,31,41.9,14,26,40,13,20,20,17,4,58,0
22396,521956,581_17_02,SINGAPORE,0,TOTALS,SINGAPORE,200,15,70,21.4,12,44,27.3,3,26,11.5,9,15,60.0,12,32,44,8,24,32,10,4,42,1
22397,521969,581_17_02,PHILIPPINES,0,TOTALS,PHILIPPINES,200,44,92,47.8,40,71,56.3,4,21,19.0,16,32,50.0,24,45,69,30,17,19,17,10,108,0
22398,521982,581_17_03,THAILAND,0,TOTALS,THAILAND,200,24,62,38.7,21,47,44.7,3,15,20.0,11,23,47.8,14,25,39,10,17,30,9,4,62,0
22399,521995,581_17_03,MALAYSIA,0,TOTALS,MALAYSIA,200,30,84,35.7,21,51,41.2,9,33,27.3,5,13,38.5,30,27,57,14,24,20,13,5,74,1
22400,522008,581_17_04,PHILIPPINES,0,TOTALS,PHILIPPINES,200,40,75,53.3,38,66,57.6,2,9,22.2,14,26,53.8,15,41,56,32,14,26,17,9,96,1
22401,522021,581_17_04,INDONESIA,0,TOTALS,INDONESIA,200,30,89,33.7,23,61,37.7,7,28,25.0,6,7,85.7,16,25,41,14,21,27,13,3,73,0
22402,522034,581_17_05,INDONESIA,0,TOTALS,INDONESIA,200,24,75,32.0,19,47,40.4,5,28,17.9,16,20,80.0,20,26,46,12,28,24,11,3,69,0
22403,522047,581_17_05,THAILAND,0,TOTALS,THAILAND,200,29,66,43.9,25,48,52.1,4,18,22.2,17,29,58.6,14,33,47,17,19,26,15,4,79,1
22404,522060,581_17_06,MALAYSIA,0,TOTALS,MALAYSIA,200,26,66,39.4,19,49,38.8,7,17,41.2,18,29,62.1,23,32,55,11,26,23,11,3,77,1
22405,522073,581_17_06,SINGAPORE,0,TOTALS,SINGAPORE,200,18,62,29.0,13,33,39.4,5,29,17.2,15,25,60.0,18,20,38,9,21,25,13,0,56,0
22406,522086,581_17_07,INDONESIA,0,TOTALS,INDONESIA,200,24,75,32.0,21,52,40.4,3,23,13.0,24,36,66.7,24,27,51,12,29,19,14,6,75,1
22407,522099,581_17_07,SINGAPORE,0,TOTALS,SINGAPORE,200,24,64,37.5,22,50,44.0,2,14,14.3,17,30,56.7,18,34,52,11,23,32,6,4,67,0
22408,522112,581_17_08,THAILAND,0,TOTALS,THAILAND,200,18,67,26.9,15,44,34.1,3,23,13.0,7,16,43.8,18,19,37,8,17,31,6,2,46,1
22409,522125,581_17_08,PHILIPPINES,0,TOTALS,PHILIPPINES,200,43,91,47.3,32,63,50.8,11,28,39.3,16,26,61.5,31,38,69,27,18,18,17,6,113,0
22410,522138,581_17_09,SINGAPORE,0,TOTALS,SINGAPORE,200,21,58,36.2,16,44,36.4,5,14,35.7,11,18,61.1,12,28,40,14,22,30,5,3,58,0
22411,522151,581_17_09,THAILAND,0,TOTALS,THAILAND,200,27,69,39.1,24,51,47.1,3,18,16.7,18,32,56.2,21,29,50,20,17,16,15,2,75,1
22412,522164,581_17_10,PHILIPPINES,0,TOTALS,PHILIPPINES,200,32,70,45.7,27,46,58.7,5,24,20.8,14,25,56.0,23,34,57,18,14,19,2,5,83,1
22413,522177,581_17_10,MALAYSIA,0,TOTALS,MALAYSIA,200,21,67,31.3,13,43,30.2,8,24,33.3,12,19,63.2,13,20,33,13,22,12,13,1,62,0
22414,522190,582_17_01,LEBANON,0,TOTALS,LEBANON,200,25,62,40.3,23,50,46.0,2,12,16.7,16,27,59.3,21,36,57,8,25,28,11,10,68,1
22415,522203,582_17_01,IRAQ,0,TOTALS,IRAQ,200,19,65,29.2,18,56,32.1,1,9,11.1,17,32,53.1,17,19,36,4,23,20,15,1,56,0
22416,522216,582_17_02,SYRIA,0,TOTALS,SYRIA,200,14,55,25.5,14,45,31.1,0,10,0.0,14,27,51.9,8,25,33,5,10,29,13,3,42,0
22417,522229,582_17_02,IRAN,0,TOTALS,IRAN,200,36,90,40.0,29,66,43.9,7,24,29.2,5,10,50.0,32,38,70,11,18,24,20,1,84,1
22418,522241,582_17_03,JORDAN,0,TOTALS,JORDAN,200,17,67,25.4,17,54,31.5,0,13,0.0,13,30,43.3,21,31,52,2,17,30,8,0,47,0
22419,522254,582_17_03,LEBANON,0,TOTALS,LEBANON,200,33,87,37.9,30,68,44.1,3,19,15.8,9,18,50.0,27,37,64,9,26,23,16,10,78,1
22420,522267,582_17_04,IRAQ,0,TOTALS,IRAQ,200,29,75,38.7,24,49,49.0,5,26,19.2,6,17,35.3,9,29,38,9,29,17,15,1,69,0
22421,522280,582_17_04,SYRIA,0,TOTALS,SYRIA,200,24,69,34.8,19,52,36.5,5,17,29.4,21,33,63.6,20,42,62,6,19,24,5,4,74,1
22422,522293,582_17_05,SYRIA,0,TOTALS,SYRIA,200,29,72,40.3,23,47,48.9,6,25,24.0,10,19,52.6,17,39,56,12,16,23,8,4,74,1
22423,522305,582_17_05,JORDAN,0,TOTALS,JORDAN,200,26,74,35.1,21,55,38.2,5,19,26.3,6,15,40.0,12,31,43,13,20,20,13,1,63,0
22424,522318,582_17_06,IRAN,0,TOTALS,IRAN,200,32,71,45.1,27,55,49.1,5,16,31.2,16,23,69.6,19,41,60,10,25,20,13,2,85,1
22425,522331,582_17_06,IRAQ,0,TOTALS,IRAQ,200,18,61,29.5,12,41,29.3,6,20,30.0,16,27,59.3,7,25,32,3,18,16,10,2,58,0
22426,522344,582_17_07,LEBANON,0,TOTALS,LEBANON,200,41,83,49.4,30,62,48.4,11,21,52.4,13,25,52.0,21,31,52,20,29,23,11,10,106,0
22427,522357,582_17_07,SYRIA,0,TOTALS,SYRIA,200,30,76,39.5,27,64,42.2,3,12,25.0,17,31,54.8,20,25,45,6,23,23,7,2,80,1
22428,522369,582_17_08,JORDAN,0,TOTALS,JORDAN,200,18,63,28.6,10,41,24.4,8,22,36.4,9,21,42.9,16,20,36,6,8,21,5,3,53,0
22429,522382,582_17_08,IRAN,0,TOTALS,IRAN,200,40,82,48.8,33,58,56.9,7,24,29.2,7,10,70.0,22,32,54,16,18,14,14,8,94,1
22430,522395,582_17_09,IRAQ,0,TOTALS,IRAQ,200,20,83,24.1,17,58,29.3,3,25,12.0,13,19,68.4,25,26,51,8,26,17,16,1,56,0
22431,522407,582_17_09,JORDAN,0,TOTALS,JORDAN,200,20,57,35.1,20,47,42.6,0,10,0.0,21,34,61.8,16,40,56,5,18,26,4,5,61,1
22432,522420,582_17_10,IRAN,0,TOTALS,IRAN,200,27,74,36.5,18,56,32.1,9,18,50.0,9,19,47.4,17,33,50,7,27,18,11,1,72,1
22433,522433,582_17_10,LEBANON,0,TOTALS,LEBANON,200,18,64,28.1,17,51,33.3,1,13,7.7,27,33,81.8,15,37,52,6,15,18,15,5,64,0
22434,522446,583_17_01,PUERTO RICO,0,TOTALS,PUERTO RICO,200,22,56,39.3,15,36,41.7,7,20,35.0,15,23,65.2,11,34,45,18,19,16,4,3,66,0
22435,522459,583_17_01,MEXICO,0,TOTALS,MEXICO,200,26,72,36.1,18,47,38.3,8,25,32.0,9,17,52.9,14,26,40,13,21,10,9,6,69,1
22436,522472,583_17_02,BRAZIL,0,TOTALS,BRAZIL,200,23,55,41.8,15,30,50.0,8,25,32.0,22,28,78.6,10,33,43,18,22,17,5,3,76,1
22437,522485,583_17_02,COLOMBIA,0,TOTALS,COLOMBIA,200,27,69,39.1,22,51,43.1,5,18,27.8,15,23,65.2,13,26,39,13,25,12,8,1,74,0
22438,522498,583_17_03,MEXICO,0,TOTALS,MEXICO,200,41,72,56.9,33,55,60.0,8,17,47.1,9,14,64.3,11,26,37,20,25,15,12,1,99,1
22439,522511,583_17_03,BRAZIL,0,TOTALS,BRAZIL,200,27,57,47.4,21,39,53.8,6,18,33.3,16,27,59.3,8,22,30,19,20,19,7,1,76,0
22440,522524,583_17_04,COLOMBIA,0,TOTALS,COLOMBIA,200,27,76,35.5,17,43,39.5,10,33,30.3,8,10,80.0,18,22,40,16,17,16,7,1,72,0
22441,522537,583_17_04,PUERTO RICO,0,TOTALS,PUERTO RICO,200,34,62,54.8,20,38,52.6,14,24,58.3,9,15,60.0,8,30,38,21,19,17,7,5,91,1
22442,522550,583_17_05,BRAZIL,0,TOTALS,BRAZIL,200,24,58,41.4,17,36,47.2,7,22,31.8,25,37,67.6,7,27,34,20,30,16,7,3,80,0
22443,522563,583_17_05,PUERTO RICO,0,TOTALS,PUERTO RICO,200,27,62,43.5,19,44,43.2,8,18,44.4,27,36,75.0,13,33,46,17,29,17,13,5,89,1
22444,522576,583_17_06,MEXICO,0,TOTALS,MEXICO,200,29,64,45.3,25,44,56.8,4,20,20.0,20,23,87.0,9,33,42,17,25,15,9,3,82,1
22445,522589,583_17_06,COLOMBIA,0,TOTALS,COLOMBIA,200,24,67,35.8,18,48,37.5,6,19,31.6,16,26,61.5,16,26,42,15,24,16,9,3,70,0
22446,522602,583_17_07,VIRGIN ISLANDS,0,TOTALS,VIRGIN ISLANDS,200,28,65,43.1,17,39,43.6,11,26,42.3,16,21,76.2,8,38,46,15,17,13,5,6,83,1
22447,522615,583_17_07,CANADA,0,TOTALS,CANADA,200,24,76,31.6,17,44,38.6,7,32,21.9,16,19,84.2,16,29,45,13,20,8,5,5,71,0
22448,522628,583_17_08,ARGENTINA,0,TOTALS,ARGENTINA,200,26,61,42.6,22,37,59.5,4,24,16.7,11,14,78.6,10,23,33,16,17,14,9,5,67,1
22449,522641,583_17_08,VENEZUELA,0,TOTALS,VENEZUELA,200,23,59,39.0,20,44,45.5,3,15,20.0,13,14,92.9,14,24,38,11,20,19,12,1,62,0
22450,522654,583_17_09,USA,0,TOTALS,USA,200,34,67,50.7,23,35,65.7,11,32,34.4,18,21,85.7,10,36,46,29,25,13,14,3,97,1
22451,522667,583_17_09,PANAMA,0,TOTALS,PANAMA,200,18,62,29.0,14,40,35.0,4,22,18.2,16,26,61.5,13,23,36,14,19,18,4,0,56,0
22452,522680,583_17_10,CANADA,0,TOTALS,CANADA,225,32,72,44.4,25,49,51.0,7,23,30.4,15,19,78.9,9,39,48,9,24,14,4,3,86,0
22453,522693,583_17_10,ARGENTINA,0,TOTALS,ARGENTINA,225,32,74,43.2,20,36,55.6,12,38,31.6,16,24,66.7,8,32,40,19,20,8,10,1,92,1
22454,522706,583_17_11,DOMINICAN REPUBLIC,0,TOTALS,DOMINICAN REPUBLIC,200,23,61,37.7,19,41,46.3,4,20,20.0,7,14,50.0,13,28,41,10,20,18,7,2,57,0
22455,522719,583_17_11,URUGUAY,0,TOTALS,URUGUAY,200,25,57,43.9,16,33,48.5,9,24,37.5,7,14,50.0,7,26,33,16,17,15,5,2,66,1
22456,522732,583_17_12,VENEZUELA,0,TOTALS,VENEZUELA,200,33,68,48.5,26,43,60.5,7,25,28.0,13,26,50.0,16,22,38,19,24,10,7,2,86,1
22457,522745,583_17_12,VIRGIN ISLANDS,0,TOTALS,VIRGIN ISLANDS,200,29,55,52.7,20,38,52.6,9,17,52.9,17,22,77.3,5,23,28,13,21,11,1,2,84,0
22458,522758,583_17_13,PANAMA,0,TOTALS,PANAMA,200,25,54,46.3,21,35,60.0,4,19,21.1,10,19,52.6,5,26,31,11,26,17,5,3,64,0
22459,522771,583_17_13,DOMINICAN REPUBLIC,0,TOTALS,DOMINICAN REPUBLIC,200,30,70,42.9,22,36,61.1,8,34,23.5,18,27,66.7,20,28,48,18,20,14,9,1,86,1
22460,522784,583_17_14,VENEZUELA,0,TOTALS,VENEZUELA,200,25,66,37.9,18,40,45.0,7,26,26.9,9,14,64.3,12,25,37,14,20,11,7,3,66,0
22461,522797,583_17_14,CANADA,0,TOTALS,CANADA,200,29,63,46.0,22,40,55.0,7,23,30.4,10,14,71.4,8,31,39,14,16,12,6,7,75,1
22462,522810,583_17_15,URUGUAY,0,TOTALS,URUGUAY,200,26,70,37.1,23,47,48.9,3,23,13.0,11,19,57.9,15,28,43,9,22,13,6,1,66,0
22463,522823,583_17_15,USA,0,TOTALS,USA,200,28,69,40.6,19,41,46.3,9,28,32.1,9,13,69.2,15,32,47,16,24,13,2,1,74,1
22464,522836,583_17_16,VIRGIN ISLANDS,0,TOTALS,VIRGIN ISLANDS,200,19,58,32.8,15,40,37.5,4,18,22.2,16,23,69.6,12,25,37,12,17,25,4,2,58,1
22465,522849,583_17_16,ARGENTINA,0,TOTALS,ARGENTINA,200,38,70,54.3,25,36,69.4,13,34,38.2,15,17,88.2,6,30,36,29,20,12,17,5,104,0
22466,522862,583_17_17,DOMINICAN REPUBLIC,0,TOTALS,DOMINICAN REPUBLIC,200,21,69,30.4,16,39,41.0,5,30,16.7,9,13,69.2,16,24,40,9,21,17,5,3,56,0
22467,522875,583_17_17,USA,0,TOTALS,USA,200,27,57,47.4,24,41,58.5,3,16,18.8,15,20,75.0,6,33,39,15,19,13,7,1,72,1
22468,522888,583_17_18,PANAMA,0,TOTALS,PANAMA,200,26,66,39.4,19,45,42.2,7,21,33.3,9,11,81.8,12,28,40,14,17,21,9,4,68,0
22469,522901,583_17_18,URUGUAY,0,TOTALS,URUGUAY,200,28,61,45.9,15,31,48.4,13,30,43.3,10,16,62.5,6,26,32,20,13,18,9,4,79,1
22470,522914,583_17_19,USA,0,TOTALS,USA,200,32,66,48.5,24,38,63.2,8,28,28.6,18,25,72.0,9,41,50,22,13,10,7,5,90,1
22471,522927,583_17_19,VIRGIN ISLANDS,0,TOTALS,VIRGIN ISLANDS,200,24,72,33.3,17,46,37.0,7,26,26.9,7,9,77.8,8,25,33,17,18,11,3,2,62,0
22472,522940,583_17_20,ARGENTINA,0,TOTALS,ARGENTINA,200,35,65,53.8,27,43,62.8,8,22,36.4,6,9,66.7,6,34,40,27,19,19,8,1,84,1
22473,522953,583_17_20,MEXICO,0,TOTALS,MEXICO,200,25,62,40.3,20,40,50.0,5,22,22.7,12,18,66.7,5,25,30,10,16,13,10,6,67,0
22474,522966,583_17_21,VIRGIN ISLANDS,0,TOTALS,VIRGIN ISLANDS,200,25,69,36.2,16,42,38.1,9,27,33.3,6,7,85.7,5,25,30,12,25,11,3,5,65,0
22475,522979,583_17_21,MEXICO,0,TOTALS,MEXICO,200,26,65,40.0,20,45,44.4,6,20,30.0,21,29,72.4,16,38,54,17,16,16,6,1,79,1
22476,522992,583_17_22,USA,0,TOTALS,USA,200,29,66,43.9,19,49,38.8,10,17,58.8,13,23,56.5,1,33,34,17,19,7,7,2,81,1
22477,523005,583_17_22,ARGENTINA,0,TOTALS,ARGENTINA,200,28,66,42.4,19,37,51.4,9,29,31.0,11,13,84.6,6,34,40,16,26,13,3,7,76,0
22478,524015,586_17_01,VENEZUELA,0,TOTALS,VENEZUELA,200,24,51,47.1,20,37,54.1,4,14,28.6,12,28,42.9,6,25,31,7,20,22,20,2,64,0
22479,524028,586_17_01,PARAGUAY,0,TOTALS,PARAGUAY,200,27,55,49.1,21,38,55.3,6,17,35.3,10,19,52.6,7,31,38,9,22,25,8,3,70,1
22480,524041,586_17_02,USA,0,TOTALS,USA,200,40,77,51.9,30,50,60.0,10,27,37.0,20,28,71.4,18,34,52,20,18,22,16,6,110,0
22481,524054,586_17_02,PUERTO RICO,0,TOTALS,PUERTO RICO,200,25,66,37.9,19,46,41.3,6,20,30.0,13,21,61.9,12,22,34,12,24,30,10,0,69,1
22482,524067,586_17_03,MEXICO,0,TOTALS,MEXICO,200,18,61,29.5,15,40,37.5,3,21,14.3,6,13,46.2,13,24,37,8,17,30,12,1,45,0
22483,524080,586_17_03,DOMINICAN REPUBLIC,0,TOTALS,DOMINICAN REPUBLIC,200,35,74,47.3,30,56,53.6,5,18,27.8,11,14,78.6,14,32,46,10,16,23,16,2,86,1
22484,524093,586_17_04,CANADA,0,TOTALS,CANADA,200,27,66,40.9,22,45,48.9,5,21,23.8,16,26,61.5,17,28,45,6,18,13,8,3,75,1
22485,524106,586_17_04,ARGENTINA,0,TOTALS,ARGENTINA,200,23,61,37.7,17,38,44.7,6,23,26.1,9,11,81.8,11,26,37,11,18,19,5,2,61,0
22486,524119,586_17_05,PUERTO RICO,0,TOTALS,PUERTO RICO,200,30,66,45.5,24,51,47.1,6,15,40.0,15,28,53.6,11,21,32,10,22,13,8,2,81,1
22487,524132,586_17_05,MEXICO,0,TOTALS,MEXICO,200,23,54,42.6,11,23,47.8,12,31,38.7,10,20,50.0,8,22,30,13,24,16,2,0,68,0
22488,524145,586_17_06,PARAGUAY,0,TOTALS,PARAGUAY,200,29,64,45.3,25,44,56.8,4,20,20.0,9,15,60.0,6,23,29,15,24,17,7,1,71,0
22489,524158,586_17_06,CANADA,0,TOTALS,CANADA,200,28,60,46.7,24,45,53.3,4,15,26.7,19,32,59.4,13,31,44,9,17,21,6,4,79,1
22490,524171,586_17_07,DOMINICAN REPUBLIC,0,TOTALS,DOMINICAN REPUBLIC,200,17,65,26.2,17,49,34.7,0,16,0.0,11,16,68.8,13,19,32,5,22,22,8,0,45,0
22491,524184,586_17_07,USA,0,TOTALS,USA,200,38,72,52.8,33,52,63.5,5,20,25.0,13,20,65.0,16,35,51,16,21,20,14,6,94,1
22492,524197,586_17_08,ARGENTINA,0,TOTALS,ARGENTINA,200,17,56,30.4,13,37,35.1,4,19,21.1,8,20,40.0,12,32,44,9,18,22,14,4,46,1
22493,524210,586_17_08,VENEZUELA,0,TOTALS,VENEZUELA,200,13,58,22.4,11,39,28.2,2,19,10.5,11,23,47.8,16,33,49,2,16,22,10,1,39,0
22494,524223,586_17_09,USA,0,TOTALS,USA,200,47,79,59.5,44,67,65.7,3,12,25.0,30,39,76.9,11,32,43,24,11,13,15,2,127,0
22495,524236,586_17_09,MEXICO,0,TOTALS,MEXICO,200,21,62,33.9,17,41,41.5,4,21,19.0,6,10,60.0,9,18,27,8,27,25,8,1,52,1
22496,524249,586_17_10,DOMINICAN REPUBLIC,0,TOTALS,DOMINICAN REPUBLIC,200,30,75,40.0,23,54,42.6,7,21,33.3,21,30,70.0,16,30,46,12,19,12,4,2,88,0
22497,524262,586_17_10,PUERTO RICO,0,TOTALS,PUERTO RICO,200,35,73,47.9,27,46,58.7,8,27,29.6,16,23,69.6,11,29,40,16,22,13,7,4,94,1
22498,524275,586_17_11,CANADA,0,TOTALS,CANADA,200,31,61,50.8,23,43,53.5,8,18,44.4,10,17,58.8,10,38,48,13,14,17,9,5,80,1
22499,524288,586_17_11,VENEZUELA,0,TOTALS,VENEZUELA,200,17,61,27.9,13,36,36.1,4,25,16.0,5,16,31.2,10,23,33,4,14,14,9,2,43,0
22500,524301,586_17_12,PARAGUAY,0,TOTALS,PARAGUAY,200,17,60,28.3,12,38,31.6,5,22,22.7,13,17,76.5,10,30,40,6,21,11,3,5,52,0
22501,524314,586_17_12,ARGENTINA,0,TOTALS,ARGENTINA,200,22,57,38.6,15,33,45.5,7,24,29.2,20,25,80.0,7,33,40,12,19,12,3,5,71,1
22502,524327,586_17_13,DOMINICAN REPUBLIC,0,TOTALS,DOMINICAN REPUBLIC,200,24,48,50.0,19,38,50.0,5,10,50.0,18,32,56.2,5,26,31,12,23,29,6,3,71,1
22503,524340,586_17_13,VENEZUELA,0,TOTALS,VENEZUELA,200,22,55,40.0,21,38,55.3,1,17,5.9,12,27,44.4,10,22,32,8,21,17,19,3,57,0
22504,524353,586_17_14,PARAGUAY,0,TOTALS,PARAGUAY,200,22,50,44.0,18,36,50.0,4,14,28.6,12,16,75.0,4,23,27,9,21,17,9,2,60,0
22505,524366,586_17_14,MEXICO,0,TOTALS,MEXICO,200,25,62,40.3,18,42,42.9,7,20,35.0,14,23,60.9,14,25,39,14,21,17,11,5,71,1
22506,524379,586_17_15,CANADA,0,TOTALS,CANADA,200,31,70,44.3,26,47,55.3,5,23,21.7,14,27,51.9,21,45,66,11,14,22,3,10,81,1
22507,524392,586_17_15,PUERTO RICO,0,TOTALS,PUERTO RICO,200,28,86,32.6,27,69,39.1,1,17,5.9,9,10,90.0,12,24,36,7,21,6,12,2,66,0
22508,524405,586_17_16,USA,0,TOTALS,USA,200,45,75,60.0,39,56,69.6,6,19,31.6,25,40,62.5,18,32,50,15,26,21,26,4,121,0
22509,524418,586_17_16,ARGENTINA,0,TOTALS,ARGENTINA,200,14,48,29.2,9,25,36.0,5,23,21.7,16,27,59.3,5,18,23,8,32,38,7,2,49,1
22510,524431,586_17_17,PARAGUAY,0,TOTALS,PARAGUAY,200,19,64,29.7,14,40,35.0,5,24,20.8,6,10,60.0,18,23,41,10,12,16,7,3,49,0
22511,524444,586_17_17,VENEZUELA,0,TOTALS,VENEZUELA,200,19,47,40.4,13,29,44.8,6,18,33.3,9,16,56.2,7,27,34,8,10,17,11,3,53,1
22512,524457,586_17_18,MEXICO,0,TOTALS,MEXICO,200,20,64,31.2,17,52,32.7,3,12,25.0,8,15,53.3,10,25,35,13,19,12,11,3,51,0
22513,524470,586_17_18,DOMINICAN REPUBLIC,0,TOTALS,DOMINICAN REPUBLIC,200,26,68,38.2,25,55,45.5,1,13,7.7,18,26,69.2,19,36,55,12,20,19,6,4,71,1
22514,524483,586_17_19,PUERTO RICO,0,TOTALS,PUERTO RICO,200,27,60,45.0,16,37,43.2,11,23,47.8,13,19,68.4,8,26,34,15,15,18,15,2,78,1
22515,524496,586_17_19,ARGENTINA,0,TOTALS,ARGENTINA,200,26,66,39.4,19,36,52.8,7,30,23.3,8,13,61.5,16,26,42,17,19,23,13,3,67,0
22516,524509,586_17_20,CANADA,0,TOTALS,CANADA,200,21,71,29.6,9,38,23.7,12,33,36.4,6,6,100.0,19,20,39,8,13,21,3,2,60,1
22517,524522,586_17_20,USA,0,TOTALS,USA,200,45,75,60.0,36,59,61.0,9,16,56.2,12,15,80.0,11,30,41,24,12,11,12,5,111,0
22518,525045,588_17_01,PARAGUAY,0,TOTALS,PARAGUAY,200,27,73,37.0,20,53,37.7,7,20,35.0,10,24,41.7,19,26,45,17,16,14,19,2,71,1
22519,525058,588_17_01,BOLIVIA,0,TOTALS,BOLIVIA,200,13,50,26.0,10,30,33.3,3,20,15.0,6,13,46.2,12,31,43,4,19,33,8,7,35,0
22520,525071,588_17_02,ECUADOR,0,TOTALS,ECUADOR,200,22,60,36.7,20,48,41.7,2,12,16.7,2,5,40.0,9,31,40,8,17,26,6,6,48,0
22521,525084,588_17_02,ARGENTINA,0,TOTALS,ARGENTINA,200,26,79,32.9,23,51,45.1,3,28,10.7,9,13,69.2,23,32,55,11,14,18,13,0,64,1
22522,525097,588_17_03,URUGUAY,0,TOTALS,URUGUAY,200,16,67,23.9,14,44,31.8,2,23,8.7,18,32,56.2,24,35,59,7,23,22,14,6,52,0
22523,525110,588_17_03,ECUADOR,0,TOTALS,ECUADOR,200,22,71,31.0,16,54,29.6,6,17,35.3,8,14,57.1,18,32,50,9,24,21,8,2,58,1
22524,525123,588_17_04,ARGENTINA,0,TOTALS,ARGENTINA,200,28,65,43.1,21,38,55.3,7,27,25.9,14,20,70.0,16,34,50,25,21,23,18,1,77,1
22525,525136,588_17_04,PARAGUAY,0,TOTALS,PARAGUAY,200,15,53,28.3,12,32,37.5,3,21,14.3,10,15,66.7,6,24,30,7,19,29,9,3,43,0
22526,525149,588_17_05,COLOMBIA,0,TOTALS,COLOMBIA,200,26,68,38.2,21,41,51.2,5,27,18.5,2,11,18.2,11,20,31,14,26,35,21,8,59,1
22527,525162,588_17_05,VENEZUELA,0,TOTALS,VENEZUELA,200,20,54,37.0,18,43,41.9,2,11,18.2,16,35,45.7,24,33,57,11,14,40,15,2,58,0
22528,525175,588_17_06,CHILE,0,TOTALS,CHILE,200,40,96,41.7,40,81,49.4,0,15,0.0,20,38,52.6,34,37,71,23,10,13,27,4,100,0
22529,525188,588_17_06,PERU,0,TOTALS,PERU,200,11,57,19.3,7,31,22.6,4,26,15.4,9,11,81.8,11,29,40,4,22,37,6,5,35,1
22530,525201,588_17_07,VENEZUELA,0,TOTALS,VENEZUELA,200,18,56,32.1,13,37,35.1,5,19,26.3,17,25,68.0,11,30,41,10,22,27,17,5,58,0
22531,525214,588_17_07,CHILE,0,TOTALS,CHILE,200,25,61,41.0,19,41,46.3,6,20,30.0,15,23,65.2,10,28,38,15,17,22,18,6,71,1
22532,525227,588_17_08,BOLIVIA,0,TOTALS,BOLIVIA,200,10,57,17.5,7,38,18.4,3,19,15.8,6,10,60.0,14,19,33,8,20,38,14,1,29,0
22533,525240,588_17_08,ARGENTINA,0,TOTALS,ARGENTINA,200,38,78,48.7,31,58,53.4,7,20,35.0,8,22,36.4,23,35,58,24,16,27,19,7,91,1
22534,525253,588_17_09,PARAGUAY,0,TOTALS,PARAGUAY,200,25,58,43.1,19,43,44.2,6,15,40.0,10,18,55.6,12,27,39,16,17,23,11,1,66,1
22535,525266,588_17_09,URUGUAY,0,TOTALS,URUGUAY,200,20,65,30.8,18,46,39.1,2,19,10.5,15,21,71.4,21,23,44,7,20,23,8,1,57,0
22536,525279,588_17_10,COLOMBIA,0,TOTALS,COLOMBIA,200,34,77,44.2,25,45,55.6,9,32,28.1,8,18,44.4,17,39,56,23,13,22,21,2,85,1
22537,525292,588_17_10,PERU,0,TOTALS,PERU,200,10,54,18.5,5,21,23.8,5,33,15.2,9,13,69.2,6,29,35,10,13,33,5,6,34,0
22538,525305,588_17_11,CHILE,0,TOTALS,CHILE,200,29,66,43.9,21,42,50.0,8,24,33.3,17,29,58.6,15,36,51,20,15,20,12,6,83,1
22539,525318,588_17_11,COLOMBIA,0,TOTALS,COLOMBIA,200,17,65,26.2,13,44,29.5,4,21,19.0,11,18,61.1,13,27,40,11,28,23,8,5,49,0
22540,525331,588_17_12,ECUADOR,0,TOTALS,ECUADOR,200,18,58,31.0,14,38,36.8,4,20,20.0,10,17,58.8,7,36,43,7,15,18,8,4,50,1
22541,525344,588_17_12,PARAGUAY,0,TOTALS,PARAGUAY,200,17,66,25.8,12,36,33.3,5,30,16.7,7,10,70.0,15,33,48,9,15,20,9,2,46,0
22542,525357,588_17_13,URUGUAY,0,TOTALS,URUGUAY,200,32,65,49.2,25,52,48.1,7,13,53.8,17,27,63.0,13,27,40,16,13,16,17,0,88,1
22543,525370,588_17_13,BOLIVIA,0,TOTALS,BOLIVIA,200,20,51,39.2,14,25,56.0,6,26,23.1,2,6,33.3,8,23,31,8,20,30,5,3,48,0
22544,525383,588_17_14,PERU,0,TOTALS,PERU,200,12,46,26.1,10,21,47.6,2,25,8.0,5,6,83.3,2,28,30,6,16,34,11,11,31,0
22545,525396,588_17_14,VENEZUELA,0,TOTALS,VENEZUELA,200,27,83,32.5,20,60,33.3,7,23,30.4,9,18,50.0,36,31,67,15,13,26,25,1,70,1
22546,525409,588_17_15,BOLIVIA,0,TOTALS,BOLIVIA,200,18,60,30.0,12,32,37.5,6,28,21.4,4,15,26.7,17,34,51,11,13,35,9,4,46,0
22547,525422,588_17_15,ECUADOR,0,TOTALS,ECUADOR,200,26,73,35.6,23,55,41.8,3,18,16.7,2,10,20.0,17,30,47,11,17,19,18,1,57,1
22548,525435,588_17_16,ARGENTINA,0,TOTALS,ARGENTINA,200,30,61,49.2,15,35,42.9,15,26,57.7,9,10,90.0,12,28,40,24,20,23,12,7,84,1
22549,525448,588_17_16,URUGUAY,0,TOTALS,URUGUAY,200,23,67,34.3,16,45,35.6,7,22,31.8,12,13,92.3,14,18,32,10,13,18,15,4,65,0
22550,525461,588_17_17,VENEZUELA,0,TOTALS,VENEZUELA,200,25,67,37.3,21,50,42.0,4,17,23.5,12,25,48.0,18,22,40,20,26,19,19,5,66,0
22551,525474,588_17_17,URUGUAY,0,TOTALS,URUGUAY,200,24,54,44.4,18,31,58.1,6,23,26.1,19,29,65.5,13,27,40,15,20,26,12,6,73,1
22552,525487,588_17_18,PARAGUAY,0,TOTALS,PARAGUAY,200,29,75,38.7,21,42,50.0,8,33,24.2,14,21,66.7,17,37,54,20,14,19,20,4,80,1
22553,525500,588_17_18,PERU,0,TOTALS,PERU,200,13,59,22.0,10,30,33.3,3,29,10.3,9,14,64.3,12,31,43,10,15,29,13,3,38,0
22554,525513,588_17_19,CHILE,0,TOTALS,CHILE,200,29,72,40.3,25,52,48.1,4,20,20.0,12,19,63.2,18,32,50,13,12,14,7,11,74,1
22555,525526,588_17_19,ECUADOR,0,TOTALS,ECUADOR,200,23,80,28.7,18,62,29.0,5,18,27.8,9,9,100.0,25,26,51,13,19,17,4,3,60,0
22556,525539,588_17_20,ARGENTINA,0,TOTALS,ARGENTINA,200,24,62,38.7,20,39,51.3,4,23,17.4,16,24,66.7,14,38,52,13,16,20,13,6,68,1
22557,525552,588_17_20,COLOMBIA,0,TOTALS,COLOMBIA,200,18,65,27.7,12,43,27.9,6,22,27.3,5,15,33.3,14,26,40,8,19,24,13,0,47,0
22558,525565,588_17_21,ECUADOR,0,TOTALS,ECUADOR,200,29,70,41.4,18,49,36.7,11,21,52.4,11,13,84.6,15,31,46,19,18,22,13,4,80,1
22559,525578,588_17_21,COLOMBIA,0,TOTALS,COLOMBIA,200,24,74,32.4,18,48,37.5,6,26,23.1,9,17,52.9,21,26,47,13,15,24,12,3,63,0
22560,525591,588_17_22,VENEZUELA,0,TOTALS,VENEZUELA,200,33,88,37.5,27,63,42.9,6,25,24.0,12,20,60.0,36,35,71,18,6,17,18,5,84,1
22561,525604,588_17_22,PERU,0,TOTALS,PERU,200,14,55,25.5,11,34,32.4,3,21,14.3,1,2,50.0,6,23,29,7,13,28,11,5,32,0
22562,525617,588_17_23,URUGUAY,0,TOTALS,URUGUAY,200,7,22,31.8,6,19,31.6,1,3,33.3,8,12,66.7,3,13,16,4,6,12,6,0,23,0
22563,525630,588_17_23,PARAGUAY,0,TOTALS,PARAGUAY,200,11,31,35.5,8,23,34.8,3,8,37.5,0,2,0.0,7,15,22,5,9,14,7,1,25,1
22564,525643,588_17_24,CHILE,0,TOTALS,CHILE,200,26,54,48.1,24,39,61.5,2,15,13.3,16,28,57.1,9,38,47,16,10,24,10,6,70,1
22565,525656,588_17_24,ARGENTINA,0,TOTALS,ARGENTINA,200,23,76,30.3,17,48,35.4,6,28,21.4,8,10,80.0,16,23,39,13,21,16,10,4,60,0
22566,526189,590_17_01,GUYANA,0,TOTALS,GUYANA,200,21,67,31.3,15,42,35.7,6,25,24.0,15,42,35.7,20,31,51,5,24,33,10,6,63,1
22567,526202,590_17_01,BAHAMAS,0,TOTALS,BAHAMAS,200,45,86,52.3,37,57,64.9,8,29,27.6,16,29,55.2,16,38,54,18,32,21,22,2,114,0
22568,526214,590_17_02,VIRGIN ISLANDS,0,TOTALS,VIRGIN ISLANDS,200,23,70,32.9,15,46,32.6,8,24,33.3,15,20,75.0,16,32,48,15,23,14,10,3,69,1
22569,526227,590_17_02,JAMAICA,0,TOTALS,JAMAICA,200,21,64,32.8,17,43,39.5,4,21,19.0,15,31,48.4,16,33,49,10,18,18,10,4,61,0
22570,526240,590_17_03,MEXICO,0,TOTALS,MEXICO,200,19,51,37.3,17,33,51.5,2,18,11.1,13,21,61.9,7,30,37,7,20,21,10,2,53,0
22571,526253,590_17_03,PUERTO RICO,0,TOTALS,PUERTO RICO,200,27,72,37.5,23,49,46.9,4,23,17.4,9,19,47.4,21,26,47,13,18,18,12,4,67,1
22572,526266,590_17_04,PANAMA,0,TOTALS,PANAMA,200,21,74,28.4,20,58,34.5,1,16,6.2,12,21,57.1,19,35,54,8,14,19,9,8,55,0
22573,526279,590_17_04,DOMINICAN REPUBLIC,0,TOTALS,DOMINICAN REPUBLIC,200,22,77,28.6,17,59,28.8,5,18,27.8,10,16,62.5,23,38,61,12,23,22,10,6,59,1
22574,526292,590_17_05,BAHAMAS,0,TOTALS,BAHAMAS,200,24,80,30.0,18,63,28.6,6,17,35.3,21,31,67.7,26,26,52,8,26,17,12,2,75,0
22575,526305,590_17_05,MEXICO,0,TOTALS,MEXICO,200,31,68,45.6,24,47,51.1,7,21,33.3,14,24,58.3,14,35,49,20,25,24,9,8,83,1
22576,526318,590_17_06,PUERTO RICO,0,TOTALS,PUERTO RICO,200,44,79,55.7,33,49,67.3,11,30,36.7,16,26,61.5,11,29,40,35,20,19,25,4,115,0
22577,526331,590_17_06,GUYANA,0,TOTALS,GUYANA,200,18,58,31.0,16,43,37.2,2,15,13.3,10,17,58.8,16,28,44,7,26,41,8,0,48,1
22578,526344,590_17_07,JAMAICA,0,TOTALS,JAMAICA,200,19,54,35.2,16,37,43.2,3,17,17.6,15,36,41.7,20,32,52,10,22,30,11,8,56,1
22579,526357,590_17_07,PANAMA,0,TOTALS,PANAMA,200,17,66,25.8,13,42,31.0,4,24,16.7,16,25,64.0,18,25,43,10,27,22,20,1,54,0
22580,526370,590_17_08,DOMINICAN REPUBLIC,0,TOTALS,DOMINICAN REPUBLIC,200,38,78,48.7,32,59,54.2,6,19,31.6,15,25,60.0,21,44,65,14,14,21,13,4,97,1
22581,526382,590_17_08,VIRGIN ISLANDS,0,TOTALS,VIRGIN ISLANDS,200,24,77,31.2,19,44,43.2,5,33,15.2,7,17,41.2,14,25,39,11,21,18,15,2,60,0
22582,526395,590_17_09,PANAMA,0,TOTALS,PANAMA,200,33,69,47.8,32,60,53.3,1,9,11.1,22,36,61.1,16,41,57,14,20,16,9,10,89,1
22583,526407,590_17_09,VIRGIN ISLANDS,0,TOTALS,VIRGIN ISLANDS,200,21,77,27.3,19,54,35.2,2,23,8.7,18,24,75.0,16,27,43,6,27,16,6,5,62,0
22584,526420,590_17_10,MEXICO,0,TOTALS,MEXICO,200,29,73,39.7,19,40,47.5,10,33,30.3,6,12,50.0,19,31,50,24,14,16,11,1,74,1
22585,526433,590_17_10,GUYANA,0,TOTALS,GUYANA,200,23,68,33.8,17,43,39.5,6,25,24.0,11,24,45.8,18,27,45,8,11,16,8,2,63,0
22586,526446,590_17_11,BAHAMAS,0,TOTALS,BAHAMAS,200,26,75,34.7,21,60,35.0,5,15,33.3,18,31,58.1,25,27,52,15,18,16,10,3,75,0
22587,526459,590_17_11,PUERTO RICO,0,TOTALS,PUERTO RICO,200,35,73,47.9,30,56,53.6,5,17,29.4,8,15,53.3,14,31,45,24,22,18,9,6,83,1
22588,526472,590_17_12,DOMINICAN REPUBLIC,0,TOTALS,DOMINICAN REPUBLIC,200,27,74,36.5,22,46,47.8,5,28,17.9,12,18,66.7,22,36,58,22,21,15,11,6,71,1
22589,526485,590_17_12,JAMAICA,0,TOTALS,JAMAICA,200,13,60,21.7,9,43,20.9,4,17,23.5,16,28,57.1,16,29,45,10,16,22,10,5,46,0
22590,526498,590_17_13,JAMAICA,0,TOTALS,JAMAICA,200,32,78,41.0,25,53,47.2,7,25,28.0,10,16,62.5,22,28,50,20,16,19,10,6,81,1
22591,526511,590_17_13,GUYANA,0,TOTALS,GUYANA,200,21,66,31.8,18,39,46.2,3,27,11.1,12,20,60.0,18,26,44,11,17,23,14,3,57,0
22592,526524,590_17_14,BAHAMAS,0,TOTALS,BAHAMAS,200,28,80,35.0,21,54,38.9,7,26,26.9,26,42,61.9,25,30,55,11,20,28,14,8,89,0
22593,526536,590_17_14,VIRGIN ISLANDS,0,TOTALS,VIRGIN ISLANDS,200,34,80,42.5,27,58,46.6,7,22,31.8,16,26,61.5,16,34,50,22,27,25,18,5,91,1
22594,526549,590_17_15,PUERTO RICO,0,TOTALS,PUERTO RICO,200,20,73,27.4,14,49,28.6,6,24,25.0,13,22,59.1,22,24,46,14,15,12,12,3,59,1
22595,526562,590_17_15,PANAMA,0,TOTALS,PANAMA,200,19,56,33.9,14,32,43.8,5,24,20.8,13,17,76.5,14,33,47,15,16,26,7,10,56,0
22596,526575,590_17_16,DOMINICAN REPUBLIC,0,TOTALS,DOMINICAN REPUBLIC,200,38,71,53.5,30,52,57.7,8,19,42.1,22,33,66.7,19,30,49,25,19,20,16,4,106,0
22597,526588,590_17_16,MEXICO,0,TOTALS,MEXICO,200,22,59,37.3,13,37,35.1,9,22,40.9,18,25,72.0,9,17,26,9,26,21,11,0,71,1
22598,526601,590_17_17,BAHAMAS,0,TOTALS,BAHAMAS,200,39,81,48.1,31,61,50.8,8,20,40.0,5,13,38.5,20,38,58,23,18,24,12,8,91,1
22599,526614,590_17_17,GUYANA,0,TOTALS,GUYANA,200,22,72,30.6,16,50,32.0,6,22,27.3,13,23,56.5,15,25,40,10,12,18,9,8,63,0
22600,526626,590_17_18,VIRGIN ISLANDS,0,TOTALS,VIRGIN ISLANDS,200,25,81,30.9,23,50,46.0,2,31,6.5,18,29,62.1,19,31,50,12,23,20,18,0,70,1
22601,526639,590_17_18,JAMAICA,0,TOTALS,JAMAICA,200,21,69,30.4,20,52,38.5,1,17,5.9,15,29,51.7,21,39,60,5,23,32,8,10,58,0
22602,526652,590_17_19,PANAMA,0,TOTALS,PANAMA,200,24,78,30.8,20,59,33.9,4,19,21.1,33,45,73.3,26,21,47,8,22,12,9,5,85,1
22603,526665,590_17_19,MEXICO,0,TOTALS,MEXICO,200,27,59,45.8,22,38,57.9,5,21,23.8,21,29,72.4,11,26,37,11,34,23,5,9,80,0
22604,526678,590_17_20,PUERTO RICO,0,TOTALS,PUERTO RICO,200,32,78,41.0,28,67,41.8,4,11,36.4,12,15,80.0,15,18,33,16,20,9,10,3,80,0
22605,526691,590_17_20,DOMINICAN REPUBLIC,0,TOTALS,DOMINICAN REPUBLIC,200,30,66,45.5,27,51,52.9,3,15,20.0,18,27,66.7,17,30,47,15,10,15,6,3,81,1
22606,527219,592_17_01,SLOVENIA,0,TOTALS,SLOVENIA,200,32,75,42.7,24,46,52.2,8,29,27.6,18,20,90.0,11,30,41,20,26,10,12,3,90,1
22607,527232,592_17_01,POLAND,0,TOTALS,POLAND,200,26,64,40.6,17,39,43.6,9,25,36.0,20,25,80.0,11,32,43,13,22,16,4,0,81,0
22608,527245,592_17_02,GERMANY,0,TOTALS,GERMANY,200,27,60,45.0,19,34,55.9,8,26,30.8,13,18,72.2,9,28,37,17,19,12,5,2,75,1
22609,527258,592_17_02,UKRAINE,0,TOTALS,UKRAINE,200,25,61,41.0,19,39,48.7,6,22,27.3,7,10,70.0,9,26,35,15,22,13,3,6,63,0
22610,527271,592_17_03,ICELAND,0,TOTALS,ICELAND,200,18,57,31.6,16,34,47.1,2,23,8.7,23,32,71.9,14,18,32,17,21,22,11,3,61,0
22611,527284,592_17_03,GREECE,0,TOTALS,GREECE,200,34,63,54.0,27,47,57.4,7,16,43.8,15,22,68.2,14,32,46,22,23,20,12,2,90,1
22612,527297,592_17_04,LITHUANIA,0,TOTALS,LITHUANIA,200,28,63,44.4,20,36,55.6,8,27,29.6,13,22,59.1,15,23,38,18,25,16,7,3,77,0
22613,527310,592_17_04,GEORGIA,0,TOTALS,GEORGIA,200,26,59,44.1,23,44,52.3,3,15,20.0,24,29,82.8,10,22,32,15,25,10,12,1,79,1
22614,527323,592_17_05,FRANCE,0,TOTALS,FRANCE,225,26,61,42.6,20,45,44.4,6,16,37.5,26,28,92.9,12,32,44,15,19,23,5,2,84,0
22615,527336,592_17_05,FINLAND,0,TOTALS,FINLAND,225,35,79,44.3,29,60,48.3,6,19,31.6,10,13,76.9,12,20,32,19,25,11,9,2,86,1
22616,527349,592_17_06,ITALY,0,TOTALS,ITALY,200,24,54,44.4,11,27,40.7,13,27,48.1,8,12,66.7,8,35,43,14,20,15,7,5,69,1
22617,527362,592_17_06,ISRAEL,0,TOTALS,ISRAEL,200,15,57,26.3,14,43,32.6,1,14,7.1,17,23,73.9,7,25,32,13,17,8,8,1,48,0
22618,527375,592_17_07,BELGIUM,0,TOTALS,BELGIUM,200,30,66,45.5,16,28,57.1,14,38,36.8,29,37,78.4,18,27,45,20,24,9,2,1,103,0
22619,527388,592_17_07,GREAT BRITAIN,0,TOTALS,GREAT BRITAIN,200,34,66,51.5,29,46,63.0,5,20,25.0,17,26,65.4,10,23,33,19,30,6,4,0,90,1
22620,527401,592_17_08,HUNGARY,0,TOTALS,HUNGARY,200,25,72,34.7,20,43,46.5,5,29,17.2,3,8,37.5,21,19,40,12,20,12,7,1,58,0
22621,527414,592_17_08,CROATIA,0,TOTALS,CROATIA,200,24,46,52.2,19,27,70.4,5,19,26.3,14,15,93.3,4,25,29,11,19,16,5,3,67,1
22622,527427,592_17_09,SERBIA,0,TOTALS,SERBIA,200,28,72,38.9,22,53,41.5,6,19,31.6,30,40,75.0,19,27,46,18,23,5,7,4,92,1
22623,527440,592_17_09,LATVIA,0,TOTALS,LATVIA,200,26,62,41.9,17,39,43.6,9,23,39.1,21,23,91.3,10,29,39,15,29,13,3,4,82,0
22624,527453,592_17_10,SPAIN,0,TOTALS,SPAIN,200,29,52,55.8,18,34,52.9,11,18,61.1,30,40,75.0,7,33,40,26,14,12,12,6,99,1
22625,527466,592_17_10,MONTENEGRO,0,TOTALS,MONTENEGRO,200,23,67,34.3,15,43,34.9,8,24,33.3,6,13,46.2,12,20,32,16,29,14,6,0,60,0
22626,527479,592_17_11,ROMANIA,0,TOTALS,ROMANIA,200,22,57,38.6,13,36,36.1,9,21,42.9,15,19,78.9,11,30,41,19,21,21,3,5,68,0
22627,527491,592_17_11,CZECH REPUBLIC,0,TOTALS,CZECH REPUBLIC,200,30,67,44.8,21,44,47.7,9,23,39.1,14,17,82.4,8,25,33,17,21,13,13,2,83,1
22628,527504,592_17_12,TURKEY,0,TOTALS,TURKEY,200,26,54,48.1,21,37,56.8,5,17,29.4,16,23,69.6,6,16,22,12,29,16,15,1,73,0
22629,527517,592_17_12,RUSSIA,0,TOTALS,RUSSIA,200,19,37,51.4,13,22,59.1,6,15,40.0,32,40,80.0,4,25,29,19,19,22,6,2,76,1
22630,527530,592_17_13,POLAND,0,TOTALS,POLAND,200,28,66,42.4,18,41,43.9,10,25,40.0,25,28,89.3,15,38,53,19,17,13,4,5,91,1
22631,527543,592_17_13,ICELAND,0,TOTALS,ICELAND,200,24,70,34.3,17,50,34.0,7,20,35.0,6,12,50.0,10,23,33,17,22,13,7,1,61,0
22632,527556,592_17_14,LATVIA,0,TOTALS,LATVIA,200,34,63,54.0,27,41,65.9,7,22,31.8,17,19,89.5,6,22,28,31,17,9,6,2,92,1
22633,527569,592_17_14,BELGIUM,0,TOTALS,BELGIUM,200,25,51,49.0,19,31,61.3,6,20,30.0,8,11,72.7,5,24,29,17,23,21,7,2,64,0
22634,527582,592_17_15,MONTENEGRO,0,TOTALS,MONTENEGRO,200,26,64,40.6,18,39,46.2,8,25,32.0,12,17,70.6,16,36,52,17,25,14,6,4,72,1
22635,527595,592_17_15,HUNGARY,0,TOTALS,HUNGARY,200,16,63,25.4,13,36,36.1,3,27,11.1,13,22,59.1,13,21,34,9,21,10,5,3,48,0
22636,527608,592_17_16,GEORGIA,0,TOTALS,GEORGIA,200,21,49,42.9,18,39,46.2,3,10,30.0,12,18,66.7,5,27,32,15,19,24,9,5,57,0
22637,527621,592_17_16,GERMANY,0,TOTALS,GERMANY,200,24,64,37.5,15,36,41.7,9,28,32.1,10,12,83.3,12,25,37,12,25,20,13,3,67,1
22638,527634,592_17_17,GREECE,0,TOTALS,GREECE,200,30,56,53.6,22,31,71.0,8,25,32.0,19,28,67.9,7,22,29,19,28,11,11,2,87,0
22639,527647,592_17_17,FRANCE,0,TOTALS,FRANCE,200,32,56,57.1,25,38,65.8,7,18,38.9,24,34,70.6,7,24,31,19,26,15,5,1,95,1
22640,527660,592_17_18,RUSSIA,0,TOTALS,RUSSIA,200,26,59,44.1,15,26,57.7,11,33,33.3,12,19,63.2,11,20,31,20,29,14,7,1,75,1
22641,527673,592_17_18,SERBIA,0,TOTALS,SERBIA,200,21,44,47.7,15,28,53.6,6,16,37.5,24,35,68.6,8,20,28,21,24,16,8,2,72,0
22642,527685,592_17_19,CZECH REPUBLIC,0,TOTALS,CZECH REPUBLIC,200,24,70,34.3,18,42,42.9,6,28,21.4,2,4,50.0,12,15,27,16,23,10,5,1,56,0
22643,527698,592_17_19,SPAIN,0,TOTALS,SPAIN,200,32,60,53.3,27,46,58.7,5,14,35.7,24,28,85.7,16,35,51,31,11,12,4,5,93,1
22644,527711,592_17_20,UKRAINE,0,TOTALS,UKRAINE,200,22,52,42.3,19,37,51.4,3,15,20.0,19,21,90.5,6,24,30,16,24,12,6,2,66,0
22645,527724,592_17_20,ITALY,0,TOTALS,ITALY,200,25,51,49.0,8,20,40.0,17,31,54.8,11,21,52.4,7,21,28,16,22,14,4,0,78,1
22646,527737,592_17_21,FINLAND,0,TOTALS,FINLAND,200,30,67,44.8,16,35,45.7,14,32,43.8,4,8,50.0,10,29,39,18,26,16,3,6,78,0
22647,527750,592_17_21,SLOVENIA,0,TOTALS,SLOVENIA,200,28,65,43.1,24,42,57.1,4,23,17.4,21,27,77.8,10,28,38,15,18,9,9,2,81,1
22648,527763,592_17_22,CROATIA,0,TOTALS,CROATIA,200,21,44,47.7,9,24,37.5,12,20,60.0,20,27,74.1,5,33,38,15,13,17,4,2,74,1
22649,527776,592_17_22,ROMANIA,0,TOTALS,ROMANIA,200,26,66,39.4,21,39,53.8,5,27,18.5,1,2,50.0,7,21,28,17,25,9,7,4,58,0
22650,527789,592_17_23,GREAT BRITAIN,0,TOTALS,GREAT BRITAIN,200,24,58,41.4,13,29,44.8,11,29,37.9,11,12,91.7,8,24,32,20,17,19,6,4,70,0
22651,527802,592_17_23,TURKEY,0,TOTALS,TURKEY,200,29,60,48.3,17,34,50.0,12,26,46.2,14,15,93.3,8,23,31,20,15,13,11,3,84,1
22652,527815,592_17_24,ISRAEL,0,TOTALS,ISRAEL,200,27,59,45.8,22,46,47.8,5,13,38.5,14,19,73.7,5,16,21,18,25,10,8,0,73,0
22653,527828,592_17_24,LITHUANIA,0,TOTALS,LITHUANIA,200,32,57,56.1,27,42,64.3,5,15,33.3,19,28,67.9,14,29,43,23,21,16,5,3,88,1
22654,527841,592_17_25,FRANCE,0,TOTALS,FRANCE,200,45,66,68.2,35,48,72.9,10,18,55.6,15,26,57.7,5,34,39,31,16,11,11,7,115,0
22655,527854,592_17_25,ICELAND,0,TOTALS,ICELAND,200,30,83,36.1,21,53,39.6,9,30,30.0,10,11,90.9,19,20,39,19,26,16,5,2,79,1
22656,527867,592_17_26,GEORGIA,0,TOTALS,GEORGIA,200,25,50,50.0,17,31,54.8,8,19,42.1,23,29,79.3,5,24,29,20,24,16,4,2,81,0
22657,527879,592_17_26,UKRAINE,0,TOTALS,UKRAINE,200,31,67,46.3,21,40,52.5,10,27,37.0,16,21,76.2,11,22,33,25,27,12,7,3,88,1
22658,527892,592_17_27,SLOVENIA,0,TOTALS,SLOVENIA,200,25,59,42.4,18,39,46.2,7,20,35.0,21,30,70.0,15,21,36,14,21,11,4,5,78,1
22659,527905,592_17_27,GREECE,0,TOTALS,GREECE,200,29,69,42.0,26,49,53.1,3,20,15.0,11,14,78.6,17,23,40,12,28,12,5,3,72,0
22660,527918,592_17_28,LITHUANIA,0,TOTALS,LITHUANIA,200,29,58,50.0,18,30,60.0,11,28,39.3,9,14,64.3,14,24,38,15,17,13,3,2,78,1
22661,527931,592_17_28,ITALY,0,TOTALS,ITALY,200,28,61,45.9,17,35,48.6,11,26,42.3,6,8,75.0,9,15,24,21,19,6,6,2,73,0
22662,527944,592_17_29,FINLAND,0,TOTALS,FINLAND,250,31,73,42.5,20,44,45.5,11,29,37.9,17,20,85.0,14,31,45,23,25,16,8,2,90,1
22663,527957,592_17_29,POLAND,0,TOTALS,POLAND,250,30,67,44.8,20,42,47.6,10,25,40.0,17,28,60.7,10,28,38,23,21,17,8,3,87,0
22664,527970,592_17_30,GERMANY,0,TOTALS,GERMANY,200,26,54,48.1,22,37,59.5,4,17,23.5,24,29,82.8,10,22,32,18,25,17,7,4,80,0
22665,527983,592_17_30,ISRAEL,0,TOTALS,ISRAEL,200,29,60,48.3,24,46,52.2,5,14,35.7,19,26,73.1,12,22,34,17,22,14,13,1,82,1
22666,527996,592_17_31,LATVIA,0,TOTALS,LATVIA,200,35,71,49.3,18,37,48.6,17,34,50.0,10,15,66.7,11,26,37,28,19,11,4,2,97,1
22667,528009,592_17_31,GREAT BRITAIN,0,TOTALS,GREAT BRITAIN,200,35,67,52.2,26,43,60.5,9,24,37.5,13,16,81.2,8,26,34,26,17,12,6,0,92,0
22668,528022,592_17_32,HUNGARY,0,TOTALS,HUNGARY,200,30,59,50.8,21,35,60.0,9,24,37.5,16,24,66.7,11,25,36,17,21,16,11,3,85,1
22669,528034,592_17_32,CZECH REPUBLIC,0,TOTALS,CZECH REPUBLIC,200,29,64,45.3,23,44,52.3,6,20,30.0,9,12,75.0,12,21,33,15,21,15,8,3,73,0
22670,528047,592_17_33,BELGIUM,0,TOTALS,BELGIUM,200,25,49,51.0,15,25,60.0,10,24,41.7,7,11,63.6,2,25,27,17,27,16,6,4,67,0
22671,528060,592_17_33,RUSSIA,0,TOTALS,RUSSIA,200,21,60,35.0,14,34,41.2,7,26,26.9,27,31,87.1,14,23,37,14,16,12,7,2,76,1
22672,528073,592_17_34,MONTENEGRO,0,TOTALS,MONTENEGRO,200,27,69,39.1,19,39,48.7,8,30,26.7,10,15,66.7,15,20,35,13,25,8,7,3,72,0
22673,528086,592_17_34,CROATIA,0,TOTALS,CROATIA,200,24,53,45.3,13,27,48.1,11,26,42.3,17,25,68.0,10,29,39,21,24,15,7,5,76,1
22674,528099,592_17_35,SPAIN,0,TOTALS,SPAIN,200,35,66,53.0,26,46,56.5,9,20,45.0,12,16,75.0,14,34,48,26,14,9,11,3,91,1
22675,528112,592_17_35,ROMANIA,0,TOTALS,ROMANIA,200,20,64,31.2,13,40,32.5,7,24,29.2,3,8,37.5,12,17,29,15,24,15,4,0,50,0
22676,528125,592_17_36,SERBIA,0,TOTALS,SERBIA,200,29,59,49.2,23,44,52.3,6,15,40.0,16,22,72.7,15,26,41,21,24,13,7,1,80,1
22677,528138,592_17_36,TURKEY,0,TOTALS,TURKEY,200,23,52,44.2,12,26,46.2,11,26,42.3,17,26,65.4,9,17,26,14,23,12,7,4,74,0
22678,528151,592_17_37,ICELAND,0,TOTALS,ICELAND,200,29,68,42.6,22,44,50.0,7,24,29.2,10,12,83.3,11,22,33,18,16,18,11,2,75,1
22679,528164,592_17_37,SLOVENIA,0,TOTALS,SLOVENIA,200,38,72,52.8,25,42,59.5,13,30,43.3,13,15,86.7,13,29,42,27,18,14,11,5,102,0
22680,528177,592_17_38,RUSSIA,0,TOTALS,RUSSIA,200,20,52,38.5,15,31,48.4,5,21,23.8,24,30,80.0,9,26,35,16,29,18,4,6,69,0
22681,528190,592_17_38,LATVIA,0,TOTALS,LATVIA,200,28,63,44.4,24,43,55.8,4,20,20.0,24,30,80.0,11,24,35,18,27,11,5,1,84,1
22682,528202,592_17_39,CZECH REPUBLIC,0,TOTALS,CZECH REPUBLIC,200,26,68,38.2,18,47,38.3,8,21,38.1,15,18,83.3,13,26,39,20,18,14,10,1,75,0
22683,528215,592_17_39,MONTENEGRO,0,TOTALS,MONTENEGRO,200,33,66,50.0,17,32,53.1,16,34,47.1,6,11,54.5,10,27,37,22,23,14,7,6,88,1
22684,528228,592_17_40,UKRAINE,0,TOTALS,UKRAINE,200,27,70,38.6,24,57,42.1,3,13,23.1,5,8,62.5,15,21,36,19,22,13,7,5,62,0
22685,528241,592_17_40,LITHUANIA,0,TOTALS,LITHUANIA,200,34,65,52.3,22,39,56.4,12,26,46.2,14,19,73.7,12,30,42,22,13,11,6,2,94,1
22686,528254,592_17_41,POLAND,0,TOTALS,POLAND,200,26,67,38.8,17,39,43.6,9,28,32.1,14,16,87.5,10,23,33,18,24,12,9,2,75,0
22687,528267,592_17_41,FRANCE,0,TOTALS,FRANCE,200,28,59,47.5,22,38,57.9,6,21,28.6,16,21,76.2,8,30,38,16,21,16,8,1,78,1
22688,528280,592_17_42,GREAT BRITAIN,0,TOTALS,GREAT BRITAIN,200,23,52,44.2,14,29,48.3,9,23,39.1,13,13,100.0,3,27,30,13,10,15,5,4,68,0
22689,528293,592_17_42,SERBIA,0,TOTALS,SERBIA,200,31,68,45.6,21,40,52.5,10,28,35.7,10,12,83.3,10,26,36,27,15,7,11,1,82,1
22690,528306,592_17_43,CROATIA,0,TOTALS,CROATIA,200,29,65,44.6,20,36,55.6,9,29,31.0,6,8,75.0,11,22,33,17,22,13,3,5,73,0
22691,528319,592_17_43,SPAIN,0,TOTALS,SPAIN,200,25,69,36.2,15,44,34.1,10,25,40.0,19,23,82.6,22,25,47,16,18,11,8,4,79,1
22692,528332,592_17_44,ITALY,0,TOTALS,ITALY,200,18,59,30.5,11,30,36.7,7,29,24.1,12,14,85.7,9,24,33,9,19,8,6,4,55,0
22693,528345,592_17_44,GERMANY,0,TOTALS,GERMANY,200,20,51,39.2,14,31,45.2,6,20,30.0,15,16,93.8,7,31,38,16,19,14,6,2,61,1
22694,528358,592_17_45,GREECE,0,TOTALS,GREECE,200,26,50,52.0,18,33,54.5,8,17,47.1,17,29,58.6,6,20,26,17,22,11,5,2,77,0
22695,528371,592_17_45,FINLAND,0,TOTALS,FINLAND,200,29,60,48.3,19,32,59.4,10,28,35.7,21,23,91.3,12,22,34,17,24,12,4,3,89,1
22696,528384,592_17_46,ROMANIA,0,TOTALS,ROMANIA,200,25,56,44.6,21,42,50.0,4,14,28.6,17,27,63.0,5,23,28,16,24,11,8,0,71,0
22697,528397,592_17_46,HUNGARY,0,TOTALS,HUNGARY,200,29,63,46.0,23,37,62.2,6,26,23.1,16,24,66.7,13,30,43,9,27,13,4,3,80,1
22698,528410,592_17_47,TURKEY,0,TOTALS,TURKEY,200,29,52,55.8,23,36,63.9,6,16,37.5,14,15,93.3,4,19,23,13,19,13,8,1,78,1
22699,528423,592_17_47,BELGIUM,0,TOTALS,BELGIUM,200,23,51,45.1,14,27,51.9,9,24,37.5,10,12,83.3,7,17,24,17,21,16,7,0,65,0
22700,528436,592_17_48,ISRAEL,0,TOTALS,ISRAEL,225,36,69,52.2,33,53,62.3,3,16,18.8,16,20,80.0,2,20,22,24,24,9,8,4,91,1
22701,528449,592_17_48,GEORGIA,0,TOTALS,GEORGIA,225,35,70,50.0,26,47,55.3,9,23,39.1,25,31,80.6,16,34,50,26,15,17,5,3,104,0
22702,528462,592_17_49,SLOVENIA,0,TOTALS,SLOVENIA,200,30,60,50.0,20,30,66.7,10,30,33.3,25,30,83.3,8,28,36,17,28,15,10,1,95,1
22703,528475,592_17_49,FRANCE,0,TOTALS,FRANCE,200,24,60,40.0,20,40,50.0,4,20,20.0,26,29,89.7,9,22,31,23,27,14,7,0,78,0
22704,528488,592_17_50,GERMANY,0,TOTALS,GERMANY,200,27,69,39.1,19,36,52.8,8,33,24.2,10,13,76.9,15,16,31,14,17,10,8,4,72,0
22705,528501,592_17_50,LITHUANIA,0,TOTALS,LITHUANIA,200,32,62,51.6,25,42,59.5,7,20,35.0,18,22,81.8,15,29,44,20,17,14,5,1,89,1
22706,528514,592_17_51,GREECE,0,TOTALS,GREECE,200,36,65,55.4,23,45,51.1,13,20,65.0,10,13,76.9,13,24,37,23,19,13,6,7,95,1
22707,528527,592_17_51,POLAND,0,TOTALS,POLAND,200,29,58,50.0,22,39,56.4,7,19,36.8,12,14,85.7,6,18,24,22,17,11,9,1,77,0
22708,528540,592_17_52,GEORGIA,0,TOTALS,GEORGIA,200,25,61,41.0,18,34,52.9,7,27,25.9,12,16,75.0,10,30,40,10,21,14,8,0,69,0
22709,528553,592_17_52,ITALY,0,TOTALS,ITALY,200,27,62,43.5,17,32,53.1,10,30,33.3,7,16,43.8,8,25,33,20,21,12,10,5,71,1
22710,528566,592_17_53,FINLAND,0,TOTALS,FINLAND,200,27,61,44.3,17,36,47.2,10,25,40.0,19,21,90.5,10,28,38,19,23,15,4,2,83,1
22711,528579,592_17_53,ICELAND,0,TOTALS,ICELAND,200,27,60,45.0,21,39,53.8,6,21,28.6,19,27,70.4,7,25,32,24,21,10,5,3,79,0
22712,528591,592_17_54,ISRAEL,0,TOTALS,ISRAEL,200,26,59,44.1,19,41,46.3,7,18,38.9,5,11,45.5,6,23,29,23,13,17,4,1,64,0
22713,528603,592_17_54,UKRAINE,0,TOTALS,UKRAINE,200,37,73,50.7,29,52,55.8,8,21,38.1,6,10,60.0,14,31,45,25,15,11,9,7,88,1
22714,528615,592_17_55,CZECH REPUBLIC,0,TOTALS,CZECH REPUBLIC,200,28,76,36.8,18,43,41.9,10,33,30.3,3,3,100.0,11,20,31,24,24,13,10,1,69,1
22715,528628,592_17_55,CROATIA,0,TOTALS,CROATIA,200,36,65,55.4,23,41,56.1,13,24,54.2,22,33,66.7,13,35,48,26,11,13,7,5,107,0
22716,528641,592_17_56,RUSSIA,0,TOTALS,RUSSIA,200,29,69,42.0,15,37,40.5,14,32,43.8,10,13,76.9,12,23,35,22,15,10,12,0,82,1
22717,528654,592_17_56,GREAT BRITAIN,0,TOTALS,GREAT BRITAIN,200,25,56,44.6,18,37,48.6,7,19,36.8,13,14,92.9,8,26,34,22,18,18,6,2,70,0
22718,528667,592_17_57,HUNGARY,0,TOTALS,HUNGARY,200,22,70,31.4,9,35,25.7,13,35,37.1,7,8,87.5,9,20,29,15,21,8,7,1,64,0
22719,528680,592_17_57,SPAIN,0,TOTALS,SPAIN,200,29,58,50.0,18,32,56.2,11,26,42.3,18,23,78.3,10,39,49,26,10,14,6,4,87,1
22720,528693,592_17_58,BELGIUM,0,TOTALS,BELGIUM,200,17,59,28.8,9,32,28.1,8,27,29.6,12,12,100.0,12,20,32,15,17,13,7,3,54,0
22721,528706,592_17_58,SERBIA,0,TOTALS,SERBIA,200,29,63,46.0,26,48,54.2,3,15,20.0,13,17,76.5,15,30,45,20,19,13,6,1,74,1
22722,528719,592_17_59,MONTENEGRO,0,TOTALS,MONTENEGRO,190,31,65,47.7,19,35,54.3,12,30,40.0,12,16,75.0,11,31,42,25,13,13,6,6,86,1
22723,528732,592_17_59,ROMANIA,0,TOTALS,ROMANIA,200,27,66,40.9,20,43,46.5,7,23,30.4,8,12,66.7,9,24,33,25,17,11,9,1,69,0
22724,528745,592_17_60,LATVIA,0,TOTALS,LATVIA,200,28,55,50.9,17,27,63.0,11,28,39.3,22,26,84.6,4,25,29,28,26,11,8,3,89,1
22725,528758,592_17_60,TURKEY,0,TOTALS,TURKEY,200,27,58,46.6,18,34,52.9,9,24,37.5,16,25,64.0,10,22,32,11,24,13,8,1,79,0
22726,528771,592_17_61,SLOVENIA,0,TOTALS,SLOVENIA,200,26,63,41.3,20,44,45.5,6,19,31.6,21,26,80.8,13,29,42,17,12,10,10,4,79,1
22727,528784,592_17_61,UKRAINE,0,TOTALS,UKRAINE,200,22,63,34.9,18,45,40.0,4,18,22.2,7,7,100.0,10,26,36,16,26,18,6,5,55,0
22728,528797,592_17_62,GERMANY,0,TOTALS,GERMANY,200,28,61,45.9,19,33,57.6,9,28,32.1,19,21,90.5,9,19,28,17,20,8,7,2,84,1
22729,528810,592_17_62,FRANCE,0,TOTALS,FRANCE,200,32,67,47.8,24,41,58.5,8,26,30.8,9,11,81.8,14,25,39,22,21,13,5,1,81,0
22730,528823,592_17_63,FINLAND,0,TOTALS,FINLAND,200,24,62,38.7,19,44,43.2,5,18,27.8,4,5,80.0,12,19,31,10,17,10,4,1,57,0
22731,528836,592_17_63,ITALY,0,TOTALS,ITALY,200,23,53,43.4,14,25,56.0,9,28,32.1,15,16,93.8,8,27,35,11,16,12,5,4,70,1
22732,528849,592_17_64,LITHUANIA,0,TOTALS,LITHUANIA,200,22,55,40.0,16,31,51.6,6,24,25.0,14,15,93.3,6,31,37,12,18,13,3,1,64,0
22733,528862,592_17_64,GREECE,0,TOTALS,GREECE,200,30,65,46.2,19,41,46.3,11,24,45.8,6,11,54.5,7,25,32,20,20,7,7,3,77,1
22734,528875,592_17_65,LATVIA,0,TOTALS,LATVIA,200,35,59,59.3,20,34,58.8,15,25,60.0,15,16,93.8,7,33,40,26,17,13,4,2,100,0
22735,528888,592_17_65,MONTENEGRO,0,TOTALS,MONTENEGRO,200,26,67,38.8,17,45,37.8,9,22,40.9,7,13,53.8,8,17,25,15,17,9,4,3,68,1
22736,528901,592_17_66,SERBIA,0,TOTALS,SERBIA,200,32,51,62.7,26,38,68.4,6,13,46.2,16,19,84.2,9,28,37,23,18,15,4,1,86,1
22737,528914,592_17_66,HUNGARY,0,TOTALS,HUNGARY,200,28,64,43.8,16,36,44.4,12,28,42.9,10,14,71.4,10,13,23,16,24,6,10,4,78,0
22738,528927,592_17_67,SPAIN,0,TOTALS,SPAIN,200,25,54,46.3,17,30,56.7,8,24,33.3,15,20,75.0,8,25,33,22,18,9,6,3,73,1
22739,528940,592_17_67,TURKEY,0,TOTALS,TURKEY,200,22,58,37.9,19,38,50.0,3,20,15.0,9,9,100.0,11,22,33,16,24,10,5,0,56,0
22740,528953,592_17_68,CROATIA,0,TOTALS,CROATIA,200,26,57,45.6,21,37,56.8,5,20,25.0,21,30,70.0,12,20,32,13,27,12,3,3,78,1
22741,528966,592_17_68,RUSSIA,0,TOTALS,RUSSIA,200,33,60,55.0,24,35,68.6,9,25,36.0,26,30,86.7,8,23,31,23,24,7,5,0,101,0
22742,528979,592_17_69,GERMANY,0,TOTALS,GERMANY,200,26,59,44.1,20,37,54.1,6,22,27.3,14,22,63.6,7,25,32,14,23,14,8,0,72,0
22743,528991,592_17_69,SPAIN,0,TOTALS,SPAIN,200,29,60,48.3,19,35,54.3,10,25,40.0,16,21,76.2,8,29,37,27,20,14,8,4,84,1
22744,529004,592_17_70,SLOVENIA,0,TOTALS,SLOVENIA,200,30,59,50.8,19,31,61.3,11,28,39.3,32,39,82.1,9,32,41,18,29,13,3,5,103,0
22745,529017,592_17_70,LATVIA,0,TOTALS,LATVIA,200,35,75,46.7,23,39,59.0,12,36,33.3,15,18,83.3,9,19,28,24,32,9,5,1,97,1
22746,529030,592_17_71,GREECE,0,TOTALS,GREECE,200,27,56,48.2,22,36,61.1,5,20,25.0,10,20,50.0,5,28,33,18,24,15,13,3,69,0
22747,529043,592_17_71,RUSSIA,0,TOTALS,RUSSIA,200,24,60,40.0,18,34,52.9,6,26,23.1,20,25,80.0,11,27,38,13,22,14,10,2,74,1
22748,529056,592_17_72,ITALY,0,TOTALS,ITALY,200,22,58,37.9,14,29,48.3,8,29,27.6,15,16,93.8,8,11,19,12,27,9,6,1,67,0
22749,529069,592_17_72,SERBIA,0,TOTALS,SERBIA,200,27,55,49.1,24,38,63.2,3,17,17.6,26,29,89.7,17,27,44,20,22,13,7,4,83,1
22750,529081,592_17_73,SPAIN,0,TOTALS,SPAIN,200,25,63,39.7,18,36,50.0,7,27,25.9,15,16,93.8,12,23,35,16,20,13,8,2,72,0
22751,529094,592_17_73,SLOVENIA,0,TOTALS,SLOVENIA,200,35,67,52.2,21,42,50.0,14,25,56.0,8,12,66.7,9,26,35,23,19,8,7,1,92,1
22752,529107,592_17_74,RUSSIA,0,TOTALS,RUSSIA,200,25,59,42.4,13,27,48.1,12,32,37.5,17,24,70.8,8,18,26,15,23,7,4,0,79,0
22753,529120,592_17_74,SERBIA,0,TOTALS,SERBIA,200,33,56,58.9,26,37,70.3,7,19,36.8,14,21,66.7,8,26,34,21,24,10,3,2,87,1
22754,529132,592_17_75,SPAIN,0,TOTALS,SPAIN,200,32,60,53.3,29,47,61.7,3,13,23.1,26,37,70.3,13,25,38,25,19,14,6,5,93,1
22755,529145,592_17_75,RUSSIA,0,TOTALS,RUSSIA,200,31,64,48.4,17,33,51.5,14,31,45.2,9,12,75.0,9,18,27,28,31,17,9,0,85,0
22756,529158,592_17_76,SLOVENIA,0,TOTALS,SLOVENIA,200,29,63,46.0,21,37,56.8,8,26,30.8,27,32,84.4,11,25,36,14,20,9,6,7,93,1
22757,529171,592_17_76,SERBIA,0,TOTALS,SERBIA,200,32,70,45.7,24,45,53.3,8,25,32.0,13,15,86.7,13,23,36,16,28,9,5,4,85,0
22758,529184,593_16_01,BELGIUM,0,TOTALS,BELGIUM,200,23,61,37.7,15,37,40.5,8,24,33.3,11,19,57.9,15,34,49,18,24,14,9,1,65,1
22759,529197,593_16_01,CYPRUS,0,TOTALS,CYPRUS,200,10,48,20.8,6,32,18.8,4,16,25.0,22,28,78.6,9,24,33,8,26,15,6,3,46,0
22760,529210,593_16_02,HUNGARY,0,TOTALS,HUNGARY,200,37,70,52.9,24,37,64.9,13,33,39.4,9,9,100.0,10,23,33,19,21,11,6,1,96,1
22761,529223,593_16_02,GREAT BRITAIN,0,TOTALS,GREAT BRITAIN,200,30,60,50.0,24,41,58.5,6,19,31.6,11,15,73.3,9,21,30,15,20,13,2,1,77,0
22762,529236,593_16_03,UKRAINE,0,TOTALS,UKRAINE,200,28,56,50.0,20,36,55.6,8,20,40.0,15,23,65.2,10,27,37,24,22,14,5,1,79,1
22763,529249,593_16_03,BULGARIA,0,TOTALS,BULGARIA,200,26,66,39.4,17,33,51.5,9,33,27.3,8,12,66.7,14,20,34,18,26,12,5,1,69,0
22764,529262,593_16_04,GEORGIA,0,TOTALS,GEORGIA,200,31,52,59.6,25,38,65.8,6,14,42.9,18,22,81.8,5,37,42,27,17,19,10,4,86,1
22765,529275,593_16_04,ALBANIA,0,TOTALS,ALBANIA,200,18,55,32.7,15,37,40.5,3,18,16.7,8,16,50.0,3,20,23,9,23,18,10,0,47,0
22766,529288,593_16_05,ESTONIA,0,TOTALS,ESTONIA,200,27,65,41.5,14,30,46.7,13,35,37.1,14,18,77.8,7,24,31,21,27,9,11,2,81,1
22767,529301,593_16_05,BELARUS,0,TOTALS,BELARUS,200,20,58,34.5,15,37,40.5,5,21,23.8,17,23,73.9,17,32,49,12,20,20,6,0,62,0
22768,529314,593_16_06,ICELAND,0,TOTALS,ICELAND,200,29,54,53.7,17,26,65.4,12,28,42.9,18,32,56.2,7,29,36,28,18,12,6,1,88,1
22769,529327,593_16_06,SWITZERLAND,0,TOTALS,SWITZERLAND,200,28,71,39.4,20,46,43.5,8,25,32.0,8,14,57.1,17,25,42,20,29,15,6,2,72,0
22770,529340,593_16_07,GERMANY,0,TOTALS,GERMANY,200,35,63,55.6,26,41,63.4,9,22,40.9,22,22,100.0,13,25,38,33,16,14,14,7,101,0
22771,529353,593_16_07,DENMARK,0,TOTALS,DENMARK,200,25,58,43.1,14,32,43.8,11,26,42.3,13,16,81.2,9,15,24,17,22,22,9,1,74,1
22772,529366,593_16_08,RUSSIA,0,TOTALS,RUSSIA,207,30,73,41.1,20,44,45.5,10,29,34.5,13,13,100.0,13,31,44,24,28,8,12,3,83,1
22773,529380,593_16_08,BOSNIA AND HERZEGOVINA,0,TOTALS,BOSNIA AND HERZEGOVINA,200,17,58,29.3,14,46,30.4,3,12,25.0,17,30,56.7,15,34,49,6,20,19,4,1,54,0
22774,529393,593_16_09,POLAND,0,TOTALS,POLAND,200,35,57,61.4,26,37,70.3,9,20,45.0,4,8,50.0,9,26,35,16,15,16,8,0,83,1
22775,529406,593_16_09,PORTUGAL,0,TOTALS,PORTUGAL,200,21,60,35.0,11,28,39.3,10,32,31.2,5,11,45.5,13,14,27,13,15,15,7,1,57,0
22776,529419,593_16_10,NETHERLANDS,0,TOTALS,NETHERLANDS,208,26,71,36.6,18,46,39.1,8,25,32.0,12,19,63.2,22,20,42,12,20,10,9,0,72,0
22777,529432,593_16_10,AUSTRIA,0,TOTALS,AUSTRIA,200,27,47,57.4,16,25,64.0,11,22,50.0,10,12,83.3,2,25,27,18,23,15,3,3,75,1
22778,529445,593_16_11,SLOVENIA,0,TOTALS,SLOVENIA,200,45,77,58.4,35,51,68.6,10,26,38.5,13,17,76.5,9,39,48,32,13,10,9,1,113,0
22779,529458,593_16_11,KOSOVO,0,TOTALS,KOSOVO,200,29,69,42.0,25,42,59.5,4,27,14.8,6,10,60.0,4,26,30,13,21,15,6,3,68,1
22780,529471,593_16_12,MKD,0,TOTALS,MKD,200,33,65,50.8,23,42,54.8,10,23,43.5,13,22,59.1,11,25,36,21,19,10,8,4,89,1
22781,529484,593_16_12,LUXEMBOURG,0,TOTALS,LUXEMBOURG,200,29,60,48.3,21,39,53.8,8,21,38.1,9,13,69.2,6,24,30,14,21,13,4,0,75,0
22782,529497,593_16_13,MONTENEGRO,0,TOTALS,MONTENEGRO,200,39,72,54.2,30,48,62.5,9,24,37.5,10,16,62.5,16,29,45,28,19,15,8,0,97,1
22783,529510,593_16_13,SLOVAK REPUBLIC,0,TOTALS,SLOVAK REPUBLIC,200,21,59,35.6,16,41,39.0,5,18,27.8,18,24,75.0,9,19,28,14,20,19,10,0,65,0
22784,529523,593_16_14,CYPRUS,0,TOTALS,CYPRUS,200,23,56,41.1,15,32,46.9,8,24,33.3,10,16,62.5,7,24,31,9,20,13,3,3,64,0
22785,529536,593_16_14,ICELAND,0,TOTALS,ICELAND,200,28,62,45.2,17,35,48.6,11,27,40.7,8,10,80.0,11,29,40,20,20,12,8,2,75,1
22786,529549,593_16_15,SWITZERLAND,0,TOTALS,SWITZERLAND,200,25,62,40.3,20,41,48.8,5,21,23.8,17,25,68.0,12,21,33,13,27,13,4,2,72,0
22787,529562,593_16_15,BELGIUM,0,TOTALS,BELGIUM,200,28,56,50.0,20,27,74.1,8,29,27.6,23,30,76.7,10,27,37,17,22,15,8,1,87,1
22788,529575,593_16_16,BULGARIA,0,TOTALS,BULGARIA,200,30,71,42.3,21,41,51.2,9,30,30.0,9,14,64.3,10,17,27,20,25,11,17,2,78,0
22789,529588,593_16_16,SLOVENIA,0,TOTALS,SLOVENIA,200,28,54,51.9,20,32,62.5,8,22,36.4,19,27,70.4,10,33,43,19,19,23,7,1,83,1
22790,529601,593_16_17,SLOVAK REPUBLIC,0,TOTALS,SLOVAK REPUBLIC,200,25,66,37.9,18,39,46.2,7,27,25.9,6,12,50.0,3,18,21,17,34,12,10,2,63,0
22791,529614,593_16_17,GEORGIA,0,TOTALS,GEORGIA,200,27,47,57.4,16,26,61.5,11,21,52.4,29,38,76.3,4,37,41,18,17,20,7,0,94,1
22792,529627,593_16_18,GREAT BRITAIN,0,TOTALS,GREAT BRITAIN,200,30,56,53.6,17,31,54.8,13,25,52.0,22,28,78.6,9,28,37,21,16,13,6,0,96,1
22793,529640,593_16_18,MKD,0,TOTALS,MKD,200,27,54,50.0,22,37,59.5,5,17,29.4,18,25,72.0,5,20,25,13,22,7,8,2,79,0
22794,529653,593_16_19,BELARUS,0,TOTALS,BELARUS,200,31,63,49.2,24,41,58.5,7,22,31.8,10,16,62.5,7,20,27,17,22,17,7,4,79,0
22795,529666,593_16_19,POLAND,0,TOTALS,POLAND,200,36,63,57.1,28,41,68.3,8,22,36.4,17,20,85.0,7,28,35,20,18,16,8,0,97,1
22796,529679,593_16_20,PORTUGAL,0,TOTALS,PORTUGAL,200,21,52,40.4,13,29,44.8,8,23,34.8,18,27,66.7,7,20,27,9,26,13,9,2,68,0
22797,529692,593_16_20,ESTONIA,0,TOTALS,ESTONIA,200,28,54,51.9,23,35,65.7,5,19,26.3,15,23,65.2,6,23,29,10,26,14,9,3,76,1
22798,529705,593_16_21,HUNGARY,0,TOTALS,HUNGARY,200,35,69,50.7,26,38,68.4,9,31,29.0,10,17,58.8,12,31,43,24,17,14,13,6,89,1
22799,529718,593_16_21,LUXEMBOURG,0,TOTALS,LUXEMBOURG,200,23,63,36.5,16,44,36.4,7,19,36.8,11,14,78.6,10,25,35,12,18,17,5,1,64,0
22800,529731,593_16_22,DENMARK,0,TOTALS,DENMARK,200,20,50,40.0,10,24,41.7,10,26,38.5,22,29,75.9,10,20,30,10,20,15,7,3,72,0
22801,529744,593_16_22,NETHERLANDS,0,TOTALS,NETHERLANDS,200,31,62,50.0,21,37,56.8,10,25,40.0,18,25,72.0,13,24,37,20,22,11,9,3,90,1
22802,529757,593_16_23,ALBANIA,0,TOTALS,ALBANIA,200,28,63,44.4,19,38,50.0,9,25,36.0,8,9,88.9,8,14,22,16,27,23,9,0,73,1
22803,529770,593_16_23,MONTENEGRO,0,TOTALS,MONTENEGRO,200,41,63,65.1,32,42,76.2,9,21,42.9,22,31,71.0,12,25,37,26,15,13,19,0,113,0
22804,529783,593_16_24,KOSOVO,0,TOTALS,KOSOVO,200,26,66,39.4,20,44,45.5,6,22,27.3,5,9,55.6,8,21,29,16,23,10,9,1,63,0
22805,529796,593_16_24,UKRAINE,0,TOTALS,UKRAINE,200,22,53,41.5,19,32,59.4,3,21,14.3,23,32,71.9,10,28,38,12,16,14,9,6,70,1
22806,529809,593_16_25,BOSNIA AND HERZEGOVINA,0,TOTALS,BOSNIA AND HERZEGOVINA,200,23,64,35.9,19,40,47.5,4,24,16.7,24,32,75.0,17,40,57,13,20,15,4,2,74,1
22807,529822,593_16_25,SWEDEN,0,TOTALS,SWEDEN,200,25,81,30.9,14,37,37.8,11,44,25.0,10,13,76.9,19,24,43,15,29,10,7,1,71,0
22808,529835,593_16_26,AUSTRIA,0,TOTALS,AUSTRIA,200,22,50,44.0,19,34,55.9,3,16,18.8,12,16,75.0,7,23,30,12,20,16,8,2,59,0
22809,529848,593_16_26,GERMANY,0,TOTALS,GERMANY,200,22,54,40.7,16,27,59.3,6,27,22.2,11,14,78.6,9,21,30,9,20,14,9,4,61,1
22810,529861,593_16_27,BULGARIA,0,TOTALS,BULGARIA,200,37,69,53.6,24,38,63.2,13,31,41.9,18,27,66.7,14,25,39,28,17,11,12,1,105,0
22811,529874,593_16_27,KOSOVO,0,TOTALS,KOSOVO,200,29,61,47.5,16,33,48.5,13,28,46.4,13,16,81.2,7,23,30,18,25,17,3,0,84,1
22812,529886,593_16_28,SLOVAK REPUBLIC,0,TOTALS,SLOVAK REPUBLIC,200,22,50,44.0,18,33,54.5,4,17,23.5,21,24,87.5,7,31,38,11,23,21,9,1,69,1
22813,529899,593_16_28,ALBANIA,0,TOTALS,ALBANIA,200,21,58,36.2,16,36,44.4,5,22,22.7,13,16,81.2,6,20,26,10,23,12,6,2,60,0
22814,529912,593_16_29,BELARUS,0,TOTALS,BELARUS,200,29,62,46.8,24,42,57.1,5,20,25.0,9,12,75.0,12,29,41,19,24,16,4,1,72,1
22815,529925,593_16_29,PORTUGAL,0,TOTALS,PORTUGAL,200,19,60,31.7,15,37,40.5,4,23,17.4,20,24,83.3,12,17,29,6,22,10,12,2,62,0
22816,529938,593_16_30,GEORGIA,0,TOTALS,GEORGIA,200,29,69,42.0,26,49,53.1,3,20,15.0,13,15,86.7,15,33,48,17,19,16,3,2,74,0
22817,529951,593_16_30,MONTENEGRO,0,TOTALS,MONTENEGRO,200,27,75,36.0,14,42,33.3,13,33,39.4,9,14,64.3,15,22,37,16,21,8,5,2,76,1
22818,529964,593_16_31,GREAT BRITAIN,0,TOTALS,GREAT BRITAIN,200,34,68,50.0,23,45,51.1,11,23,47.8,16,21,76.2,11,28,39,23,17,13,13,4,95,1
22819,529977,593_16_31,LUXEMBOURG,0,TOTALS,LUXEMBOURG,200,29,60,48.3,22,35,62.9,7,25,28.0,7,15,46.7,6,26,32,15,20,20,5,2,72,0
22820,529990,593_16_32,AUSTRIA,0,TOTALS,AUSTRIA,200,27,55,49.1,19,33,57.6,8,22,36.4,24,33,72.7,8,33,41,27,23,18,10,1,86,1
22821,530003,593_16_32,DENMARK,0,TOTALS,DENMARK,200,23,58,39.7,15,33,45.5,8,25,32.0,12,17,70.6,4,22,26,14,28,18,6,0,66,0
22822,530016,593_16_33,SWITZERLAND,0,TOTALS,SWITZERLAND,200,25,53,47.2,18,31,58.1,7,22,31.8,19,30,63.3,8,30,38,14,28,15,2,2,76,0
22823,530029,593_16_33,CYPRUS,0,TOTALS,CYPRUS,200,25,61,41.0,14,31,45.2,11,30,36.7,19,28,67.9,9,21,30,16,26,7,8,2,80,1
22824,530042,593_16_34,GERMANY,0,TOTALS,GERMANY,200,19,49,38.8,6,19,31.6,13,30,43.3,20,26,76.9,8,19,27,15,24,14,4,3,71,0
22825,530055,593_16_34,NETHERLANDS,0,TOTALS,NETHERLANDS,200,26,58,44.8,20,35,57.1,6,23,26.1,17,18,94.4,11,22,33,11,25,11,6,1,75,1
22826,530070,593_16_35,SLOVENIA,0,TOTALS,SLOVENIA,200,31,66,47.0,24,46,52.2,7,20,35.0,15,30,50.0,16,20,36,23,23,16,10,1,84,1
22827,530084,593_16_35,UKRAINE,0,TOTALS,UKRAINE,200,27,53,50.9,21,34,61.8,6,19,31.6,17,23,73.9,7,25,32,19,24,21,13,3,77,0
22828,530097,593_16_36,BELGIUM,0,TOTALS,BELGIUM,200,28,56,50.0,17,28,60.7,11,28,39.3,13,14,92.9,9,26,35,19,25,14,6,2,80,1
22829,530110,593_16_36,ICELAND,0,TOTALS,ICELAND,200,23,56,41.1,20,38,52.6,3,18,16.7,16,21,76.2,7,18,25,12,19,15,12,1,65,0
22830,530123,593_16_37,SWEDEN,0,TOTALS,SWEDEN,200,27,59,45.8,23,40,57.5,4,19,21.1,15,20,75.0,10,18,28,14,23,11,5,4,73,0
22831,530136,593_16_37,RUSSIA,0,TOTALS,RUSSIA,200,30,53,56.6,18,35,51.4,12,18,66.7,13,20,65.0,8,24,32,22,22,15,5,2,85,1
22832,530149,593_16_38,POLAND,0,TOTALS,POLAND,200,27,63,42.9,22,43,51.2,5,20,25.0,19,24,79.2,14,25,39,17,24,14,11,2,78,1
22833,530162,593_16_38,ESTONIA,0,TOTALS,ESTONIA,200,20,51,39.2,8,25,32.0,12,26,46.2,12,18,66.7,7,19,26,15,25,19,6,1,64,0
22834,530175,593_16_39,MKD,0,TOTALS,MKD,200,21,52,40.4,17,38,44.7,4,14,28.6,20,27,74.1,13,30,43,12,19,16,4,1,66,0
22835,530188,593_16_39,HUNGARY,0,TOTALS,HUNGARY,200,29,70,41.4,19,40,47.5,10,30,33.3,8,12,66.7,12,22,34,16,25,8,15,1,76,1
22836,530201,593_16_40,CYPRUS,0,TOTALS,CYPRUS,200,20,50,40.0,12,31,38.7,8,19,42.1,7,12,58.3,9,21,30,16,24,19,6,3,55,0
22837,530214,593_16_40,BELGIUM,0,TOTALS,BELGIUM,200,25,60,41.7,18,34,52.9,7,26,26.9,15,23,65.2,16,23,39,20,23,13,11,4,72,1
22838,530227,593_16_41,SWITZERLAND,0,TOTALS,SWITZERLAND,200,32,62,51.6,26,48,54.2,6,14,42.9,13,20,65.0,7,32,39,20,31,15,9,4,83,1
22839,530240,593_16_41,ICELAND,0,TOTALS,ICELAND,200,24,62,38.7,15,35,42.9,9,27,33.3,23,35,65.7,12,27,39,20,24,11,6,1,80,0
22840,530253,593_16_42,BULGARIA,0,TOTALS,BULGARIA,200,22,68,32.4,12,34,35.3,10,34,29.4,13,18,72.2,10,18,28,7,25,8,12,0,67,0
22841,530266,593_16_42,UKRAINE,0,TOTALS,UKRAINE,200,26,53,49.1,20,33,60.6,6,20,30.0,14,24,58.3,12,35,47,19,20,24,3,7,72,1
22842,530279,593_16_43,SLOVAK REPUBLIC,0,TOTALS,SLOVAK REPUBLIC,200,27,56,48.2,24,38,63.2,3,18,16.7,5,9,55.6,8,24,32,12,19,26,5,1,62,0
22843,530292,593_16_43,MONTENEGRO,0,TOTALS,MONTENEGRO,200,36,67,53.7,22,32,68.8,14,35,40.0,13,19,68.4,6,20,26,13,16,11,14,0,99,1
22844,530305,593_16_44,PORTUGAL,0,TOTALS,PORTUGAL,200,26,66,39.4,17,34,50.0,9,32,28.1,13,20,65.0,12,17,29,12,24,12,7,1,74,0
22845,530317,593_16_44,POLAND,0,TOTALS,POLAND,200,27,54,50.0,22,34,64.7,5,20,25.0,22,25,88.0,11,24,35,14,23,21,8,1,81,1
22846,530330,593_16_45,BELARUS,0,TOTALS,BELARUS,200,29,60,48.3,24,43,55.8,5,17,29.4,16,22,72.7,12,31,43,12,20,18,8,1,79,1
22847,530343,593_16_45,ESTONIA,0,TOTALS,ESTONIA,200,22,55,40.0,13,25,52.0,9,30,30.0,10,16,62.5,5,21,26,18,22,17,12,2,63,0
22848,530356,593_16_46,GREAT BRITAIN,0,TOTALS,GREAT BRITAIN,200,32,70,45.7,25,46,54.3,7,24,29.2,9,12,75.0,11,25,36,16,25,9,4,2,80,0
22849,530369,593_16_46,HUNGARY,0,TOTALS,HUNGARY,200,28,63,44.4,17,33,51.5,11,30,36.7,21,27,77.8,12,28,40,18,20,8,2,2,88,1
22850,530383,593_16_47,DENMARK,0,TOTALS,DENMARK,275,32,77,41.6,21,46,45.7,11,31,35.5,31,38,81.6,19,37,56,14,27,17,4,1,106,1
22851,530397,593_16_47,GERMANY,0,TOTALS,GERMANY,275,37,91,40.7,27,48,56.2,10,43,23.3,18,22,81.8,17,30,47,18,32,12,8,2,102,0
22852,530410,593_16_48,ALBANIA,0,TOTALS,ALBANIA,200,22,61,36.1,16,36,44.4,6,25,24.0,14,18,77.8,5,18,23,5,27,16,9,2,64,0
22853,530423,593_16_48,GEORGIA,0,TOTALS,GEORGIA,200,27,53,50.9,24,42,57.1,3,11,27.3,27,30,90.0,9,34,43,18,25,18,7,1,84,1
22854,530436,593_16_49,LUXEMBOURG,0,TOTALS,LUXEMBOURG,200,28,64,43.8,21,38,55.3,7,26,26.9,11,15,73.3,9,18,27,11,21,15,3,0,74,0
22855,530449,593_16_49,MKD,0,TOTALS,MKD,200,28,55,50.9,22,35,62.9,6,20,30.0,20,30,66.7,6,25,31,12,13,8,6,2,82,1
22856,530462,593_16_50,KOSOVO,0,TOTALS,KOSOVO,200,28,64,43.8,16,31,51.6,12,33,36.4,13,15,86.7,6,22,28,19,21,11,6,2,81,0
22857,530475,593_16_50,SLOVENIA,0,TOTALS,SLOVENIA,200,32,66,48.5,21,41,51.2,11,25,44.0,16,19,84.2,14,28,42,18,17,9,4,1,91,1
22858,530488,593_16_51,BOSNIA AND HERZEGOVINA,0,TOTALS,BOSNIA AND HERZEGOVINA,200,23,71,32.4,15,43,34.9,8,28,28.6,13,24,54.2,15,27,42,14,17,10,6,1,67,0
22859,530501,593_16_51,RUSSIA,0,TOTALS,RUSSIA,200,29,61,47.5,18,39,46.2,11,22,50.0,9,11,81.8,4,35,39,17,25,12,6,3,78,1
22860,530514,593_16_52,AUSTRIA,0,TOTALS,AUSTRIA,200,22,56,39.3,14,31,45.2,8,25,32.0,9,14,64.3,8,19,27,19,26,17,10,0,61,0
22861,530526,593_16_52,NETHERLANDS,0,TOTALS,NETHERLANDS,200,26,51,51.0,20,35,57.1,6,16,37.5,17,27,63.0,10,30,40,17,20,17,10,1,75,1
22862,530539,593_16_53,UKRAINE,0,TOTALS,UKRAINE,200,39,71,54.9,31,47,66.0,8,24,33.3,14,20,70.0,18,40,58,29,18,13,4,8,100,0
22863,530552,593_16_53,KOSOVO,0,TOTALS,KOSOVO,200,22,67,32.8,16,42,38.1,6,25,24.0,11,14,78.6,6,15,21,12,20,9,8,3,61,1
22864,530565,593_16_54,GEORGIA,0,TOTALS,GEORGIA,200,36,69,52.2,31,51,60.8,5,18,27.8,19,20,95.0,15,27,42,27,15,19,20,6,96,1
22865,530577,593_16_54,SLOVAK REPUBLIC,0,TOTALS,SLOVAK REPUBLIC,200,26,58,44.8,15,34,44.1,11,24,45.8,5,7,71.4,6,16,22,20,19,24,9,3,68,0
22866,530590,593_16_55,MKD,0,TOTALS,MKD,200,21,65,32.3,12,31,38.7,9,34,26.5,11,12,91.7,12,28,40,13,26,15,4,2,62,0
22867,530603,593_16_55,GREAT BRITAIN,0,TOTALS,GREAT BRITAIN,200,31,63,49.2,22,40,55.0,9,23,39.1,18,29,62.1,9,33,42,13,17,8,8,3,89,1
22868,530616,593_16_56,ESTONIA,0,TOTALS,ESTONIA,200,32,61,52.5,21,35,60.0,11,26,42.3,7,7,100.0,8,25,33,23,22,10,4,0,82,1
22869,530629,593_16_56,PORTUGAL,0,TOTALS,PORTUGAL,200,21,55,38.2,14,33,42.4,7,22,31.8,14,15,93.3,8,19,27,16,18,12,4,0,63,0
22870,530642,593_16_57,GERMANY,0,TOTALS,GERMANY,200,24,48,50.0,16,29,55.2,8,19,42.1,22,25,88.0,6,26,32,18,22,15,11,0,78,1
22871,530655,593_16_57,AUSTRIA,0,TOTALS,AUSTRIA,200,23,54,42.6,20,38,52.6,3,16,18.8,9,16,56.2,10,16,26,16,24,16,5,1,58,0
22872,530668,593_16_58,LUXEMBOURG,0,TOTALS,LUXEMBOURG,200,24,65,36.9,19,42,45.2,5,23,21.7,12,18,66.7,12,23,35,10,23,8,9,1,65,0
22873,530681,593_16_58,HUNGARY,0,TOTALS,HUNGARY,200,26,61,42.6,16,27,59.3,10,34,29.4,6,19,31.6,7,24,31,6,20,12,3,3,68,1
22874,530694,593_16_59,BELGIUM,0,TOTALS,BELGIUM,200,26,62,41.9,14,29,48.3,12,33,36.4,23,36,63.9,20,31,51,15,19,10,10,2,87,1
22875,530707,593_16_59,SWITZERLAND,0,TOTALS,SWITZERLAND,200,17,58,29.3,8,33,24.2,9,25,36.0,6,8,75.0,12,25,37,10,33,20,3,4,49,0
22876,530719,593_16_60,NETHERLANDS,0,TOTALS,NETHERLANDS,225,34,75,45.3,20,41,48.8,14,34,41.2,16,24,66.7,15,29,44,19,22,14,8,2,98,1
22877,530732,593_16_60,DENMARK,0,TOTALS,DENMARK,225,33,66,50.0,23,41,56.1,10,25,40.0,12,19,63.2,8,25,33,17,24,12,7,2,88,0
22878,530745,593_16_61,SWEDEN,0,TOTALS,SWEDEN,200,25,66,37.9,16,39,41.0,9,27,33.3,17,26,65.4,11,27,38,18,27,13,8,1,76,0
22879,530758,593_16_61,BOSNIA AND HERZEGOVINA,0,TOTALS,BOSNIA AND HERZEGOVINA,200,26,62,41.9,20,40,50.0,6,22,27.3,20,31,64.5,16,33,49,16,23,17,10,3,78,1
22880,530771,593_16_62,POLAND,0,TOTALS,POLAND,200,22,62,35.5,19,46,41.3,3,16,18.8,10,12,83.3,15,17,32,16,17,13,5,2,57,0
22881,530784,593_16_62,BELARUS,0,TOTALS,BELARUS,200,31,61,50.8,25,40,62.5,6,21,28.6,8,11,72.7,13,27,40,18,18,13,8,4,76,1
22882,530797,593_16_63,SLOVENIA,0,TOTALS,SLOVENIA,200,32,69,46.4,25,39,64.1,7,30,23.3,14,24,58.3,18,26,44,22,16,14,12,3,85,1
22883,530810,593_16_63,BULGARIA,0,TOTALS,BULGARIA,200,27,63,42.9,22,38,57.9,5,25,20.0,4,9,44.4,11,22,33,12,24,20,8,2,63,0
22884,530823,593_16_64,ICELAND,0,TOTALS,ICELAND,200,31,66,47.0,19,35,54.3,12,31,38.7,10,17,58.8,12,28,40,21,21,9,7,1,84,1
22885,530836,593_16_64,CYPRUS,0,TOTALS,CYPRUS,200,19,53,35.8,8,22,36.4,11,31,35.5,13,20,65.0,9,26,35,13,17,18,6,5,62,0
22886,530849,593_16_65,MONTENEGRO,0,TOTALS,MONTENEGRO,200,31,66,47.0,20,38,52.6,11,28,39.3,21,27,77.8,9,33,42,19,18,12,12,0,94,1
22887,530862,593_16_65,ALBANIA,0,TOTALS,ALBANIA,200,21,56,37.5,14,32,43.8,7,24,29.2,7,14,50.0,5,27,32,14,26,23,6,0,56,0
22888,530875,593_16_66,RUSSIA,0,TOTALS,RUSSIA,200,21,57,36.8,14,31,45.2,7,26,26.9,14,20,70.0,11,32,43,19,20,14,7,4,63,1
22889,530888,593_16_66,SWEDEN,0,TOTALS,SWEDEN,200,19,62,30.6,9,39,23.1,10,23,43.5,11,16,68.8,10,26,36,14,20,11,9,4,59,0
22890,530901,593_16_67,ICELAND,0,TOTALS,ICELAND,200,26,64,40.6,20,39,51.3,6,25,24.0,16,22,72.7,8,27,35,18,21,11,9,4,74,1
22891,530914,593_16_67,BELGIUM,0,TOTALS,BELGIUM,200,19,53,35.8,11,32,34.4,8,21,38.1,22,24,91.7,7,32,39,12,23,20,9,3,68,0
22892,530927,593_16_68,UKRAINE,0,TOTALS,UKRAINE,200,22,56,39.3,12,34,35.3,10,22,45.5,15,24,62.5,10,29,39,17,26,21,7,7,69,0
22893,530940,593_16_68,SLOVENIA,0,TOTALS,SLOVENIA,200,26,65,40.0,18,42,42.9,8,23,34.8,20,27,74.1,13,27,40,18,26,14,15,2,80,1
22894,530952,593_16_69,HUNGARY,0,TOTALS,HUNGARY,200,23,58,39.7,15,37,40.5,8,21,38.1,9,15,60.0,15,16,31,19,20,14,15,2,63,1
22895,530964,593_16_69,MKD,0,TOTALS,MKD,200,22,48,45.8,14,25,56.0,8,23,34.8,9,11,81.8,9,22,31,16,18,23,10,0,61,0
22896,530977,593_16_70,CYPRUS,0,TOTALS,CYPRUS,200,34,70,48.6,18,37,48.6,16,33,48.5,8,10,80.0,13,22,35,24,23,12,10,2,92,1
22897,530988,593_16_70,SWITZERLAND,0,TOTALS,SWITZERLAND,200,27,53,50.9,16,32,50.0,11,21,52.4,13,18,72.2,5,23,28,15,17,17,8,4,78,0
22898,531001,593_16_71,PORTUGAL,0,TOTALS,PORTUGAL,200,28,55,50.9,21,37,56.8,7,18,38.9,14,21,66.7,11,21,32,19,27,8,7,0,77,1
22899,531014,593_16_71,BELARUS,0,TOTALS,BELARUS,200,20,53,37.7,15,28,53.6,5,25,20.0,17,26,65.4,9,14,23,5,24,15,5,0,62,0
22900,531028,593_16_72,DENMARK,0,TOTALS,DENMARK,200,26,58,44.8,17,29,58.6,9,29,31.0,25,29,86.2,7,30,37,20,21,16,5,12,86,1
22901,531042,593_16_72,AUSTRIA,0,TOTALS,AUSTRIA,200,26,63,41.3,18,41,43.9,8,22,36.4,12,23,52.2,11,28,39,9,27,14,12,1,72,0
22902,531054,593_16_73,NETHERLANDS,0,TOTALS,NETHERLANDS,200,16,59,27.1,10,36,27.8,6,23,26.1,13,19,68.4,9,14,23,9,18,11,3,3,51,0
22903,531067,593_16_73,GERMANY,0,TOTALS,GERMANY,200,27,45,60.0,17,27,63.0,10,18,55.6,18,22,81.8,3,30,33,14,23,8,5,3,82,1
22904,531080,593_16_74,ALBANIA,0,TOTALS,ALBANIA,200,25,53,47.2,17,30,56.7,8,23,34.8,14,22,63.6,4,22,26,16,25,14,11,1,72,1
22905,531093,593_16_74,SLOVAK REPUBLIC,0,TOTALS,SLOVAK REPUBLIC,200,21,53,39.6,16,34,47.1,5,19,26.3,18,24,75.0,9,25,34,8,20,21,10,1,65,0
22906,531106,593_16_75,LUXEMBOURG,0,TOTALS,LUXEMBOURG,200,29,69,42.0,16,39,41.0,13,30,43.3,11,20,55.0,6,29,35,15,21,6,8,2,82,1
22907,531119,593_16_75,GREAT BRITAIN,0,TOTALS,GREAT BRITAIN,200,27,65,41.5,20,39,51.3,7,26,26.9,14,24,58.3,10,37,47,14,18,13,4,2,75,0
22908,531132,593_16_76,ESTONIA,0,TOTALS,ESTONIA,200,24,58,41.4,18,35,51.4,6,23,26.1,9,15,60.0,6,24,30,19,16,11,3,1,63,0
22909,531145,593_16_76,POLAND,0,TOTALS,POLAND,200,36,67,53.7,24,41,58.5,12,26,46.2,10,13,76.9,8,29,37,21,21,8,7,2,94,1
22910,531158,593_16_77,KOSOVO,0,TOTALS,KOSOVO,200,23,67,34.3,15,33,45.5,8,34,23.5,8,10,80.0,11,28,39,15,21,12,7,1,62,0
22911,531171,593_16_77,BULGARIA,0,TOTALS,BULGARIA,200,22,58,37.9,15,33,45.5,7,25,28.0,16,26,61.5,10,30,40,11,16,10,5,2,67,1
22912,531184,593_16_78,MONTENEGRO,0,TOTALS,MONTENEGRO,200,26,66,39.4,20,40,50.0,6,26,23.1,26,31,83.9,13,24,37,9,28,11,7,2,84,0
22913,531197,593_16_78,GEORGIA,0,TOTALS,GEORGIA,200,28,61,45.9,18,41,43.9,10,20,50.0,24,28,85.7,8,28,36,17,26,12,4,1,90,1
22914,534579,596_17_01,SWEDEN,0,TOTALS,SWEDEN,200,28,58,48.3,20,37,54.1,8,21,38.1,17,26,65.4,6,19,25,18,23,10,8,7,81,1
22915,534592,596_17_01,BOSNIA AND HERZEGOVINA,0,TOTALS,BOSNIA AND HERZEGOVINA,200,25,62,40.3,17,46,37.0,8,16,50.0,15,22,68.2,20,27,47,11,27,19,5,2,73,0
22916,534605,596_17_02,PORTUGAL,0,TOTALS,PORTUGAL,200,26,67,38.8,20,37,54.1,6,30,20.0,13,13,100.0,7,19,26,11,18,9,7,1,71,0
22917,534618,596_17_02,BULGARIA,0,TOTALS,BULGARIA,200,29,54,53.7,14,25,56.0,15,29,51.7,9,14,64.3,7,29,36,16,18,19,3,2,82,1
22918,534631,596_17_03,ARMENIA,0,TOTALS,ARMENIA,200,28,63,44.4,22,42,52.4,6,21,28.6,13,14,92.9,12,35,47,15,20,15,4,4,75,1
22919,534644,596_17_03,SLOVAK REPUBLIC,0,TOTALS,SLOVAK REPUBLIC,200,21,69,30.4,12,40,30.0,9,29,31.0,10,17,58.8,16,24,40,12,22,11,7,1,61,0
22920,534657,596_17_04,KOSOVO,0,TOTALS,KOSOVO,200,26,58,44.8,18,28,64.3,8,30,26.7,12,17,70.6,11,24,35,15,23,13,4,2,72,1
22921,534670,596_17_04,MKD,0,TOTALS,MKD,210,23,51,45.1,16,23,69.6,7,28,25.0,15,19,78.9,7,22,29,11,21,9,5,1,68,0
22922,534683,596_17_05,ALBANIA,0,TOTALS,ALBANIA,200,19,55,34.5,12,32,37.5,7,23,30.4,6,11,54.5,5,17,22,10,24,16,7,2,51,0
22923,534696,596_17_05,AUSTRIA,0,TOTALS,AUSTRIA,200,32,57,56.1,29,42,69.0,3,15,20.0,12,19,63.2,8,32,40,19,20,15,6,1,79,1
22924,534709,596_17_06,BULGARIA,0,TOTALS,BULGARIA,200,30,68,44.1,22,42,52.4,8,26,30.8,10,15,66.7,15,21,36,17,21,16,11,0,78,1
22925,534722,596_17_06,BELARUS,0,TOTALS,BELARUS,200,27,63,42.9,20,40,50.0,7,23,30.4,7,13,53.8,12,23,35,17,20,21,8,3,68,0
22926,534735,596_17_07,AUSTRIA,0,TOTALS,AUSTRIA,200,24,48,50.0,17,31,54.8,7,17,41.2,17,19,89.5,4,20,24,18,24,18,8,1,72,0
22927,534748,596_17_07,NETHERLANDS,0,TOTALS,NETHERLANDS,200,29,57,50.9,20,33,60.6,9,24,37.5,12,17,70.6,8,19,27,14,22,16,8,1,79,1
22928,534761,596_17_08,ARMENIA,0,TOTALS,ARMENIA,200,31,59,52.5,27,47,57.4,4,12,33.3,16,20,80.0,9,28,37,10,19,16,7,2,82,1
22929,534774,596_17_08,SWEDEN,0,TOTALS,SWEDEN,200,25,60,41.7,18,36,50.0,7,24,29.2,12,13,92.3,6,19,25,16,24,17,4,1,69,0
22930,534787,596_17_09,BOSNIA AND HERZEGOVINA,0,TOTALS,BOSNIA AND HERZEGOVINA,200,33,69,47.8,23,44,52.3,10,25,40.0,8,12,66.7,19,22,41,16,19,16,11,2,84,1
22931,534800,596_17_09,SLOVAK REPUBLIC,0,TOTALS,SLOVAK REPUBLIC,200,27,62,43.5,22,39,56.4,5,23,21.7,12,16,75.0,11,18,29,15,18,17,10,2,71,0
22932,534813,596_17_10,MKD,0,TOTALS,MKD,200,27,54,50.0,21,34,61.8,6,20,30.0,16,31,51.6,8,25,33,13,24,7,6,0,76,0
22933,534826,596_17_10,ESTONIA,0,TOTALS,ESTONIA,200,25,60,41.7,12,22,54.5,13,38,34.2,17,23,73.9,11,26,37,18,25,11,3,2,80,1
22934,534839,596_17_11,SLOVAK REPUBLIC,0,TOTALS,SLOVAK REPUBLIC,200,20,64,31.2,14,39,35.9,6,25,24.0,22,25,88.0,18,34,52,14,23,16,5,2,68,1
22935,534852,596_17_11,SWEDEN,0,TOTALS,SWEDEN,200,21,57,36.8,18,39,46.2,3,18,16.7,14,20,70.0,6,26,32,13,24,12,10,1,59,0
22936,534865,596_17_12,ESTONIA,0,TOTALS,ESTONIA,200,29,58,50.0,17,28,60.7,12,30,40.0,6,11,54.5,7,27,34,23,21,10,8,3,76,1
22937,534878,596_17_12,KOSOVO,0,TOTALS,KOSOVO,200,17,54,31.5,10,32,31.2,7,22,31.8,9,13,69.2,9,24,33,11,17,17,4,0,50,0
22938,534891,596_17_13,BELARUS,0,TOTALS,BELARUS,191,21,55,38.2,14,38,36.8,7,17,41.2,29,34,85.3,15,29,44,17,28,15,6,2,78,1
22939,534904,596_17_13,PORTUGAL,0,TOTALS,PORTUGAL,200,22,56,39.3,13,33,39.4,9,23,39.1,22,30,73.3,8,20,28,18,27,11,8,4,75,0
22940,534917,596_17_14,BOSNIA AND HERZEGOVINA,0,TOTALS,BOSNIA AND HERZEGOVINA,200,33,62,53.2,24,42,57.1,9,20,45.0,23,25,92.0,10,20,30,22,25,17,13,1,98,1
22941,534929,596_17_14,ARMENIA,0,TOTALS,ARMENIA,200,30,62,48.4,20,34,58.8,10,28,35.7,15,26,57.7,16,20,36,17,27,25,8,4,85,0
22942,534942,596_17_15,NETHERLANDS,0,TOTALS,NETHERLANDS,200,31,64,48.4,23,42,54.8,8,22,36.4,21,26,80.8,17,20,37,25,19,18,14,2,91,1
22943,534955,596_17_15,ALBANIA,0,TOTALS,ALBANIA,200,27,50,54.0,18,29,62.1,9,21,42.9,14,19,73.7,5,19,24,18,26,24,7,3,77,0
22944,534968,596_17_16,AUSTRIA,0,TOTALS,AUSTRIA,200,36,63,57.1,30,43,69.8,6,20,30.0,19,27,70.4,11,31,42,33,21,13,11,5,97,1
22945,534981,596_17_16,ALBANIA,0,TOTALS,ALBANIA,200,22,61,36.1,14,37,37.8,8,24,33.3,11,14,78.6,9,18,27,14,25,16,7,0,63,0
22946,534994,596_17_17,BULGARIA,0,TOTALS,BULGARIA,200,36,68,52.9,24,42,57.1,12,26,46.2,7,11,63.6,14,33,47,26,25,10,5,1,91,1
22947,535007,596_17_17,PORTUGAL,0,TOTALS,PORTUGAL,200,21,58,36.2,15,36,41.7,6,22,27.3,17,25,68.0,9,19,28,14,16,11,2,4,65,0
22948,535020,596_17_18,SLOVAK REPUBLIC,0,TOTALS,SLOVAK REPUBLIC,200,23,55,41.8,16,35,45.7,7,20,35.0,25,27,92.6,15,26,41,17,26,19,5,4,78,0
22949,535032,596_17_18,ARMENIA,0,TOTALS,ARMENIA,200,31,68,45.6,21,40,52.5,10,28,35.7,20,26,76.9,13,19,32,15,27,9,8,0,92,1
22950,535045,596_17_19,BOSNIA AND HERZEGOVINA,0,TOTALS,BOSNIA AND HERZEGOVINA,200,28,61,45.9,22,40,55.0,6,21,28.6,10,15,66.7,9,20,29,16,28,17,9,0,72,0
22951,535058,596_17_19,SWEDEN,0,TOTALS,SWEDEN,200,33,55,60.0,26,36,72.2,7,19,36.8,15,24,62.5,6,25,31,15,19,15,9,2,88,1
22952,535071,596_17_20,MKD,0,TOTALS,MKD,200,32,74,43.2,24,44,54.5,8,30,26.7,15,24,62.5,17,29,46,12,22,9,12,1,87,1
22953,535084,596_17_20,KOSOVO,0,TOTALS,KOSOVO,200,27,59,45.8,18,30,60.0,9,29,31.0,11,20,55.0,8,27,35,17,25,16,3,2,74,0
22954,535097,596_17_21,SLOVAK REPUBLIC,0,TOTALS,SLOVAK REPUBLIC,200,22,56,39.3,13,31,41.9,9,25,36.0,21,26,80.8,11,23,34,17,33,16,5,0,74,0
22955,535110,596_17_21,BOSNIA AND HERZEGOVINA,0,TOTALS,BOSNIA AND HERZEGOVINA,200,28,60,46.7,20,32,62.5,8,28,28.6,28,40,70.0,15,25,40,16,29,12,11,6,92,1
22956,535123,596_17_22,ESTONIA,0,TOTALS,ESTONIA,200,27,59,45.8,23,38,60.5,4,21,19.0,16,20,80.0,13,22,35,15,21,7,8,2,74,1
22957,535136,596_17_22,MKD,0,TOTALS,MKD,200,26,52,50.0,19,36,52.8,7,16,43.8,6,12,50.0,6,20,26,12,21,12,3,2,65,0
22958,535149,596_17_23,SWEDEN,0,TOTALS,SWEDEN,200,35,75,46.7,28,51,54.9,7,24,29.2,16,20,80.0,11,29,40,18,31,8,14,5,93,1
22959,535161,596_17_23,ARMENIA,0,TOTALS,ARMENIA,200,21,53,39.6,15,32,46.9,6,21,28.6,22,35,62.9,8,31,39,13,20,17,4,4,70,0
22960,535174,596_17_24,BELARUS,0,TOTALS,BELARUS,200,24,63,38.1,17,39,43.6,7,24,29.2,15,18,83.3,16,23,39,13,21,19,9,1,70,0
22961,535187,596_17_24,BULGARIA,0,TOTALS,BULGARIA,200,33,69,47.8,27,40,67.5,6,29,20.7,12,14,85.7,13,24,37,21,20,13,13,2,84,1
22962,535200,596_17_25,NETHERLANDS,0,TOTALS,NETHERLANDS,200,24,58,41.4,14,34,41.2,10,24,41.7,13,16,81.2,10,24,34,15,21,15,6,2,71,0
22963,535213,596_17_25,AUSTRIA,0,TOTALS,AUSTRIA,200,28,57,49.1,19,34,55.9,9,23,39.1,13,14,92.9,5,24,29,20,18,13,6,2,78,1
22964,535226,596_17_26,SWEDEN,0,TOTALS,SWEDEN,200,30,64,46.9,17,37,45.9,13,27,48.1,13,19,68.4,12,27,39,20,24,13,5,5,86,1
22965,535238,596_17_26,SLOVAK REPUBLIC,0,TOTALS,SLOVAK REPUBLIC,200,31,60,51.7,24,39,61.5,7,21,33.3,13,19,68.4,7,26,33,18,21,9,5,1,82,0
22966,535251,596_17_27,PORTUGAL,0,TOTALS,PORTUGAL,225,26,72,36.1,21,53,39.6,5,19,26.3,22,32,68.8,16,23,39,20,30,11,8,0,79,1
22967,535264,596_17_27,BELARUS,0,TOTALS,BELARUS,225,23,51,45.1,16,30,53.3,7,21,33.3,25,32,78.1,8,34,42,14,28,21,5,2,78,0
22968,535278,596_17_28,ARMENIA,0,TOTALS,ARMENIA,200,25,64,39.1,20,41,48.8,5,23,21.7,11,14,78.6,15,19,34,11,18,14,3,0,66,0
22969,535291,596_17_28,BOSNIA AND HERZEGOVINA,0,TOTALS,BOSNIA AND HERZEGOVINA,200,32,60,53.3,21,34,61.8,11,26,42.3,8,14,57.1,10,24,34,15,20,16,5,3,83,1
22970,535304,596_17_29,KOSOVO,0,TOTALS,KOSOVO,200,25,60,41.7,15,31,48.4,10,29,34.5,15,26,57.7,8,27,35,17,18,6,7,2,75,1
22971,535318,596_17_29,ESTONIA,0,TOTALS,ESTONIA,200,27,59,45.8,20,30,66.7,7,29,24.1,8,13,61.5,8,24,32,20,23,12,2,0,69,0
22972,535333,596_17_30,ALBANIA,0,TOTALS,ALBANIA,200,11,52,21.2,3,24,12.5,8,28,28.6,7,10,70.0,4,12,16,10,27,25,4,0,37,1
22973,535347,596_17_30,NETHERLANDS,0,TOTALS,NETHERLANDS,200,41,66,62.1,30,46,65.2,11,20,55.0,18,27,66.7,15,35,50,31,15,16,16,1,111,0
22974,535360,597_17_01,SWEDEN,0,TOTALS,SWEDEN,200,26,62,41.9,17,40,42.5,9,22,40.9,11,16,68.8,12,23,35,15,20,15,3,5,72,1
22975,535373,597_17_01,GERMANY,0,TOTALS,GERMANY,200,24,61,39.3,22,48,45.8,2,13,15.4,16,25,64.0,18,26,44,11,18,16,9,2,66,0
22976,535386,597_17_02,UKRAINE,0,TOTALS,UKRAINE,200,27,58,46.6,17,33,51.5,10,25,40.0,15,19,78.9,12,23,35,13,25,26,12,1,79,0
22977,535399,597_17_02,LITHUANIA,0,TOTALS,LITHUANIA,200,34,71,47.9,27,55,49.1,7,16,43.8,17,25,68.0,16,24,40,15,22,17,11,3,92,1
22978,535412,597_17_03,ICELAND,0,TOTALS,ICELAND,200,18,68,26.5,14,36,38.9,4,32,12.5,10,17,58.8,11,31,42,15,12,13,9,7,50,0
22979,535425,597_17_03,FRANCE,0,TOTALS,FRANCE,200,22,65,33.8,18,50,36.0,4,15,26.7,10,11,90.9,10,39,49,14,15,18,6,2,58,1
22980,535438,597_17_04,SLOVENIA,0,TOTALS,SLOVENIA,200,22,57,38.6,16,31,51.6,6,26,23.1,9,19,47.4,10,21,31,12,21,18,5,3,59,0
22981,535451,597_17_04,SPAIN,0,TOTALS,SPAIN,200,33,66,50.0,25,44,56.8,8,22,36.4,17,22,77.3,12,29,41,25,18,13,12,1,91,1
22982,535464,597_17_05,MONTENEGRO,0,TOTALS,MONTENEGRO,225,25,68,36.8,20,43,46.5,5,25,20.0,18,27,66.7,18,25,43,13,25,14,4,1,73,1
22983,535476,597_17_05,TURKEY,0,TOTALS,TURKEY,225,29,65,44.6,28,46,60.9,1,19,5.3,10,22,45.5,14,27,41,12,24,18,7,7,69,0
22984,535489,597_17_06,ISRAEL,0,TOTALS,ISRAEL,200,37,77,48.1,26,50,52.0,11,27,40.7,5,10,50.0,14,32,46,26,18,11,10,6,90,1
22985,535502,597_17_06,LATVIA,0,TOTALS,LATVIA,200,18,59,30.5,9,32,28.1,9,27,33.3,9,12,75.0,8,29,37,13,14,22,4,3,54,0
22986,535515,597_17_07,CZECH REPUBLIC,0,TOTALS,CZECH REPUBLIC,200,18,57,31.6,12,27,44.4,6,30,20.0,5,15,33.3,10,18,28,10,23,20,2,3,47,0
22987,535528,597_17_07,GREECE,0,TOTALS,GREECE,200,29,57,50.9,20,28,71.4,9,29,31.0,21,31,67.7,15,33,48,24,19,16,12,1,88,1
22988,535541,597_17_08,ITALY,0,TOTALS,ITALY,200,26,67,38.8,22,44,50.0,4,23,17.4,13,24,54.2,11,25,36,12,23,12,8,6,69,0
22989,535554,597_17_08,SERBIA,0,TOTALS,SERBIA,200,26,65,40.0,15,45,33.3,11,20,55.0,14,24,58.3,18,37,55,13,23,16,8,0,77,1
22990,535567,597_17_09,FRANCE,0,TOTALS,FRANCE,225,27,67,40.3,18,39,46.2,9,28,32.1,13,21,61.9,12,25,37,15,30,12,8,6,76,1
22991,535580,597_17_09,MONTENEGRO,0,TOTALS,MONTENEGRO,225,19,49,38.8,14,35,40.0,5,14,35.7,30,40,75.0,10,31,41,15,24,18,3,0,73,0
22992,535593,597_17_10,LATVIA,0,TOTALS,LATVIA,200,26,72,36.1,21,41,51.2,5,31,16.1,5,8,62.5,14,28,42,16,29,20,6,1,62,0
22993,535606,597_17_10,UKRAINE,0,TOTALS,UKRAINE,200,23,62,37.1,16,36,44.4,7,26,26.9,22,30,73.3,13,36,49,14,16,20,10,5,75,1
22994,535618,597_17_11,TURKEY,0,TOTALS,TURKEY,200,32,68,47.1,21,42,50.0,11,26,42.3,7,15,46.7,13,30,43,26,15,14,10,10,82,1
22995,535631,597_17_11,ICELAND,0,TOTALS,ICELAND,200,26,78,33.3,16,50,32.0,10,28,35.7,4,7,57.1,21,27,48,13,17,16,4,1,66,0
22996,535644,597_17_12,SERBIA,0,TOTALS,SERBIA,200,29,56,51.8,24,38,63.2,5,18,27.8,19,25,76.0,10,32,42,20,25,15,8,5,82,1
22997,535657,597_17_12,SLOVENIA,0,TOTALS,SLOVENIA,200,21,69,30.4,16,38,42.1,5,31,16.1,10,20,50.0,17,19,36,12,27,11,6,1,57,0
22998,535670,597_17_13,GERMANY,0,TOTALS,GERMANY,200,30,61,49.2,22,33,66.7,8,28,28.6,22,27,81.5,16,28,44,17,20,19,15,1,90,1
22999,535683,597_17_13,CZECH REPUBLIC,0,TOTALS,CZECH REPUBLIC,200,17,50,34.0,9,20,45.0,8,30,26.7,9,14,64.3,5,15,20,13,26,25,7,0,51,0
23000,535696,597_17_14,SPAIN,0,TOTALS,SPAIN,200,26,52,50.0,19,35,54.3,7,17,41.2,24,37,64.9,4,31,35,12,22,17,9,2,83,1
23001,535709,597_17_14,ITALY,0,TOTALS,ITALY,200,24,64,37.5,17,42,40.5,7,22,31.8,17,22,77.3,10,28,38,17,26,16,10,2,72,0
23002,535722,597_17_15,GREECE,0,TOTALS,GREECE,200,31,64,48.4,26,48,54.2,5,16,31.2,12,15,80.0,6,21,27,21,14,6,13,3,79,1
23003,535735,597_17_15,SWEDEN,0,TOTALS,SWEDEN,200,18,45,40.0,15,36,41.7,3,9,33.3,5,9,55.6,7,28,35,8,21,26,2,1,44,0
23004,535748,597_17_16,LITHUANIA,0,TOTALS,LITHUANIA,200,29,68,42.6,17,37,45.9,12,31,38.7,18,24,75.0,17,23,40,20,14,18,10,3,88,0
23005,535761,597_17_16,ISRAEL,0,TOTALS,ISRAEL,200,38,72,52.8,24,35,68.6,14,37,37.8,4,10,40.0,10,25,35,22,24,16,8,0,94,1
23006,535774,597_17_17,MONTENEGRO,0,TOTALS,MONTENEGRO,200,17,60,28.3,13,36,36.1,4,24,16.7,12,15,80.0,11,34,45,13,21,20,7,5,50,0
23007,535787,597_17_17,ICELAND,0,TOTALS,ICELAND,200,22,62,35.5,19,43,44.2,3,19,15.8,13,22,59.1,12,31,43,13,20,16,6,3,60,1
23008,535800,597_17_18,ITALY,0,TOTALS,ITALY,200,20,53,37.7,12,31,38.7,8,22,36.4,15,26,57.7,8,22,30,12,19,21,8,2,63,0
23009,535813,597_17_18,SLOVENIA,0,TOTALS,SLOVENIA,200,32,62,51.6,25,43,58.1,7,19,36.8,11,13,84.6,8,29,37,21,27,14,7,4,82,1
23010,535825,597_17_19,CZECH REPUBLIC,0,TOTALS,CZECH REPUBLIC,200,22,62,35.5,18,37,48.6,4,25,16.0,8,13,61.5,8,22,30,9,20,14,11,3,56,0
23011,535838,597_17_19,SWEDEN,0,TOTALS,SWEDEN,200,25,56,44.6,18,34,52.9,7,22,31.8,13,20,65.0,13,34,47,17,15,21,5,2,70,1
23012,535851,597_17_20,UKRAINE,0,TOTALS,UKRAINE,200,33,73,45.2,23,47,48.9,10,26,38.5,7,11,63.6,13,31,44,14,22,15,9,3,83,0
23013,535864,597_17_20,ISRAEL,0,TOTALS,ISRAEL,200,35,73,47.9,23,50,46.0,12,23,52.2,9,17,52.9,13,30,43,14,21,14,10,0,91,1
23014,535877,597_17_21,FRANCE,0,TOTALS,FRANCE,200,29,61,47.5,21,40,52.5,8,21,38.1,5,12,41.7,12,29,41,18,12,18,7,1,71,1
23015,535890,597_17_21,TURKEY,0,TOTALS,TURKEY,200,24,65,36.9,19,46,41.3,5,19,26.3,1,1,100.0,10,19,29,11,15,16,9,3,54,0
23016,535903,597_17_22,LATVIA,0,TOTALS,LATVIA,200,23,64,35.9,16,40,40.0,7,24,29.2,8,12,66.7,10,19,29,8,26,16,9,1,61,0
23017,535916,597_17_22,LITHUANIA,0,TOTALS,LITHUANIA,200,30,67,44.8,22,42,52.4,8,25,32.0,21,28,75.0,21,34,55,22,21,18,10,5,89,1
23018,535929,597_17_23,GERMANY,0,TOTALS,GERMANY,200,22,51,43.1,13,32,40.6,9,19,47.4,24,29,82.8,14,28,42,18,34,26,3,1,77,0
23019,535942,597_17_23,GREECE,0,TOTALS,GREECE,200,23,55,41.8,14,34,41.2,9,21,42.9,31,37,83.8,7,18,25,14,24,8,12,2,86,1
23020,535955,597_17_24,SPAIN,0,TOTALS,SPAIN,200,26,67,38.8,13,41,31.7,13,26,50.0,23,30,76.7,21,25,46,19,20,16,8,3,88,1
23021,535968,597_17_24,SERBIA,0,TOTALS,SERBIA,200,34,74,45.9,22,42,52.4,12,32,37.5,7,16,43.8,19,22,41,15,25,13,6,6,87,0
23022,535981,597_17_25,SWEDEN,0,TOTALS,SWEDEN,200,16,66,24.2,12,47,25.5,4,19,21.1,3,10,30.0,15,38,53,9,18,22,6,3,39,0
23023,535994,597_17_25,ICELAND,0,TOTALS,ICELAND,200,30,76,39.5,24,52,46.2,6,24,25.0,7,13,53.8,12,38,50,18,9,9,10,6,73,1
23024,536007,597_17_26,TURKEY,0,TOTALS,TURKEY,200,29,69,42.0,24,46,52.2,5,23,21.7,14,23,60.9,13,21,34,12,20,11,12,1,77,0
23025,536020,597_17_26,GERMANY,0,TOTALS,GERMANY,200,28,58,48.3,20,38,52.6,8,20,40.0,16,21,76.2,11,30,41,19,22,22,6,1,80,1
23026,536033,597_17_27,ISRAEL,0,TOTALS,ISRAEL,200,28,60,46.7,20,41,48.8,8,19,42.1,15,23,65.2,12,29,41,21,25,15,5,1,79,1
23027,536046,597_17_27,ITALY,0,TOTALS,ITALY,200,22,64,34.4,12,32,37.5,10,32,31.2,17,23,73.9,14,24,38,16,19,13,4,7,71,0
23028,536059,597_17_28,SPAIN,0,TOTALS,SPAIN,200,31,70,44.3,17,38,44.7,14,32,43.8,20,28,71.4,16,24,40,23,16,8,19,0,96,1
23029,536072,597_17_28,LATVIA,0,TOTALS,LATVIA,200,18,46,39.1,12,28,42.9,6,18,33.3,10,18,55.6,8,26,34,12,27,26,3,2,52,0
23030,536085,597_17_29,FRANCE,0,TOTALS,FRANCE,200,30,69,43.5,17,36,47.2,13,33,39.4,15,18,83.3,21,30,51,22,19,15,9,4,88,1
23031,536098,597_17_29,CZECH REPUBLIC,0,TOTALS,CZECH REPUBLIC,200,23,65,35.4,14,34,41.2,9,31,29.0,6,12,50.0,16,20,36,12,24,16,8,1,61,0
23032,536111,597_17_30,LITHUANIA,0,TOTALS,LITHUANIA,200,25,59,42.4,18,36,50.0,7,23,30.4,19,25,76.0,9,31,40,18,15,12,7,5,76,1
23033,536124,597_17_30,SLOVENIA,0,TOTALS,SLOVENIA,200,23,66,34.8,14,37,37.8,9,29,31.0,6,10,60.0,10,29,39,13,25,12,8,0,61,0
23034,536137,597_17_31,GREECE,0,TOTALS,GREECE,200,20,56,35.7,15,38,39.5,5,18,27.8,11,16,68.8,10,28,38,11,19,15,6,2,56,1
23035,536150,597_17_31,MONTENEGRO,0,TOTALS,MONTENEGRO,200,18,53,34.0,15,37,40.5,3,16,18.8,10,15,66.7,7,28,35,10,26,14,9,2,49,0
23036,536163,597_17_32,SERBIA,0,TOTALS,SERBIA,200,36,92,39.1,26,59,44.1,10,33,30.3,16,19,84.2,27,40,67,19,18,16,9,4,98,1
23037,536176,597_17_32,UKRAINE,0,TOTALS,UKRAINE,200,23,72,31.9,17,44,38.6,6,28,21.4,11,17,64.7,12,29,41,12,19,20,8,5,63,0
23038,536189,597_17_33,SWEDEN,0,TOTALS,SWEDEN,200,29,59,49.2,24,46,52.2,5,13,38.5,13,21,61.9,12,38,50,12,21,17,3,4,76,1
23039,536202,597_17_33,ITALY,0,TOTALS,ITALY,200,23,71,32.4,15,47,31.9,8,24,33.3,12,18,66.7,11,22,33,10,22,7,7,3,66,0
23040,536215,597_17_34,ICELAND,0,TOTALS,ICELAND,200,20,69,29.0,13,33,39.4,7,36,19.4,7,14,50.0,7,29,36,11,10,11,5,3,54,0
23041,536228,597_17_34,ISRAEL,0,TOTALS,ISRAEL,200,31,72,43.1,26,54,48.1,5,18,27.8,7,12,58.3,13,46,59,12,18,15,7,1,74,1
23042,536241,597_17_35,TURKEY,0,TOTALS,TURKEY,200,29,72,40.3,24,44,54.5,5,28,17.9,12,20,60.0,18,29,47,22,13,11,12,10,75,1
23043,536254,597_17_35,LATVIA,0,TOTALS,LATVIA,200,22,59,37.3,18,43,41.9,4,16,25.0,9,13,69.2,10,27,37,12,19,16,3,2,57,0
23044,536267,597_17_36,GERMANY,0,TOTALS,GERMANY,200,23,66,34.8,20,49,40.8,3,17,17.6,12,20,60.0,18,24,42,11,31,21,10,1,61,0
23045,536280,597_17_36,SPAIN,0,TOTALS,SPAIN,200,21,63,33.3,14,38,36.8,7,25,28.0,20,28,71.4,18,30,48,13,22,21,10,4,69,1
23046,536293,597_17_37,CZECH REPUBLIC,0,TOTALS,CZECH REPUBLIC,200,26,69,37.7,14,31,45.2,12,38,31.6,4,8,50.0,9,23,32,12,21,12,7,3,68,0
23047,536306,597_17_37,UKRAINE,0,TOTALS,UKRAINE,200,26,55,47.3,20,36,55.6,6,19,31.6,17,23,73.9,10,36,46,17,15,18,6,1,75,1
23048,536319,597_17_38,FRANCE,0,TOTALS,FRANCE,200,35,69,50.7,19,41,46.3,16,28,57.1,0,2,0.0,14,34,48,19,27,15,4,1,86,1
23049,536332,597_17_38,SERBIA,0,TOTALS,SERBIA,200,20,67,29.9,15,45,33.3,5,22,22.7,22,31,71.0,16,21,37,10,15,10,9,2,67,0
23050,536345,597_17_39,MONTENEGRO,0,TOTALS,MONTENEGRO,225,27,57,47.4,18,35,51.4,9,22,40.9,20,27,74.1,10,27,37,16,20,20,2,2,83,1
23051,536358,597_17_39,SLOVENIA,0,TOTALS,SLOVENIA,225,31,68,45.6,24,44,54.5,7,24,29.2,9,13,69.2,13,20,33,16,22,14,6,6,78,0
23052,536371,597_17_40,GREECE,0,TOTALS,GREECE,200,27,69,39.1,16,46,34.8,11,23,47.8,11,16,68.8,16,22,38,17,22,8,6,2,76,1
23053,536384,597_17_40,LITHUANIA,0,TOTALS,LITHUANIA,200,24,63,38.1,14,28,50.0,10,35,28.6,14,22,63.6,17,30,47,18,20,13,3,5,72,0
23054,536397,597_17_41,SLOVENIA,0,TOTALS,SLOVENIA,200,26,71,36.6,20,47,42.6,6,24,25.0,20,25,80.0,19,33,52,18,21,11,10,6,78,1
23055,536410,597_17_41,LATVIA,0,TOTALS,LATVIA,200,17,59,28.8,14,41,34.1,3,18,16.7,13,19,68.4,13,28,41,7,24,19,6,5,50,0
23056,536423,597_17_42,MONTENEGRO,0,TOTALS,MONTENEGRO,200,22,57,38.6,19,42,45.2,3,15,20.0,25,31,80.6,9,30,39,15,16,18,8,2,72,0
23057,536436,597_17_42,TURKEY,0,TOTALS,TURKEY,200,30,69,43.5,19,37,51.4,11,32,34.4,9,15,60.0,9,30,39,15,22,14,11,8,80,1
23058,536449,597_17_43,ITALY,0,TOTALS,ITALY,200,20,65,30.8,15,41,36.6,5,24,20.8,10,19,52.6,16,33,49,14,16,14,10,3,55,1
23059,536462,597_17_43,CZECH REPUBLIC,0,TOTALS,CZECH REPUBLIC,200,20,65,30.8,13,30,43.3,7,35,20.0,6,12,50.0,13,33,46,12,20,15,9,2,53,0
23060,536475,597_17_44,SWEDEN,0,TOTALS,SWEDEN,225,26,87,29.9,19,65,29.2,7,22,31.8,15,20,75.0,17,37,54,16,18,14,7,1,74,0
23061,536488,597_17_44,UKRAINE,0,TOTALS,UKRAINE,225,31,75,41.3,28,61,45.9,3,14,21.4,12,19,63.2,9,46,55,14,16,19,10,7,77,1
23062,536501,597_17_45,LITHUANIA,0,TOTALS,LITHUANIA,200,32,64,50.0,21,40,52.5,11,24,45.8,10,14,71.4,9,26,35,21,15,19,9,2,85,1
23063,536514,597_17_45,GERMANY,0,TOTALS,GERMANY,200,33,65,50.8,26,42,61.9,7,23,30.4,8,10,80.0,7,24,31,17,21,19,11,3,81,0
23064,536527,597_17_46,ISRAEL,0,TOTALS,ISRAEL,200,26,57,45.6,20,43,46.5,6,14,42.9,16,22,72.7,8,40,48,26,20,21,5,2,74,1
23065,536540,597_17_46,FRANCE,0,TOTALS,FRANCE,200,19,64,29.7,12,31,38.7,7,33,21.2,7,13,53.8,6,27,33,9,22,16,9,4,52,0
23066,536553,597_17_47,ICELAND,0,TOTALS,ICELAND,200,28,77,36.4,24,47,51.1,4,30,13.3,7,15,46.7,14,26,40,18,11,15,8,6,67,0
23067,536566,597_17_47,SERBIA,0,TOTALS,SERBIA,200,35,67,52.2,24,44,54.5,11,23,47.8,8,10,80.0,6,38,44,22,23,16,5,5,89,1
23068,536579,597_17_48,GREECE,0,TOTALS,GREECE,200,27,58,46.6,21,42,50.0,6,16,37.5,17,19,89.5,6,27,33,17,24,9,5,3,77,1
23069,536592,597_17_48,SPAIN,0,TOTALS,SPAIN,200,19,57,33.3,17,39,43.6,2,18,11.1,16,23,69.6,12,25,37,8,24,11,5,3,56,0
23070,536605,597_17_49,LATVIA,0,TOTALS,LATVIA,200,28,65,43.1,14,31,45.2,14,34,41.2,7,11,63.6,14,26,40,17,24,19,5,2,77,0
23071,536618,597_17_49,CZECH REPUBLIC,0,TOTALS,CZECH REPUBLIC,200,28,60,46.7,21,38,55.3,7,22,31.8,17,23,73.9,6,25,31,15,17,12,8,4,80,1
23072,536631,597_17_50,MONTENEGRO,0,TOTALS,MONTENEGRO,200,24,65,36.9,20,42,47.6,4,23,17.4,13,18,72.2,10,25,35,14,19,12,14,5,65,1
23073,536644,597_17_50,SWEDEN,0,TOTALS,SWEDEN,200,23,59,39.0,19,44,43.2,4,15,26.7,11,19,57.9,16,30,46,7,18,24,8,2,61,0
23074,536657,597_17_51,TURKEY,0,TOTALS,TURKEY,200,35,75,46.7,29,50,58.0,6,25,24.0,9,11,81.8,11,26,37,18,19,13,13,4,85,1
23075,536670,597_17_51,UKRAINE,0,TOTALS,UKRAINE,200,33,79,41.8,25,51,49.0,8,28,28.6,8,13,61.5,19,31,50,24,16,18,6,3,82,0
23076,536683,597_17_52,GERMANY,0,TOTALS,GERMANY,200,30,62,48.4,24,44,54.5,6,18,33.3,13,17,76.5,9,28,37,18,20,17,9,7,79,1
23077,536696,597_17_52,ICELAND,0,TOTALS,ICELAND,200,26,68,38.2,21,44,47.7,5,24,20.8,16,18,88.9,14,24,38,15,18,18,8,2,73,0
23078,536709,597_17_53,SLOVENIA,0,TOTALS,SLOVENIA,200,22,61,36.1,18,44,40.9,4,17,23.5,4,9,44.4,12,21,33,15,22,16,6,3,52,0
23079,536722,597_17_53,ITALY,0,TOTALS,ITALY,200,25,61,41.0,19,44,43.2,6,17,35.3,13,17,76.5,16,31,47,17,15,17,8,4,69,1
23080,536735,597_17_54,LITHUANIA,0,TOTALS,LITHUANIA,200,33,75,44.0,27,44,61.4,6,31,19.4,14,18,77.8,26,17,43,14,16,20,9,2,86,1
23081,536748,597_17_54,SERBIA,0,TOTALS,SERBIA,200,41,68,60.3,28,43,65.1,13,25,52.0,7,8,87.5,11,18,29,22,18,14,14,1,102,0
23082,536761,597_17_55,SPAIN,0,TOTALS,SPAIN,200,19,62,30.6,13,40,32.5,6,22,27.3,14,21,66.7,16,22,38,16,13,11,4,1,58,0
23083,536774,597_17_55,FRANCE,0,TOTALS,FRANCE,200,30,67,44.8,24,47,51.1,6,20,30.0,6,11,54.5,14,30,44,17,23,11,4,4,72,1
23084,536787,597_17_56,GREECE,0,TOTALS,GREECE,200,20,62,32.3,10,33,30.3,10,29,34.5,15,21,71.4,13,29,42,12,16,10,11,3,65,1
23085,536800,597_17_56,ISRAEL,0,TOTALS,ISRAEL,200,20,59,33.9,13,33,39.4,7,26,26.9,9,14,64.3,10,33,43,13,23,13,4,1,56,0
23086,536813,598_17_01,ALBANIA,0,TOTALS,ALBANIA,200,36,83,43.4,33,63,52.4,3,20,15.0,17,19,89.5,29,30,59,15,22,15,11,1,92,1
23087,536826,598_17_01,MALTA,0,TOTALS,MALTA,200,23,62,37.1,16,41,39.0,7,21,33.3,8,17,47.1,9,19,28,14,16,18,4,1,61,0
23088,536837,598_17_02,MOLDOVA,0,TOTALS,MOLDOVA,200,23,68,33.8,13,39,33.3,10,29,34.5,9,15,60.0,11,34,45,14,16,40,12,4,65,1
23089,536850,598_17_02,IRELAND,0,TOTALS,IRELAND,200,45,90,50.0,42,73,57.5,3,17,17.6,10,17,58.8,13,34,47,25,14,18,20,6,103,0
23090,536861,598_17_03,AZERBAIJAN,0,TOTALS,AZERBAIJAN,200,22,56,39.3,16,36,44.4,6,20,30.0,6,12,50.0,8,22,30,9,15,26,6,3,56,0
23091,536874,598_17_03,RUSSIA,0,TOTALS,RUSSIA,200,36,77,46.8,34,58,58.6,2,19,10.5,11,17,64.7,21,28,49,20,16,13,13,1,85,1
23092,536887,598_17_04,CROATIA,0,TOTALS,CROATIA,200,35,66,53.0,27,41,65.9,8,25,32.0,22,29,75.9,15,34,49,17,11,18,18,2,100,0
23093,536900,598_17_04,KOSOVO,0,TOTALS,KOSOVO,200,17,57,29.8,15,42,35.7,2,15,13.3,6,9,66.7,7,17,24,8,23,28,11,2,42,1
23094,536913,598_17_05,POLAND,0,TOTALS,POLAND,200,31,58,53.4,24,42,57.1,7,16,43.8,10,17,58.8,12,36,48,13,14,17,8,1,79,1
23095,536926,598_17_05,BELGIUM,0,TOTALS,BELGIUM,200,19,62,30.6,14,37,37.8,5,25,20.0,8,15,53.3,11,17,28,9,23,13,10,2,51,0
23096,536937,598_17_06,ARMENIA,0,TOTALS,ARMENIA,200,27,69,39.1,18,47,38.3,9,22,40.9,6,9,66.7,12,26,38,17,24,21,10,1,69,0
23097,536950,598_17_06,FINLAND,0,TOTALS,FINLAND,200,32,69,46.4,20,34,58.8,12,35,34.3,19,23,82.6,14,29,43,20,9,14,9,3,95,1
23098,536963,598_17_07,GEORGIA,0,TOTALS,GEORGIA,200,17,53,32.1,10,32,31.2,7,21,33.3,10,18,55.6,6,28,34,10,16,15,11,4,51,0
23099,536976,598_17_07,ROMANIA,0,TOTALS,ROMANIA,200,25,69,36.2,19,44,43.2,6,25,24.0,7,9,77.8,17,33,50,13,19,15,8,5,63,1
23100,536989,598_17_08,GREAT BRITAIN,0,TOTALS,GREAT BRITAIN,200,22,59,37.3,20,43,46.5,2,16,12.5,19,26,73.1,12,25,37,7,21,23,10,3,65,0
23101,537002,598_17_08,NETHERLANDS,0,TOTALS,NETHERLANDS,200,28,59,47.5,24,48,50.0,4,11,36.4,14,20,70.0,9,22,31,14,23,26,11,3,74,1
23102,537015,598_17_09,PORTUGAL,0,TOTALS,PORTUGAL,225,25,70,35.7,17,39,43.6,8,31,25.8,10,15,66.7,15,27,42,8,20,16,7,2,68,1
23103,537028,598_17_09,HUNGARY,0,TOTALS,HUNGARY,225,20,61,32.8,11,37,29.7,9,24,37.5,18,27,66.7,15,30,45,8,19,17,10,1,67,0
23104,537041,598_17_10,KOSOVO,0,TOTALS,KOSOVO,200,40,76,52.6,34,61,55.7,6,15,40.0,16,29,55.2,18,34,52,16,17,21,19,5,102,0
23105,537052,598_17_10,MOLDOVA,0,TOTALS,MOLDOVA,200,17,63,27.0,14,32,43.8,3,31,9.7,9,17,52.9,14,22,36,7,22,33,14,1,46,1
23106,537065,598_17_11,FINLAND,0,TOTALS,FINLAND,200,21,53,39.6,15,38,39.5,6,15,40.0,13,19,68.4,5,25,30,8,26,19,7,3,61,0
23107,537078,598_17_11,POLAND,0,TOTALS,POLAND,200,25,58,43.1,20,44,45.5,5,14,35.7,13,27,48.1,12,26,38,10,21,17,7,4,68,1
23108,537091,598_17_12,MALTA,0,TOTALS,MALTA,200,23,59,39.0,16,40,40.0,7,19,36.8,16,23,69.6,10,22,32,9,20,19,9,0,69,0
23109,537104,598_17_12,GEORGIA,0,TOTALS,GEORGIA,200,34,71,47.9,27,47,57.4,7,24,29.2,15,26,57.7,22,31,53,16,19,19,14,6,90,1
23110,537117,598_17_13,BELARUS,0,TOTALS,BELARUS,200,23,56,41.1,16,35,45.7,7,21,33.3,14,21,66.7,12,32,44,2,14,19,4,3,67,1
23111,537128,598_17_13,ARMENIA,0,TOTALS,ARMENIA,200,22,56,39.3,17,40,42.5,5,16,31.2,7,10,70.0,4,24,28,2,20,8,5,3,56,0
23112,537141,598_17_14,IRELAND,0,TOTALS,IRELAND,200,22,57,38.6,19,42,45.2,3,15,20.0,6,15,40.0,12,22,34,9,20,31,14,1,53,0
23113,537154,598_17_14,PORTUGAL,0,TOTALS,PORTUGAL,200,28,71,39.4,19,36,52.8,9,35,25.7,16,18,88.9,19,25,44,13,11,24,24,3,81,1
23114,537167,598_17_15,SLOVAK REPUBLIC,0,TOTALS,SLOVAK REPUBLIC,200,34,80,42.5,24,42,57.1,10,38,26.3,8,16,50.0,17,27,44,9,11,12,3,0,86,1
23115,537179,598_17_15,AZERBAIJAN,0,TOTALS,AZERBAIJAN,200,32,72,44.4,25,49,51.0,7,23,30.4,7,10,70.0,7,30,37,5,14,6,8,4,78,0
23116,537192,598_17_16,HUNGARY,0,TOTALS,HUNGARY,200,20,61,32.8,13,33,39.4,7,28,25.0,10,22,45.5,9,19,28,14,19,12,11,5,57,0
23117,537205,598_17_16,CROATIA,0,TOTALS,CROATIA,200,29,63,46.0,22,41,53.7,7,22,31.8,13,20,65.0,16,34,50,23,20,20,11,8,78,1
23118,537218,598_17_17,RUSSIA,0,TOTALS,RUSSIA,200,24,65,36.9,17,48,35.4,7,17,41.2,2,5,40.0,10,24,34,2,17,11,9,3,57,0
23119,537231,598_17_17,GREAT BRITAIN,0,TOTALS,GREAT BRITAIN,200,23,59,39.0,17,44,38.6,6,15,40.0,12,17,70.6,12,30,42,7,16,14,5,3,64,1
23120,537244,598_17_18,MKD,0,TOTALS,MKD,225,21,73,28.8,14,36,38.9,7,37,18.9,13,22,59.1,17,31,48,14,15,21,10,3,62,1
23121,537257,598_17_18,ALBANIA,0,TOTALS,ALBANIA,225,19,63,30.2,15,41,36.6,4,22,18.2,12,14,85.7,12,38,50,7,18,31,15,7,54,0
23122,537270,598_17_19,POLAND,0,TOTALS,POLAND,200,28,68,41.2,21,54,38.9,7,14,50.0,13,19,68.4,14,29,43,14,16,9,14,2,76,1
23123,537283,598_17_19,BELARUS,0,TOTALS,BELARUS,200,17,59,28.8,16,37,43.2,1,22,4.5,10,12,83.3,12,29,41,8,20,19,8,0,45,0
23124,537296,598_17_20,CROATIA,0,TOTALS,CROATIA,200,25,52,48.1,17,31,54.8,8,21,38.1,17,21,81.0,7,30,37,13,27,18,6,0,75,1
23125,537309,598_17_20,PORTUGAL,0,TOTALS,PORTUGAL,200,21,56,37.5,13,35,37.1,8,21,38.1,11,21,52.4,6,23,29,13,23,16,10,0,61,0
23126,537320,598_17_21,MOLDOVA,0,TOTALS,MOLDOVA,200,13,64,20.3,6,36,16.7,7,28,25.0,9,17,52.9,15,26,41,8,19,26,6,4,42,0
23127,537333,598_17_21,HUNGARY,0,TOTALS,HUNGARY,200,35,76,46.1,20,40,50.0,15,36,41.7,6,16,37.5,18,36,54,18,20,16,13,2,91,1
23128,537346,598_17_22,GREAT BRITAIN,0,TOTALS,GREAT BRITAIN,200,28,66,42.4,24,48,50.0,4,18,22.2,7,12,58.3,12,31,43,13,11,9,8,3,67,1
23129,537359,598_17_22,SLOVAK REPUBLIC,0,TOTALS,SLOVAK REPUBLIC,200,22,59,37.3,20,40,50.0,2,19,10.5,7,10,70.0,9,26,35,11,15,15,5,2,53,0
23130,537372,598_17_23,GEORGIA,0,TOTALS,GEORGIA,200,25,47,53.2,24,35,68.6,1,12,8.3,27,43,62.8,8,37,45,11,23,13,4,3,78,1
23131,537385,598_17_23,MKD,0,TOTALS,MKD,200,13,57,22.8,10,32,31.2,3,25,12.0,19,26,73.1,7,18,25,5,30,9,5,1,48,0
23132,537398,598_17_24,BELGIUM,0,TOTALS,BELGIUM,200,29,78,37.2,22,51,43.1,7,27,25.9,11,15,73.3,16,35,51,13,26,11,7,3,76,1
23133,537411,598_17_24,FINLAND,0,TOTALS,FINLAND,200,19,66,28.8,12,37,32.4,7,29,24.1,19,28,67.9,18,33,51,13,18,16,4,3,64,0
23134,537424,598_17_25,ROMANIA,0,TOTALS,ROMANIA,200,31,70,44.3,19,33,57.6,12,37,32.4,10,18,55.6,20,27,47,17,23,19,11,2,84,1
23135,537437,598_17_25,MALTA,0,TOTALS,MALTA,200,21,58,36.2,17,41,41.5,4,17,23.5,19,26,73.1,8,23,31,5,13,20,11,0,65,0
23136,537450,598_17_26,NETHERLANDS,0,TOTALS,NETHERLANDS,200,20,48,41.7,18,38,47.4,2,10,20.0,6,13,46.2,7,22,29,16,21,20,7,3,48,0
23137,537463,598_17_26,RUSSIA,0,TOTALS,RUSSIA,200,21,55,38.2,11,32,34.4,10,23,43.5,15,25,60.0,11,24,35,15,17,15,6,1,67,1
23138,537476,598_17_27,KOSOVO,0,TOTALS,KOSOVO,200,25,59,42.4,17,42,40.5,8,17,47.1,18,27,66.7,12,34,46,12,22,29,18,1,76,1
23139,537489,598_17_27,IRELAND,0,TOTALS,IRELAND,200,24,64,37.5,16,42,38.1,8,22,36.4,13,22,59.1,9,24,33,11,20,26,12,5,69,0
23140,537502,598_17_28,ALBANIA,0,TOTALS,ALBANIA,200,19,61,31.1,15,44,34.1,4,17,23.5,11,17,64.7,10,20,30,12,23,25,9,0,53,1
23141,537515,598_17_28,GEORGIA,0,TOTALS,GEORGIA,200,38,63,60.3,26,41,63.4,12,22,54.5,14,22,63.6,8,30,38,27,20,17,19,3,102,0
23142,537528,598_17_29,BELARUS,0,TOTALS,BELARUS,200,30,66,45.5,28,48,58.3,2,18,11.1,9,18,50.0,12,26,38,15,16,19,7,2,71,0
23143,537541,598_17_29,BELGIUM,0,TOTALS,BELGIUM,200,32,74,43.2,24,48,50.0,8,26,30.8,8,13,61.5,15,28,43,19,21,12,8,1,80,1
23144,537554,598_17_30,HUNGARY,0,TOTALS,HUNGARY,200,26,59,44.1,14,27,51.9,12,32,37.5,16,24,66.7,16,26,42,16,17,18,15,3,80,1
23145,537567,598_17_30,KOSOVO,0,TOTALS,KOSOVO,200,21,58,36.2,19,41,46.3,2,17,11.8,11,19,57.9,14,22,36,12,20,21,7,0,55,0
23146,537579,598_17_31,AZERBAIJAN,0,TOTALS,AZERBAIJAN,200,27,78,34.6,16,46,34.8,11,32,34.4,3,5,60.0,9,27,36,6,19,10,5,3,68,1
23147,537592,598_17_31,GREAT BRITAIN,0,TOTALS,GREAT BRITAIN,200,40,86,46.5,25,49,51.0,15,37,40.5,16,30,53.3,25,43,68,30,3,8,6,1,111,0
23148,537605,598_17_32,PORTUGAL,0,TOTALS,PORTUGAL,200,33,67,49.3,26,42,61.9,7,25,28.0,16,20,80.0,8,37,45,17,11,9,10,5,89,1
23149,537616,598_17_32,MOLDOVA,0,TOTALS,MOLDOVA,200,18,58,31.0,13,40,32.5,5,18,27.8,4,9,44.4,6,27,33,5,23,22,6,2,45,0
23150,537629,598_17_33,SLOVAK REPUBLIC,0,TOTALS,SLOVAK REPUBLIC,200,16,54,29.6,13,36,36.1,3,18,16.7,21,26,80.8,12,23,35,14,19,18,8,5,56,0
23151,537642,598_17_33,NETHERLANDS,0,TOTALS,NETHERLANDS,200,27,62,43.5,24,40,60.0,3,22,13.6,17,21,81.0,13,29,42,21,22,16,10,5,74,1
23152,537655,598_17_34,MKD,0,TOTALS,MKD,200,25,53,47.2,24,40,60.0,1,13,7.7,12,21,57.1,12,23,35,12,22,19,9,1,63,0
23153,537668,598_17_34,ROMANIA,0,TOTALS,ROMANIA,200,22,59,37.3,15,31,48.4,7,28,25.0,17,22,77.3,14,21,35,13,23,15,9,3,68,1
23154,537679,598_17_35,ARMENIA,0,TOTALS,ARMENIA,200,18,57,31.6,10,30,33.3,8,27,29.6,12,15,80.0,9,40,49,7,21,24,10,3,56,1
23155,537692,598_17_35,POLAND,0,TOTALS,POLAND,200,18,69,26.1,15,42,35.7,3,27,11.1,8,18,44.4,15,28,43,13,18,16,12,1,47,0
23156,537705,598_17_36,IRELAND,0,TOTALS,IRELAND,200,16,60,26.7,12,33,36.4,4,27,14.8,11,16,68.8,8,20,28,6,25,23,8,0,47,0
23157,537718,598_17_36,CROATIA,0,TOTALS,CROATIA,200,31,61,50.8,21,38,55.3,10,23,43.5,23,37,62.2,11,37,48,15,18,20,13,1,95,1
23158,537731,598_17_37,MALTA,0,TOTALS,MALTA,200,25,68,36.8,19,50,38.0,6,18,33.3,4,11,36.4,11,24,35,18,21,18,9,1,60,0
23159,537744,598_17_37,MKD,0,TOTALS,MKD,200,37,69,53.6,26,46,56.5,11,23,47.8,14,25,56.0,17,32,49,31,19,13,12,4,99,1
23160,537757,598_17_38,NETHERLANDS,0,TOTALS,NETHERLANDS,200,31,69,44.9,22,47,46.8,9,22,40.9,14,21,66.7,17,21,38,28,23,12,12,2,85,1
23161,537769,598_17_38,AZERBAIJAN,0,TOTALS,AZERBAIJAN,200,15,47,31.9,6,24,25.0,9,23,39.1,15,23,65.2,12,22,34,7,21,28,6,4,54,0
23162,537782,598_17_39,RUSSIA,0,TOTALS,RUSSIA,200,30,69,43.5,23,42,54.8,7,27,25.9,19,25,76.0,21,21,42,11,23,15,6,0,86,1
23163,537795,598_17_39,SLOVAK REPUBLIC,0,TOTALS,SLOVAK REPUBLIC,200,21,53,39.6,16,33,48.5,5,20,25.0,21,30,70.0,10,16,26,8,24,19,8,5,68,0
23164,537807,598_17_40,BELGIUM,0,TOTALS,BELGIUM,200,32,73,43.8,21,42,50.0,11,31,35.5,12,19,63.2,17,28,45,25,20,13,10,0,87,1
23165,537818,598_17_40,ARMENIA,0,TOTALS,ARMENIA,200,26,61,42.6,16,38,42.1,10,23,43.5,12,19,63.2,8,26,34,10,15,19,9,2,74,0
23166,537831,598_17_41,HUNGARY,0,TOTALS,HUNGARY,200,22,66,33.3,15,34,44.1,7,32,21.9,7,26,26.9,19,28,47,12,22,18,9,5,58,1
23167,537844,598_17_41,IRELAND,0,TOTALS,IRELAND,200,19,58,32.8,17,40,42.5,2,18,11.1,6,13,46.2,13,31,44,10,23,25,4,4,46,0
23168,537857,598_17_42,ROMANIA,0,TOTALS,ROMANIA,200,28,71,39.4,20,35,57.1,8,36,22.2,10,18,55.6,20,34,54,20,19,18,10,3,74,1
23169,537870,598_17_42,ALBANIA,0,TOTALS,ALBANIA,200,20,58,34.5,19,46,41.3,1,12,8.3,6,17,35.3,10,26,36,7,20,20,10,3,47,0
23170,537881,598_17_43,MOLDOVA,0,TOTALS,MOLDOVA,200,17,64,26.6,9,27,33.3,8,37,21.6,5,7,71.4,7,12,19,10,11,40,7,1,47,1
23171,537894,598_17_43,CROATIA,0,TOTALS,CROATIA,200,67,102,65.7,61,80,76.2,6,22,27.3,10,15,66.7,24,41,65,45,9,17,26,6,150,0
23172,537907,598_17_44,FINLAND,0,TOTALS,FINLAND,200,39,74,52.7,24,40,60.0,15,34,44.1,20,24,83.3,15,25,40,23,28,13,12,1,113,0
23173,537920,598_17_44,BELARUS,0,TOTALS,BELARUS,200,27,63,42.9,25,47,53.2,2,16,12.5,12,26,46.2,17,22,39,11,20,25,5,3,68,1
23174,537933,598_17_45,KOSOVO,0,TOTALS,KOSOVO,200,27,59,45.8,22,42,52.4,5,17,29.4,4,11,36.4,10,20,30,11,16,20,13,0,63,0
23175,537946,598_17_45,PORTUGAL,0,TOTALS,PORTUGAL,200,29,62,46.8,19,34,55.9,10,28,35.7,9,18,50.0,15,24,39,18,16,17,12,3,77,1
23176,537957,598_17_46,ARMENIA,0,TOTALS,ARMENIA,200,32,82,39.0,20,51,39.2,12,31,38.7,6,10,60.0,15,41,56,24,20,8,5,3,82,1
23177,537969,598_17_46,AZERBAIJAN,0,TOTALS,AZERBAIJAN,200,30,87,34.5,19,47,40.4,11,40,27.5,9,21,42.9,19,37,56,11,13,7,4,7,80,0
23178,537980,598_17_47,MOLDOVA,0,TOTALS,MOLDOVA,200,17,59,28.8,13,30,43.3,4,29,13.8,10,18,55.6,8,27,35,11,14,31,8,7,48,0
23179,537993,598_17_47,MALTA,0,TOTALS,MALTA,200,41,87,47.1,37,70,52.9,4,17,23.5,10,16,62.5,20,37,57,21,23,16,18,3,96,1
23180,538006,598_17_48,POLAND,0,TOTALS,POLAND,200,25,57,43.9,20,41,48.8,5,16,31.2,14,20,70.0,11,23,34,16,24,21,8,5,69,0
23181,538019,598_17_48,GREAT BRITAIN,0,TOTALS,GREAT BRITAIN,200,21,59,35.6,15,39,38.5,6,20,30.0,23,31,74.2,14,22,36,9,22,17,13,3,71,1
23182,538032,598_17_49,FINLAND,0,TOTALS,FINLAND,200,34,71,47.9,23,38,60.5,11,33,33.3,14,17,82.4,11,26,37,18,20,19,14,2,93,1
23183,538045,598_17_49,SLOVAK REPUBLIC,0,TOTALS,SLOVAK REPUBLIC,200,26,64,40.6,20,44,45.5,6,20,30.0,14,21,66.7,13,26,39,16,17,24,10,2,72,0
23184,538058,598_17_50,CROATIA,0,TOTALS,CROATIA,200,22,55,40.0,17,42,40.5,5,13,38.5,25,35,71.4,11,32,43,13,24,20,12,2,74,1
23185,538071,598_17_50,GEORGIA,0,TOTALS,GEORGIA,200,26,66,39.4,20,42,47.6,6,24,25.0,13,23,56.5,11,28,39,18,27,14,9,4,71,0
23186,538084,598_17_51,HUNGARY,0,TOTALS,HUNGARY,200,30,69,43.5,19,39,48.7,11,30,36.7,9,21,42.9,16,27,43,18,17,7,11,0,80,1
23187,538097,598_17_51,ALBANIA,0,TOTALS,ALBANIA,200,14,50,28.0,8,31,25.8,6,19,31.6,10,20,50.0,12,27,39,7,25,21,3,0,44,0
23188,538110,598_17_52,ROMANIA,0,TOTALS,ROMANIA,200,22,57,38.6,15,31,48.4,7,26,26.9,10,20,50.0,19,27,46,11,17,19,5,4,61,1
23189,538123,598_17_52,PORTUGAL,0,TOTALS,PORTUGAL,200,23,63,36.5,19,41,46.3,4,22,18.2,7,11,63.6,13,19,32,7,18,8,10,1,57,0
23190,538136,598_17_53,NETHERLANDS,0,TOTALS,NETHERLANDS,200,32,63,50.8,25,50,50.0,7,13,53.8,12,18,66.7,8,28,36,24,19,17,15,3,83,1
23191,538149,598_17_53,BELARUS,0,TOTALS,BELARUS,200,26,67,38.8,22,51,43.1,4,16,25.0,6,13,46.2,17,27,44,14,20,24,10,4,62,0
23192,538162,598_17_54,RUSSIA,0,TOTALS,RUSSIA,200,29,65,44.6,21,40,52.5,8,25,32.0,14,18,77.8,12,28,40,18,12,14,12,3,80,1
23193,538174,598_17_54,BELGIUM,0,TOTALS,BELGIUM,200,29,67,43.3,23,47,48.9,6,20,30.0,6,11,54.5,10,27,37,11,23,14,9,0,70,0
23194,538187,598_17_55,MKD,0,TOTALS,MKD,200,16,52,30.8,12,30,40.0,4,22,18.2,28,35,80.0,10,28,38,12,24,22,11,3,64,0
23195,538200,598_17_55,KOSOVO,0,TOTALS,KOSOVO,200,23,61,37.7,19,44,43.2,4,17,23.5,16,21,76.2,10,29,39,10,32,21,11,1,66,1
23196,538213,598_17_56,MALTA,0,TOTALS,MALTA,200,25,68,36.8,20,41,48.8,5,27,18.5,6,14,42.9,16,22,38,17,18,27,8,2,61,0
23197,538226,598_17_56,IRELAND,0,TOTALS,IRELAND,200,38,79,48.1,35,64,54.7,3,15,20.0,12,17,70.6,18,32,50,28,20,21,15,4,91,1
23198,538239,598_17_57,POLAND,0,TOTALS,POLAND,200,31,65,47.7,17,39,43.6,14,26,53.8,15,19,78.9,12,33,45,18,12,14,9,3,91,1
23199,538252,598_17_57,GEORGIA,0,TOTALS,GEORGIA,200,27,63,42.9,17,40,42.5,10,23,43.5,6,12,50.0,6,23,29,13,20,16,8,3,70,0
23200,538265,598_17_58,SLOVAK REPUBLIC,0,TOTALS,SLOVAK REPUBLIC,200,23,70,32.9,19,41,46.3,4,29,13.8,12,20,60.0,25,27,52,10,26,22,13,2,62,0
23201,538278,598_17_58,ALBANIA,0,TOTALS,ALBANIA,200,27,67,40.3,22,49,44.9,5,18,27.8,15,29,51.7,20,24,44,15,20,20,12,1,74,1
23202,538290,598_17_59,BELGIUM,0,TOTALS,BELGIUM,200,34,61,55.7,27,40,67.5,7,21,33.3,12,18,66.7,14,23,37,20,15,19,13,4,87,1
23203,538303,598_17_59,PORTUGAL,0,TOTALS,PORTUGAL,200,23,60,38.3,12,31,38.7,11,29,37.9,5,5,100.0,12,16,28,14,16,21,10,0,62,0
23204,538316,598_17_60,BELARUS,0,TOTALS,BELARUS,200,23,52,44.2,20,30,66.7,3,22,13.6,9,16,56.2,8,30,38,16,22,25,10,4,58,0
23205,538329,598_17_60,MKD,0,TOTALS,MKD,200,25,62,40.3,22,46,47.8,3,16,18.8,9,18,50.0,11,23,34,11,18,19,8,0,62,1
23206,538342,598_17_61,RUSSIA,0,TOTALS,RUSSIA,225,29,61,47.5,23,42,54.8,6,19,31.6,15,23,65.2,5,22,27,13,24,14,10,1,79,0
23207,538355,598_17_61,ROMANIA,0,TOTALS,ROMANIA,225,32,68,47.1,27,40,67.5,5,28,17.9,18,28,64.3,15,29,44,12,22,19,9,7,87,1
23208,538368,598_17_62,FINLAND,0,TOTALS,FINLAND,200,24,57,42.1,13,27,48.1,11,30,36.7,19,29,65.5,13,25,38,20,22,21,10,6,78,1
23209,538381,598_17_62,HUNGARY,0,TOTALS,HUNGARY,200,20,57,35.1,17,45,37.8,3,12,25.0,13,21,61.9,15,22,37,9,26,24,10,2,56,0
23210,538394,598_17_63,GREAT BRITAIN,0,TOTALS,GREAT BRITAIN,200,26,60,43.3,16,35,45.7,10,25,40.0,7,13,53.8,7,22,29,12,17,8,2,2,69,0
23211,538407,598_17_63,CROATIA,0,TOTALS,CROATIA,200,28,61,45.9,21,46,45.7,7,15,46.7,16,19,84.2,13,31,44,17,17,8,3,3,79,1
23212,538420,598_17_64,NETHERLANDS,0,TOTALS,NETHERLANDS,200,22,54,40.7,14,32,43.8,8,22,36.4,14,25,56.0,7,23,30,15,20,13,13,3,66,1
23213,538433,598_17_64,KOSOVO,0,TOTALS,KOSOVO,200,22,51,43.1,13,27,48.1,9,24,37.5,7,16,43.8,9,29,38,16,20,22,3,1,60,0
23214,538445,598_17_65,AZERBAIJAN,0,TOTALS,AZERBAIJAN,200,34,73,46.6,27,50,54.0,7,23,30.4,13,18,72.2,15,38,53,18,11,19,8,11,88,1
23215,538458,598_17_65,MALTA,0,TOTALS,MALTA,200,25,77,32.5,20,55,36.4,5,22,22.7,8,15,53.3,16,27,43,16,17,17,6,0,63,0
23216,538469,598_17_66,ARMENIA,0,TOTALS,ARMENIA,200,38,73,52.1,24,39,61.5,14,34,41.2,6,9,66.7,7,29,36,30,15,10,10,6,96,1
23217,538482,598_17_66,IRELAND,0,TOTALS,IRELAND,200,32,75,42.7,29,54,53.7,3,21,14.3,8,21,38.1,18,28,46,24,10,15,5,1,75,0
23218,538495,598_17_67,SLOVAK REPUBLIC,0,TOTALS,SLOVAK REPUBLIC,200,24,64,37.5,22,43,51.2,2,21,9.5,11,15,73.3,9,22,31,14,18,23,13,3,61,0
23219,538508,598_17_67,BELARUS,0,TOTALS,BELARUS,200,39,79,49.4,36,65,55.4,3,14,21.4,11,15,73.3,21,34,55,25,14,18,16,3,92,1
23220,538521,598_17_68,FINLAND,0,TOTALS,FINLAND,200,30,57,52.6,16,29,55.2,14,28,50.0,11,13,84.6,10,21,31,21,17,22,12,3,85,1
23221,538534,598_17_68,NETHERLANDS,0,TOTALS,NETHERLANDS,200,27,57,47.4,26,50,52.0,1,7,14.3,11,13,84.6,8,17,25,18,14,17,14,2,66,0
23222,538547,598_17_69,GEORGIA,0,TOTALS,GEORGIA,200,27,56,48.2,23,40,57.5,4,16,25.0,3,6,50.0,8,31,39,16,12,19,12,3,61,1
23223,538560,598_17_69,PORTUGAL,0,TOTALS,PORTUGAL,200,23,61,37.7,18,45,40.0,5,16,31.2,2,8,25.0,11,21,32,11,12,18,12,1,53,0
23224,538573,598_17_70,ALBANIA,0,TOTALS,ALBANIA,200,23,66,34.8,20,48,41.7,3,18,16.7,16,25,64.0,15,24,39,15,21,14,12,2,65,0
23225,538586,598_17_70,MKD,0,TOTALS,MKD,200,25,55,45.5,15,33,45.5,10,22,45.5,11,14,78.6,8,27,35,16,21,19,6,5,71,1
23226,538599,598_17_71,POLAND,0,TOTALS,POLAND,200,28,69,40.6,21,46,45.7,7,23,30.4,13,18,72.2,15,34,49,12,15,12,5,0,76,1
23227,538611,598_17_71,BELGIUM,0,TOTALS,BELGIUM,200,22,63,34.9,17,45,37.8,5,18,27.8,8,9,88.9,7,26,33,11,23,13,4,3,57,0
23228,538624,598_17_72,HUNGARY,0,TOTALS,HUNGARY,200,29,68,42.6,16,36,44.4,13,32,40.6,7,14,50.0,17,30,47,18,18,12,6,3,78,1
23229,538637,598_17_72,KOSOVO,0,TOTALS,KOSOVO,200,20,63,31.7,16,42,38.1,4,21,19.0,9,14,64.3,13,25,38,8,19,13,6,5,53,0
23230,538650,598_17_73,GREAT BRITAIN,0,TOTALS,GREAT BRITAIN,200,28,57,49.1,18,34,52.9,10,23,43.5,15,17,88.2,8,27,35,16,12,12,9,2,81,1
23231,538663,598_17_73,RUSSIA,0,TOTALS,RUSSIA,200,26,60,43.3,16,34,47.1,10,26,38.5,3,7,42.9,8,20,28,17,18,12,3,1,65,0
23232,538676,598_17_74,CROATIA,0,TOTALS,CROATIA,200,25,71,35.2,20,47,42.6,5,24,20.8,12,20,60.0,16,24,40,14,25,9,5,2,67,0
23233,538689,598_17_74,ROMANIA,0,TOTALS,ROMANIA,200,25,61,41.0,16,27,59.3,9,34,26.5,21,33,63.6,15,31,46,16,22,13,5,6,80,1
23234,541242,601_17_01,FINLAND,0,TOTALS,FINLAND,200,27,71,38.0,19,42,45.2,8,29,27.6,20,30,66.7,18,30,48,9,23,19,5,2,82,1
23235,541255,601_17_01,LITHUANIA,0,TOTALS,LITHUANIA,200,21,63,33.3,13,27,48.1,8,36,22.2,12,20,60.0,15,27,42,12,25,22,8,0,62,0
23236,541268,601_17_02,UKRAINE,0,TOTALS,UKRAINE,200,17,56,30.4,15,39,38.5,2,17,11.8,16,20,80.0,9,27,36,2,21,25,12,6,52,0
23237,541281,601_17_02,ITALY,0,TOTALS,ITALY,200,26,64,40.6,20,45,44.4,6,19,31.6,11,16,68.8,11,28,39,11,20,20,16,4,69,1
23238,541294,601_17_03,GERMANY,0,TOTALS,GERMANY,200,24,64,37.5,16,38,42.1,8,26,30.8,5,10,50.0,9,23,32,11,21,19,5,2,61,0
23239,541307,601_17_03,TURKEY,0,TOTALS,TURKEY,200,26,62,41.9,22,49,44.9,4,13,30.8,14,24,58.3,13,29,42,12,19,14,9,0,70,1
23240,541320,601_17_04,FRANCE,0,TOTALS,FRANCE,200,24,56,42.9,18,31,58.1,6,25,24.0,11,17,64.7,12,20,32,6,22,21,11,0,65,0
23241,541333,601_17_04,BOSNIA AND HERZEGOVINA,0,TOTALS,BOSNIA AND HERZEGOVINA,200,22,52,42.3,18,37,48.6,4,15,26.7,18,23,78.3,7,22,29,3,15,18,10,1,66,1
23242,541346,601_17_05,RUSSIA,0,TOTALS,RUSSIA,200,31,68,45.6,22,51,43.1,9,17,52.9,10,16,62.5,13,22,35,14,14,13,5,2,81,1
23243,541359,601_17_05,MONTENEGRO,0,TOTALS,MONTENEGRO,200,32,67,47.8,30,52,57.7,2,15,13.3,5,10,50.0,11,26,37,11,23,16,5,3,71,0
23244,541372,601_17_06,SLOVAK REPUBLIC,0,TOTALS,SLOVAK REPUBLIC,200,17,61,27.9,11,34,32.4,6,27,22.2,21,29,72.4,21,22,43,12,22,18,11,5,61,0
23245,541385,601_17_06,LATVIA,0,TOTALS,LATVIA,200,29,64,45.3,20,38,52.6,9,26,34.6,11,15,73.3,12,26,38,16,23,16,6,2,78,1
23246,541398,601_17_07,SERBIA,0,TOTALS,SERBIA,200,27,63,42.9,23,44,52.3,4,19,21.1,12,15,80.0,4,22,26,14,17,11,4,2,70,0
23247,541411,601_17_07,SPAIN,0,TOTALS,SPAIN,200,30,63,47.6,24,43,55.8,6,20,30.0,10,15,66.7,12,33,45,11,18,17,8,1,76,1
23248,541424,601_17_08,SLOVENIA,0,TOTALS,SLOVENIA,200,24,76,31.6,19,48,39.6,5,28,17.9,14,20,70.0,24,20,44,14,19,13,7,0,67,0
23249,541437,601_17_08,GREECE,0,TOTALS,GREECE,200,29,61,47.5,21,37,56.8,8,24,33.3,15,21,71.4,14,29,43,18,19,18,11,4,81,1
23250,541450,601_17_09,LATVIA,0,TOTALS,LATVIA,200,19,57,33.3,14,42,33.3,5,15,33.3,6,8,75.0,14,22,36,10,24,25,3,1,49,0
23251,541463,601_17_09,FRANCE,0,TOTALS,FRANCE,200,30,59,50.8,19,40,47.5,11,19,57.9,22,32,68.8,11,24,35,25,16,9,13,2,93,1
23252,541476,601_17_10,TURKEY,0,TOTALS,TURKEY,200,34,61,55.7,31,52,59.6,3,9,33.3,19,32,59.4,12,28,40,12,26,17,7,5,90,1
23253,541489,601_17_10,RUSSIA,0,TOTALS,RUSSIA,200,26,68,38.2,16,45,35.6,10,23,43.5,15,22,68.2,13,19,32,15,28,16,6,0,77,0
23254,541502,601_17_11,ITALY,0,TOTALS,ITALY,200,19,52,36.5,16,36,44.4,3,16,18.8,5,9,55.6,5,20,25,8,21,17,12,5,46,0
23255,541515,601_17_11,SERBIA,0,TOTALS,SERBIA,200,21,53,39.6,15,30,50.0,6,23,26.1,15,16,93.8,10,27,37,14,16,17,9,3,63,1
23256,541528,601_17_12,GREECE,0,TOTALS,GREECE,200,20,60,33.3,13,35,37.1,7,25,28.0,34,50,68.0,20,31,51,11,24,17,9,3,81,1
23257,541540,601_17_12,FINLAND,0,TOTALS,FINLAND,200,27,68,39.7,19,41,46.3,8,27,29.6,16,22,72.7,13,28,41,16,32,12,12,2,78,0
23258,541553,601_17_13,SPAIN,0,TOTALS,SPAIN,225,30,73,41.1,21,49,42.9,9,24,37.5,15,21,71.4,15,30,45,28,19,21,16,4,84,1
23259,541566,601_17_13,UKRAINE,0,TOTALS,UKRAINE,225,28,73,38.4,19,43,44.2,9,30,30.0,7,11,63.6,18,27,45,13,19,28,10,4,72,0
23260,541579,601_17_14,BOSNIA AND HERZEGOVINA,0,TOTALS,BOSNIA AND HERZEGOVINA,200,23,57,40.4,10,30,33.3,13,27,48.1,14,23,60.9,13,29,42,18,21,18,10,6,73,1
23261,541592,601_17_14,SLOVAK REPUBLIC,0,TOTALS,SLOVAK REPUBLIC,200,23,65,35.4,15,39,38.5,8,26,30.8,14,22,63.6,15,23,38,15,25,14,11,5,68,0
23262,541605,601_17_15,MONTENEGRO,0,TOTALS,MONTENEGRO,200,31,57,54.4,24,40,60.0,7,17,41.2,12,18,66.7,3,33,36,24,21,19,9,1,81,1
23263,541618,601_17_15,GERMANY,0,TOTALS,GERMANY,200,24,64,37.5,17,47,36.2,7,17,41.2,18,23,78.3,7,25,32,15,19,15,10,0,73,0
23264,541631,601_17_16,LITHUANIA,0,TOTALS,LITHUANIA,200,24,64,37.5,18,28,64.3,6,36,16.7,21,28,75.0,15,30,45,15,24,9,10,4,75,1
23265,541644,601_17_16,SLOVENIA,0,TOTALS,SLOVENIA,200,20,68,29.4,18,46,39.1,2,22,9.1,15,24,62.5,20,26,46,6,27,13,5,1,57,0
23266,541657,601_17_17,LATVIA,0,TOTALS,LATVIA,200,31,71,43.7,22,42,52.4,9,29,31.0,8,14,57.1,17,30,47,21,23,18,8,6,79,1
23267,541670,601_17_17,BOSNIA AND HERZEGOVINA,0,TOTALS,BOSNIA AND HERZEGOVINA,200,29,63,46.0,23,41,56.1,6,22,27.3,10,15,66.7,7,25,32,17,21,14,6,3,74,0
23268,541683,601_17_18,SERBIA,0,TOTALS,SERBIA,200,25,63,39.7,18,42,42.9,7,21,33.3,15,27,55.6,20,29,49,15,20,24,7,4,72,1
23269,541696,601_17_18,UKRAINE,0,TOTALS,UKRAINE,200,26,70,37.1,22,47,46.8,4,23,17.4,7,13,53.8,13,21,34,9,25,16,13,3,63,0
23270,541709,601_17_19,MONTENEGRO,0,TOTALS,MONTENEGRO,200,28,64,43.8,22,43,51.2,6,21,28.6,12,18,66.7,13,20,33,9,20,19,7,2,74,0
23271,541722,601_17_19,TURKEY,0,TOTALS,TURKEY,200,34,69,49.3,30,58,51.7,4,11,36.4,13,15,86.7,12,22,34,23,19,13,14,4,85,1
23272,541734,601_17_20,FINLAND,0,TOTALS,FINLAND,200,25,64,39.1,16,33,48.5,9,31,29.0,21,30,70.0,9,21,30,19,22,14,15,1,80,0
23273,541747,601_17_20,SLOVENIA,0,TOTALS,SLOVENIA,200,35,63,55.6,26,44,59.1,9,19,47.4,11,18,61.1,10,36,46,15,23,20,10,2,90,1
23274,541760,601_17_21,ITALY,0,TOTALS,ITALY,200,25,63,39.7,15,35,42.9,10,28,35.7,8,11,72.7,7,25,32,15,22,12,10,10,68,1
23275,541773,601_17_21,SPAIN,0,TOTALS,SPAIN,200,19,52,36.5,13,38,34.2,6,14,42.9,17,25,68.0,10,32,42,11,14,18,7,4,61,0
23276,541786,601_17_22,FRANCE,0,TOTALS,FRANCE,200,23,58,39.7,17,37,45.9,6,21,28.6,16,29,55.2,15,29,44,21,21,21,11,5,68,1
23277,541799,601_17_22,SLOVAK REPUBLIC,0,TOTALS,SLOVAK REPUBLIC,200,21,57,36.8,17,40,42.5,4,17,23.5,8,18,44.4,11,23,34,8,27,23,9,7,54,0
23278,541812,601_17_23,GERMANY,0,TOTALS,GERMANY,225,23,63,36.5,17,44,38.6,6,19,31.6,17,30,56.7,16,34,50,14,33,24,8,2,69,1
23279,541825,601_17_23,RUSSIA,0,TOTALS,RUSSIA,225,21,69,30.4,20,45,44.4,1,24,4.2,24,37,64.9,16,29,45,10,25,17,8,3,67,0
23280,541838,601_17_24,GREECE,0,TOTALS,GREECE,200,21,62,33.9,16,40,40.0,5,22,22.7,14,19,73.7,9,30,39,11,17,16,12,2,61,0
23281,541851,601_17_24,LITHUANIA,0,TOTALS,LITHUANIA,200,30,73,41.1,21,49,42.9,9,24,37.5,12,16,75.0,16,32,48,16,22,15,10,4,81,1
23282,541864,601_17_25,TURKEY,0,TOTALS,TURKEY,200,25,54,46.3,20,42,47.6,5,12,41.7,23,32,71.9,15,20,35,16,28,24,13,6,78,1
23283,541877,601_17_25,UKRAINE,0,TOTALS,UKRAINE,200,25,57,43.9,19,36,52.8,6,21,28.6,20,32,62.5,13,16,29,12,25,24,11,4,76,0
23284,541890,601_17_26,BOSNIA AND HERZEGOVINA,0,TOTALS,BOSNIA AND HERZEGOVINA,200,22,66,33.3,17,35,48.6,5,31,16.1,16,20,80.0,16,30,46,13,18,11,7,4,65,1
23285,541903,601_17_26,SLOVENIA,0,TOTALS,SLOVENIA,200,24,58,41.4,16,29,55.2,8,29,27.6,3,7,42.9,7,28,35,17,21,15,5,5,59,0
23286,541916,601_17_27,SPAIN,0,TOTALS,SPAIN,200,31,71,43.7,20,45,44.4,11,26,42.3,14,18,77.8,15,33,48,22,18,15,12,0,87,1
23287,541929,601_17_27,MONTENEGRO,0,TOTALS,MONTENEGRO,200,22,63,34.9,17,41,41.5,5,22,22.7,12,16,75.0,8,23,31,14,18,19,5,3,61,0
23288,541942,601_17_28,FRANCE,0,TOTALS,FRANCE,200,24,66,36.4,17,45,37.8,7,21,33.3,11,11,100.0,16,27,43,13,19,19,8,5,66,1
23289,541954,601_17_28,FINLAND,0,TOTALS,FINLAND,200,23,64,35.9,18,40,45.0,5,24,20.8,7,14,50.0,16,25,41,12,13,16,12,4,58,0
23290,541967,601_17_29,SERBIA,0,TOTALS,SERBIA,200,30,67,44.8,26,52,50.0,4,15,26.7,7,9,77.8,12,27,39,17,18,16,8,3,71,1
23291,541980,601_17_29,GERMANY,0,TOTALS,GERMANY,200,28,61,45.9,24,49,49.0,4,12,33.3,4,12,33.3,9,23,32,15,13,16,3,3,64,0
23292,541993,601_17_30,LITHUANIA,0,TOTALS,LITHUANIA,200,26,68,38.2,16,39,41.0,10,29,34.5,17,19,89.5,16,33,49,15,19,14,10,6,79,1
23293,542006,601_17_30,SLOVAK REPUBLIC,0,TOTALS,SLOVAK REPUBLIC,200,23,66,34.8,20,48,41.7,3,18,16.7,6,10,60.0,13,26,39,13,22,16,7,6,55,0
23294,542019,601_17_31,RUSSIA,0,TOTALS,RUSSIA,200,20,65,30.8,13,42,31.0,7,23,30.4,17,18,94.4,16,31,47,17,20,20,5,0,64,0
23295,542032,601_17_31,ITALY,0,TOTALS,ITALY,200,34,73,46.6,28,52,53.8,6,21,28.6,8,11,72.7,10,27,37,19,21,8,11,6,82,1
23296,542045,601_17_32,GREECE,0,TOTALS,GREECE,200,26,66,39.4,21,43,48.8,5,23,21.7,14,19,73.7,14,24,38,12,14,12,10,7,71,1
23297,542058,601_17_32,LATVIA,0,TOTALS,LATVIA,200,25,63,39.7,18,38,47.4,7,25,28.0,8,11,72.7,12,29,41,15,23,15,5,3,65,0
23298,542071,601_17_33,UKRAINE,0,TOTALS,UKRAINE,200,28,65,43.1,23,48,47.9,5,17,29.4,17,31,54.8,11,29,40,16,22,17,17,7,78,1
23299,542084,601_17_33,LATVIA,0,TOTALS,LATVIA,200,19,61,31.1,13,39,33.3,6,22,27.3,16,26,61.5,12,28,40,9,27,22,12,3,60,0
23300,542097,601_17_34,TURKEY,0,TOTALS,TURKEY,200,33,63,52.4,26,43,60.5,7,20,35.0,8,23,34.8,11,32,43,20,15,18,14,2,81,1
23301,542110,601_17_34,GREECE,0,TOTALS,GREECE,200,25,67,37.3,19,38,50.0,6,29,20.7,7,11,63.6,11,28,39,16,22,18,13,2,63,0
23302,542123,601_17_35,MONTENEGRO,0,TOTALS,MONTENEGRO,200,26,59,44.1,21,41,51.2,5,18,27.8,10,11,90.9,10,27,37,14,23,24,8,2,67,0
23303,542135,601_17_35,FINLAND,0,TOTALS,FINLAND,200,30,67,44.8,21,42,50.0,9,25,36.0,13,25,52.0,13,24,37,16,18,12,13,1,82,1
23304,542148,601_17_36,SPAIN,0,TOTALS,SPAIN,225,33,63,52.4,26,50,52.0,7,13,53.8,13,18,72.2,11,23,34,15,20,20,14,1,86,1
23305,542161,601_17_36,FRANCE,0,TOTALS,FRANCE,225,28,68,41.2,17,39,43.6,11,29,37.9,18,24,75.0,18,21,39,12,23,19,10,7,85,0
23306,542174,601_17_37,ITALY,0,TOTALS,ITALY,200,23,66,34.8,18,42,42.9,5,24,20.8,16,18,88.9,7,23,30,19,26,9,14,3,67,0
23307,542187,601_17_37,LITHUANIA,0,TOTALS,LITHUANIA,200,27,67,40.3,22,43,51.2,5,24,20.8,14,19,73.7,19,34,53,17,18,20,2,5,73,1
23308,542200,601_17_38,RUSSIA,0,TOTALS,RUSSIA,200,27,70,38.6,21,49,42.9,6,21,28.6,16,21,76.2,25,33,58,11,15,17,8,5,76,1
23309,542213,601_17_38,SLOVAK REPUBLIC,0,TOTALS,SLOVAK REPUBLIC,200,23,70,32.9,18,45,40.0,5,25,20.0,4,6,66.7,12,19,31,13,23,11,8,4,55,0
23310,542226,601_17_39,GERMANY,0,TOTALS,GERMANY,200,32,63,50.8,22,37,59.5,10,26,38.5,17,21,81.0,16,24,40,25,13,20,16,7,91,1
23311,542239,601_17_39,SLOVENIA,0,TOTALS,SLOVENIA,200,21,62,33.9,17,42,40.5,4,20,20.0,4,6,66.7,16,16,32,9,20,26,9,1,50,0
23312,542252,601_17_40,SERBIA,0,TOTALS,SERBIA,200,29,55,52.7,20,34,58.8,9,21,42.9,15,25,60.0,12,36,48,22,17,19,8,1,82,1
23313,542265,601_17_40,BOSNIA AND HERZEGOVINA,0,TOTALS,BOSNIA AND HERZEGOVINA,200,20,58,34.5,14,35,40.0,6,23,26.1,4,10,40.0,6,17,23,7,21,18,11,1,50,0
23314,542278,601_17_41,LATVIA,0,TOTALS,LATVIA,200,20,65,30.8,15,44,34.1,5,21,23.8,10,18,55.6,19,21,40,11,18,16,9,2,55,0
23315,542291,601_17_41,MONTENEGRO,0,TOTALS,MONTENEGRO,200,26,63,41.3,22,48,45.8,4,15,26.7,10,13,76.9,11,28,39,13,24,15,10,3,66,1
23316,542303,601_17_42,GREECE,0,TOTALS,GREECE,200,19,57,33.3,19,44,43.2,0,13,0.0,15,24,62.5,16,21,37,6,19,18,9,1,53,0
23317,542316,601_17_42,FRANCE,0,TOTALS,FRANCE,200,30,65,46.2,22,40,55.0,8,25,32.0,13,24,54.2,18,23,41,22,22,14,11,4,81,1
23318,542329,601_17_43,SLOVAK REPUBLIC,0,TOTALS,SLOVAK REPUBLIC,200,19,55,34.5,10,28,35.7,9,27,33.3,10,24,41.7,9,24,33,10,21,19,13,2,57,0
23319,542342,601_17_43,SLOVENIA,0,TOTALS,SLOVENIA,200,19,51,37.3,9,29,31.0,10,22,45.5,13,24,54.2,16,29,45,18,24,25,10,3,61,1
23320,542355,601_17_44,ITALY,0,TOTALS,ITALY,200,24,64,37.5,11,29,37.9,13,35,37.1,16,22,72.7,12,20,32,17,19,13,16,6,77,1
23321,542367,601_17_44,BOSNIA AND HERZEGOVINA,0,TOTALS,BOSNIA AND HERZEGOVINA,200,21,53,39.6,16,36,44.4,5,17,29.4,12,16,75.0,13,28,41,10,17,22,9,1,59,0
23322,542380,601_17_45,UKRAINE,0,TOTALS,UKRAINE,200,21,72,29.2,14,49,28.6,7,23,30.4,7,11,63.6,14,21,35,6,21,20,19,3,56,0
23323,542392,601_17_45,FINLAND,0,TOTALS,FINLAND,200,24,66,36.4,14,36,38.9,10,30,33.3,12,19,63.2,18,37,55,20,18,25,7,6,70,1
23324,542405,601_17_46,TURKEY,0,TOTALS,TURKEY,200,24,57,42.1,19,37,51.4,5,20,25.0,16,23,69.6,12,35,47,12,19,26,6,2,69,0
23325,542418,601_17_46,SPAIN,0,TOTALS,SPAIN,200,29,72,40.3,25,49,51.0,4,23,17.4,9,16,56.2,12,21,33,18,19,11,15,4,71,1
23326,542431,601_17_47,RUSSIA,0,TOTALS,RUSSIA,225,27,84,32.1,21,57,36.8,6,27,22.2,10,18,55.6,30,28,58,12,12,21,10,1,70,1
23327,542444,601_17_47,GERMANY,0,TOTALS,GERMANY,225,29,73,39.7,25,56,44.6,4,17,23.5,7,9,77.8,15,27,42,15,20,19,11,1,69,0
23328,542457,601_17_48,LITHUANIA,0,TOTALS,LITHUANIA,200,30,67,44.8,22,41,53.7,8,26,30.8,9,14,64.3,14,29,43,17,26,14,4,6,77,0
23329,542470,601_17_48,SERBIA,0,TOTALS,SERBIA,200,28,64,43.8,24,48,50.0,4,16,25.0,23,33,69.7,13,26,39,14,21,10,11,4,83,1
23330,542482,601_17_49,GREECE,0,TOTALS,GREECE,200,33,65,50.8,28,46,60.9,5,19,26.3,6,11,54.5,10,28,38,12,15,14,13,4,77,1
23331,542493,601_17_49,BOSNIA AND HERZEGOVINA,0,TOTALS,BOSNIA AND HERZEGOVINA,200,22,62,35.5,18,35,51.4,4,27,14.8,7,12,58.3,13,25,38,9,18,21,9,0,55,0
23332,542506,601_17_50,LATVIA,0,TOTALS,LATVIA,200,21,67,31.3,16,36,44.4,5,31,16.1,10,11,90.9,17,23,40,11,17,24,16,1,57,0
23333,542519,601_17_50,SLOVAK REPUBLIC,0,TOTALS,SLOVAK REPUBLIC,200,25,62,40.3,15,37,40.5,10,25,40.0,9,13,69.2,15,29,44,14,16,22,11,2,69,1
23334,542532,601_17_51,MONTENEGRO,0,TOTALS,MONTENEGRO,200,23,46,50.0,17,33,51.5,6,13,46.2,21,24,87.5,9,23,32,12,17,20,6,4,73,1
23335,542545,601_17_51,SLOVENIA,0,TOTALS,SLOVENIA,200,22,57,38.6,15,37,40.5,7,20,35.0,10,14,71.4,12,17,29,13,23,17,10,1,61,0
23336,542558,601_17_52,FRANCE,0,TOTALS,FRANCE,200,20,58,34.5,18,40,45.0,2,18,11.1,13,21,61.9,12,22,34,9,14,19,10,2,55,0
23337,542571,601_17_52,ITALY,0,TOTALS,ITALY,200,34,58,58.6,30,43,69.8,4,15,26.7,7,11,63.6,5,29,34,10,17,14,14,6,79,1
23338,542584,601_17_53,UKRAINE,0,TOTALS,UKRAINE,200,26,62,41.9,22,45,48.9,4,17,23.5,15,17,88.2,7,22,29,9,16,19,12,3,71,0
23339,542597,601_17_53,GERMANY,0,TOTALS,GERMANY,200,34,73,46.6,23,48,47.9,11,25,44.0,10,15,66.7,16,29,45,27,14,19,9,2,89,1
23340,542610,601_17_54,TURKEY,0,TOTALS,TURKEY,225,29,74,39.2,22,53,41.5,7,21,33.3,23,32,71.9,13,30,43,21,30,11,7,2,88,0
23341,542623,601_17_54,LITHUANIA,0,TOTALS,LITHUANIA,225,32,70,45.7,22,40,55.0,10,30,33.3,23,32,71.9,11,33,44,24,27,10,5,7,97,1
23342,542635,601_17_55,FINLAND,0,TOTALS,FINLAND,200,24,61,39.3,16,38,42.1,8,23,34.8,13,16,81.2,13,29,42,16,19,24,6,3,69,0
23343,542648,601_17_55,RUSSIA,0,TOTALS,RUSSIA,200,30,73,41.1,23,52,44.2,7,21,33.3,8,10,80.0,12,23,35,13,19,13,14,1,75,1
23344,542661,601_17_56,SPAIN,0,TOTALS,SPAIN,200,25,63,39.7,22,47,46.8,3,16,18.8,9,15,60.0,15,28,43,18,19,16,6,3,62,0
23345,542674,601_17_56,SERBIA,0,TOTALS,SERBIA,200,25,67,37.3,16,38,42.1,9,29,31.0,15,19,78.9,14,28,42,20,15,9,9,3,74,1
23346,542687,602_17_01,GREAT BRITAIN,0,TOTALS,GREAT BRITAIN,200,31,62,50.0,24,43,55.8,7,19,36.8,15,15,100.0,11,30,41,15,20,24,14,3,84,1
23347,542700,602_17_01,CZECH REPUBLIC,0,TOTALS,CZECH REPUBLIC,200,20,69,29.0,14,47,29.8,6,22,27.3,9,16,56.2,20,20,40,9,15,25,10,2,55,0
23348,542713,602_17_02,LUXEMBOURG,0,TOTALS,LUXEMBOURG,200,25,70,35.7,20,56,35.7,5,14,35.7,14,25,56.0,13,30,43,14,15,21,13,0,69,0
23349,542726,602_17_02,SWEDEN,0,TOTALS,SWEDEN,200,34,80,42.5,25,45,55.6,9,35,25.7,8,15,53.3,21,37,58,19,21,22,14,6,85,1
23350,542739,602_17_03,ALBANIA,0,TOTALS,ALBANIA,200,17,48,35.4,13,32,40.6,4,16,25.0,17,29,58.6,12,24,36,8,25,40,13,1,55,1
23351,542752,602_17_03,NETHERLANDS,0,TOTALS,NETHERLANDS,200,36,74,48.6,20,41,48.8,16,33,48.5,22,28,78.6,18,23,41,25,26,22,21,3,110,0
23352,542765,602_17_04,CROATIA,0,TOTALS,CROATIA,200,34,61,55.7,32,55,58.2,2,6,33.3,12,19,63.2,14,27,41,18,23,15,11,3,82,1
23353,542778,602_17_04,HUNGARY,0,TOTALS,HUNGARY,200,16,50,32.0,9,25,36.0,7,25,28.0,11,23,47.8,9,17,26,10,21,20,8,1,50,0
23354,542791,602_17_05,ICELAND,0,TOTALS,ICELAND,200,32,69,46.4,22,37,59.5,10,32,31.2,18,27,66.7,12,23,35,21,18,14,7,2,92,1
23355,542804,602_17_05,GEORGIA,0,TOTALS,GEORGIA,200,33,72,45.8,30,55,54.5,3,17,17.6,10,17,58.8,18,28,46,10,25,21,7,2,79,0
23356,542817,602_17_06,BELARUS,0,TOTALS,BELARUS,200,37,79,46.8,29,58,50.0,8,21,38.1,8,19,42.1,14,41,55,12,19,14,10,7,90,1
23357,542830,602_17_06,BULGARIA,0,TOTALS,BULGARIA,200,29,79,36.7,21,50,42.0,8,29,27.6,9,18,50.0,14,32,46,13,18,16,8,0,75,0
23358,542843,602_17_07,ROMANIA,0,TOTALS,ROMANIA,200,24,60,40.0,20,46,43.5,4,14,28.6,6,17,35.3,12,23,35,13,21,17,10,2,58,0
23359,542856,602_17_07,POLAND,0,TOTALS,POLAND,200,29,64,45.3,18,36,50.0,11,28,39.3,8,12,66.7,13,30,43,16,22,20,9,0,77,1
23360,542869,602_17_08,AZERBAIJAN,0,TOTALS,AZERBAIJAN,200,16,54,29.6,12,33,36.4,4,21,19.0,9,14,64.3,11,22,33,9,16,23,8,2,45,0
23361,542882,602_17_08,PORTUGAL,0,TOTALS,PORTUGAL,200,32,66,48.5,27,51,52.9,5,15,33.3,6,10,60.0,13,27,40,21,16,19,16,5,75,1
23362,542895,602_17_09,ESTONIA,0,TOTALS,ESTONIA,200,39,72,54.2,30,52,57.7,9,20,45.0,7,8,87.5,19,28,47,25,19,21,15,7,94,1
23363,542908,602_17_09,SWITZERLAND,0,TOTALS,SWITZERLAND,200,18,57,31.6,12,41,29.3,6,16,37.5,13,21,61.9,14,14,28,8,13,25,14,0,55,0
23364,542921,602_17_10,ISRAEL,0,TOTALS,ISRAEL,200,32,76,42.1,20,45,44.4,12,31,38.7,9,14,64.3,19,28,47,23,16,20,5,1,85,1
23365,542934,602_17_10,AUSTRIA,0,TOTALS,AUSTRIA,200,33,74,44.6,24,46,52.2,9,28,32.1,5,7,71.4,12,27,39,19,21,19,11,5,80,0
23366,542946,602_17_11,IRELAND,0,TOTALS,IRELAND,200,23,64,35.9,22,49,44.9,1,15,6.7,11,19,57.9,13,29,42,8,22,22,7,0,58,0
23367,542959,602_17_11,BELGIUM,0,TOTALS,BELGIUM,200,25,80,31.2,17,49,34.7,8,31,25.8,11,25,44.0,32,31,63,14,21,19,12,5,69,1
23368,542972,602_17_12,MKD,0,TOTALS,MKD,200,33,67,49.3,26,46,56.5,7,21,33.3,15,19,78.9,13,27,40,13,22,18,13,2,88,0
23369,542985,602_17_12,DENMARK,0,TOTALS,DENMARK,200,34,67,50.7,23,41,56.1,11,26,42.3,13,20,65.0,10,24,34,27,21,18,10,3,92,1
23370,542998,602_17_13,GEORGIA,0,TOTALS,GEORGIA,200,24,81,29.6,16,52,30.8,8,29,27.6,7,17,41.2,27,22,49,18,20,21,14,2,63,0
23371,543011,602_17_13,BELARUS,0,TOTALS,BELARUS,200,38,71,53.5,32,54,59.3,6,17,35.3,15,23,65.2,17,37,54,24,11,21,13,6,97,1
23372,543024,602_17_14,HUNGARY,0,TOTALS,HUNGARY,200,25,57,43.9,14,30,46.7,11,27,40.7,11,15,73.3,10,20,30,11,17,23,9,1,72,0
23373,543037,602_17_14,ICELAND,0,TOTALS,ICELAND,200,30,57,52.6,23,36,63.9,7,21,33.3,7,11,63.6,8,20,28,13,21,21,15,4,74,1
23374,543050,602_17_15,BULGARIA,0,TOTALS,BULGARIA,200,24,65,36.9,20,44,45.5,4,21,19.0,9,22,40.9,12,32,44,9,17,9,7,1,61,0
23375,543063,602_17_15,CROATIA,0,TOTALS,CROATIA,200,25,67,37.3,15,38,39.5,10,29,34.5,7,9,77.8,12,34,46,18,24,12,7,0,67,1
23376,543076,602_17_16,AUSTRIA,0,TOTALS,AUSTRIA,200,14,56,25.0,10,34,29.4,4,22,18.2,21,26,80.8,19,24,43,9,22,24,7,2,53,0
23377,543089,602_17_16,ROMANIA,0,TOTALS,ROMANIA,200,27,60,45.0,20,40,50.0,7,20,35.0,10,15,66.7,12,25,37,9,24,19,12,1,71,1
23378,543102,602_17_17,PORTUGAL,0,TOTALS,PORTUGAL,200,26,74,35.1,20,46,43.5,6,28,21.4,6,9,66.7,20,36,56,19,18,20,8,3,64,0
23379,543115,602_17_17,ISRAEL,0,TOTALS,ISRAEL,200,21,69,30.4,8,30,26.7,13,39,33.3,15,21,71.4,14,29,43,19,16,14,9,2,70,1
23380,543128,602_17_18,POLAND,0,TOTALS,POLAND,200,28,68,41.2,24,50,48.0,4,18,22.2,13,21,61.9,16,34,50,19,20,18,14,0,73,1
23381,543141,602_17_18,AZERBAIJAN,0,TOTALS,AZERBAIJAN,200,17,55,30.9,14,34,41.2,3,21,14.3,10,15,66.7,7,26,33,6,20,23,10,4,47,0
23382,543154,602_17_19,SWITZERLAND,0,TOTALS,SWITZERLAND,200,26,72,36.1,19,50,38.0,7,22,31.8,13,21,61.9,22,33,55,15,24,17,14,6,72,1
23383,543166,602_17_19,IRELAND,0,TOTALS,IRELAND,200,17,57,29.8,9,30,30.0,8,27,29.6,14,30,46.7,15,25,40,13,20,20,8,0,56,0
23384,543179,602_17_20,DENMARK,0,TOTALS,DENMARK,200,16,55,29.1,11,29,37.9,5,26,19.2,13,22,59.1,13,14,27,10,15,20,5,0,50,0
23385,543192,602_17_20,ESTONIA,0,TOTALS,ESTONIA,200,34,63,54.0,25,37,67.6,9,26,34.6,5,7,71.4,15,30,45,22,24,20,9,5,82,1
23386,543205,602_17_21,BELGIUM,0,TOTALS,BELGIUM,200,32,78,41.0,22,53,41.5,10,25,40.0,11,20,55.0,21,33,54,19,20,12,8,3,85,1
23387,543218,602_17_21,MKD,0,TOTALS,MKD,200,25,62,40.3,22,36,61.1,3,26,11.5,12,18,66.7,7,26,33,11,17,12,6,1,65,0
23388,543231,602_17_22,CZECH REPUBLIC,0,TOTALS,CZECH REPUBLIC,200,26,69,37.7,14,41,34.1,12,28,42.9,12,17,70.6,13,39,52,19,17,21,18,1,76,1
23389,543244,602_17_22,LUXEMBOURG,0,TOTALS,LUXEMBOURG,200,18,65,27.7,11,42,26.2,7,23,30.4,8,14,57.1,9,32,41,9,12,24,9,3,51,0
23390,543257,602_17_23,NETHERLANDS,0,TOTALS,NETHERLANDS,200,31,76,40.8,23,47,48.9,8,29,27.6,6,11,54.5,12,32,44,19,22,27,8,2,76,0
23391,543270,602_17_23,GREAT BRITAIN,0,TOTALS,GREAT BRITAIN,200,31,72,43.1,23,53,43.4,8,19,42.1,17,23,73.9,10,35,45,25,15,23,14,2,87,1
23392,543283,602_17_24,SWEDEN,0,TOTALS,SWEDEN,200,29,66,43.9,17,37,45.9,12,29,41.4,14,20,70.0,18,34,52,17,18,20,7,3,84,1
23393,543296,602_17_24,ALBANIA,0,TOTALS,ALBANIA,200,24,67,35.8,19,50,38.0,5,17,29.4,8,21,38.1,15,23,38,11,19,16,11,4,61,0
23394,543309,602_17_25,PORTUGAL,0,TOTALS,PORTUGAL,200,30,60,50.0,22,40,55.0,8,20,40.0,19,31,61.3,17,28,45,22,27,20,7,2,87,1
23395,543322,602_17_25,AUSTRIA,0,TOTALS,AUSTRIA,200,22,66,33.3,17,46,37.0,5,20,25.0,16,28,57.1,21,22,43,14,27,20,7,1,65,0
23396,543335,602_17_26,AZERBAIJAN,0,TOTALS,AZERBAIJAN,200,18,53,34.0,11,32,34.4,7,21,33.3,7,11,63.6,6,25,31,7,24,27,13,1,50,0
23397,543348,602_17_26,ROMANIA,0,TOTALS,ROMANIA,200,22,57,38.6,18,41,43.9,4,16,25.0,20,29,69.0,12,29,41,21,16,20,12,3,68,1
23398,543361,602_17_27,ISRAEL,0,TOTALS,ISRAEL,225,30,78,38.5,18,41,43.9,12,37,32.4,16,23,69.6,12,35,47,21,23,18,15,4,88,1
23399,543374,602_17_27,POLAND,0,TOTALS,POLAND,225,31,78,39.7,22,46,47.8,9,32,28.1,14,20,70.0,13,38,51,18,24,21,6,4,85,0
23400,543387,602_17_28,NETHERLANDS,0,TOTALS,NETHERLANDS,200,20,67,29.9,14,40,35.0,6,27,22.2,21,28,75.0,24,40,64,16,16,25,13,0,67,1
23401,543400,602_17_28,CZECH REPUBLIC,0,TOTALS,CZECH REPUBLIC,200,22,63,34.9,18,41,43.9,4,22,18.2,4,11,36.4,7,26,33,13,24,20,12,3,52,0
23402,543413,602_17_29,DENMARK,0,TOTALS,DENMARK,200,17,48,35.4,10,24,41.7,7,24,29.2,12,18,66.7,7,33,40,12,16,21,3,3,53,0
23403,543426,602_17_29,SWITZERLAND,0,TOTALS,SWITZERLAND,200,22,70,31.4,18,46,39.1,4,24,16.7,6,10,60.0,15,25,40,13,17,11,14,1,54,1
23404,543439,602_17_30,MKD,0,TOTALS,MKD,200,25,68,36.8,16,35,45.7,9,33,27.3,14,26,53.8,16,36,52,18,16,20,13,1,73,1
23405,543451,602_17_30,IRELAND,0,TOTALS,IRELAND,200,20,65,30.8,15,48,31.2,5,17,29.4,10,20,50.0,13,32,45,9,23,20,7,1,55,0
23406,543464,602_17_31,ALBANIA,0,TOTALS,ALBANIA,200,26,74,35.1,23,48,47.9,3,26,11.5,14,22,63.6,11,30,41,17,25,13,9,5,69,0
23407,543477,602_17_31,LUXEMBOURG,0,TOTALS,LUXEMBOURG,200,21,65,32.3,17,47,36.2,4,18,22.2,26,30,86.7,15,37,52,13,19,18,6,3,72,1
23408,543490,602_17_32,GREAT BRITAIN,0,TOTALS,GREAT BRITAIN,200,25,80,31.2,25,65,38.5,0,15,0.0,17,26,65.4,23,42,65,10,24,19,9,3,67,0
23409,543503,602_17_32,SWEDEN,0,TOTALS,SWEDEN,200,24,75,32.0,15,41,36.6,9,34,26.5,12,22,54.5,12,34,46,18,23,17,10,1,69,1
23410,543516,602_17_33,ESTONIA,0,TOTALS,ESTONIA,200,23,55,41.8,19,35,54.3,4,20,20.0,20,25,80.0,13,33,46,14,20,25,9,8,70,1
23411,543529,602_17_33,BELGIUM,0,TOTALS,BELGIUM,200,25,70,35.7,15,51,29.4,10,19,52.6,8,17,47.1,16,21,37,14,20,18,11,2,68,0
23412,543542,602_17_34,BULGARIA,0,TOTALS,BULGARIA,200,30,63,47.6,22,40,55.0,8,23,34.8,16,19,84.2,11,32,43,17,18,17,6,2,84,1
23413,543555,602_17_34,HUNGARY,0,TOTALS,HUNGARY,200,31,69,44.9,26,47,55.3,5,22,22.7,11,20,55.0,9,24,33,18,23,10,10,5,78,0
23414,543568,602_17_35,BELARUS,0,TOTALS,BELARUS,200,25,76,32.9,20,53,37.7,5,23,21.7,16,27,59.3,22,28,50,11,25,16,13,4,71,0
23415,543581,602_17_35,ICELAND,0,TOTALS,ICELAND,200,28,68,41.2,19,42,45.2,9,26,34.6,13,22,59.1,15,32,47,20,20,19,6,4,78,1
23416,543594,602_17_36,CROATIA,0,TOTALS,CROATIA,200,20,60,33.3,13,33,39.4,7,27,25.9,15,22,68.2,20,25,45,12,18,18,8,4,62,1
23417,543607,602_17_36,GEORGIA,0,TOTALS,GEORGIA,200,18,54,33.3,14,35,40.0,4,19,21.1,9,15,60.0,13,24,37,10,22,21,7,2,49,0
23418,543620,602_17_37,CZECH REPUBLIC,0,TOTALS,CZECH REPUBLIC,207,31,66,47.0,21,42,50.0,10,24,41.7,16,30,53.3,19,28,47,20,24,16,11,4,88,1
23419,543633,602_17_37,ALBANIA,0,TOTALS,ALBANIA,200,15,53,28.3,11,37,29.7,4,16,25.0,18,27,66.7,14,24,38,9,25,25,8,2,52,0
23420,543646,602_17_38,SWITZERLAND,0,TOTALS,SWITZERLAND,200,23,59,39.0,19,45,42.2,4,14,28.6,11,17,64.7,6,25,31,15,14,12,4,2,61,0
23421,543659,602_17_38,MKD,0,TOTALS,MKD,200,31,76,40.8,19,46,41.3,12,30,40.0,10,13,76.9,15,30,45,16,16,9,8,2,84,1
23422,543672,602_17_39,BELGIUM,0,TOTALS,BELGIUM,200,23,64,35.9,17,44,38.6,6,20,30.0,7,15,46.7,13,29,42,13,13,15,7,4,59,0
23423,543685,602_17_39,DENMARK,0,TOTALS,DENMARK,200,25,60,41.7,20,45,44.4,5,15,33.3,9,15,60.0,10,32,42,15,17,15,5,0,64,1
23424,543698,602_17_40,SWEDEN,0,TOTALS,SWEDEN,200,29,67,43.3,18,34,52.9,11,33,33.3,11,17,64.7,8,27,35,14,24,23,14,4,80,0
23425,543711,602_17_40,NETHERLANDS,0,TOTALS,NETHERLANDS,200,28,72,38.9,16,49,32.7,12,23,52.2,20,28,71.4,21,29,50,16,20,26,17,3,88,1
23426,543724,602_17_41,LUXEMBOURG,0,TOTALS,LUXEMBOURG,200,31,77,40.3,22,51,43.1,9,26,34.6,11,17,64.7,13,33,46,13,15,24,11,2,82,0
23427,543737,602_17_41,GREAT BRITAIN,0,TOTALS,GREAT BRITAIN,200,38,91,41.8,32,64,50.0,6,27,22.2,9,16,56.2,24,35,59,17,21,21,15,4,91,1
23428,543750,602_17_42,HUNGARY,0,TOTALS,HUNGARY,200,35,72,48.6,21,41,51.2,14,31,45.2,7,13,53.8,16,26,42,27,21,20,12,3,91,1
23429,543763,602_17_42,BELARUS,0,TOTALS,BELARUS,200,30,66,45.5,22,43,51.2,8,23,34.8,17,28,60.7,17,23,40,16,19,20,15,4,85,0
23430,543776,602_17_43,GEORGIA,0,TOTALS,GEORGIA,200,26,72,36.1,20,52,38.5,6,20,30.0,4,10,40.0,14,26,40,12,14,11,6,2,62,0
23431,543789,602_17_43,BULGARIA,0,TOTALS,BULGARIA,200,29,72,40.3,19,37,51.4,10,35,28.6,15,18,83.3,18,34,52,26,16,12,8,2,83,1
23432,543802,602_17_44,ICELAND,0,TOTALS,ICELAND,200,15,60,25.0,10,36,27.8,5,24,20.8,10,13,76.9,15,18,33,11,16,20,6,2,45,0
23433,543815,602_17_44,CROATIA,0,TOTALS,CROATIA,200,30,58,51.7,24,43,55.8,6,15,40.0,9,17,52.9,13,30,43,19,20,17,14,5,75,1
23434,543827,602_17_45,IRELAND,0,TOTALS,IRELAND,200,23,57,40.4,21,42,50.0,2,15,13.3,12,28,42.9,12,38,50,13,21,32,6,0,60,1
23435,543840,602_17_45,ESTONIA,0,TOTALS,ESTONIA,200,35,91,38.5,20,51,39.2,15,40,37.5,16,27,59.3,25,31,56,28,24,12,19,3,101,0
23436,543853,602_17_46,AUSTRIA,0,TOTALS,AUSTRIA,200,28,59,47.5,18,35,51.4,10,24,41.7,16,20,80.0,8,36,44,22,18,18,8,4,82,1
23437,543866,602_17_46,AZERBAIJAN,0,TOTALS,AZERBAIJAN,200,27,68,39.7,16,44,36.4,11,24,45.8,6,15,40.0,11,25,36,14,16,15,14,3,71,0
23438,543879,602_17_47,POLAND,0,TOTALS,POLAND,200,29,64,45.3,24,48,50.0,5,16,31.2,10,15,66.7,18,21,39,22,16,19,11,1,73,1
23439,543892,602_17_47,PORTUGAL,0,TOTALS,PORTUGAL,200,26,60,43.3,22,44,50.0,4,16,25.0,8,10,80.0,12,19,31,11,19,19,10,4,64,0
23440,543905,602_17_48,ROMANIA,0,TOTALS,ROMANIA,200,19,56,33.9,16,41,39.0,3,15,20.0,14,34,41.2,14,34,48,9,17,29,10,2,55,0
23441,543918,602_17_48,ISRAEL,0,TOTALS,ISRAEL,200,33,78,42.3,21,46,45.7,12,32,37.5,11,19,57.9,15,32,47,24,28,15,19,6,89,1
23442,543931,602_17_49,NETHERLANDS,0,TOTALS,NETHERLANDS,200,40,82,48.8,29,54,53.7,11,28,39.3,5,9,55.6,20,28,48,27,12,20,16,5,96,1
23443,543944,602_17_49,LUXEMBOURG,0,TOTALS,LUXEMBOURG,200,25,56,44.6,18,37,48.6,7,19,36.8,4,10,40.0,6,24,30,21,9,32,7,1,61,0
23444,543957,602_17_50,SWEDEN,0,TOTALS,SWEDEN,200,26,60,43.3,20,35,57.1,6,25,24.0,3,7,42.9,4,21,25,11,18,17,7,2,61,0
23445,543970,602_17_50,CZECH REPUBLIC,0,TOTALS,CZECH REPUBLIC,200,28,75,37.3,17,49,34.7,11,26,42.3,17,21,81.0,26,31,57,23,13,17,7,2,84,1
23446,543983,602_17_51,GREAT BRITAIN,0,TOTALS,GREAT BRITAIN,200,36,76,47.4,24,46,52.2,12,30,40.0,16,25,64.0,23,26,49,24,14,19,18,4,100,0
23447,543996,602_17_51,ALBANIA,0,TOTALS,ALBANIA,200,19,50,38.0,18,42,42.9,1,8,12.5,4,8,50.0,5,22,27,10,20,32,9,3,43,1
23448,544009,602_17_52,GEORGIA,0,TOTALS,GEORGIA,200,24,69,34.8,21,48,43.8,3,21,14.3,8,16,50.0,21,23,44,8,21,21,15,1,59,0
23449,544022,602_17_52,HUNGARY,0,TOTALS,HUNGARY,200,21,49,42.9,13,26,50.0,8,23,34.8,16,21,76.2,7,27,34,21,17,24,8,3,66,1
23450,544035,602_17_53,CROATIA,0,TOTALS,CROATIA,200,25,61,41.0,20,39,51.3,5,22,22.7,18,26,69.2,21,26,47,12,15,32,15,5,73,1
23451,544048,602_17_53,BELARUS,0,TOTALS,BELARUS,200,25,58,43.1,18,38,47.4,7,20,35.0,10,13,76.9,8,20,28,16,23,27,23,7,67,0
23452,544061,602_17_54,BULGARIA,0,TOTALS,BULGARIA,200,30,66,45.5,26,43,60.5,4,23,17.4,13,18,72.2,13,25,38,9,15,15,12,3,77,1
23453,544074,602_17_54,ICELAND,0,TOTALS,ICELAND,200,32,69,46.4,25,46,54.3,7,23,30.4,5,7,71.4,12,26,38,19,17,16,8,2,76,0
23454,544087,602_17_55,ESTONIA,0,TOTALS,ESTONIA,200,32,79,40.5,25,54,46.3,7,25,28.0,7,11,63.6,22,34,56,21,16,20,15,7,78,1
23455,544100,602_17_55,MKD,0,TOTALS,MKD,200,24,75,32.0,19,49,38.8,5,26,19.2,5,10,50.0,19,27,46,9,14,21,10,2,58,0
23456,544113,602_17_56,ISRAEL,0,TOTALS,ISRAEL,200,27,65,41.5,17,30,56.7,10,35,28.6,16,19,84.2,13,38,51,25,14,12,11,5,80,1
23457,544126,602_17_56,AZERBAIJAN,0,TOTALS,AZERBAIJAN,200,20,68,29.4,14,37,37.8,6,31,19.4,3,5,60.0,9,27,36,7,15,15,5,0,49,0
23458,544139,602_17_57,PORTUGAL,0,TOTALS,PORTUGAL,200,22,57,38.6,20,44,45.5,2,13,15.4,18,24,75.0,13,24,37,12,9,22,18,2,64,1
23459,544152,602_17_57,ROMANIA,0,TOTALS,ROMANIA,200,20,52,38.5,10,29,34.5,10,23,43.5,9,15,60.0,10,25,35,11,20,28,9,2,59,0
23460,544165,602_17_58,DENMARK,0,TOTALS,DENMARK,200,35,74,47.3,29,51,56.9,6,23,26.1,8,8,100.0,13,37,50,27,20,19,8,6,84,1
23461,544177,602_17_58,IRELAND,0,TOTALS,IRELAND,200,25,76,32.9,21,54,38.9,4,22,18.2,9,16,56.2,17,25,42,12,17,15,10,1,63,0
23462,544190,602_17_59,POLAND,0,TOTALS,POLAND,200,25,60,41.7,14,33,42.4,11,27,40.7,5,6,83.3,7,26,33,13,15,22,15,5,66,1
23463,544203,602_17_59,AUSTRIA,0,TOTALS,AUSTRIA,200,23,67,34.3,18,48,37.5,5,19,26.3,6,12,50.0,18,27,45,9,15,25,9,3,57,0
23464,544216,602_17_60,BELGIUM,0,TOTALS,BELGIUM,200,36,71,50.7,27,46,58.7,9,25,36.0,3,5,60.0,15,29,44,25,13,16,17,2,84,1
23465,544229,602_17_60,SWITZERLAND,0,TOTALS,SWITZERLAND,200,22,59,37.3,20,51,39.2,2,8,25.0,4,8,50.0,8,21,29,12,9,20,9,1,50,0
23466,544242,602_17_61,GREAT BRITAIN,0,TOTALS,GREAT BRITAIN,200,33,81,40.7,28,57,49.1,5,24,20.8,5,6,83.3,16,40,56,16,17,20,6,6,76,1
23467,544255,602_17_61,BULGARIA,0,TOTALS,BULGARIA,200,28,83,33.7,19,45,42.2,9,38,23.7,8,14,57.1,18,32,50,17,12,17,13,2,73,0
23468,544268,602_17_62,CZECH REPUBLIC,0,TOTALS,CZECH REPUBLIC,200,27,64,42.2,16,38,42.1,11,26,42.3,6,9,66.7,15,20,35,18,22,15,8,0,71,0
23469,544281,602_17_62,HUNGARY,0,TOTALS,HUNGARY,200,26,58,44.8,19,37,51.4,7,21,33.3,14,24,58.3,13,23,36,13,16,14,7,2,73,1
23470,544294,602_17_63,LUXEMBOURG,0,TOTALS,LUXEMBOURG,200,20,75,26.7,18,49,36.7,2,26,7.7,2,8,25.0,21,34,55,10,15,25,11,2,44,0
23471,544307,602_17_63,GEORGIA,0,TOTALS,GEORGIA,200,25,70,35.7,23,46,50.0,2,24,8.3,10,16,62.5,14,36,50,8,16,21,17,4,62,1
23472,544320,602_17_64,CROATIA,0,TOTALS,CROATIA,200,24,61,39.3,20,40,50.0,4,21,19.0,13,18,72.2,15,35,50,15,18,20,13,4,65,1
23473,544333,602_17_64,NETHERLANDS,0,TOTALS,NETHERLANDS,200,16,61,26.2,8,27,29.6,8,34,23.5,14,21,66.7,13,24,37,9,22,20,11,2,54,0
23474,544346,602_17_65,BELGIUM,0,TOTALS,BELGIUM,200,26,61,42.6,15,33,45.5,11,28,39.3,19,24,79.2,14,29,43,16,15,17,5,1,82,1
23475,544359,602_17_65,ROMANIA,0,TOTALS,ROMANIA,200,32,70,45.7,28,56,50.0,4,14,28.6,9,12,75.0,11,23,34,12,21,12,7,3,77,0
23476,544372,602_17_66,SWITZERLAND,0,TOTALS,SWITZERLAND,200,26,66,39.4,23,57,40.4,3,9,33.3,5,11,45.5,17,31,48,15,15,25,15,5,60,1
23477,544385,602_17_66,AZERBAIJAN,0,TOTALS,AZERBAIJAN,200,23,68,33.8,18,49,36.7,5,19,26.3,7,9,77.8,15,26,41,13,14,24,18,1,58,0
23478,544398,602_17_67,ESTONIA,0,TOTALS,ESTONIA,200,29,72,40.3,24,45,53.3,5,27,18.5,5,6,83.3,10,33,43,12,27,15,11,2,68,1
23479,544411,602_17_67,POLAND,0,TOTALS,POLAND,200,21,67,31.3,19,45,42.2,2,22,9.1,19,30,63.3,17,33,50,7,17,19,9,1,63,0
23480,544424,602_17_68,ICELAND,0,TOTALS,ICELAND,200,24,66,36.4,18,43,41.9,6,23,26.1,17,25,68.0,11,30,41,19,15,17,11,1,71,1
23481,544437,602_17_68,SWEDEN,0,TOTALS,SWEDEN,200,23,63,36.5,14,34,41.2,9,29,31.0,8,15,53.3,12,35,47,15,23,26,12,1,63,0
23482,544450,602_17_69,BELARUS,0,TOTALS,BELARUS,200,25,56,44.6,17,33,51.5,8,23,34.8,18,36,50.0,14,32,46,18,16,29,12,3,76,1
23483,544463,602_17_69,ALBANIA,0,TOTALS,ALBANIA,200,26,74,35.1,18,49,36.7,8,25,32.0,8,11,72.7,15,23,38,17,30,21,16,0,68,0
23484,544476,602_17_70,ISRAEL,0,TOTALS,ISRAEL,200,29,76,38.2,22,49,44.9,7,27,25.9,13,16,81.2,23,36,59,20,19,21,14,4,78,1
23485,544489,602_17_70,DENMARK,0,TOTALS,DENMARK,200,17,63,27.0,10,33,30.3,7,30,23.3,14,18,77.8,10,26,36,11,16,30,11,1,55,0
23486,544502,602_17_71,PORTUGAL,0,TOTALS,PORTUGAL,200,27,64,42.2,20,46,43.5,7,18,38.9,11,17,64.7,12,36,48,23,15,21,14,1,72,1
23487,544515,602_17_71,MKD,0,TOTALS,MKD,200,22,65,33.8,13,33,39.4,9,32,28.1,16,18,88.9,9,26,35,14,19,17,10,4,69,0
23488,544528,602_17_72,AUSTRIA,0,TOTALS,AUSTRIA,200,35,74,47.3,30,49,61.2,5,25,20.0,13,22,59.1,21,29,50,19,17,20,11,3,88,1
23489,544540,602_17_72,IRELAND,0,TOTALS,IRELAND,200,31,77,40.3,23,55,41.8,8,22,36.4,13,16,81.2,18,22,40,18,21,15,6,4,83,0
23490,544553,602_17_73,BULGARIA,0,TOTALS,BULGARIA,200,31,72,43.1,24,49,49.0,7,23,30.4,8,13,61.5,15,25,40,14,16,15,6,1,77,0
23491,544566,602_17_73,POLAND,0,TOTALS,POLAND,200,32,68,47.1,25,46,54.3,7,22,31.8,11,19,57.9,13,28,41,22,15,13,8,1,82,1
23492,544579,602_17_74,CZECH REPUBLIC,0,TOTALS,CZECH REPUBLIC,200,26,60,43.3,19,37,51.4,7,23,30.4,13,16,81.2,12,22,34,15,21,17,11,1,72,1
23493,544592,602_17_74,ROMANIA,0,TOTALS,ROMANIA,200,24,59,40.7,19,35,54.3,5,24,20.8,13,18,72.2,16,20,36,13,20,22,8,3,66,0
23494,544605,602_17_75,LUXEMBOURG,0,TOTALS,LUXEMBOURG,225,27,72,37.5,22,48,45.8,5,24,20.8,10,16,62.5,15,33,48,15,17,23,9,3,69,0
23495,544618,602_17_75,AZERBAIJAN,0,TOTALS,AZERBAIJAN,225,28,75,37.3,24,55,43.6,4,20,20.0,13,24,54.2,19,31,50,12,18,18,10,2,73,1
23496,544631,602_17_76,NETHERLANDS,0,TOTALS,NETHERLANDS,200,32,72,44.4,21,50,42.0,11,22,50.0,20,30,66.7,19,26,45,18,18,14,11,3,95,1
23497,544644,602_17_76,DENMARK,0,TOTALS,DENMARK,200,21,53,39.6,14,35,40.0,7,18,38.9,10,17,58.8,9,25,34,14,23,26,8,1,59,0
23498,544657,602_17_77,SWEDEN,0,TOTALS,SWEDEN,200,28,68,41.2,18,36,50.0,10,32,31.2,14,18,77.8,13,36,49,14,23,19,10,5,80,1
23499,544670,602_17_77,MKD,0,TOTALS,MKD,200,23,69,33.3,16,42,38.1,7,27,25.9,14,21,66.7,12,27,39,6,16,17,12,3,67,0
23500,544683,602_17_78,ALBANIA,0,TOTALS,ALBANIA,200,28,59,47.5,18,38,47.4,10,21,47.6,16,25,64.0,11,31,42,19,27,24,8,2,82,1
23501,544695,602_17_78,IRELAND,0,TOTALS,IRELAND,200,25,65,38.5,20,44,45.5,5,21,23.8,20,30,66.7,14,24,38,9,22,18,9,3,75,0
23502,544708,602_17_79,GREAT BRITAIN,0,TOTALS,GREAT BRITAIN,200,32,80,40.0,28,65,43.1,4,15,26.7,7,17,41.2,28,32,60,19,17,23,10,3,75,1
23503,544721,602_17_79,ESTONIA,0,TOTALS,ESTONIA,200,25,65,38.5,22,43,51.2,3,22,13.6,8,10,80.0,10,23,33,12,16,22,10,8,61,0
23504,544734,602_17_80,HUNGARY,0,TOTALS,HUNGARY,200,19,57,33.3,14,36,38.9,5,21,23.8,11,17,64.7,11,17,28,15,19,14,7,2,54,0
23505,544747,602_17_80,BELGIUM,0,TOTALS,BELGIUM,200,30,67,44.8,24,48,50.0,6,19,31.6,6,12,50.0,22,29,51,19,20,19,4,4,72,1
23506,544760,602_17_81,GEORGIA,0,TOTALS,GEORGIA,200,30,74,40.5,20,44,45.5,10,30,33.3,6,11,54.5,19,26,45,19,13,17,16,1,76,1
23507,544773,602_17_81,SWITZERLAND,0,TOTALS,SWITZERLAND,200,27,66,40.9,22,48,45.8,5,18,27.8,3,5,60.0,14,27,41,19,12,23,9,1,62,0
23508,544786,602_17_82,CROATIA,0,TOTALS,CROATIA,200,26,66,39.4,20,39,51.3,6,27,22.2,17,20,85.0,17,31,48,15,19,17,7,6,75,1
23509,544799,602_17_82,ISRAEL,0,TOTALS,ISRAEL,200,27,69,39.1,18,40,45.0,9,29,31.0,6,10,60.0,14,25,39,18,23,15,12,4,69,0
23510,544812,602_17_83,ICELAND,0,TOTALS,ICELAND,200,23,54,42.6,10,30,33.3,13,24,54.2,6,6,100.0,10,32,42,22,12,25,7,1,65,1
23511,544825,602_17_83,PORTUGAL,0,TOTALS,PORTUGAL,200,24,73,32.9,20,57,35.1,4,16,25.0,4,11,36.4,16,21,37,10,10,16,15,1,56,0
23512,544838,602_17_84,BELARUS,0,TOTALS,BELARUS,200,26,62,41.9,22,40,55.0,4,22,18.2,15,23,65.2,10,30,40,18,18,26,17,4,71,0
23513,544851,602_17_84,AUSTRIA,0,TOTALS,AUSTRIA,200,33,78,42.3,25,61,41.0,8,17,47.1,12,14,85.7,15,28,43,21,15,20,16,1,86,1
23514,544864,602_17_85,AZERBAIJAN,0,TOTALS,AZERBAIJAN,200,24,68,35.3,22,58,37.9,2,10,20.0,6,11,54.5,16,29,45,9,17,12,7,4,56,0
23515,544877,602_17_85,ALBANIA,0,TOTALS,ALBANIA,200,27,64,42.2,19,44,43.2,8,20,40.0,7,10,70.0,10,30,40,19,17,13,6,7,69,1
23516,544890,602_17_86,ROMANIA,0,TOTALS,ROMANIA,200,27,57,47.4,18,36,50.0,9,21,42.9,11,17,64.7,11,30,41,19,15,16,7,5,74,1
23517,544903,602_17_86,MKD,0,TOTALS,MKD,200,23,67,34.3,14,36,38.9,9,31,29.0,6,9,66.7,15,22,37,12,16,15,7,0,61,0
23518,544916,602_17_87,LUXEMBOURG,0,TOTALS,LUXEMBOURG,200,31,68,45.6,28,46,60.9,3,22,13.6,7,14,50.0,13,40,53,14,13,20,7,5,72,1
23519,544928,602_17_87,IRELAND,0,TOTALS,IRELAND,200,26,77,33.8,21,58,36.2,5,19,26.3,6,7,85.7,11,27,38,13,18,10,7,2,63,0
23520,544941,602_17_88,CZECH REPUBLIC,0,TOTALS,CZECH REPUBLIC,200,31,59,52.5,21,33,63.6,10,26,38.5,12,14,85.7,5,28,33,22,14,14,12,4,84,1
23521,544954,602_17_88,SWEDEN,0,TOTALS,SWEDEN,200,23,65,35.4,16,38,42.1,7,27,25.9,7,9,77.8,14,22,36,12,12,19,7,2,60,0
23522,544967,602_17_89,BULGARIA,0,TOTALS,BULGARIA,200,28,71,39.4,19,46,41.3,9,25,36.0,11,12,91.7,12,38,50,16,14,12,8,6,76,1
23523,544980,602_17_89,DENMARK,0,TOTALS,DENMARK,200,23,78,29.5,20,52,38.5,3,26,11.5,2,5,40.0,17,33,50,10,18,13,6,5,51,0
23524,544993,602_17_90,HUNGARY,0,TOTALS,HUNGARY,200,23,64,35.9,11,32,34.4,12,32,37.5,7,8,87.5,10,17,27,17,16,17,13,3,65,0
23525,545006,602_17_90,PORTUGAL,0,TOTALS,PORTUGAL,200,28,57,49.1,24,42,57.1,4,15,26.7,11,14,78.6,12,31,43,19,13,20,10,3,71,1
23526,545019,602_17_91,SWITZERLAND,0,TOTALS,SWITZERLAND,200,39,76,51.3,33,57,57.9,6,19,31.6,14,22,63.6,17,31,48,24,15,21,8,1,98,1
23527,545032,602_17_91,BELARUS,0,TOTALS,BELARUS,200,33,78,42.3,27,52,51.9,6,26,23.1,16,24,66.7,18,23,41,18,13,19,17,4,88,0
23528,545045,602_17_92,POLAND,0,TOTALS,POLAND,200,28,69,40.6,18,39,46.2,10,30,33.3,10,12,83.3,15,29,44,18,17,17,8,3,76,1
23529,545058,602_17_92,NETHERLANDS,0,TOTALS,NETHERLANDS,200,28,64,43.8,22,41,53.7,6,23,26.1,6,11,54.5,9,28,37,16,16,16,8,2,68,0
23530,545071,602_17_93,GEORGIA,0,TOTALS,GEORGIA,200,30,84,35.7,24,62,38.7,6,22,27.3,16,18,88.9,22,23,45,12,23,12,8,2,82,0
23531,545084,602_17_93,AUSTRIA,0,TOTALS,AUSTRIA,200,31,67,46.3,24,52,46.2,7,15,46.7,17,20,85.0,10,33,43,22,21,19,7,5,86,1
23532,545097,602_17_94,BELGIUM,0,TOTALS,BELGIUM,200,36,74,48.6,28,51,54.9,8,23,34.8,7,12,58.3,17,23,40,20,16,11,10,3,87,1
23533,545110,602_17_94,ICELAND,0,TOTALS,ICELAND,200,27,52,51.9,15,29,51.7,12,23,52.2,12,18,66.7,6,23,29,15,16,19,4,1,78,0
23534,545123,602_17_95,ESTONIA,0,TOTALS,ESTONIA,200,33,70,47.1,20,40,50.0,13,30,43.3,11,19,57.9,14,39,53,22,16,14,6,4,90,1
23535,545136,602_17_95,ISRAEL,0,TOTALS,ISRAEL,200,27,76,35.5,20,47,42.6,7,29,24.1,10,17,58.8,15,27,42,11,18,10,8,3,71,0
23536,545149,602_17_96,GREAT BRITAIN,0,TOTALS,GREAT BRITAIN,225,35,82,42.7,29,59,49.2,6,23,26.1,8,11,72.7,21,31,52,19,19,27,9,6,84,0
23537,545162,602_17_96,CROATIA,0,TOTALS,CROATIA,225,33,79,41.8,22,45,48.9,11,34,32.4,13,20,65.0,16,27,43,19,20,18,15,5,90,1
23538,545175,603_17_01,SAN MARINO,0,TOTALS,SAN MARINO,200,22,71,31.0,15,41,36.6,7,30,23.3,10,20,50.0,16,28,44,12,23,18,16,2,61,0
23539,545188,603_17_01,MALTA,0,TOTALS,MALTA,200,25,64,39.1,19,49,38.8,6,15,40.0,18,29,62.1,16,36,52,16,18,22,8,1,74,1
23540,545199,603_17_02,GIBRALTAR,0,TOTALS,GIBRALTAR,200,28,89,31.5,25,71,35.2,3,18,16.7,25,39,64.1,17,21,38,14,29,21,21,2,84,0
23541,545211,603_17_02,MOLDOVA,0,TOTALS,MOLDOVA,200,31,73,42.5,26,54,48.1,5,19,26.3,23,39,59.0,27,50,77,23,32,45,17,3,90,1
23542,545223,603_17_03,ARMENIA,0,TOTALS,ARMENIA,200,17,61,27.9,10,36,27.8,7,25,28.0,6,11,54.5,9,27,36,11,14,23,10,2,47,0
23543,545236,603_17_03,CYPRUS,0,TOTALS,CYPRUS,200,31,77,40.3,23,53,43.4,8,24,33.3,10,21,47.6,21,36,57,21,18,15,17,3,80,1
23544,545249,603_17_04,NORWAY,0,TOTALS,NORWAY,200,30,73,41.1,22,50,44.0,8,23,34.8,14,19,73.7,18,34,52,20,16,16,9,5,82,1
23545,545262,603_17_04,KOSOVO,0,TOTALS,KOSOVO,194,23,68,33.8,19,46,41.3,4,22,18.2,15,23,65.2,14,29,43,10,18,14,5,6,65,0
23546,545274,603_17_05,MOLDOVA,0,TOTALS,MOLDOVA,200,32,66,48.5,29,55,52.7,3,11,27.3,25,45,55.6,23,45,68,21,24,32,6,2,92,1
23547,545287,603_17_05,SAN MARINO,0,TOTALS,SAN MARINO,200,32,85,37.6,28,59,47.5,4,26,15.4,10,28,35.7,17,20,37,10,31,18,23,4,78,0
23548,545300,603_17_06,KOSOVO,0,TOTALS,KOSOVO,200,28,66,42.4,21,44,47.7,7,22,31.8,9,13,69.2,12,37,49,12,18,23,15,4,72,1
23549,545312,603_17_06,ARMENIA,0,TOTALS,ARMENIA,200,21,71,29.6,15,45,33.3,6,26,23.1,6,8,75.0,16,28,44,15,19,21,13,3,54,0
23550,545325,603_17_07,CYPRUS,0,TOTALS,CYPRUS,200,22,76,28.9,17,53,32.1,5,23,21.7,5,13,38.5,20,26,46,9,26,20,12,0,54,0
23551,545338,603_17_07,NORWAY,0,TOTALS,NORWAY,200,24,65,36.9,19,38,50.0,5,27,18.5,16,31,51.6,22,36,58,16,17,23,10,2,69,1
23552,545351,603_17_08,MALTA,0,TOTALS,MALTA,200,32,73,43.8,26,44,59.1,6,29,20.7,12,30,40.0,26,35,61,17,22,22,13,3,82,1
23553,545362,603_17_08,GIBRALTAR,0,TOTALS,GIBRALTAR,200,25,62,40.3,20,39,51.3,5,23,21.7,11,20,55.0,7,21,28,15,23,18,11,2,66,0
23554,545373,603_17_09,NORWAY,0,TOTALS,NORWAY,200,28,60,46.7,19,34,55.9,9,26,34.6,11,17,64.7,10,39,49,21,16,16,3,3,76,1
23555,545385,603_17_09,ARMENIA,0,TOTALS,ARMENIA,200,19,66,28.8,13,48,27.1,6,18,33.3,8,16,50.0,13,27,40,18,16,12,11,1,52,0
23556,545398,603_17_10,SAN MARINO,0,TOTALS,SAN MARINO,200,26,71,36.6,21,46,45.7,5,25,20.0,19,28,67.9,17,32,49,22,26,24,20,4,76,1
23557,545409,603_17_10,GIBRALTAR,0,TOTALS,GIBRALTAR,200,15,57,26.3,13,43,30.2,2,14,14.3,21,33,63.6,14,30,44,13,21,31,12,3,53,0
23558,545422,603_17_11,CYPRUS,0,TOTALS,CYPRUS,200,27,61,44.3,17,39,43.6,10,22,45.5,17,30,56.7,15,31,46,14,27,17,11,1,81,1
23559,545435,603_17_11,KOSOVO,0,TOTALS,KOSOVO,200,19,64,29.7,14,40,35.0,5,24,20.8,17,24,70.8,15,23,38,11,23,18,10,4,60,0
23560,545447,603_17_12,MOLDOVA,0,TOTALS,MOLDOVA,200,25,76,32.9,21,44,47.7,4,32,12.5,15,18,83.3,22,37,59,11,19,17,1,4,69,0
23561,545460,603_17_12,MALTA,0,TOTALS,MALTA,200,29,84,34.5,19,58,32.8,10,26,38.5,8,18,44.4,20,32,52,18,16,8,10,3,76,1
23562,545473,603_17_13,KOSOVO,0,TOTALS,KOSOVO,200,34,85,40.0,25,54,46.3,9,31,29.0,23,34,67.6,26,39,65,22,24,18,16,10,100,0
23563,545484,603_17_13,GIBRALTAR,0,TOTALS,GIBRALTAR,200,17,57,29.8,13,40,32.5,4,17,23.5,15,30,50.0,7,28,35,12,25,24,6,1,53,1
23564,545497,603_17_14,SAN MARINO,0,TOTALS,SAN MARINO,200,20,66,30.3,15,45,33.3,5,21,23.8,8,13,61.5,10,23,33,8,14,16,13,2,53,0
23565,545509,603_17_14,ARMENIA,0,TOTALS,ARMENIA,200,21,55,38.2,13,33,39.4,8,22,36.4,13,14,92.9,12,39,51,18,16,27,11,3,63,1
23566,545522,603_17_15,MALTA,0,TOTALS,MALTA,200,23,59,39.0,19,38,50.0,4,21,19.0,14,24,58.3,14,43,57,17,14,26,6,9,64,0
23567,545535,603_17_15,CYPRUS,0,TOTALS,CYPRUS,200,24,83,28.9,15,42,35.7,9,41,22.0,10,16,62.5,19,25,44,16,20,8,16,0,67,1
23568,545548,603_17_16,NORWAY,0,TOTALS,NORWAY,200,44,82,53.7,31,62,50.0,13,20,65.0,7,14,50.0,14,41,55,32,8,18,16,6,108,0
23569,545560,603_17_16,MOLDOVA,0,TOTALS,MOLDOVA,200,22,79,27.8,20,57,35.1,2,22,9.1,3,6,50.0,17,26,43,8,13,27,7,2,49,1
23570,545571,603_17_17,GIBRALTAR,0,TOTALS,GIBRALTAR,200,24,60,40.0,24,43,55.8,0,17,0.0,11,24,45.8,14,36,50,15,24,28,12,5,59,0
23571,545584,603_17_17,SAN MARINO,0,TOTALS,SAN MARINO,200,24,72,33.3,16,43,37.2,8,29,27.6,18,27,66.7,19,31,50,18,20,21,16,1,74,1
23572,545597,603_17_18,KOSOVO,0,TOTALS,KOSOVO,200,30,68,44.1,24,50,48.0,6,18,33.3,8,13,61.5,14,37,51,15,10,22,10,5,74,1
23573,545609,603_17_18,ARMENIA,0,TOTALS,ARMENIA,200,21,74,28.4,13,44,29.5,8,30,26.7,2,2,100.0,14,25,39,13,14,19,14,5,52,0
23574,545621,603_17_19,MOLDOVA,0,TOTALS,MOLDOVA,200,23,69,33.3,18,44,40.9,5,25,20.0,10,18,55.6,15,32,47,13,20,16,12,2,61,0
23575,545634,603_17_19,MALTA,0,TOTALS,MALTA,200,27,69,39.1,23,46,50.0,4,23,17.4,10,19,52.6,13,35,48,18,11,14,7,7,68,1
23576,545647,603_17_20,NORWAY,0,TOTALS,NORWAY,200,31,70,44.3,23,42,54.8,8,28,28.6,14,20,70.0,17,37,54,21,12,19,10,5,84,1
23577,545660,603_17_20,CYPRUS,0,TOTALS,CYPRUS,200,22,72,30.6,15,49,30.6,7,23,30.4,2,11,18.2,17,23,40,14,20,20,11,1,53,0
23578,549619,607_17_01,ESTONIA,0,TOTALS,ESTONIA,200,27,56,48.2,24,39,61.5,3,17,17.6,14,19,73.7,10,22,32,5,27,11,7,1,71,0
23579,549632,607_17_01,RUSSIA,0,TOTALS,RUSSIA,200,26,56,46.4,20,41,48.8,6,15,40.0,16,29,55.2,10,21,31,12,16,11,6,2,74,1
23580,549645,607_17_02,SPAIN,0,TOTALS,SPAIN,200,36,69,52.2,32,57,56.1,4,12,33.3,15,24,62.5,17,35,52,22,20,18,12,0,91,1
23581,549658,607_17_02,LATVIA,0,TOTALS,LATVIA,200,26,75,34.7,16,49,32.7,10,26,38.5,8,14,57.1,16,20,36,15,23,15,5,1,70,0
23582,549671,607_17_03,LITHUANIA,0,TOTALS,LITHUANIA,200,21,59,35.6,18,44,40.9,3,15,20.0,9,17,52.9,13,33,46,7,28,21,6,4,54,0
23583,549684,607_17_03,SERBIA,0,TOTALS,SERBIA,200,18,62,29.0,18,43,41.9,0,19,0.0,20,35,57.1,17,31,48,7,18,14,13,3,56,1
23584,549697,607_17_04,FRANCE,0,TOTALS,FRANCE,200,21,52,40.4,15,31,48.4,6,21,28.6,16,24,66.7,12,26,38,11,15,11,5,1,64,1
23585,549710,607_17_04,ITALY,0,TOTALS,ITALY,200,21,54,38.9,17,26,65.4,4,28,14.3,13,18,72.2,8,22,30,10,17,7,4,0,59,0
23586,549723,607_17_05,ISRAEL,0,TOTALS,ISRAEL,200,25,61,41.0,15,31,48.4,10,30,33.3,7,14,50.0,8,31,39,15,15,12,8,0,67,1
23587,549736,607_17_05,CROATIA,0,TOTALS,CROATIA,200,26,68,38.2,19,39,48.7,7,29,24.1,5,11,45.5,14,30,44,14,12,16,5,2,64,0
23588,549749,607_17_06,TURKEY,0,TOTALS,TURKEY,200,26,73,35.6,22,53,41.5,4,20,20.0,9,13,69.2,26,19,45,9,19,14,13,1,65,0
23589,549762,607_17_06,GERMANY,0,TOTALS,GERMANY,200,31,54,57.4,21,32,65.6,10,22,45.5,15,19,78.9,8,26,34,13,20,19,6,2,87,1
23590,549775,607_17_07,SLOVENIA,0,TOTALS,SLOVENIA,200,19,46,41.3,14,24,58.3,5,22,22.7,22,33,66.7,12,23,35,9,21,22,6,4,65,1
23591,549788,607_17_07,FINLAND,0,TOTALS,FINLAND,200,20,56,35.7,17,42,40.5,3,14,21.4,10,21,47.6,19,20,39,9,23,21,11,0,53,0
23592,549801,607_17_08,SWEDEN,0,TOTALS,SWEDEN,200,19,67,28.4,17,59,28.8,2,8,25.0,5,9,55.6,18,26,44,6,18,23,11,0,45,0
23593,549814,607_17_08,MONTENEGRO,0,TOTALS,MONTENEGRO,200,33,72,45.8,30,53,56.6,3,19,15.8,8,17,47.1,17,31,48,18,10,16,15,6,77,1
23594,549827,607_17_09,SERBIA,0,TOTALS,SERBIA,200,26,74,35.1,15,40,37.5,11,34,32.4,8,18,44.4,14,26,40,20,21,10,8,2,71,0
23595,549840,607_17_09,ISRAEL,0,TOTALS,ISRAEL,200,28,57,49.1,17,34,50.0,11,23,47.8,12,22,54.5,7,39,46,19,23,17,7,2,79,1
23596,549853,607_17_10,RUSSIA,0,TOTALS,RUSSIA,200,22,61,36.1,16,31,51.6,6,30,20.0,11,14,78.6,12,28,40,16,16,12,4,3,61,0
23597,549866,607_17_10,FRANCE,0,TOTALS,FRANCE,200,22,65,33.8,17,32,53.1,5,33,15.2,14,19,73.7,17,27,44,11,17,14,7,2,63,1
23598,549879,607_17_11,CROATIA,0,TOTALS,CROATIA,200,14,53,26.4,7,29,24.1,7,24,29.2,7,9,77.8,12,31,43,11,18,24,11,2,42,0
23599,549892,607_17_11,LITHUANIA,0,TOTALS,LITHUANIA,200,24,75,32.0,17,42,40.5,7,33,21.2,8,19,42.1,28,29,57,14,13,17,14,3,63,1
23600,549905,607_17_12,GERMANY,0,TOTALS,GERMANY,200,18,52,34.6,15,29,51.7,3,23,13.0,17,35,48.6,19,23,42,9,16,24,12,1,56,0
23601,549918,607_17_12,SLOVENIA,0,TOTALS,SLOVENIA,200,25,67,37.3,19,39,48.7,6,28,21.4,12,12,100.0,18,22,40,8,28,18,14,2,68,1
23602,549931,607_17_13,LATVIA,0,TOTALS,LATVIA,200,18,66,27.3,13,40,32.5,5,26,19.2,17,35,48.6,23,32,55,11,23,23,14,5,58,1
23603,549944,607_17_13,SWEDEN,0,TOTALS,SWEDEN,200,17,57,29.8,14,38,36.8,3,19,15.8,11,21,52.4,16,35,51,6,27,26,14,4,48,0
23604,549957,607_17_14,FINLAND,0,TOTALS,FINLAND,200,26,76,34.2,19,50,38.0,7,26,26.9,14,21,66.7,16,28,44,11,21,19,9,4,73,0
23605,549970,607_17_14,TURKEY,0,TOTALS,TURKEY,200,28,72,38.9,25,53,47.2,3,19,15.8,25,32,78.1,19,36,55,18,21,18,14,5,84,1
23606,549983,607_17_15,ITALY,0,TOTALS,ITALY,200,24,66,36.4,17,38,44.7,7,28,25.0,15,25,60.0,14,29,43,12,23,17,21,1,70,1
23607,549996,607_17_15,ESTONIA,0,TOTALS,ESTONIA,200,21,56,37.5,13,34,38.2,8,22,36.4,14,29,48.3,14,37,51,11,21,25,9,4,64,0
23608,550009,607_17_16,MONTENEGRO,0,TOTALS,MONTENEGRO,200,32,66,48.5,24,39,61.5,8,27,29.6,5,6,83.3,7,34,41,14,25,17,8,4,77,1
23609,550022,607_17_16,SPAIN,0,TOTALS,SPAIN,200,28,78,35.9,20,46,43.5,8,32,25.0,12,26,46.2,24,27,51,12,19,14,11,2,76,0
23610,550035,607_17_17,LITHUANIA,0,TOTALS,LITHUANIA,200,28,77,36.4,22,52,42.3,6,25,24.0,8,13,61.5,23,36,59,11,13,10,5,5,70,1
23611,550048,607_17_17,ISRAEL,0,TOTALS,ISRAEL,200,24,68,35.3,14,41,34.1,10,27,37.0,4,6,66.7,14,32,46,14,19,9,7,5,62,0
23612,550061,607_17_18,FINLAND,0,TOTALS,FINLAND,200,14,69,20.3,8,39,20.5,6,30,20.0,10,15,66.7,16,24,40,7,17,14,7,2,44,0
23613,550074,607_17_18,GERMANY,0,TOTALS,GERMANY,200,24,63,38.1,16,34,47.1,8,29,27.6,10,14,71.4,15,40,55,13,17,20,7,6,66,1
23614,550087,607_17_19,FRANCE,0,TOTALS,FRANCE,200,29,69,42.0,23,41,56.1,6,28,21.4,14,23,60.9,16,28,44,12,16,17,18,2,78,1
23615,550100,607_17_19,ESTONIA,0,TOTALS,ESTONIA,200,23,57,40.4,16,36,44.4,7,21,33.3,6,12,50.0,8,27,35,8,22,25,6,1,59,0
23616,550113,607_17_20,SPAIN,0,TOTALS,SPAIN,200,44,79,55.7,32,53,60.4,12,26,46.2,13,20,65.0,18,28,46,25,19,14,17,2,113,0
23617,550126,607_17_20,SWEDEN,0,TOTALS,SWEDEN,200,25,64,39.1,22,49,44.9,3,15,20.0,11,18,61.1,15,21,36,8,20,24,4,1,64,1
23618,550139,607_17_21,CROATIA,0,TOTALS,CROATIA,200,23,64,35.9,23,53,43.4,0,11,0.0,6,9,66.7,19,20,39,12,22,29,9,1,52,1
23619,550152,607_17_21,SERBIA,0,TOTALS,SERBIA,200,39,78,50.0,29,58,50.0,10,20,50.0,14,20,70.0,19,24,43,24,14,15,17,2,102,0
23620,550165,607_17_22,RUSSIA,0,TOTALS,RUSSIA,200,17,54,31.5,12,35,34.3,5,19,26.3,18,27,66.7,18,28,46,10,15,30,9,6,57,0
23621,550178,607_17_22,ITALY,0,TOTALS,ITALY,200,34,73,46.6,25,52,48.1,9,21,42.9,9,11,81.8,13,24,37,12,26,18,22,0,86,1
23622,550191,607_17_23,TURKEY,0,TOTALS,TURKEY,200,23,68,33.8,21,46,45.7,2,22,9.1,9,15,60.0,18,30,48,13,22,20,9,1,57,0
23623,550204,607_17_23,SLOVENIA,0,TOTALS,SLOVENIA,200,22,65,33.8,15,33,45.5,7,32,21.9,13,21,61.9,18,30,48,11,18,16,11,1,64,1
23624,550217,607_17_24,MONTENEGRO,0,TOTALS,MONTENEGRO,200,18,60,30.0,11,36,30.6,7,24,29.2,23,40,57.5,11,24,35,10,23,15,8,1,66,0
23625,550230,607_17_24,LATVIA,0,TOTALS,LATVIA,200,27,71,38.0,17,44,38.6,10,27,37.0,16,22,72.7,21,35,56,7,32,16,10,2,80,1
23626,550243,607_17_25,LATVIA,0,TOTALS,LATVIA,225,27,73,37.0,21,51,41.2,6,22,27.3,24,39,61.5,12,26,38,7,27,17,14,0,84,1
23627,550256,607_17_25,RUSSIA,0,TOTALS,RUSSIA,225,30,63,47.6,27,46,58.7,3,17,17.6,18,37,48.6,13,37,50,13,30,25,12,7,81,0
23628,550269,607_17_26,GERMANY,0,TOTALS,GERMANY,200,22,64,34.4,17,43,39.5,5,21,23.8,6,10,60.0,15,27,42,6,21,17,9,4,55,0
23629,550282,607_17_26,SERBIA,0,TOTALS,SERBIA,200,21,65,32.3,18,45,40.0,3,20,15.0,14,22,63.6,25,31,56,10,18,21,11,2,59,1
23630,550295,607_17_27,SLOVENIA,0,TOTALS,SLOVENIA,200,24,74,32.4,17,42,40.5,7,32,21.9,10,17,58.8,16,22,38,12,26,12,8,0,65,0
23631,550308,607_17_27,CROATIA,0,TOTALS,CROATIA,200,25,46,54.3,17,24,70.8,8,22,36.4,18,31,58.1,4,36,40,19,17,20,5,1,76,1
23632,550321,607_17_28,SPAIN,0,TOTALS,SPAIN,200,21,71,29.6,17,39,43.6,4,32,12.5,13,21,61.9,17,33,50,13,18,15,12,3,59,1
23633,550334,607_17_28,ESTONIA,0,TOTALS,ESTONIA,200,20,64,31.2,13,32,40.6,7,32,21.9,7,14,50.0,16,38,54,13,22,22,8,1,54,0
23634,550347,607_17_29,LITHUANIA,0,TOTALS,LITHUANIA,200,24,60,40.0,19,45,42.2,5,15,33.3,17,27,63.0,16,33,49,15,12,22,9,4,70,1
23635,550360,607_17_29,FINLAND,0,TOTALS,FINLAND,200,20,68,29.4,15,43,34.9,5,25,20.0,13,15,86.7,14,24,38,7,25,13,13,2,58,0
23636,550373,607_17_30,ISRAEL,0,TOTALS,ISRAEL,200,23,66,34.8,17,39,43.6,6,27,22.2,14,22,63.6,11,23,34,15,16,14,6,1,66,0
23637,550386,607_17_30,TURKEY,0,TOTALS,TURKEY,200,38,74,51.4,31,56,55.4,7,18,38.9,6,9,66.7,15,35,50,19,19,14,8,1,89,1
23638,550399,607_17_31,FRANCE,0,TOTALS,FRANCE,200,27,72,37.5,20,44,45.5,7,28,25.0,12,18,66.7,19,29,48,19,21,17,14,3,73,1
23639,550412,607_17_31,SWEDEN,0,TOTALS,SWEDEN,200,24,61,39.3,18,43,41.9,6,18,33.3,14,28,50.0,16,31,47,15,15,20,11,3,68,0
23640,550425,607_17_32,ITALY,0,TOTALS,ITALY,200,18,76,23.7,16,54,29.6,2,22,9.1,9,13,69.2,19,33,52,7,18,15,6,0,47,0
23641,550438,607_17_32,MONTENEGRO,0,TOTALS,MONTENEGRO,200,21,59,35.6,12,31,38.7,9,28,32.1,17,22,77.3,7,38,45,10,14,12,9,4,68,1
23642,550451,607_17_33,SLOVENIA,0,TOTALS,SLOVENIA,200,29,68,42.6,23,40,57.5,6,28,21.4,14,22,63.6,17,31,48,13,31,23,15,2,78,1
23643,550464,607_17_33,RUSSIA,0,TOTALS,RUSSIA,200,16,52,30.8,12,29,41.4,4,23,17.4,18,34,52.9,15,26,41,11,23,28,10,2,54,0
23644,550477,607_17_34,CROATIA,0,TOTALS,CROATIA,200,25,61,41.0,17,44,38.6,8,17,47.1,13,28,46.4,15,27,42,14,17,15,7,2,71,1
23645,550490,607_17_34,LATVIA,0,TOTALS,LATVIA,200,30,71,42.3,25,44,56.8,5,27,18.5,4,12,33.3,15,27,42,17,27,15,5,2,69,0
23646,550503,607_17_35,GERMANY,0,TOTALS,GERMANY,200,21,68,30.9,12,40,30.0,9,28,32.1,10,19,52.6,22,23,45,12,15,20,13,2,61,0
23647,550516,607_17_35,ESTONIA,0,TOTALS,ESTONIA,200,26,60,43.3,18,37,48.6,8,23,34.8,8,15,53.3,16,28,44,14,18,22,11,1,68,1
23648,550529,607_17_36,SERBIA,0,TOTALS,SERBIA,200,30,67,44.8,24,45,53.3,6,22,27.3,16,19,84.2,18,25,43,15,23,12,4,0,82,1
23649,550542,607_17_36,SPAIN,0,TOTALS,SPAIN,200,26,66,39.4,18,43,41.9,8,23,34.8,13,25,52.0,19,20,39,16,22,16,4,2,73,0
23650,550555,607_17_37,ISRAEL,0,TOTALS,ISRAEL,200,23,64,35.9,16,35,45.7,7,29,24.1,21,27,77.8,9,32,41,14,18,13,18,4,74,1
23651,550568,607_17_37,SWEDEN,0,TOTALS,SWEDEN,200,21,68,30.9,13,44,29.5,8,24,33.3,16,26,61.5,23,35,58,13,21,19,5,0,66,0
23652,550581,607_17_38,TURKEY,0,TOTALS,TURKEY,200,30,68,44.1,26,50,52.0,4,18,22.2,12,17,70.6,10,24,34,14,21,18,10,0,76,0
23653,550594,607_17_38,FRANCE,0,TOTALS,FRANCE,200,28,62,45.2,22,38,57.9,6,24,25.0,18,23,78.3,12,30,42,16,20,23,11,3,80,1
23654,550607,607_17_39,FINLAND,0,TOTALS,FINLAND,200,19,63,30.2,13,35,37.1,6,28,21.4,5,11,45.5,20,27,47,9,17,23,8,3,49,0
23655,550620,607_17_39,ITALY,0,TOTALS,ITALY,200,26,69,37.7,20,45,44.4,6,24,25.0,7,10,70.0,19,29,48,12,17,16,12,2,65,1
23656,550633,607_17_40,LITHUANIA,0,TOTALS,LITHUANIA,200,26,68,38.2,17,43,39.5,9,25,36.0,13,26,50.0,21,30,51,10,24,18,5,2,74,0
23657,550646,607_17_40,MONTENEGRO,0,TOTALS,MONTENEGRO,200,27,62,43.5,15,34,44.1,12,28,42.9,14,34,41.2,12,27,39,14,24,9,12,2,80,1
23658,550659,607_17_41,FINLAND,0,TOTALS,FINLAND,200,21,63,33.3,10,29,34.5,11,34,32.4,9,12,75.0,16,24,40,11,16,16,5,0,62,0
23659,550672,607_17_41,GERMANY,0,TOTALS,GERMANY,200,28,64,43.8,19,36,52.8,9,28,32.1,10,16,62.5,15,31,46,20,18,16,11,3,75,1
23660,550685,607_17_42,LITHUANIA,0,TOTALS,LITHUANIA,200,36,68,52.9,29,44,65.9,7,24,29.2,13,23,56.5,16,37,53,29,15,21,5,4,92,1
23661,550698,607_17_42,SPAIN,0,TOTALS,SPAIN,200,33,88,37.5,28,66,42.4,5,22,22.7,9,14,64.3,22,21,43,16,21,11,15,1,80,0
23662,550710,607_17_43,SWEDEN,0,TOTALS,SWEDEN,225,33,103,32.0,25,77,32.5,8,26,30.8,5,9,55.6,30,32,62,11,25,19,22,2,79,1
23663,550723,607_17_43,RUSSIA,0,TOTALS,RUSSIA,225,32,72,44.4,29,57,50.9,3,15,20.0,9,23,39.1,17,48,65,17,18,35,11,5,76,0
23664,550736,607_17_44,TURKEY,0,TOTALS,TURKEY,200,32,62,51.6,23,44,52.3,9,18,50.0,6,11,54.5,11,36,47,15,20,24,12,2,79,1
23665,550749,607_17_44,LATVIA,0,TOTALS,LATVIA,200,27,77,35.1,20,46,43.5,7,31,22.6,12,16,75.0,18,20,38,12,21,19,9,2,73,0
23666,550762,607_17_45,ITALY,0,TOTALS,ITALY,200,25,75,33.3,24,58,41.4,1,17,5.9,14,22,63.6,19,33,52,9,19,7,16,2,65,1
23667,550775,607_17_45,ESTONIA,0,TOTALS,ESTONIA,200,19,53,35.8,15,35,42.9,4,18,22.2,11,18,61.1,7,40,47,11,20,21,4,5,53,0
23668,550788,607_17_46,FRANCE,0,TOTALS,FRANCE,200,34,67,50.7,31,48,64.6,3,19,15.8,12,16,75.0,12,25,37,10,16,11,18,1,83,1
23669,550801,607_17_46,CROATIA,0,TOTALS,CROATIA,200,22,58,37.9,15,32,46.9,7,26,26.9,9,13,69.2,12,23,35,13,15,22,4,0,60,0
23670,550814,607_17_47,ISRAEL,0,TOTALS,ISRAEL,200,21,61,34.4,18,36,50.0,3,25,12.0,14,21,66.7,14,31,45,10,14,18,8,4,59,0
23671,550827,607_17_47,SLOVENIA,0,TOTALS,SLOVENIA,200,26,71,36.6,16,37,43.2,10,34,29.4,8,15,53.3,18,28,46,14,20,15,8,2,70,1
23672,550840,607_17_48,MONTENEGRO,0,TOTALS,MONTENEGRO,200,29,75,38.7,25,48,52.1,4,27,14.8,11,22,50.0,21,26,47,16,19,9,6,1,73,1
23673,550853,607_17_48,SERBIA,0,TOTALS,SERBIA,200,26,59,44.1,23,45,51.1,3,14,21.4,11,20,55.0,8,30,38,17,21,12,3,3,66,0
23674,550866,607_17_49,FINLAND,0,TOTALS,FINLAND,200,27,74,36.5,18,45,40.0,9,29,31.0,6,10,60.0,21,28,49,17,23,21,12,2,69,1
23675,550879,607_17_49,RUSSIA,0,TOTALS,RUSSIA,200,23,65,35.4,19,48,39.6,4,17,23.5,15,28,53.6,22,29,51,14,18,24,10,3,65,0
23676,550892,607_17_50,GERMANY,0,TOTALS,GERMANY,200,31,65,47.7,25,40,62.5,6,25,24.0,9,14,64.3,13,41,54,12,12,17,17,2,77,1
23677,550905,607_17_50,SWEDEN,0,TOTALS,SWEDEN,200,16,69,23.2,12,46,26.1,4,23,17.4,8,10,80.0,16,25,41,4,14,19,11,2,44,0
23678,550918,607_17_51,SPAIN,0,TOTALS,SPAIN,200,32,62,51.6,22,41,53.7,10,21,47.6,21,32,65.6,20,27,47,18,19,15,10,4,95,1
23679,550931,607_17_51,LATVIA,0,TOTALS,LATVIA,200,27,70,38.6,18,41,43.9,9,29,31.0,14,18,77.8,18,16,34,12,25,12,10,3,77,0
23680,550944,607_17_52,ESTONIA,0,TOTALS,ESTONIA,200,29,69,42.0,22,45,48.9,7,24,29.2,13,15,86.7,19,30,49,17,22,16,6,2,78,0
23681,550957,607_17_52,ISRAEL,0,TOTALS,ISRAEL,200,29,68,42.6,19,40,47.5,10,28,35.7,17,27,63.0,15,27,42,18,20,12,10,4,85,1
23682,550970,607_17_53,LITHUANIA,0,TOTALS,LITHUANIA,200,18,58,31.0,13,32,40.6,5,26,19.2,21,30,70.0,14,26,40,6,14,18,8,2,62,0
23683,550983,607_17_53,TURKEY,0,TOTALS,TURKEY,200,34,74,45.9,27,53,50.9,7,21,33.3,5,7,71.4,14,28,42,21,22,14,16,1,80,1
23684,550996,607_17_54,SERBIA,0,TOTALS,SERBIA,200,27,68,39.7,23,54,42.6,4,14,28.6,17,25,68.0,17,27,44,13,15,12,11,5,75,1
23685,551009,607_17_54,CROATIA,0,TOTALS,CROATIA,200,29,66,43.9,26,49,53.1,3,17,17.6,10,15,66.7,13,27,40,15,22,19,7,4,71,0
23686,551022,607_17_55,ITALY,0,TOTALS,ITALY,200,28,63,44.4,19,40,47.5,9,23,39.1,8,10,80.0,16,31,47,19,18,16,15,3,73,1
23687,551035,607_17_55,SLOVENIA,0,TOTALS,SLOVENIA,200,18,70,25.7,14,39,35.9,4,31,12.9,7,18,38.9,29,22,51,8,13,21,8,2,47,0
23688,551048,607_17_56,MONTENEGRO,0,TOTALS,MONTENEGRO,200,22,63,34.9,17,33,51.5,5,30,16.7,19,21,90.5,13,23,36,11,16,19,6,4,68,0
23689,551061,607_17_56,FRANCE,0,TOTALS,FRANCE,200,28,58,48.3,17,35,48.6,11,23,47.8,8,11,72.7,8,27,35,15,22,21,16,0,75,1
23690,551074,608_17_01,SWITZERLAND,0,TOTALS,SWITZERLAND,200,20,65,30.8,12,36,33.3,8,29,27.6,12,18,66.7,16,20,36,13,19,22,8,1,60,0
23691,551087,608_17_01,ICELAND,0,TOTALS,ICELAND,200,31,67,46.3,28,46,60.9,3,21,14.3,15,22,68.2,18,32,50,12,21,19,15,1,80,1
23692,551100,608_17_02,POLAND,0,TOTALS,POLAND,200,30,72,41.7,22,53,41.5,8,19,42.1,12,16,75.0,22,30,52,15,20,16,15,1,80,1
23693,551113,608_17_02,DENMARK,0,TOTALS,DENMARK,200,15,61,24.6,13,38,34.2,2,23,8.7,11,25,44.0,20,22,42,8,20,25,7,1,43,0
23694,551126,608_17_03,BOSNIA AND HERZEGOVINA,0,TOTALS,BOSNIA AND HERZEGOVINA,200,32,72,44.4,29,56,51.8,3,16,18.8,24,38,63.2,19,39,58,16,11,19,20,4,91,1
23695,551139,608_17_03,NORWAY,0,TOTALS,NORWAY,200,22,69,31.9,12,42,28.6,10,27,37.0,4,11,36.4,13,27,40,11,25,31,12,2,58,0
23696,551152,608_17_04,ROMANIA,0,TOTALS,ROMANIA,200,14,59,23.7,12,45,26.7,2,14,14.3,18,24,75.0,13,29,42,5,15,21,6,0,48,0
23697,551165,608_17_04,BELGIUM,0,TOTALS,BELGIUM,200,33,84,39.3,25,58,43.1,8,26,30.8,11,16,68.8,26,34,60,20,18,12,16,4,85,1
23698,551178,608_17_05,UKRAINE,0,TOTALS,UKRAINE,200,18,52,34.6,12,37,32.4,6,15,40.0,6,9,66.7,10,34,44,15,19,28,7,5,48,0
23699,551191,608_17_05,NETHERLANDS,0,TOTALS,NETHERLANDS,200,19,64,29.7,15,45,33.3,4,19,21.1,13,26,50.0,18,25,43,13,19,18,13,6,55,1
23700,551204,608_17_06,PORTUGAL,0,TOTALS,PORTUGAL,200,24,51,47.1,19,36,52.8,5,15,33.3,12,15,80.0,4,23,27,12,22,21,13,0,65,1
23701,551217,608_17_06,KOSOVO,0,TOTALS,KOSOVO,200,21,52,40.4,14,32,43.8,7,20,35.0,15,33,45.5,17,25,42,10,21,23,8,1,64,0
23702,551230,608_17_07,BULGARIA,0,TOTALS,BULGARIA,200,32,75,42.7,24,50,48.0,8,25,32.0,6,15,40.0,21,37,58,22,17,24,17,5,78,1
23703,551243,608_17_07,CYPRUS,0,TOTALS,CYPRUS,200,19,68,27.9,12,43,27.9,7,25,28.0,3,12,25.0,18,24,42,10,16,28,16,3,48,0
23704,551256,608_17_08,HUNGARY,0,TOTALS,HUNGARY,200,22,64,34.4,16,40,40.0,6,24,25.0,8,9,88.9,12,26,38,13,16,17,13,3,58,1
23705,551269,608_17_08,IRELAND,0,TOTALS,IRELAND,200,20,46,43.5,20,35,57.1,0,11,0.0,11,18,61.1,2,31,33,15,15,20,8,3,51,0
23706,551282,608_17_09,MKD,0,TOTALS,MKD,200,19,59,32.2,15,38,39.5,4,21,19.0,11,20,55.0,12,22,34,10,22,28,9,3,53,0
23707,551295,608_17_09,GEORGIA,0,TOTALS,GEORGIA,200,31,73,42.5,24,49,49.0,7,24,29.2,19,26,73.1,21,31,52,26,20,21,18,2,88,1
23708,551308,608_17_10,GREECE,0,TOTALS,GREECE,200,45,93,48.4,42,82,51.2,3,11,27.3,8,15,53.3,23,33,56,20,25,13,16,7,101,0
23709,551321,608_17_10,BELARUS,0,TOTALS,BELARUS,200,19,58,32.8,16,48,33.3,3,10,30.0,19,33,57.6,15,29,44,10,20,28,7,3,60,1
23710,551334,608_17_11,SLOVAK REPUBLIC,0,TOTALS,SLOVAK REPUBLIC,200,20,58,34.5,16,39,41.0,4,19,21.1,9,25,36.0,19,23,42,7,20,20,12,2,53,0
23711,551347,608_17_11,CZECH REPUBLIC,0,TOTALS,CZECH REPUBLIC,200,21,60,35.0,14,41,34.1,7,19,36.8,10,20,50.0,19,26,45,14,21,23,8,0,59,1
23712,551360,608_17_12,GREAT BRITAIN,0,TOTALS,GREAT BRITAIN,200,27,63,42.9,18,32,56.2,9,31,29.0,14,21,66.7,15,35,50,19,18,21,22,4,77,1
23713,551373,608_17_12,LUXEMBOURG,0,TOTALS,LUXEMBOURG,200,16,59,27.1,11,37,29.7,5,22,22.7,6,9,66.7,10,24,34,11,19,26,8,1,43,0
23714,551386,608_17_13,ICELAND,0,TOTALS,ICELAND,200,21,61,34.4,14,34,41.2,7,27,25.9,18,26,69.2,18,40,58,17,23,24,14,8,67,1
23715,551399,608_17_13,ROMANIA,0,TOTALS,ROMANIA,200,12,61,19.7,9,39,23.1,3,22,13.6,18,26,69.2,14,26,40,9,23,21,15,3,45,0
23716,551412,608_17_14,NETHERLANDS,0,TOTALS,NETHERLANDS,200,28,63,44.4,23,42,54.8,5,21,23.8,8,21,38.1,18,37,55,17,19,22,7,5,69,1
23717,551425,608_17_14,POLAND,0,TOTALS,POLAND,200,18,66,27.3,14,44,31.8,4,22,18.2,14,18,77.8,14,26,40,7,20,17,12,1,54,0
23718,551438,608_17_15,KOSOVO,0,TOTALS,KOSOVO,200,22,55,40.0,14,35,40.0,8,20,40.0,9,17,52.9,18,33,51,14,25,25,7,3,61,0
23719,551451,608_17_15,MKD,0,TOTALS,MKD,200,19,63,30.2,12,32,37.5,7,31,22.6,19,27,70.4,15,19,34,12,15,9,14,0,64,1
23720,551464,608_17_16,BELARUS,0,TOTALS,BELARUS,200,27,70,38.6,23,60,38.3,4,10,40.0,16,42,38.1,26,44,70,12,19,18,6,5,74,1
23721,551477,608_17_16,SWITZERLAND,0,TOTALS,SWITZERLAND,200,26,74,35.1,19,53,35.8,7,21,33.3,9,16,56.2,8,32,40,12,29,10,14,4,68,0
23722,551490,608_17_17,IRELAND,0,TOTALS,IRELAND,200,19,57,33.3,15,47,31.9,4,10,40.0,12,23,52.2,12,41,53,13,19,24,10,4,54,1
23723,551503,608_17_17,SLOVAK REPUBLIC,0,TOTALS,SLOVAK REPUBLIC,200,17,70,24.3,11,43,25.6,6,27,22.2,9,16,56.2,17,32,49,7,24,20,13,3,49,0
23724,551516,608_17_18,LUXEMBOURG,0,TOTALS,LUXEMBOURG,200,22,51,43.1,19,35,54.3,3,16,18.8,8,15,53.3,6,25,31,10,21,23,4,3,55,0
23725,551529,608_17_18,PORTUGAL,0,TOTALS,PORTUGAL,200,30,72,41.7,23,47,48.9,7,25,28.0,18,29,62.1,21,29,50,21,15,10,15,1,85,1
23726,551542,608_17_19,BELGIUM,0,TOTALS,BELGIUM,200,23,69,33.3,19,44,43.2,4,25,16.0,10,15,66.7,14,28,42,14,23,20,10,1,60,0
23727,551555,608_17_19,GREECE,0,TOTALS,GREECE,200,29,77,37.7,23,55,41.8,6,22,27.3,13,20,65.0,26,32,58,18,17,18,7,1,77,1
23728,551568,608_17_20,DENMARK,0,TOTALS,DENMARK,200,27,69,39.1,21,47,44.7,6,22,27.3,8,14,57.1,18,24,42,12,24,18,4,2,68,0
23729,551581,608_17_20,BULGARIA,0,TOTALS,BULGARIA,200,30,69,43.5,27,51,52.9,3,18,16.7,14,24,58.3,19,27,46,15,21,15,12,4,77,1
23730,551594,608_17_21,NORWAY,0,TOTALS,NORWAY,200,18,47,38.3,14,37,37.8,4,10,40.0,11,15,73.3,11,33,44,9,19,35,5,5,51,0
23731,551607,608_17_21,HUNGARY,0,TOTALS,HUNGARY,200,23,72,31.9,23,56,41.1,0,16,0.0,17,30,56.7,24,19,43,12,16,11,20,5,63,1
23732,551620,608_17_22,CYPRUS,0,TOTALS,CYPRUS,200,18,70,25.7,15,51,29.4,3,19,15.8,7,15,46.7,13,25,38,15,26,15,10,2,46,0
23733,551633,608_17_22,UKRAINE,0,TOTALS,UKRAINE,200,23,55,41.8,19,41,46.3,4,14,28.6,17,31,54.8,15,44,59,18,20,27,7,3,67,1
23734,551646,608_17_23,CZECH REPUBLIC,0,TOTALS,CZECH REPUBLIC,200,24,71,33.8,18,51,35.3,6,20,30.0,19,28,67.9,13,41,54,19,27,15,11,5,73,1
23735,551659,608_17_23,BOSNIA AND HERZEGOVINA,0,TOTALS,BOSNIA AND HERZEGOVINA,200,21,79,26.6,15,52,28.8,6,27,22.2,13,28,46.4,24,37,61,14,24,19,8,7,61,0
23736,551672,608_17_24,GEORGIA,0,TOTALS,GEORGIA,200,15,46,32.6,11,28,39.3,4,18,22.2,24,32,75.0,9,32,41,10,27,27,6,2,58,0
23737,551685,608_17_24,GREAT BRITAIN,0,TOTALS,GREAT BRITAIN,200,30,71,42.3,19,36,52.8,11,35,31.4,14,26,53.8,15,24,39,18,28,16,11,5,85,1
23738,551698,608_17_25,GREECE,0,TOTALS,GREECE,200,44,81,54.3,37,67,55.2,7,14,50.0,16,28,57.1,26,29,55,20,22,15,17,2,111,0
23739,551711,608_17_25,ROMANIA,0,TOTALS,ROMANIA,200,19,58,32.8,12,34,35.3,7,24,29.2,15,19,78.9,11,19,30,11,21,26,10,6,60,1
23740,551724,608_17_26,NORWAY,0,TOTALS,NORWAY,200,24,63,38.1,17,37,45.9,7,26,26.9,1,6,16.7,9,26,35,19,22,21,5,5,56,0
23741,551737,608_17_26,IRELAND,0,TOTALS,IRELAND,200,33,72,45.8,23,45,51.1,10,27,37.0,22,33,66.7,19,32,51,23,14,11,15,2,98,1
23742,551750,608_17_27,LUXEMBOURG,0,TOTALS,LUXEMBOURG,200,17,57,29.8,11,36,30.6,6,21,28.6,11,25,44.0,7,33,40,15,29,22,14,2,51,0
23743,551763,608_17_27,KOSOVO,0,TOTALS,KOSOVO,200,16,57,28.1,12,38,31.6,4,19,21.1,25,45,55.6,20,40,60,12,23,26,9,1,61,1
23744,551776,608_17_28,BOSNIA AND HERZEGOVINA,0,TOTALS,BOSNIA AND HERZEGOVINA,190,27,64,42.2,22,49,44.9,5,15,33.3,17,33,51.5,14,28,42,10,26,14,8,5,76,1
23745,551789,608_17_28,SLOVAK REPUBLIC,0,TOTALS,SLOVAK REPUBLIC,200,25,66,37.9,22,40,55.0,3,26,11.5,16,26,61.5,18,30,48,11,29,18,6,1,69,0
23746,551802,608_17_29,SWITZERLAND,0,TOTALS,SWITZERLAND,200,16,54,29.6,14,36,38.9,2,18,11.1,18,21,85.7,5,25,30,10,18,29,12,5,52,0
23747,551815,608_17_29,BELGIUM,0,TOTALS,BELGIUM,200,40,78,51.3,34,59,57.6,6,19,31.6,12,22,54.5,21,31,52,22,21,17,18,3,98,1
23748,551828,608_17_30,GREAT BRITAIN,0,TOTALS,GREAT BRITAIN,200,34,64,53.1,26,39,66.7,8,25,32.0,18,30,60.0,18,34,52,25,17,17,10,1,94,1
23749,551841,608_17_30,MKD,0,TOTALS,MKD,200,22,64,34.4,19,42,45.2,3,22,13.6,5,14,35.7,10,17,27,10,21,17,7,1,52,0
23750,551854,608_17_31,DENMARK,0,TOTALS,DENMARK,200,25,72,34.7,19,52,36.5,6,20,30.0,25,38,65.8,20,34,54,14,25,28,12,3,81,1
23751,551867,608_17_31,CYPRUS,0,TOTALS,CYPRUS,200,25,69,36.2,21,48,43.8,4,21,19.0,15,28,53.6,15,31,46,12,32,29,16,5,69,0
23752,551880,608_17_32,BULGARIA,0,TOTALS,BULGARIA,200,20,63,31.7,17,43,39.5,3,20,15.0,7,13,53.8,10,25,35,6,17,14,12,4,50,0
23753,551893,608_17_32,NETHERLANDS,0,TOTALS,NETHERLANDS,200,28,74,37.8,20,45,44.4,8,29,27.6,5,7,71.4,23,37,60,17,15,23,10,6,69,1
23754,551906,608_17_33,PORTUGAL,0,TOTALS,PORTUGAL,200,16,61,26.2,9,39,23.1,7,22,31.8,20,28,71.4,14,23,37,10,24,13,7,1,59,0
23755,551919,608_17_33,GEORGIA,0,TOTALS,GEORGIA,200,26,58,44.8,17,32,53.1,9,26,34.6,19,27,70.4,15,32,47,17,26,17,4,0,80,1
23756,551932,608_17_34,BELARUS,0,TOTALS,BELARUS,200,27,66,40.9,21,52,40.4,6,14,42.9,18,26,69.2,14,31,45,16,26,24,10,6,78,1
23757,551945,608_17_34,ICELAND,0,TOTALS,ICELAND,200,28,69,40.6,20,50,40.0,8,19,42.1,13,28,46.4,15,30,45,19,19,20,12,4,77,0
23758,551958,608_17_35,POLAND,0,TOTALS,POLAND,200,22,67,32.8,15,45,33.3,7,22,31.8,8,11,72.7,15,27,42,12,25,21,16,2,59,1
23759,551971,608_17_35,UKRAINE,0,TOTALS,UKRAINE,200,16,57,28.1,12,42,28.6,4,15,26.7,21,26,80.8,16,32,48,8,16,24,8,8,57,0
23760,551984,608_17_36,HUNGARY,0,TOTALS,HUNGARY,200,22,57,38.6,19,40,47.5,3,17,17.6,9,16,56.2,12,28,40,18,20,18,8,5,56,0
23761,551997,608_17_36,CZECH REPUBLIC,0,TOTALS,CZECH REPUBLIC,200,28,79,35.4,28,61,45.9,0,18,0.0,10,20,50.0,27,24,51,12,15,11,6,2,66,1
23762,552010,608_17_37,NETHERLANDS,0,TOTALS,NETHERLANDS,200,36,73,49.3,29,48,60.4,7,25,28.0,21,31,67.7,21,42,63,24,24,20,19,3,100,0
23763,552023,608_17_37,DENMARK,0,TOTALS,DENMARK,200,11,55,20.0,7,37,18.9,4,18,22.2,10,23,43.5,8,21,29,9,27,27,11,1,36,1
23764,552036,608_17_38,GEORGIA,0,TOTALS,GEORGIA,200,25,58,43.1,18,32,56.2,7,26,26.9,20,34,58.8,18,34,52,20,17,23,23,2,77,1
23765,552049,608_17_38,LUXEMBOURG,0,TOTALS,LUXEMBOURG,200,15,52,28.8,12,38,31.6,3,14,21.4,5,14,35.7,7,20,27,10,26,28,14,3,38,0
23766,552062,608_17_39,MKD,0,TOTALS,MKD,200,13,52,25.0,10,40,25.0,3,12,25.0,17,26,65.4,12,33,45,9,21,18,6,2,46,0
23767,552075,608_17_39,PORTUGAL,0,TOTALS,PORTUGAL,200,19,65,29.2,16,45,35.6,3,20,15.0,14,21,66.7,19,32,51,11,20,14,13,2,55,1
23768,552088,608_17_40,ICELAND,0,TOTALS,ICELAND,200,28,65,43.1,22,47,46.8,6,18,33.3,14,24,58.3,10,19,29,12,30,16,13,1,76,0
23769,552101,608_17_40,GREECE,0,TOTALS,GREECE,200,29,62,46.8,27,51,52.9,2,11,18.2,25,35,71.4,21,33,54,19,22,22,10,5,85,1
23770,552114,608_17_41,CYPRUS,0,TOTALS,CYPRUS,200,21,56,37.5,16,35,45.7,5,21,23.8,9,14,64.3,11,22,33,19,22,24,7,3,56,0
23771,552127,608_17_41,POLAND,0,TOTALS,POLAND,200,31,65,47.7,20,33,60.6,11,32,34.4,15,22,68.2,16,26,42,21,15,16,12,2,88,1
23772,552140,608_17_42,CZECH REPUBLIC,0,TOTALS,CZECH REPUBLIC,200,33,74,44.6,27,56,48.2,6,18,33.3,7,15,46.7,20,35,55,20,22,20,18,2,79,1
23773,552153,608_17_42,NORWAY,0,TOTALS,NORWAY,200,15,50,30.0,11,35,31.4,4,15,26.7,8,20,40.0,5,26,31,9,18,25,15,1,42,0
23774,552166,608_17_43,BELGIUM,0,TOTALS,BELGIUM,200,38,84,45.2,29,59,49.2,9,25,36.0,5,11,45.5,21,37,58,25,15,12,8,1,90,1
23775,552179,608_17_43,BELARUS,0,TOTALS,BELARUS,200,23,67,34.3,21,50,42.0,2,17,11.8,12,20,60.0,11,26,37,14,12,14,6,3,60,0
23776,552192,608_17_44,UKRAINE,0,TOTALS,UKRAINE,200,28,70,40.0,21,49,42.9,7,21,33.3,15,16,93.8,14,30,44,24,12,9,9,2,78,1
23777,552205,608_17_44,BULGARIA,0,TOTALS,BULGARIA,200,23,66,34.8,18,41,43.9,5,25,20.0,5,9,55.6,15,28,43,12,12,15,5,4,56,0
23778,552218,608_17_45,SLOVAK REPUBLIC,0,TOTALS,SLOVAK REPUBLIC,200,23,65,35.4,20,45,44.4,3,20,15.0,2,5,40.0,19,23,42,10,15,18,4,2,51,0
23779,552231,608_17_45,HUNGARY,0,TOTALS,HUNGARY,200,27,54,50.0,23,41,56.1,4,13,30.8,9,17,52.9,11,24,35,13,15,16,13,3,67,1
23780,552244,608_17_46,ROMANIA,0,TOTALS,ROMANIA,225,28,71,39.4,22,50,44.0,6,21,28.6,12,27,44.4,22,32,54,13,29,28,14,5,74,0
23781,552257,608_17_46,SWITZERLAND,0,TOTALS,SWITZERLAND,225,24,65,36.9,17,43,39.5,7,22,31.8,21,34,61.8,16,29,45,12,25,24,12,5,76,1
23782,552270,608_17_47,IRELAND,0,TOTALS,IRELAND,200,27,74,36.5,18,43,41.9,9,31,29.0,8,14,57.1,19,30,49,22,21,30,11,0,71,0
23783,552283,608_17_47,BOSNIA AND HERZEGOVINA,0,TOTALS,BOSNIA AND HERZEGOVINA,200,36,71,50.7,28,44,63.6,8,27,29.6,17,22,77.3,7,30,37,22,24,21,20,5,97,1
23784,552296,608_17_48,KOSOVO,0,TOTALS,KOSOVO,200,14,62,22.6,12,49,24.5,2,13,15.4,5,11,45.5,11,36,47,4,17,22,10,5,35,0
23785,552309,608_17_48,GREAT BRITAIN,0,TOTALS,GREAT BRITAIN,200,22,68,32.4,16,40,40.0,6,28,21.4,7,15,46.7,14,39,53,9,16,18,13,7,57,1
23786,552322,608_17_49,BELGIUM,0,TOTALS,BELGIUM,209,37,80,46.2,32,56,57.1,5,24,20.8,10,15,66.7,26,30,56,26,16,17,11,2,89,1
23787,552335,608_17_49,ICELAND,0,TOTALS,ICELAND,200,24,59,40.7,18,45,40.0,6,14,42.9,9,15,60.0,9,18,27,9,17,20,10,3,63,0
23788,552348,608_17_50,NETHERLANDS,0,TOTALS,NETHERLANDS,200,38,64,59.4,29,42,69.0,9,22,40.9,13,20,65.0,13,34,47,29,14,18,12,4,98,1
23789,552361,608_17_50,CYPRUS,0,TOTALS,CYPRUS,200,15,57,26.3,11,43,25.6,4,14,28.6,9,18,50.0,11,15,26,12,18,23,11,1,43,0
23790,552374,608_17_51,NORWAY,0,TOTALS,NORWAY,200,19,59,32.2,15,44,34.1,4,15,26.7,5,9,55.6,8,26,34,10,25,23,10,1,47,0
23791,552387,608_17_51,SLOVAK REPUBLIC,0,TOTALS,SLOVAK REPUBLIC,200,27,68,39.7,20,49,40.8,7,19,36.8,12,22,54.5,20,33,53,15,15,18,12,5,73,1
23792,552400,608_17_52,SWITZERLAND,0,TOTALS,SWITZERLAND,200,14,55,25.5,7,34,20.6,7,21,33.3,4,20,20.0,9,19,28,8,22,25,5,2,39,1
23793,552413,608_17_52,GREECE,0,TOTALS,GREECE,200,43,75,57.3,41,63,65.1,2,12,16.7,23,28,82.1,15,40,55,37,20,11,13,8,111,0
23794,552426,608_17_53,DENMARK,0,TOTALS,DENMARK,200,27,74,36.5,20,53,37.7,7,21,33.3,3,5,60.0,20,18,38,18,22,25,11,1,64,0
23795,552439,608_17_53,UKRAINE,0,TOTALS,UKRAINE,200,36,70,51.4,27,45,60.0,9,25,36.0,15,20,75.0,18,27,45,26,16,21,16,6,96,1
23796,552452,608_17_54,GEORGIA,0,TOTALS,GEORGIA,200,24,57,42.1,17,29,58.6,7,28,25.0,22,38,57.9,15,34,49,15,22,17,18,5,77,1
23797,552465,608_17_54,KOSOVO,0,TOTALS,KOSOVO,200,14,58,24.1,11,33,33.3,3,25,12.0,17,30,56.7,19,24,43,5,28,23,9,2,48,0
23798,552478,608_17_55,BULGARIA,0,TOTALS,BULGARIA,200,29,62,46.8,25,45,55.6,4,17,23.5,13,22,59.1,12,35,47,18,20,19,8,7,75,1
23799,552491,608_17_55,POLAND,0,TOTALS,POLAND,200,26,74,35.1,18,44,40.9,8,30,26.7,12,19,63.2,15,24,39,13,21,12,9,5,72,0
23800,552504,608_17_56,CZECH REPUBLIC,0,TOTALS,CZECH REPUBLIC,200,20,74,27.0,13,38,34.2,7,36,19.4,19,23,82.6,28,27,55,17,23,20,12,4,66,1
23801,552516,608_17_56,IRELAND,0,TOTALS,IRELAND,200,22,62,35.5,19,44,43.2,3,18,16.7,15,23,65.2,14,30,44,14,22,21,9,4,62,0
23802,552529,608_17_57,PORTUGAL,0,TOTALS,PORTUGAL,200,19,50,38.0,17,40,42.5,2,10,20.0,14,23,60.9,13,23,36,6,18,19,5,3,54,0
23803,552542,608_17_57,GREAT BRITAIN,0,TOTALS,GREAT BRITAIN,200,25,61,41.0,23,47,48.9,2,14,14.3,12,19,63.2,17,20,37,10,23,15,7,4,64,1
23804,552555,608_17_58,BELARUS,0,TOTALS,BELARUS,200,35,68,51.5,33,59,55.9,2,9,22.2,13,29,44.8,24,35,59,22,15,21,13,8,85,1
23805,552568,608_17_58,ROMANIA,0,TOTALS,ROMANIA,200,16,66,24.2,13,48,27.1,3,18,16.7,8,13,61.5,17,17,34,9,28,23,14,5,43,0
23806,552581,608_17_59,HUNGARY,0,TOTALS,HUNGARY,200,29,64,45.3,26,45,57.8,3,19,15.8,18,22,81.8,8,36,44,24,21,10,6,3,79,1
23807,552593,608_17_59,BOSNIA AND HERZEGOVINA,0,TOTALS,BOSNIA AND HERZEGOVINA,200,22,70,31.4,15,46,32.6,7,24,29.2,14,24,58.3,18,27,45,12,23,13,8,4,65,0
23808,552606,608_17_60,LUXEMBOURG,0,TOTALS,LUXEMBOURG,200,29,65,44.6,20,39,51.3,9,26,34.6,4,12,33.3,6,36,42,21,18,20,8,7,71,0
23809,552619,608_17_60,MKD,0,TOTALS,MKD,200,26,76,34.2,22,54,40.7,4,22,18.2,19,28,67.9,16,36,52,13,19,12,11,1,75,1
23810,552632,608_17_61,GREECE,0,TOTALS,GREECE,200,28,67,41.8,26,57,45.6,2,10,20.0,20,33,60.6,19,30,49,15,21,14,13,7,78,1
23811,552645,608_17_61,UKRAINE,0,TOTALS,UKRAINE,200,19,63,30.2,10,38,26.3,9,25,36.0,16,21,76.2,15,28,43,11,23,19,2,8,63,0
23812,552658,608_17_62,POLAND,0,TOTALS,POLAND,200,20,57,35.1,15,37,40.5,5,20,25.0,17,29,58.6,10,31,41,16,14,16,5,3,62,1
23813,552671,608_17_62,ICELAND,0,TOTALS,ICELAND,200,23,63,36.5,21,50,42.0,2,13,15.4,10,17,58.8,11,33,44,12,23,18,8,0,58,0
23814,552684,608_17_63,SWITZERLAND,0,TOTALS,SWITZERLAND,200,22,59,37.3,14,38,36.8,8,21,38.1,9,14,64.3,16,46,62,14,18,30,5,3,61,1
23815,552697,608_17_63,CYPRUS,0,TOTALS,CYPRUS,200,19,78,24.4,14,50,28.0,5,28,17.9,8,13,61.5,16,23,39,8,18,10,16,2,51,0
23816,552710,608_17_64,GREAT BRITAIN,0,TOTALS,GREAT BRITAIN,200,35,74,47.3,27,53,50.9,8,21,38.1,7,9,77.8,17,30,47,14,18,15,15,1,85,1
23817,552723,608_17_64,HUNGARY,0,TOTALS,HUNGARY,200,21,61,34.4,17,43,39.5,4,18,22.2,8,15,53.3,13,23,36,13,11,20,9,3,54,0
23818,552736,608_17_65,BOSNIA AND HERZEGOVINA,0,TOTALS,BOSNIA AND HERZEGOVINA,200,31,66,47.0,27,47,57.4,4,19,21.1,16,19,84.2,11,36,47,21,22,15,7,1,82,1
23819,552749,608_17_65,MKD,0,TOTALS,MKD,200,25,74,33.8,20,50,40.0,5,24,20.8,12,21,57.1,18,26,44,13,20,13,6,2,67,0
23820,552762,608_17_66,KOSOVO,0,TOTALS,KOSOVO,200,20,64,31.2,15,45,33.3,5,19,26.3,21,33,63.6,19,32,51,11,18,13,15,0,66,1
23821,552775,608_17_66,NORWAY,0,TOTALS,NORWAY,200,16,55,29.1,11,27,40.7,5,28,17.9,12,16,75.0,9,32,41,6,26,19,8,2,49,0
23822,552788,608_17_67,NETHERLANDS,0,TOTALS,NETHERLANDS,200,25,73,34.2,19,47,40.4,6,26,23.1,9,18,50.0,19,38,57,16,16,9,7,6,65,1
23823,552801,608_17_67,BELGIUM,0,TOTALS,BELGIUM,200,19,74,25.7,14,48,29.2,5,26,19.2,8,16,50.0,20,36,56,8,21,13,6,5,51,0
23824,552814,608_17_68,BELARUS,0,TOTALS,BELARUS,200,28,69,40.6,26,58,44.8,2,11,18.2,13,20,65.0,20,32,52,13,18,21,11,6,71,1
23825,552827,608_17_68,BULGARIA,0,TOTALS,BULGARIA,200,26,63,41.3,21,44,47.7,5,19,26.3,8,13,61.5,8,26,34,15,20,21,13,8,65,0
23826,552840,608_17_69,DENMARK,0,TOTALS,DENMARK,200,23,62,37.1,14,35,40.0,9,27,33.3,23,39,59.0,13,21,34,18,26,16,13,2,78,1
23827,552853,608_17_69,ROMANIA,0,TOTALS,ROMANIA,200,24,50,48.0,15,33,45.5,9,17,52.9,17,28,60.7,12,36,48,18,31,32,6,4,74,0
23828,552866,608_17_70,CZECH REPUBLIC,0,TOTALS,CZECH REPUBLIC,200,18,65,27.7,12,39,30.8,6,26,23.1,9,15,60.0,10,29,39,9,24,14,10,0,51,0
23829,552879,608_17_70,GEORGIA,0,TOTALS,GEORGIA,200,22,57,38.6,14,26,53.8,8,31,25.8,13,27,48.1,15,38,53,11,17,18,7,1,65,1
23830,552892,608_17_71,PORTUGAL,0,TOTALS,PORTUGAL,200,24,68,35.3,20,44,45.5,4,24,16.7,11,17,64.7,17,15,32,14,23,14,18,3,63,0
23831,552904,608_17_71,IRELAND,0,TOTALS,IRELAND,200,28,53,52.8,24,38,63.2,4,15,26.7,17,23,73.9,15,30,45,14,19,26,6,5,77,1
23832,552917,608_17_72,SLOVAK REPUBLIC,0,TOTALS,SLOVAK REPUBLIC,200,22,69,31.9,15,46,32.6,7,23,30.4,3,6,50.0,15,32,47,13,13,18,10,1,54,0
23833,552930,608_17_72,LUXEMBOURG,0,TOTALS,LUXEMBOURG,200,26,63,41.3,22,40,55.0,4,23,17.4,3,13,23.1,11,33,44,18,12,20,9,3,59,1
23834,552943,608_17_73,UKRAINE,0,TOTALS,UKRAINE,200,29,58,50.0,24,48,50.0,5,10,50.0,10,14,71.4,9,29,38,20,17,15,6,3,73,1
23835,552956,608_17_73,HUNGARY,0,TOTALS,HUNGARY,200,24,65,36.9,19,47,40.4,5,18,27.8,6,9,66.7,12,23,35,21,17,15,10,5,59,0
23836,552969,608_17_74,ICELAND,0,TOTALS,ICELAND,200,34,70,48.6,32,56,57.1,2,14,14.3,0,5,0.0,14,28,42,22,12,13,10,0,70,1
23837,552982,608_17_74,MKD,0,TOTALS,MKD,200,23,64,35.9,15,37,40.5,8,27,29.6,12,14,85.7,14,24,38,14,13,14,6,1,66,0
23838,552995,608_17_75,CYPRUS,0,TOTALS,CYPRUS,200,17,61,27.9,13,39,33.3,4,22,18.2,22,36,61.1,19,26,45,13,26,18,15,1,60,1
23839,553008,608_17_75,NORWAY,0,TOTALS,NORWAY,200,16,47,34.0,12,24,50.0,4,23,17.4,15,24,62.5,8,34,42,10,28,31,10,2,51,0
23840,553021,608_17_76,BELGIUM,0,TOTALS,BELGIUM,200,38,74,51.4,31,52,59.6,7,22,31.8,5,8,62.5,13,32,45,27,17,15,13,3,88,1
23841,553034,608_17_76,CZECH REPUBLIC,0,TOTALS,CZECH REPUBLIC,200,23,59,39.0,15,34,44.1,8,25,32.0,16,24,66.7,10,23,33,17,10,16,10,1,70,0
23842,553047,608_17_77,BULGARIA,0,TOTALS,BULGARIA,200,21,57,36.8,16,35,45.7,5,22,22.7,13,29,44.8,14,32,46,17,19,17,9,6,60,1
23843,553060,608_17_77,PORTUGAL,0,TOTALS,PORTUGAL,206,21,67,31.3,19,55,34.5,2,12,16.7,11,16,68.8,16,27,43,8,24,15,9,3,55,0
23844,553073,608_17_78,ROMANIA,0,TOTALS,ROMANIA,200,28,72,38.9,26,60,43.3,2,12,16.7,11,19,57.9,19,27,46,15,17,17,14,3,69,1
23845,553086,608_17_78,SLOVAK REPUBLIC,0,TOTALS,SLOVAK REPUBLIC,200,23,58,39.7,15,33,45.5,8,25,32.0,10,17,58.8,11,26,37,16,17,25,11,9,64,0
23846,553099,608_17_79,GREECE,0,TOTALS,GREECE,200,25,66,37.9,19,49,38.8,6,17,35.3,19,26,73.1,20,37,57,17,19,19,15,9,75,1
23847,553112,608_17_79,GREAT BRITAIN,0,TOTALS,GREAT BRITAIN,200,19,58,32.8,12,31,38.7,7,27,25.9,7,17,41.2,8,24,32,15,22,20,11,2,52,0
23848,553125,608_17_80,BELARUS,0,TOTALS,BELARUS,200,33,64,51.6,29,50,58.0,4,14,28.6,17,23,73.9,11,32,43,22,18,16,8,5,87,1
23849,553137,608_17_80,IRELAND,0,TOTALS,IRELAND,200,24,69,34.8,22,51,43.1,2,18,11.1,8,16,50.0,16,22,38,18,18,17,10,2,58,0
23850,553150,608_17_81,SWITZERLAND,0,TOTALS,SWITZERLAND,200,25,54,46.3,21,36,58.3,4,18,22.2,17,28,60.7,8,29,37,11,23,15,9,3,71,1
23851,553163,608_17_81,KOSOVO,0,TOTALS,KOSOVO,200,21,65,32.3,16,43,37.2,5,22,22.7,18,28,64.3,19,27,46,8,25,14,7,1,65,0
23852,553176,608_17_82,NETHERLANDS,0,TOTALS,NETHERLANDS,200,27,77,35.1,17,42,40.5,10,35,28.6,3,3,100.0,24,23,47,18,16,9,6,2,67,1
23853,553189,608_17_82,GEORGIA,0,TOTALS,GEORGIA,200,25,61,41.0,22,47,46.8,3,14,21.4,9,12,75.0,14,26,40,14,14,13,2,1,62,0
23854,553201,608_17_83,POLAND,0,TOTALS,POLAND,200,29,78,37.2,15,40,37.5,14,38,36.8,10,17,58.8,27,34,61,24,21,24,11,2,82,1
23855,553213,608_17_83,BOSNIA AND HERZEGOVINA,0,TOTALS,BOSNIA AND HERZEGOVINA,200,20,71,28.2,18,49,36.7,2,22,9.1,12,17,70.6,19,25,44,17,17,20,8,2,54,0
23856,553226,608_17_84,DENMARK,0,TOTALS,DENMARK,200,28,65,43.1,22,45,48.9,6,20,30.0,13,24,54.2,12,31,43,20,31,16,8,1,75,1
23857,553239,608_17_84,LUXEMBOURG,0,TOTALS,LUXEMBOURG,200,24,71,33.8,20,48,41.7,4,23,17.4,16,32,50.0,22,31,53,19,23,19,8,2,68,0
23858,553252,608_17_85,CYPRUS,0,TOTALS,CYPRUS,200,20,69,29.0,16,48,33.3,4,21,19.0,9,18,50.0,17,22,39,10,19,15,13,0,53,0
23859,553265,608_17_85,ROMANIA,0,TOTALS,ROMANIA,200,28,62,45.2,22,44,50.0,6,18,33.3,10,13,76.9,14,38,52,15,15,20,9,6,72,1
23860,553278,608_17_86,PORTUGAL,0,TOTALS,PORTUGAL,200,20,64,31.2,16,42,38.1,4,22,18.2,6,9,66.7,14,30,44,15,21,15,10,2,50,0
23861,553291,608_17_86,MKD,0,TOTALS,MKD,200,19,55,34.5,16,35,45.7,3,20,15.0,15,26,57.7,12,33,45,12,12,16,9,2,56,1
23862,553304,608_17_87,NORWAY,0,TOTALS,NORWAY,200,21,62,33.9,18,55,32.7,3,7,42.9,20,26,76.9,17,30,47,10,20,19,5,2,65,0
23863,553317,608_17_87,SLOVAK REPUBLIC,0,TOTALS,SLOVAK REPUBLIC,200,26,71,36.6,18,48,37.5,8,23,34.8,12,20,60.0,20,27,47,14,23,15,4,1,72,1
23864,553330,608_17_88,BULGARIA,0,TOTALS,BULGARIA,200,25,61,41.0,22,38,57.9,3,23,13.0,11,21,52.4,14,26,40,17,14,14,11,3,64,0
23865,553343,608_17_88,ICELAND,0,TOTALS,ICELAND,200,28,68,41.2,20,50,40.0,8,18,44.4,7,12,58.3,15,27,42,17,14,15,10,1,71,1
23866,553356,608_17_89,HUNGARY,0,TOTALS,HUNGARY,200,20,52,38.5,13,36,36.1,7,16,43.8,16,21,76.2,17,28,45,13,17,23,8,4,63,1
23867,553369,608_17_89,CZECH REPUBLIC,0,TOTALS,CZECH REPUBLIC,200,25,66,37.9,18,44,40.9,7,22,31.8,3,8,37.5,15,17,32,12,19,12,12,3,60,0
23868,553382,608_17_90,KOSOVO,0,TOTALS,KOSOVO,200,22,60,36.7,19,49,38.8,3,11,27.3,17,23,73.9,10,43,53,16,14,18,7,6,64,1
23869,553395,608_17_90,LUXEMBOURG,0,TOTALS,LUXEMBOURG,200,24,80,30.0,19,51,37.3,5,29,17.2,2,3,66.7,13,30,43,16,18,14,8,2,55,0
23870,553408,608_17_91,IRELAND,0,TOTALS,IRELAND,200,29,75,38.7,20,51,39.2,9,24,37.5,16,25,64.0,19,33,52,21,25,20,10,2,83,1
23871,553421,608_17_91,BOSNIA AND HERZEGOVINA,0,TOTALS,BOSNIA AND HERZEGOVINA,200,28,72,38.9,22,49,44.9,6,23,26.1,16,31,51.6,20,32,52,15,23,19,14,4,78,0
23872,553434,608_17_92,UKRAINE,0,TOTALS,UKRAINE,200,26,62,41.9,20,44,45.5,6,18,33.3,18,24,75.0,15,25,40,20,22,17,15,0,76,1
23873,553447,608_17_92,BELGIUM,0,TOTALS,BELGIUM,200,29,71,40.8,28,54,51.9,1,17,5.9,12,20,60.0,21,23,44,16,22,16,7,3,71,0
23874,553460,608_17_93,SWITZERLAND,0,TOTALS,SWITZERLAND,200,37,73,50.7,29,56,51.8,8,17,47.1,16,22,72.7,12,32,44,21,23,17,9,7,98,1
23875,553473,608_17_93,DENMARK,0,TOTALS,DENMARK,200,25,63,39.7,20,46,43.5,5,17,29.4,19,27,70.4,11,26,37,16,25,21,8,1,74,0
23876,553486,608_17_94,BELARUS,0,TOTALS,BELARUS,200,31,56,55.4,27,46,58.7,4,10,40.0,16,26,61.5,6,43,49,20,16,21,6,6,82,1
23877,553499,608_17_94,POLAND,0,TOTALS,POLAND,200,27,76,35.5,17,47,36.2,10,29,34.5,9,13,69.2,8,23,31,13,18,11,10,5,73,0
23878,553512,608_17_95,GREAT BRITAIN,0,TOTALS,GREAT BRITAIN,200,21,67,31.3,13,40,32.5,8,27,29.6,13,19,68.4,16,28,44,11,27,17,11,1,63,0
23879,553525,608_17_95,GEORGIA,0,TOTALS,GEORGIA,200,21,52,40.4,14,27,51.9,7,25,28.0,15,25,60.0,6,32,38,16,19,23,7,4,64,1
23880,553538,608_17_96,GREECE,0,TOTALS,GREECE,200,26,68,38.2,22,52,42.3,4,16,25.0,18,23,78.3,16,32,48,15,15,11,11,3,74,1
23881,553551,608_17_96,NETHERLANDS,0,TOTALS,NETHERLANDS,200,23,72,31.9,16,45,35.6,7,27,25.9,7,12,58.3,20,29,49,14,19,19,4,3,60,0
23882,553563,609_17_01,GIBRALTAR,0,TOTALS,GIBRALTAR,200,22,64,34.4,16,44,36.4,6,20,30.0,9,15,60.0,7,34,41,12,17,21,11,4,59,0
23883,553575,609_17_01,ARMENIA,0,TOTALS,ARMENIA,200,23,65,35.4,15,42,35.7,8,23,34.8,12,25,48.0,14,36,50,12,18,20,15,3,66,1
23884,553588,609_17_02,WALES,0,TOTALS,WALES,200,21,83,25.3,17,65,26.2,4,18,22.2,9,16,56.2,29,32,61,13,27,22,12,2,55,0
23885,553599,609_17_02,MOLDOVA,0,TOTALS,MOLDOVA,200,19,65,29.2,14,49,28.6,5,16,31.2,21,35,60.0,18,38,56,7,13,21,9,9,64,1
23886,553612,609_17_03,AZERBAIJAN,0,TOTALS,AZERBAIJAN,200,31,73,42.5,24,40,60.0,7,33,21.2,5,18,27.8,18,37,55,23,17,27,13,3,74,1
23887,553625,609_17_03,PRINCIPALITY OF MONACO,0,TOTALS,PRINCIPALITY OF MONACO,200,26,80,32.5,21,52,40.4,5,28,17.9,6,14,42.9,21,32,53,7,18,24,16,3,63,0
23888,553638,609_17_04,ANDORRA,0,TOTALS,ANDORRA,200,18,70,25.7,10,31,32.3,8,39,20.5,11,24,45.8,21,28,49,9,19,17,19,1,55,1
23889,553651,609_17_04,ALBANIA,0,TOTALS,ALBANIA,200,19,57,33.3,17,44,38.6,2,13,15.4,12,17,70.6,13,39,52,11,22,27,9,0,52,0
23890,553664,609_17_05,MALTA,0,TOTALS,MALTA,200,19,75,25.3,16,54,29.6,3,21,14.3,2,3,66.7,14,35,49,9,18,23,16,1,43,0
23891,553677,609_17_05,WALES,0,TOTALS,WALES,200,19,76,25.0,17,58,29.3,2,18,11.1,7,19,36.8,26,43,69,11,15,24,14,5,47,1
23892,553688,609_17_06,MOLDOVA,0,TOTALS,MOLDOVA,200,17,70,24.3,8,32,25.0,9,38,23.7,12,17,70.6,18,29,47,9,15,18,6,2,55,0
23893,553700,609_17_06,GIBRALTAR,0,TOTALS,GIBRALTAR,200,36,79,45.6,27,60,45.0,9,19,47.4,4,11,36.4,18,38,56,24,15,14,10,4,85,1
23894,553713,609_17_07,ALBANIA,0,TOTALS,ALBANIA,200,24,71,33.8,19,49,38.8,5,22,22.7,13,19,68.4,14,32,46,18,17,14,7,0,66,0
23895,553726,609_17_07,AZERBAIJAN,0,TOTALS,AZERBAIJAN,200,28,76,36.8,18,45,40.0,10,31,32.3,12,17,70.6,18,36,54,14,18,14,5,4,78,1
23896,553739,609_17_08,SAN MARINO,0,TOTALS,SAN MARINO,200,24,55,43.6,21,46,45.7,3,9,33.3,10,25,40.0,15,33,48,8,21,29,12,3,61,0
23897,553752,609_17_08,ANDORRA,0,TOTALS,ANDORRA,200,23,66,34.8,19,46,41.3,4,20,20.0,12,21,57.1,13,27,40,5,22,16,13,2,62,1
23898,553765,609_17_09,PRINCIPALITY OF MONACO,0,TOTALS,PRINCIPALITY OF MONACO,200,24,82,29.3,17,58,29.3,7,24,29.2,11,28,39.3,16,25,41,13,29,19,24,1,66,0
23899,553778,609_17_09,ALBANIA,0,TOTALS,ALBANIA,200,25,73,34.2,21,52,40.4,4,21,19.0,16,22,72.7,27,50,77,16,19,39,6,4,70,1
23900,553791,609_17_10,AZERBAIJAN,0,TOTALS,AZERBAIJAN,200,37,98,37.8,33,74,44.6,4,24,16.7,12,22,54.5,41,33,74,14,12,18,13,4,90,1
23901,553804,609_17_10,SAN MARINO,0,TOTALS,SAN MARINO,200,26,73,35.6,19,55,34.5,7,18,38.9,3,5,60.0,15,27,42,14,19,20,9,2,62,0
23902,553816,609_17_11,ARMENIA,0,TOTALS,ARMENIA,200,36,77,46.8,35,60,58.3,1,17,5.9,5,12,41.7,15,42,57,14,14,11,10,6,78,1
23903,553827,609_17_11,MOLDOVA,0,TOTALS,MOLDOVA,200,13,70,18.6,10,53,18.9,3,17,17.6,8,12,66.7,17,30,47,8,14,22,7,3,37,0
23904,553839,609_17_12,GIBRALTAR,0,TOTALS,GIBRALTAR,200,32,69,46.4,31,60,51.7,1,9,11.1,19,29,65.5,24,34,58,18,14,33,18,2,84,1
23905,553852,609_17_12,MALTA,0,TOTALS,MALTA,200,27,80,33.8,27,59,45.8,0,21,0.0,13,17,76.5,22,20,42,18,21,26,21,3,67,0
23906,553865,609_17_13,SAN MARINO,0,TOTALS,SAN MARINO,200,21,72,29.2,13,42,31.0,8,30,26.7,10,20,50.0,18,37,55,15,26,26,11,5,60,0
23907,553878,609_17_13,PRINCIPALITY OF MONACO,0,TOTALS,PRINCIPALITY OF MONACO,200,31,70,44.3,27,55,49.1,4,15,26.7,13,32,40.6,16,37,53,14,23,21,20,4,79,1
23908,553891,609_17_14,MALTA,0,TOTALS,MALTA,200,21,66,31.8,17,50,34.0,4,16,25.0,2,8,25.0,13,26,39,6,19,28,9,3,48,0
23909,553903,609_17_14,ARMENIA,0,TOTALS,ARMENIA,200,28,70,40.0,22,47,46.8,6,23,26.1,17,26,65.4,22,35,57,17,14,24,12,6,79,1
23910,553916,609_17_15,WALES,0,TOTALS,WALES,200,27,76,35.5,20,45,44.4,7,31,22.6,5,13,38.5,26,21,47,14,24,25,11,4,66,0
23911,553928,609_17_15,GIBRALTAR,0,TOTALS,GIBRALTAR,200,32,64,50.0,28,56,50.0,4,8,50.0,13,28,46.4,20,28,48,14,18,24,15,3,81,1
23912,553941,609_17_16,ANDORRA,0,TOTALS,ANDORRA,200,29,75,38.7,26,57,45.6,3,18,16.7,6,11,54.5,15,24,39,9,19,13,13,1,67,1
23913,553954,609_17_16,AZERBAIJAN,0,TOTALS,AZERBAIJAN,200,24,53,45.3,19,33,57.6,5,20,25.0,13,24,54.2,9,32,41,12,16,23,5,0,66,0
23914,553965,609_17_17,MOLDOVA,0,TOTALS,MOLDOVA,200,27,65,41.5,25,48,52.1,2,17,11.8,18,25,72.0,17,39,56,15,7,30,10,7,74,1
23915,553978,609_17_17,MALTA,0,TOTALS,MALTA,200,28,87,32.2,21,67,31.3,7,20,35.0,3,4,75.0,21,24,45,14,20,20,13,0,66,0
23916,553990,609_17_18,ARMENIA,0,TOTALS,ARMENIA,200,30,76,39.5,22,51,43.1,8,25,32.0,17,27,63.0,22,34,56,19,15,17,15,7,85,1
23917,554003,609_17_18,WALES,0,TOTALS,WALES,200,22,68,32.4,19,51,37.3,3,17,17.6,6,10,60.0,15,28,43,16,19,25,10,1,53,0
23918,554016,609_17_19,ALBANIA,0,TOTALS,ALBANIA,200,24,68,35.3,21,57,36.8,3,11,27.3,15,23,65.2,20,38,58,11,12,19,4,5,66,1
23919,554029,609_17_19,SAN MARINO,0,TOTALS,SAN MARINO,200,25,81,30.9,17,58,29.3,8,23,34.8,5,8,62.5,21,27,48,12,15,13,7,4,63,0
23920,554042,609_17_20,PRINCIPALITY OF MONACO,0,TOTALS,PRINCIPALITY OF MONACO,200,20,60,33.3,14,36,38.9,6,24,25.0,12,23,52.2,13,30,43,15,18,27,14,4,58,1
23921,554055,609_17_20,ANDORRA,0,TOTALS,ANDORRA,200,20,66,30.3,14,40,35.0,6,26,23.1,6,12,50.0,19,31,50,10,21,30,17,4,52,0
23922,554066,609_17_21,MOLDOVA,0,TOTALS,MOLDOVA,200,24,62,38.7,23,47,48.9,1,15,6.7,10,16,62.5,9,29,38,17,6,35,11,3,59,0
23923,554079,609_17_21,PRINCIPALITY OF MONACO,0,TOTALS,PRINCIPALITY OF MONACO,200,40,92,43.5,23,58,39.7,17,34,50.0,1,2,50.0,24,32,56,28,20,24,18,4,98,1
23924,554092,609_17_22,ALBANIA,0,TOTALS,ALBANIA,200,23,67,34.3,19,45,42.2,4,22,18.2,8,12,66.7,17,35,52,21,11,25,17,2,58,1
23925,554105,609_17_22,WALES,0,TOTALS,WALES,200,19,72,26.4,16,37,43.2,3,35,8.6,6,11,54.5,19,29,48,14,15,24,15,2,47,0
23926,554117,609_17_23,ARMENIA,0,TOTALS,ARMENIA,200,35,79,44.3,30,59,50.8,5,20,25.0,13,23,56.5,18,45,63,13,15,16,2,6,88,1
23927,554130,609_17_23,AZERBAIJAN,0,TOTALS,AZERBAIJAN,200,26,84,31.0,12,38,31.6,14,46,30.4,10,25,40.0,17,32,49,12,24,9,7,5,76,0
23928,554143,609_17_24,ANDORRA,0,TOTALS,ANDORRA,200,22,79,27.8,15,47,31.9,7,32,21.9,5,16,31.2,24,18,42,13,21,24,22,3,56,0
23929,554155,609_17_24,GIBRALTAR,0,TOTALS,GIBRALTAR,200,22,50,44.0,20,39,51.3,2,11,18.2,15,26,57.7,14,39,53,10,15,36,14,2,61,1
23930,554168,609_17_25,MALTA,0,TOTALS,MALTA,200,26,75,34.7,23,63,36.5,3,12,25.0,10,20,50.0,19,34,53,12,17,19,8,3,65,0
23931,554181,609_17_25,SAN MARINO,0,TOTALS,SAN MARINO,200,25,81,30.9,17,46,37.0,8,35,22.9,11,16,68.8,23,33,56,14,15,20,10,5,69,1
23932,554192,609_17_26,MOLDOVA,0,TOTALS,MOLDOVA,200,21,70,30.0,15,45,33.3,6,25,24.0,12,19,63.2,18,32,50,11,13,21,10,5,60,0
23933,554205,609_17_26,WALES,0,TOTALS,WALES,200,27,73,37.0,23,54,42.6,4,19,21.1,7,18,38.9,18,32,50,16,16,19,13,6,65,1
23934,554218,609_17_27,PRINCIPALITY OF MONACO,0,TOTALS,PRINCIPALITY OF MONACO,200,33,86,38.4,26,53,49.1,7,33,21.2,6,13,46.2,17,26,43,20,11,14,18,3,79,1
23935,554231,609_17_27,ALBANIA,0,TOTALS,ALBANIA,200,28,65,43.1,19,40,47.5,9,25,36.0,6,9,66.7,12,40,52,25,14,31,9,1,71,0
23936,554244,609_17_28,AZERBAIJAN,0,TOTALS,AZERBAIJAN,200,26,74,35.1,18,46,39.1,8,28,28.6,15,24,62.5,13,39,52,16,15,13,12,3,75,1
23937,554257,609_17_28,ANDORRA,0,TOTALS,ANDORRA,200,24,86,27.9,22,57,38.6,2,29,6.9,5,10,50.0,25,39,64,13,18,19,10,2,55,0
23938,554269,609_17_29,ARMENIA,0,TOTALS,ARMENIA,200,36,76,47.4,31,56,55.4,5,20,25.0,11,23,47.8,17,43,60,24,20,22,9,6,88,1
23939,554281,609_17_29,GIBRALTAR,0,TOTALS,GIBRALTAR,200,25,80,31.2,18,51,35.3,7,29,24.1,13,30,43.3,18,26,44,19,19,17,13,2,70,0
23940,558181,613_17_01,AUSTRALIA,0,TOTALS,AUSTRALIA,200,63,96,65.6,54,81,66.7,9,15,60.0,20,27,74.1,21,27,48,46,10,15,40,1,155,0
23941,558193,613_17_01,NEW CALEDONIA,0,TOTALS,NEW CALEDONIA,200,12,47,25.5,11,34,32.4,1,13,7.7,7,11,63.6,6,14,20,4,21,57,7,2,32,1
23942,558206,613_17_02,PALAU,0,TOTALS,PALAU,200,17,63,27.0,15,57,26.3,2,6,33.3,12,16,75.0,17,25,42,12,34,57,8,8,48,1
23943,558219,613_17_02,SAMOA,0,TOTALS,SAMOA,200,53,107,49.5,52,97,53.6,1,10,10.0,19,37,51.4,38,30,68,30,20,27,41,10,126,0
23944,558232,613_17_03,NEW ZEALAND,0,TOTALS,NEW ZEALAND,200,39,75,52.0,33,56,58.9,6,19,31.6,22,38,57.9,24,34,58,12,13,19,8,3,106,0
23945,558245,613_17_03,TAHITI,0,TOTALS,TAHITI,200,16,58,27.6,13,39,33.3,3,19,15.8,1,6,16.7,8,18,26,2,32,28,9,0,36,1
23946,558258,613_17_04,MARSHALL ISLANDS,0,TOTALS,MARSHALL ISLANDS,200,15,56,26.8,13,38,34.2,2,18,11.1,2,4,50.0,7,21,28,8,21,53,9,2,34,1
23947,558271,613_17_04,GUAM,0,TOTALS,GUAM,200,63,109,57.8,58,94,61.7,5,15,33.3,20,30,66.7,26,36,62,37,8,16,41,1,151,0
23948,558284,613_17_05,TAHITI,0,TOTALS,TAHITI,200,39,87,44.8,34,61,55.7,5,26,19.2,14,35,40.0,20,42,62,21,19,27,27,3,97,1
23949,558297,613_17_05,MARSHALL ISLANDS,0,TOTALS,MARSHALL ISLANDS,200,13,67,19.4,9,36,25.0,4,31,12.9,6,14,42.9,15,40,55,10,30,42,14,0,36,0
23950,558310,613_17_06,SAMOA,0,TOTALS,SAMOA,200,30,84,35.7,25,64,39.1,5,20,25.0,17,29,58.6,15,43,58,10,15,15,11,3,82,1
23951,558322,613_17_06,NEW CALEDONIA,0,TOTALS,NEW CALEDONIA,200,24,76,31.6,20,56,35.7,4,20,20.0,12,19,63.2,11,40,51,12,25,21,8,3,64,0
23952,558335,613_17_07,GUAM,0,TOTALS,GUAM,200,29,72,40.3,18,49,36.7,11,23,47.8,9,18,50.0,11,17,28,10,27,11,11,0,78,0
23953,558348,613_17_07,NEW ZEALAND,0,TOTALS,NEW ZEALAND,200,31,59,52.5,27,46,58.7,4,13,30.8,24,37,64.9,12,35,47,7,14,19,6,6,90,1
23954,558361,613_17_08,PALAU,0,TOTALS,PALAU,200,11,44,25.0,11,39,28.2,0,5,0.0,10,14,71.4,2,8,10,0,26,34,5,0,32,1
23955,558372,613_17_08,AUSTRALIA,0,TOTALS,AUSTRALIA,200,66,99,66.7,53,67,79.1,13,32,40.6,23,31,74.2,23,28,51,37,19,11,26,7,168,0
23956,558384,613_17_09,NEW CALEDONIA,0,TOTALS,NEW CALEDONIA,200,26,96,27.1,21,78,26.9,5,18,27.8,8,24,33.3,35,39,74,16,22,33,21,3,65,1
23957,558397,613_17_09,PALAU,0,TOTALS,PALAU,200,17,67,25.4,15,56,26.8,2,11,18.2,5,15,33.3,13,42,55,12,22,48,17,1,41,0
23958,558408,613_17_10,AUSTRALIA,0,TOTALS,AUSTRALIA,200,58,113,51.3,45,78,57.7,13,35,37.1,13,24,54.2,40,30,70,30,22,18,27,5,142,0
23959,558421,613_17_10,SAMOA,0,TOTALS,SAMOA,200,13,46,28.3,11,40,27.5,2,6,33.3,6,19,31.6,8,17,25,4,22,42,9,5,34,1
23960,558434,613_17_11,GUAM,0,TOTALS,GUAM,200,43,100,43.0,35,71,49.3,8,29,27.6,24,34,70.6,24,29,53,15,25,11,21,2,118,0
23961,558447,613_17_11,TAHITI,0,TOTALS,TAHITI,200,28,60,46.7,27,55,49.1,1,5,20.0,17,29,58.6,10,36,46,7,26,40,7,5,74,1
23962,558460,613_17_12,NEW ZEALAND,0,TOTALS,NEW ZEALAND,200,52,76,68.4,41,54,75.9,11,22,50.0,10,13,76.9,15,36,51,26,7,14,17,3,125,0
23963,558473,613_17_12,MARSHALL ISLANDS,0,TOTALS,MARSHALL ISLANDS,200,13,59,22.0,8,27,29.6,5,32,15.6,2,4,50.0,8,12,20,4,11,25,8,0,33,1
23964,558486,613_17_13,PALAU,0,TOTALS,PALAU,200,19,79,24.1,17,64,26.6,2,15,13.3,22,32,68.8,36,44,80,7,22,28,9,3,62,1
23965,558499,613_17_13,MARSHALL ISLANDS,0,TOTALS,MARSHALL ISLANDS,200,18,72,25.0,10,35,28.6,8,37,21.6,6,15,40.0,12,25,37,11,28,17,10,0,50,0
23966,558512,613_17_14,TAHITI,0,TOTALS,TAHITI,200,29,84,34.5,25,62,40.3,4,22,18.2,15,27,55.6,19,26,45,10,20,21,32,5,77,1
23967,558524,613_17_14,NEW CALEDONIA,0,TOTALS,NEW CALEDONIA,200,26,72,36.1,23,55,41.8,3,17,17.6,15,23,65.2,21,41,62,15,27,39,13,1,70,0
23968,558537,613_17_15,NEW ZEALAND,0,TOTALS,NEW ZEALAND,200,38,79,48.1,23,43,53.5,15,36,41.7,5,6,83.3,14,36,50,24,13,11,10,5,96,1
23969,558550,613_17_15,SAMOA,0,TOTALS,SAMOA,200,25,71,35.2,22,57,38.6,3,14,21.4,5,10,50.0,13,27,40,8,11,17,6,0,58,0
23970,558561,613_17_16,AUSTRALIA,0,TOTALS,AUSTRALIA,200,68,95,71.6,65,84,77.4,3,11,27.3,16,25,64.0,16,47,63,30,14,9,25,12,155,0
23971,558574,613_17_16,GUAM,0,TOTALS,GUAM,200,12,65,18.5,8,46,17.4,4,19,21.1,11,19,57.9,9,13,22,5,18,28,4,0,39,1
23972,558587,613_17_17,SAMOA,0,TOTALS,SAMOA,200,28,58,48.3,23,44,52.3,5,14,35.7,9,13,69.2,14,21,35,11,15,27,4,3,70,1
23973,558600,613_17_17,GUAM,0,TOTALS,GUAM,200,46,85,54.1,39,62,62.9,7,23,30.4,6,14,42.9,19,16,35,16,15,17,20,1,105,0
23974,558613,613_17_18,NEW ZEALAND,0,TOTALS,NEW ZEALAND,200,21,56,37.5,19,40,47.5,2,16,12.5,11,18,61.1,7,26,33,5,11,27,6,3,55,0
23975,558624,613_17_18,AUSTRALIA,0,TOTALS,AUSTRALIA,200,39,86,45.3,33,68,48.5,6,18,33.3,9,13,69.2,21,28,49,19,16,12,17,6,93,1
